,number,last_update,available_bike_stands,available_bikes,total_bike_stands,description
0,2,1551726000,15,5,20,Rain
1,3,1551726000,19,1,20,Rain
2,4,1551726000,20,0,20,Rain
3,5,1551726000,11,29,40,Rain
4,6,1551726000,16,4,20,Rain
5,7,1551726000,9,19,28,Rain
6,8,1551726000,15,15,30,Rain
7,9,1551726000,5,19,24,Rain
8,10,1551726000,7,9,16,Rain
9,11,1551726000,30,0,30,Rain
10,12,1551726000,16,4,20,Rain
11,13,1551726000,29,1,30,Rain
12,14,1551726000,5,25,30,Rain
13,15,1551726000,16,0,16,Rain
14,16,1551726000,4,16,20,Rain
15,17,1551726000,18,2,20,Rain
16,18,1551726000,24,6,30,Rain
17,19,1551726000,30,0,30,Rain
18,21,1551726000,4,26,30,Rain
19,22,1551726000,1,19,20,Rain
20,23,1551726000,2,28,30,Rain
21,24,1551726000,14,6,20,Rain
22,25,1551726000,28,2,30,Rain
23,26,1551726000,3,17,20,Rain
24,27,1551726000,18,2,20,Rain
25,28,1551726000,26,4,30,Rain
26,29,1551726000,23,6,29,Rain
27,30,1551726000,18,2,20,Rain
28,31,1551726000,14,6,20,Rain
29,32,1551726000,7,23,30,Rain
30,33,1551726000,1,22,23,Rain
31,34,1551726000,5,25,30,Rain
32,35,1551726000,30,0,30,Rain
33,36,1551726000,35,5,40,Rain
34,38,1551726000,26,14,40,Rain
35,39,1551726000,13,7,20,Rain
36,40,1551726000,21,0,21,Rain
37,41,1551726000,20,0,20,Rain
38,42,1551726000,20,10,30,Rain
39,43,1551726000,5,25,30,Rain
40,44,1551726000,21,9,30,Rain
41,45,1551726000,23,7,30,Rain
42,46,1551726000,15,5,20,Rain
43,47,1551726000,40,0,40,Rain
44,48,1551726000,32,8,40,Rain
45,49,1551726000,29,11,40,Rain
46,50,1551726000,19,21,40,Rain
47,51,1551726000,21,19,40,Rain
48,52,1551726000,30,2,32,Rain
49,53,1551726000,30,10,40,Rain
50,54,1551726000,33,0,33,Rain
51,55,1551726000,36,0,36,Rain
52,56,1551726000,39,1,40,Rain
53,57,1551726000,22,1,23,Rain
54,58,1551726000,37,3,40,Rain
55,59,1551726000,18,2,20,Rain
56,60,1551726000,2,28,30,Rain
57,61,1551726000,23,2,25,Rain
58,62,1551726000,40,0,40,Rain
59,63,1551726000,32,3,35,Rain
60,64,1551726000,9,31,40,Rain
61,65,1551726000,39,1,40,Rain
62,66,1551726000,40,0,40,Rain
63,67,1551726000,15,25,40,Rain
64,68,1551726000,37,3,40,Rain
65,69,1551726000,35,5,40,Rain
66,70,1551726000,11,17,28,Rain
67,71,1551726000,30,10,40,Rain
68,72,1551726000,11,14,25,Rain
69,73,1551726000,27,3,30,Rain
70,74,1551726000,3,27,30,Rain
71,75,1551726000,27,13,40,Rain
72,76,1551726000,34,4,38,Rain
73,77,1551726000,29,0,29,Rain
74,78,1551726000,34,6,40,Rain
75,79,1551726000,26,1,27,Rain
76,80,1551726000,15,25,40,Rain
77,81,1551726000,31,9,40,Rain
78,82,1551726000,16,6,22,Rain
79,83,1551726000,28,12,40,Rain
80,84,1551726000,21,9,30,Rain
81,85,1551726000,21,14,35,Rain
82,86,1551726000,23,15,38,Rain
83,87,1551726000,22,16,38,Rain
84,88,1551726000,21,9,30,Rain
85,89,1551726000,39,1,40,Rain
86,90,1551726000,40,0,40,Rain
87,91,1551726000,19,11,30,Rain
88,92,1551726000,13,27,40,Rain
89,93,1551726000,1,39,40,Rain
90,94,1551726000,26,14,40,Rain
91,95,1551726000,17,23,40,Rain
92,96,1551726000,26,4,30,Rain
93,97,1551726000,28,12,40,Rain
94,98,1551726000,31,9,40,Rain
95,99,1551726000,17,13,30,Rain
96,100,1551726000,0,25,25,Rain
97,101,1551726000,27,3,30,Rain
98,102,1551726000,38,2,40,Rain
99,103,1551726000,37,3,40,Rain
100,104,1551726000,40,0,40,Rain
101,105,1551726000,32,4,36,Rain
102,106,1551726000,39,1,40,Rain
103,107,1551726000,35,5,40,Rain
104,108,1551726000,30,10,40,Rain
105,109,1551726000,29,0,29,Rain
106,110,1551726000,34,6,40,Rain
107,111,1551726000,40,0,40,Rain
108,112,1551726000,24,6,30,Rain
109,113,1551726000,20,20,40,Rain
110,114,1551726000,40,0,40,Rain
111,115,1551726000,10,20,30,Rain
112,2,1551729600,14,6,20,Clouds
113,3,1551729600,19,1,20,Clouds
114,4,1551729600,18,2,20,Clouds
115,5,1551729600,8,32,40,Clouds
116,6,1551729600,18,2,20,Clouds
117,7,1551729600,9,19,28,Clouds
118,8,1551729600,21,9,30,Clouds
119,9,1551729600,9,15,24,Clouds
120,10,1551729600,6,10,16,Clouds
121,11,1551729600,21,9,30,Clouds
122,12,1551729600,15,5,20,Clouds
123,13,1551729600,30,0,30,Clouds
124,14,1551729600,11,19,30,Clouds
125,15,1551729600,11,5,16,Clouds
126,16,1551729600,6,14,20,Clouds
127,17,1551729600,18,2,20,Clouds
128,18,1551729600,24,6,30,Clouds
129,19,1551729600,30,0,30,Clouds
130,21,1551729600,10,20,30,Clouds
131,22,1551729600,1,19,20,Clouds
132,23,1551729600,1,29,30,Clouds
133,24,1551729600,19,1,20,Clouds
134,25,1551729600,22,8,30,Clouds
135,26,1551729600,1,19,20,Clouds
136,27,1551729600,20,0,20,Clouds
137,28,1551729600,22,8,30,Clouds
138,29,1551729600,20,9,29,Clouds
139,30,1551729600,17,3,20,Clouds
140,31,1551729600,15,5,20,Clouds
141,32,1551729600,5,25,30,Clouds
142,33,1551729600,5,18,23,Clouds
143,34,1551729600,0,30,30,Clouds
144,35,1551729600,28,2,30,Clouds
145,36,1551729600,40,0,40,Clouds
146,38,1551729600,21,19,40,Clouds
147,39,1551729600,8,12,20,Clouds
148,40,1551729600,17,4,21,Clouds
149,41,1551729600,16,4,20,Clouds
150,42,1551729600,10,20,30,Clouds
151,43,1551729600,12,18,30,Clouds
152,44,1551729600,14,16,30,Clouds
153,45,1551729600,24,6,30,Clouds
154,46,1551729600,16,4,20,Clouds
155,47,1551729600,40,0,40,Clouds
156,48,1551729600,35,5,40,Clouds
157,49,1551729600,37,3,40,Clouds
158,50,1551729600,13,27,40,Clouds
159,51,1551729600,27,13,40,Clouds
160,52,1551729600,31,1,32,Clouds
161,53,1551729600,40,0,40,Clouds
162,54,1551729600,31,2,33,Clouds
163,55,1551729600,36,0,36,Clouds
164,56,1551729600,33,7,40,Clouds
165,57,1551729600,23,0,23,Clouds
166,58,1551729600,39,1,40,Clouds
167,59,1551729600,18,2,20,Clouds
168,60,1551729600,0,30,30,Clouds
169,61,1551729600,23,2,25,Clouds
170,62,1551729600,40,0,40,Clouds
171,63,1551729600,35,0,35,Clouds
172,64,1551729600,23,17,40,Clouds
173,65,1551729600,40,0,40,Clouds
174,66,1551729600,37,3,40,Clouds
175,67,1551729600,17,23,40,Clouds
176,68,1551729600,40,0,40,Clouds
177,69,1551729600,38,2,40,Clouds
178,70,1551729600,4,23,27,Clouds
179,71,1551729600,32,8,40,Clouds
180,72,1551729600,3,22,25,Clouds
181,73,1551729600,27,3,30,Clouds
182,74,1551729600,3,27,30,Clouds
183,75,1551729600,28,12,40,Clouds
184,76,1551729600,24,14,38,Clouds
185,77,1551729600,26,3,29,Clouds
186,78,1551729600,26,14,40,Clouds
187,79,1551729600,26,1,27,Clouds
188,80,1551729600,10,30,40,Clouds
189,81,1551729600,24,16,40,Clouds
190,82,1551729600,12,10,22,Clouds
191,83,1551729600,17,23,40,Clouds
192,84,1551729600,14,16,30,Clouds
193,85,1551729600,17,18,35,Clouds
194,86,1551729600,16,22,38,Clouds
195,87,1551729600,18,20,38,Clouds
196,88,1551729600,20,10,30,Clouds
197,89,1551729600,32,8,40,Clouds
198,90,1551729600,40,0,40,Clouds
199,91,1551729600,13,17,30,Clouds
200,92,1551729600,2,38,40,Clouds
201,93,1551729600,0,40,40,Clouds
202,94,1551729600,21,19,40,Clouds
203,95,1551729600,15,25,40,Clouds
204,96,1551729600,22,8,30,Clouds
205,97,1551729600,18,21,39,Clouds
206,98,1551729600,40,0,40,Clouds
207,99,1551729600,30,0,30,Clouds
208,100,1551729600,0,25,25,Clouds
209,101,1551729600,25,4,29,Clouds
210,102,1551729600,40,0,40,Clouds
211,103,1551729600,40,0,40,Clouds
212,104,1551729600,40,0,40,Clouds
213,105,1551729600,31,5,36,Clouds
214,106,1551729600,38,2,40,Clouds
215,107,1551729600,29,11,40,Clouds
216,108,1551729600,30,10,40,Clouds
217,109,1551729600,27,2,29,Clouds
218,110,1551729600,33,7,40,Clouds
219,111,1551729600,37,3,40,Clouds
220,112,1551729600,21,9,30,Clouds
221,113,1551729600,38,2,40,Clouds
222,114,1551729600,40,0,40,Clouds
223,115,1551729600,8,22,30,Clouds
224,2,1551733200,14,6,20,Rain
225,3,1551733200,20,0,20,Rain
226,4,1551733200,13,7,20,Rain
227,5,1551733200,17,23,40,Rain
228,6,1551733200,17,3,20,Rain
229,7,1551733200,5,23,28,Rain
230,8,1551733200,27,3,30,Rain
231,9,1551733200,24,0,24,Rain
232,10,1551733200,6,10,16,Rain
233,11,1551733200,22,8,30,Rain
234,12,1551733200,14,6,20,Rain
235,13,1551733200,29,1,30,Rain
236,14,1551733200,20,10,30,Rain
237,15,1551733200,14,2,16,Rain
238,16,1551733200,11,9,20,Rain
239,17,1551733200,18,2,20,Rain
240,18,1551733200,21,9,30,Rain
241,19,1551733200,26,4,30,Rain
242,21,1551733200,20,10,30,Rain
243,22,1551733200,12,8,20,Rain
244,23,1551733200,1,29,30,Rain
245,24,1551733200,18,2,20,Rain
246,25,1551733200,23,7,30,Rain
247,26,1551733200,4,16,20,Rain
248,27,1551733200,20,0,20,Rain
249,28,1551733200,20,10,30,Rain
250,29,1551733200,23,6,29,Rain
251,30,1551733200,19,1,20,Rain
252,31,1551733200,18,2,20,Rain
253,32,1551733200,6,24,30,Rain
254,33,1551733200,11,12,23,Rain
255,34,1551733200,0,30,30,Rain
256,35,1551733200,26,4,30,Rain
257,36,1551733200,31,9,40,Rain
258,38,1551733200,28,11,39,Rain
259,39,1551733200,15,5,20,Rain
260,40,1551733200,19,1,20,Rain
261,41,1551733200,18,2,20,Rain
262,42,1551733200,3,27,30,Rain
263,43,1551733200,0,30,30,Rain
264,44,1551733200,0,30,30,Rain
265,45,1551733200,24,6,30,Rain
266,46,1551733200,15,5,20,Rain
267,47,1551733200,40,0,40,Rain
268,48,1551733200,37,3,40,Rain
269,49,1551733200,40,0,40,Rain
270,50,1551733200,8,32,40,Rain
271,51,1551733200,26,14,40,Rain
272,52,1551733200,32,0,32,Rain
273,53,1551733200,34,6,40,Rain
274,54,1551733200,33,0,33,Rain
275,55,1551733200,35,1,36,Rain
276,56,1551733200,33,7,40,Rain
277,57,1551733200,23,0,23,Rain
278,58,1551733200,38,2,40,Rain
279,59,1551733200,20,0,20,Rain
280,60,1551733200,0,30,30,Rain
281,61,1551733200,25,0,25,Rain
282,62,1551733200,38,2,40,Rain
283,63,1551733200,35,0,35,Rain
284,64,1551733200,28,12,40,Rain
285,65,1551733200,40,0,40,Rain
286,66,1551733200,35,5,40,Rain
287,67,1551733200,10,30,40,Rain
288,68,1551733200,40,0,40,Rain
289,69,1551733200,38,2,40,Rain
290,70,1551733200,17,10,27,Rain
291,71,1551733200,29,11,40,Rain
292,72,1551733200,0,25,25,Rain
293,73,1551733200,13,17,30,Rain
294,74,1551733200,9,21,30,Rain
295,75,1551733200,22,18,40,Rain
296,76,1551733200,24,14,38,Rain
297,77,1551733200,27,2,29,Rain
298,78,1551733200,21,19,40,Rain
299,79,1551733200,27,0,27,Rain
300,80,1551733200,8,32,40,Rain
301,81,1551733200,25,15,40,Rain
302,82,1551733200,5,17,22,Rain
303,83,1551733200,12,28,40,Rain
304,84,1551733200,7,23,30,Rain
305,85,1551733200,13,22,35,Rain
306,86,1551733200,13,25,38,Rain
307,87,1551733200,17,21,38,Rain
308,88,1551733200,17,13,30,Rain
309,89,1551733200,33,7,40,Rain
310,90,1551733200,40,0,40,Rain
311,91,1551733200,16,14,30,Rain
312,92,1551733200,16,24,40,Rain
313,93,1551733200,0,40,40,Rain
314,94,1551733200,16,24,40,Rain
315,95,1551733200,12,28,40,Rain
316,96,1551733200,22,8,30,Rain
317,97,1551733200,10,29,39,Rain
318,98,1551733200,40,0,40,Rain
319,99,1551733200,30,0,30,Rain
320,100,1551733200,0,25,25,Rain
321,101,1551733200,25,5,30,Rain
322,102,1551733200,37,3,40,Rain
323,103,1551733200,40,0,40,Rain
324,104,1551733200,40,0,40,Rain
325,105,1551733200,31,5,36,Rain
326,106,1551733200,36,4,40,Rain
327,107,1551733200,29,11,40,Rain
328,108,1551733200,27,13,40,Rain
329,109,1551733200,25,4,29,Rain
330,110,1551733200,31,9,40,Rain
331,111,1551733200,32,8,40,Rain
332,112,1551733200,12,18,30,Rain
333,113,1551733200,40,0,40,Rain
334,114,1551733200,35,5,40,Rain
335,115,1551733200,0,30,30,Rain
336,2,1551736800,15,5,20,Rain
337,3,1551736800,20,0,20,Rain
338,4,1551736800,12,8,20,Rain
339,5,1551736800,14,26,40,Rain
340,6,1551736800,18,2,20,Rain
341,7,1551736800,6,22,28,Rain
342,8,1551736800,30,0,30,Rain
343,9,1551736800,23,1,24,Rain
344,10,1551736800,12,4,16,Rain
345,11,1551736800,29,1,30,Rain
346,12,1551736800,15,5,20,Rain
347,13,1551736800,30,0,30,Rain
348,14,1551736800,28,2,30,Rain
349,15,1551736800,15,1,16,Rain
350,16,1551736800,13,7,20,Rain
351,17,1551736800,20,0,20,Rain
352,18,1551736800,17,13,30,Rain
353,19,1551736800,24,6,30,Rain
354,21,1551736800,28,2,30,Rain
355,22,1551736800,11,9,20,Rain
356,23,1551736800,0,30,30,Rain
357,24,1551736800,20,0,20,Rain
358,25,1551736800,26,4,30,Rain
359,26,1551736800,5,15,20,Rain
360,27,1551736800,20,0,20,Rain
361,28,1551736800,21,9,30,Rain
362,29,1551736800,24,5,29,Rain
363,30,1551736800,19,1,20,Rain
364,31,1551736800,20,0,20,Rain
365,32,1551736800,11,19,30,Rain
366,33,1551736800,10,13,23,Rain
367,34,1551736800,3,27,30,Rain
368,35,1551736800,16,14,30,Rain
369,36,1551736800,35,5,40,Rain
370,38,1551736800,29,11,40,Rain
371,39,1551736800,15,5,20,Rain
372,40,1551736800,21,0,21,Rain
373,41,1551736800,16,4,20,Rain
374,42,1551736800,4,26,30,Rain
375,43,1551736800,0,30,30,Rain
376,44,1551736800,0,30,30,Rain
377,45,1551736800,22,8,30,Rain
378,46,1551736800,15,5,20,Rain
379,47,1551736800,34,6,40,Rain
380,48,1551736800,40,0,40,Rain
381,49,1551736800,39,1,40,Rain
382,50,1551736800,0,40,40,Rain
383,51,1551736800,29,11,40,Rain
384,52,1551736800,32,0,32,Rain
385,53,1551736800,38,2,40,Rain
386,54,1551736800,30,3,33,Rain
387,55,1551736800,35,1,36,Rain
388,56,1551736800,33,7,40,Rain
389,57,1551736800,21,2,23,Rain
390,58,1551736800,40,0,40,Rain
391,59,1551736800,20,0,20,Rain
392,60,1551736800,0,30,30,Rain
393,61,1551736800,24,1,25,Rain
394,62,1551736800,40,0,40,Rain
395,63,1551736800,32,3,35,Rain
396,64,1551736800,30,10,40,Rain
397,65,1551736800,40,0,40,Rain
398,66,1551736800,40,0,40,Rain
399,67,1551736800,0,40,40,Rain
400,68,1551736800,38,2,40,Rain
401,69,1551736800,37,3,40,Rain
402,70,1551736800,22,6,28,Rain
403,71,1551736800,35,5,40,Rain
404,72,1551736800,5,20,25,Rain
405,73,1551736800,10,20,30,Rain
406,74,1551736800,3,27,30,Rain
407,75,1551736800,19,21,40,Rain
408,76,1551736800,20,18,38,Rain
409,77,1551736800,26,3,29,Rain
410,78,1551736800,16,24,40,Rain
411,79,1551736800,27,0,27,Rain
412,80,1551736800,11,29,40,Rain
413,81,1551736800,27,13,40,Rain
414,82,1551736800,5,17,22,Rain
415,83,1551736800,6,34,40,Rain
416,84,1551736800,1,29,30,Rain
417,85,1551736800,7,28,35,Rain
418,86,1551736800,7,31,38,Rain
419,87,1551736800,16,22,38,Rain
420,88,1551736800,12,18,30,Rain
421,89,1551736800,38,2,40,Rain
422,90,1551736800,40,0,40,Rain
423,91,1551736800,23,7,30,Rain
424,92,1551736800,14,26,40,Rain
425,93,1551736800,0,40,40,Rain
426,94,1551736800,15,25,40,Rain
427,95,1551736800,8,32,40,Rain
428,96,1551736800,22,8,30,Rain
429,97,1551736800,9,30,39,Rain
430,98,1551736800,40,0,40,Rain
431,99,1551736800,29,1,30,Rain
432,100,1551736800,1,24,25,Rain
433,101,1551736800,21,9,30,Rain
434,102,1551736800,37,3,40,Rain
435,103,1551736800,40,0,40,Rain
436,104,1551736800,40,0,40,Rain
437,105,1551736800,32,4,36,Rain
438,106,1551736800,37,3,40,Rain
439,107,1551736800,28,12,40,Rain
440,108,1551736800,23,17,40,Rain
441,109,1551736800,21,8,29,Rain
442,110,1551736800,30,10,40,Rain
443,111,1551736800,26,14,40,Rain
444,112,1551736800,0,30,30,Rain
445,113,1551736800,40,0,40,Rain
446,114,1551736800,33,7,40,Rain
447,115,1551736800,17,13,30,Rain
448,2,1551740400,7,13,20,Clouds
449,3,1551740400,14,6,20,Clouds
450,4,1551740400,11,9,20,Clouds
451,5,1551740400,14,26,40,Clouds
452,6,1551740400,19,1,20,Clouds
453,7,1551740400,6,23,29,Clouds
454,8,1551740400,30,0,30,Clouds
455,9,1551740400,24,0,24,Clouds
456,10,1551740400,13,3,16,Clouds
457,11,1551740400,30,0,30,Clouds
458,12,1551740400,15,5,20,Clouds
459,13,1551740400,29,1,30,Clouds
460,14,1551740400,30,0,30,Clouds
461,15,1551740400,15,1,16,Clouds
462,16,1551740400,15,5,20,Clouds
463,17,1551740400,20,0,20,Clouds
464,18,1551740400,10,20,30,Clouds
465,19,1551740400,20,10,30,Clouds
466,21,1551740400,30,0,30,Clouds
467,22,1551740400,15,5,20,Clouds
468,23,1551740400,1,29,30,Clouds
469,24,1551740400,18,2,20,Clouds
470,25,1551740400,27,3,30,Clouds
471,26,1551740400,11,9,20,Clouds
472,27,1551740400,20,0,20,Clouds
473,28,1551740400,15,15,30,Clouds
474,29,1551740400,25,4,29,Clouds
475,30,1551740400,18,2,20,Clouds
476,31,1551740400,20,0,20,Clouds
477,32,1551740400,17,13,30,Clouds
478,33,1551740400,16,7,23,Clouds
479,34,1551740400,5,25,30,Clouds
480,35,1551740400,17,13,30,Clouds
481,36,1551740400,34,6,40,Clouds
482,38,1551740400,35,5,40,Clouds
483,39,1551740400,12,8,20,Clouds
484,40,1551740400,21,0,21,Clouds
485,41,1551740400,18,2,20,Clouds
486,42,1551740400,1,29,30,Clouds
487,43,1551740400,10,20,30,Clouds
488,44,1551740400,0,30,30,Clouds
489,45,1551740400,20,10,30,Clouds
490,46,1551740400,18,2,20,Clouds
491,47,1551740400,33,7,40,Clouds
492,48,1551740400,40,0,40,Clouds
493,49,1551740400,38,2,40,Clouds
494,50,1551740400,0,40,40,Clouds
495,51,1551740400,32,8,40,Clouds
496,52,1551740400,32,0,32,Clouds
497,53,1551740400,39,1,40,Clouds
498,54,1551740400,33,0,33,Clouds
499,55,1551740400,36,0,36,Clouds
500,56,1551740400,36,4,40,Clouds
501,57,1551740400,21,2,23,Clouds
502,58,1551740400,39,1,40,Clouds
503,59,1551740400,19,1,20,Clouds
504,60,1551740400,0,30,30,Clouds
505,61,1551740400,25,0,25,Clouds
506,62,1551740400,37,3,40,Clouds
507,63,1551740400,30,5,35,Clouds
508,64,1551740400,29,11,40,Clouds
509,65,1551740400,40,0,40,Clouds
510,66,1551740400,31,9,40,Clouds
511,67,1551740400,0,40,40,Clouds
512,68,1551740400,28,12,40,Clouds
513,69,1551740400,36,4,40,Clouds
514,70,1551740400,20,8,28,Clouds
515,71,1551740400,40,0,40,Clouds
516,72,1551740400,3,22,25,Clouds
517,73,1551740400,10,20,30,Clouds
518,74,1551740400,0,30,30,Clouds
519,75,1551740400,18,22,40,Clouds
520,76,1551740400,21,17,38,Clouds
521,77,1551740400,28,1,29,Clouds
522,78,1551740400,17,23,40,Clouds
523,79,1551740400,27,0,27,Clouds
524,80,1551740400,11,29,40,Clouds
525,81,1551740400,26,14,40,Clouds
526,82,1551740400,4,18,22,Clouds
527,83,1551740400,4,36,40,Clouds
528,84,1551740400,5,25,30,Clouds
529,85,1551740400,9,26,35,Clouds
530,86,1551740400,9,29,38,Clouds
531,87,1551740400,13,25,38,Clouds
532,88,1551740400,11,19,30,Clouds
533,89,1551740400,38,2,40,Clouds
534,90,1551740400,40,0,40,Clouds
535,91,1551740400,20,10,30,Clouds
536,92,1551740400,14,26,40,Clouds
537,93,1551740400,0,40,40,Clouds
538,94,1551740400,15,25,40,Clouds
539,95,1551740400,8,32,40,Clouds
540,96,1551740400,20,10,30,Clouds
541,97,1551740400,6,34,40,Clouds
542,98,1551740400,40,0,40,Clouds
543,99,1551740400,30,0,30,Clouds
544,100,1551740400,1,24,25,Clouds
545,101,1551740400,18,12,30,Clouds
546,102,1551740400,35,5,40,Clouds
547,103,1551740400,40,0,40,Clouds
548,104,1551740400,40,0,40,Clouds
549,105,1551740400,33,3,36,Clouds
550,106,1551740400,36,4,40,Clouds
551,107,1551740400,26,14,40,Clouds
552,108,1551740400,21,19,40,Clouds
553,109,1551740400,21,8,29,Clouds
554,110,1551740400,26,14,40,Clouds
555,111,1551740400,25,15,40,Clouds
556,112,1551740400,1,29,30,Clouds
557,113,1551740400,40,0,40,Clouds
558,114,1551740400,35,5,40,Clouds
559,115,1551740400,17,13,30,Clouds
560,2,1551776400,19,1,20,Rain
561,3,1551776400,18,2,20,Rain
562,4,1551776400,11,9,20,Rain
563,5,1551776400,40,0,40,Rain
564,6,1551776400,20,0,20,Rain
565,7,1551776400,22,7,29,Rain
566,8,1551776400,18,12,30,Rain
567,9,1551776400,7,17,24,Rain
568,10,1551776400,14,2,16,Rain
569,11,1551776400,24,5,29,Rain
570,12,1551776400,19,1,20,Rain
571,13,1551776400,22,8,30,Rain
572,14,1551776400,12,18,30,Rain
573,15,1551776400,16,0,16,Rain
574,16,1551776400,19,1,20,Rain
575,17,1551776400,14,6,20,Rain
576,18,1551776400,13,17,30,Rain
577,19,1551776400,24,6,30,Rain
578,21,1551776400,20,10,30,Rain
579,22,1551776400,15,5,20,Rain
580,23,1551776400,28,2,30,Rain
581,24,1551776400,17,3,20,Rain
582,25,1551776400,16,14,30,Rain
583,26,1551776400,10,10,20,Rain
584,27,1551776400,10,10,20,Rain
585,28,1551776400,22,8,30,Rain
586,29,1551776400,28,1,29,Rain
587,30,1551776400,17,3,20,Rain
588,31,1551776400,14,6,20,Rain
589,32,1551776400,25,5,30,Rain
590,33,1551776400,14,9,23,Rain
591,34,1551776400,30,0,30,Rain
592,35,1551776400,29,1,30,Rain
593,36,1551776400,37,3,40,Rain
594,38,1551776400,36,4,40,Rain
595,39,1551776400,20,0,20,Rain
596,40,1551776400,8,13,21,Rain
597,41,1551776400,20,0,20,Rain
598,42,1551776400,30,0,30,Rain
599,43,1551776400,30,0,30,Rain
600,44,1551776400,30,0,30,Rain
601,45,1551776400,25,5,30,Rain
602,46,1551776400,18,1,19,Rain
603,47,1551776400,33,7,40,Rain
604,48,1551776400,38,2,40,Rain
605,49,1551776400,31,9,40,Rain
606,50,1551776400,28,12,40,Rain
607,51,1551776400,27,12,39,Rain
608,52,1551776400,17,15,32,Rain
609,53,1551776400,36,4,40,Rain
610,54,1551776400,24,9,33,Rain
611,55,1551776400,24,12,36,Rain
612,56,1551776400,23,16,39,Rain
613,57,1551776400,14,9,23,Rain
614,58,1551776400,22,18,40,Rain
615,59,1551776400,18,2,20,Rain
616,60,1551776400,26,4,30,Rain
617,61,1551776400,23,2,25,Rain
618,62,1551776400,30,10,40,Rain
619,63,1551776400,26,9,35,Rain
620,64,1551776400,35,4,39,Rain
621,65,1551776400,31,9,40,Rain
622,66,1551776400,1,39,40,Rain
623,67,1551776400,31,8,39,Rain
624,68,1551776400,28,10,38,Rain
625,69,1551776400,11,28,39,Rain
626,70,1551776400,11,17,28,Rain
627,71,1551776400,35,5,40,Rain
628,72,1551776400,24,1,25,Rain
629,73,1551776400,28,2,30,Rain
630,74,1551776400,24,6,30,Rain
631,75,1551776400,35,5,40,Rain
632,76,1551776400,32,6,38,Rain
633,77,1551776400,29,0,29,Rain
634,78,1551776400,9,31,40,Rain
635,79,1551776400,0,27,27,Rain
636,80,1551776400,15,25,40,Rain
637,81,1551776400,25,15,40,Rain
638,82,1551776400,8,14,22,Rain
639,83,1551776400,21,19,40,Rain
640,84,1551776400,25,5,30,Rain
641,85,1551776400,23,12,35,Rain
642,86,1551776400,22,16,38,Rain
643,87,1551776400,16,22,38,Rain
644,88,1551776400,16,14,30,Rain
645,89,1551776400,30,10,40,Rain
646,90,1551776400,3,37,40,Rain
647,91,1551776400,27,3,30,Rain
648,92,1551776400,23,17,40,Rain
649,93,1551776400,27,13,40,Rain
650,94,1551776400,8,32,40,Rain
651,95,1551776400,28,12,40,Rain
652,96,1551776400,23,7,30,Rain
653,97,1551776400,33,7,40,Rain
654,98,1551776400,35,5,40,Rain
655,99,1551776400,27,2,29,Rain
656,100,1551776400,15,10,25,Rain
657,101,1551776400,30,0,30,Rain
658,102,1551776400,24,16,40,Rain
659,103,1551776400,29,11,40,Rain
660,104,1551776400,30,10,40,Rain
661,105,1551776400,33,3,36,Rain
662,106,1551776400,24,16,40,Rain
663,107,1551776400,25,15,40,Rain
664,108,1551776400,27,13,40,Rain
665,109,1551776400,14,15,29,Rain
666,110,1551776400,28,12,40,Rain
667,111,1551776400,23,17,40,Rain
668,112,1551776400,25,5,30,Rain
669,113,1551776400,35,5,40,Rain
670,114,1551776400,30,10,40,Rain
671,115,1551776400,24,6,30,Rain
672,2,1551780000,20,0,20,Clouds
673,3,1551780000,14,6,20,Clouds
674,4,1551780000,18,2,20,Clouds
675,5,1551780000,35,5,40,Clouds
676,6,1551780000,20,0,20,Clouds
677,7,1551780000,29,0,29,Clouds
678,8,1551780000,20,9,29,Clouds
679,9,1551780000,5,19,24,Clouds
680,10,1551780000,12,4,16,Clouds
681,11,1551780000,11,19,30,Clouds
682,12,1551780000,20,0,20,Clouds
683,13,1551780000,10,20,30,Clouds
684,14,1551780000,21,9,30,Clouds
685,15,1551780000,16,0,16,Clouds
686,16,1551780000,18,2,20,Clouds
687,17,1551780000,18,2,20,Clouds
688,18,1551780000,30,0,30,Clouds
689,19,1551780000,14,16,30,Clouds
690,21,1551780000,14,16,30,Clouds
691,22,1551780000,18,2,20,Clouds
692,23,1551780000,22,8,30,Clouds
693,24,1551780000,20,0,20,Clouds
694,25,1551780000,1,29,30,Clouds
695,26,1551780000,6,14,20,Clouds
696,27,1551780000,10,10,20,Clouds
697,28,1551780000,30,0,30,Clouds
698,29,1551780000,27,2,29,Clouds
699,30,1551780000,16,4,20,Clouds
700,31,1551780000,17,3,20,Clouds
701,32,1551780000,23,7,30,Clouds
702,33,1551780000,13,10,23,Clouds
703,34,1551780000,29,1,30,Clouds
704,35,1551780000,27,3,30,Clouds
705,36,1551780000,17,23,40,Clouds
706,38,1551780000,39,1,40,Clouds
707,39,1551780000,16,4,20,Clouds
708,40,1551780000,18,3,21,Clouds
709,41,1551780000,17,3,20,Clouds
710,42,1551780000,30,0,30,Clouds
711,43,1551780000,30,0,30,Clouds
712,44,1551780000,30,0,30,Clouds
713,45,1551780000,30,0,30,Clouds
714,46,1551780000,15,4,19,Clouds
715,47,1551780000,17,22,39,Clouds
716,48,1551780000,20,20,40,Clouds
717,49,1551780000,0,40,40,Clouds
718,50,1551780000,38,2,40,Clouds
719,51,1551780000,35,5,40,Clouds
720,52,1551780000,16,16,32,Clouds
721,53,1551780000,31,9,40,Clouds
722,54,1551780000,8,25,33,Clouds
723,55,1551780000,16,20,36,Clouds
724,56,1551780000,1,38,39,Clouds
725,57,1551780000,0,22,22,Clouds
726,58,1551780000,12,27,39,Clouds
727,59,1551780000,20,0,20,Clouds
728,60,1551780000,30,0,30,Clouds
729,61,1551780000,25,0,25,Clouds
730,62,1551780000,2,38,40,Clouds
731,63,1551780000,18,17,35,Clouds
732,64,1551780000,10,29,39,Clouds
733,65,1551780000,0,40,40,Clouds
734,66,1551780000,17,22,39,Clouds
735,67,1551780000,34,5,39,Clouds
736,68,1551780000,0,38,38,Clouds
737,69,1551780000,0,38,38,Clouds
738,70,1551780000,7,20,27,Clouds
739,71,1551780000,40,0,40,Clouds
740,72,1551780000,24,1,25,Clouds
741,73,1551780000,28,2,30,Clouds
742,74,1551780000,29,1,30,Clouds
743,75,1551780000,40,0,40,Clouds
744,76,1551780000,38,0,38,Clouds
745,77,1551780000,26,3,29,Clouds
746,78,1551780000,38,2,40,Clouds
747,79,1551780000,24,3,27,Clouds
748,80,1551780000,33,7,40,Clouds
749,81,1551780000,32,8,40,Clouds
750,82,1551780000,22,0,22,Clouds
751,83,1551780000,40,0,40,Clouds
752,84,1551780000,30,0,30,Clouds
753,85,1551780000,35,0,35,Clouds
754,86,1551780000,35,3,38,Clouds
755,87,1551780000,38,0,38,Clouds
756,88,1551780000,30,0,30,Clouds
757,89,1551780000,34,6,40,Clouds
758,90,1551780000,0,40,40,Clouds
759,91,1551780000,24,6,30,Clouds
760,92,1551780000,38,2,40,Clouds
761,93,1551780000,40,0,40,Clouds
762,94,1551780000,39,1,40,Clouds
763,95,1551780000,39,1,40,Clouds
764,96,1551780000,30,0,30,Clouds
765,97,1551780000,40,0,40,Clouds
766,98,1551780000,36,4,40,Clouds
767,99,1551780000,21,8,29,Clouds
768,100,1551780000,25,0,25,Clouds
769,101,1551780000,30,0,30,Clouds
770,102,1551780000,36,4,40,Clouds
771,103,1551780000,32,8,40,Clouds
772,104,1551780000,32,8,40,Clouds
773,105,1551780000,36,0,36,Clouds
774,106,1551780000,33,7,40,Clouds
775,107,1551780000,37,3,40,Clouds
776,108,1551780000,36,4,40,Clouds
777,109,1551780000,24,5,29,Clouds
778,110,1551780000,40,0,40,Clouds
779,111,1551780000,29,11,40,Clouds
780,112,1551780000,29,1,30,Clouds
781,113,1551780000,28,12,40,Clouds
782,114,1551780000,22,18,40,Clouds
783,115,1551780000,30,0,30,Clouds
784,2,1551783600,20,0,20,Clouds
785,3,1551783600,15,5,20,Clouds
786,4,1551783600,10,10,20,Clouds
787,5,1551783600,32,8,40,Clouds
788,6,1551783600,20,0,20,Clouds
789,7,1551783600,29,0,29,Clouds
790,8,1551783600,21,8,29,Clouds
791,9,1551783600,11,13,24,Clouds
792,10,1551783600,14,2,16,Clouds
793,11,1551783600,19,11,30,Clouds
794,12,1551783600,20,0,20,Clouds
795,13,1551783600,11,19,30,Clouds
796,14,1551783600,11,19,30,Clouds
797,15,1551783600,16,0,16,Clouds
798,16,1551783600,17,3,20,Clouds
799,17,1551783600,18,2,20,Clouds
800,18,1551783600,28,2,30,Clouds
801,19,1551783600,0,30,30,Clouds
802,21,1551783600,3,27,30,Clouds
803,22,1551783600,12,8,20,Clouds
804,23,1551783600,26,4,30,Clouds
805,24,1551783600,19,1,20,Clouds
806,25,1551783600,0,30,30,Clouds
807,26,1551783600,0,20,20,Clouds
808,27,1551783600,3,17,20,Clouds
809,28,1551783600,18,12,30,Clouds
810,29,1551783600,28,1,29,Clouds
811,30,1551783600,19,1,20,Clouds
812,31,1551783600,16,4,20,Clouds
813,32,1551783600,23,7,30,Clouds
814,33,1551783600,9,14,23,Clouds
815,34,1551783600,28,2,30,Clouds
816,35,1551783600,29,1,30,Clouds
817,36,1551783600,13,27,40,Clouds
818,37,1551783600,26,4,30,Clouds
819,38,1551783600,40,0,40,Clouds
820,39,1551783600,16,4,20,Clouds
821,40,1551783600,18,3,21,Clouds
822,41,1551783600,14,6,20,Clouds
823,42,1551783600,30,0,30,Clouds
824,43,1551783600,27,3,30,Clouds
825,44,1551783600,30,0,30,Clouds
826,45,1551783600,28,2,30,Clouds
827,46,1551783600,16,3,19,Clouds
828,47,1551783600,6,34,40,Clouds
829,48,1551783600,4,36,40,Clouds
830,49,1551783600,1,39,40,Clouds
831,50,1551783600,39,1,40,Clouds
832,51,1551783600,26,14,40,Clouds
833,52,1551783600,15,17,32,Clouds
834,53,1551783600,17,21,38,Clouds
835,54,1551783600,6,27,33,Clouds
836,55,1551783600,10,26,36,Clouds
837,56,1551783600,0,40,40,Clouds
838,57,1551783600,1,22,23,Clouds
839,58,1551783600,2,38,40,Clouds
840,59,1551783600,20,0,20,Clouds
841,60,1551783600,30,0,30,Clouds
842,61,1551783600,25,0,25,Clouds
843,62,1551783600,0,40,40,Clouds
844,63,1551783600,2,33,35,Clouds
845,64,1551783600,3,37,40,Clouds
846,65,1551783600,1,39,40,Clouds
847,66,1551783600,0,39,39,Clouds
848,67,1551783600,25,14,39,Clouds
849,68,1551783600,2,36,38,Clouds
850,69,1551783600,0,38,38,Clouds
851,70,1551783600,2,26,28,Clouds
852,71,1551783600,35,5,40,Clouds
853,72,1551783600,25,0,25,Clouds
854,73,1551783600,30,0,30,Clouds
855,74,1551783600,28,2,30,Clouds
856,75,1551783600,40,0,40,Clouds
857,76,1551783600,38,0,38,Clouds
858,77,1551783600,17,12,29,Clouds
859,78,1551783600,40,0,40,Clouds
860,79,1551783600,27,0,27,Clouds
861,80,1551783600,40,0,40,Clouds
862,81,1551783600,40,0,40,Clouds
863,82,1551783600,22,0,22,Clouds
864,83,1551783600,40,0,40,Clouds
865,84,1551783600,30,0,30,Clouds
866,85,1551783600,35,0,35,Clouds
867,86,1551783600,38,0,38,Clouds
868,87,1551783600,38,0,38,Clouds
869,88,1551783600,29,1,30,Clouds
870,89,1551783600,23,17,40,Clouds
871,90,1551783600,1,39,40,Clouds
872,91,1551783600,24,6,30,Clouds
873,92,1551783600,38,2,40,Clouds
874,93,1551783600,40,0,40,Clouds
875,94,1551783600,40,0,40,Clouds
876,95,1551783600,37,3,40,Clouds
877,96,1551783600,30,0,30,Clouds
878,97,1551783600,39,1,40,Clouds
879,98,1551783600,31,9,40,Clouds
880,99,1551783600,11,19,30,Clouds
881,100,1551783600,21,4,25,Clouds
882,101,1551783600,30,0,30,Clouds
883,102,1551783600,40,0,40,Clouds
884,103,1551783600,37,3,40,Clouds
885,104,1551783600,39,1,40,Clouds
886,105,1551783600,36,0,36,Clouds
887,106,1551783600,40,0,40,Clouds
888,107,1551783600,40,0,40,Clouds
889,108,1551783600,40,0,40,Clouds
890,109,1551783600,24,5,29,Clouds
891,110,1551783600,40,0,40,Clouds
892,111,1551783600,40,0,40,Clouds
893,112,1551783600,30,0,30,Clouds
894,113,1551783600,9,31,40,Clouds
895,114,1551783600,4,36,40,Clouds
896,115,1551783600,30,0,30,Clouds
897,2,1551787200,20,0,20,Rain
898,3,1551787200,16,4,20,Rain
899,4,1551787200,12,8,20,Rain
900,5,1551787200,37,3,40,Rain
901,6,1551787200,20,0,20,Rain
902,7,1551787200,29,0,29,Rain
903,8,1551787200,9,20,29,Rain
904,9,1551787200,15,9,24,Rain
905,10,1551787200,8,7,15,Rain
906,11,1551787200,19,11,30,Rain
907,12,1551787200,20,0,20,Rain
908,13,1551787200,9,21,30,Rain
909,14,1551787200,8,22,30,Rain
910,15,1551787200,16,0,16,Rain
911,16,1551787200,17,3,20,Rain
912,17,1551787200,20,0,20,Rain
913,18,1551787200,30,0,30,Rain
914,19,1551787200,7,23,30,Rain
915,21,1551787200,0,30,30,Rain
916,22,1551787200,7,13,20,Rain
917,23,1551787200,26,4,30,Rain
918,24,1551787200,15,5,20,Rain
919,25,1551787200,0,30,30,Rain
920,26,1551787200,1,19,20,Rain
921,27,1551787200,1,19,20,Rain
922,28,1551787200,24,6,30,Rain
923,29,1551787200,28,1,29,Rain
924,30,1551787200,18,2,20,Rain
925,31,1551787200,20,0,20,Rain
926,32,1551787200,16,14,30,Rain
927,33,1551787200,9,14,23,Rain
928,34,1551787200,18,12,30,Rain
929,35,1551787200,30,0,30,Rain
930,36,1551787200,17,23,40,Rain
931,37,1551787200,26,4,30,Rain
932,38,1551787200,37,3,40,Rain
933,39,1551787200,15,5,20,Rain
934,40,1551787200,14,7,21,Rain
935,41,1551787200,11,9,20,Rain
936,42,1551787200,30,0,30,Rain
937,43,1551787200,30,0,30,Rain
938,44,1551787200,30,0,30,Rain
939,45,1551787200,29,1,30,Rain
940,46,1551787200,15,4,19,Rain
941,47,1551787200,4,36,40,Rain
942,48,1551787200,0,40,40,Rain
943,49,1551787200,1,39,40,Rain
944,50,1551787200,39,1,40,Rain
945,51,1551787200,26,14,40,Rain
946,52,1551787200,11,21,32,Rain
947,53,1551787200,15,23,38,Rain
948,54,1551787200,8,25,33,Rain
949,55,1551787200,13,22,35,Rain
950,56,1551787200,13,27,40,Rain
951,57,1551787200,1,22,23,Rain
952,58,1551787200,12,28,40,Rain
953,59,1551787200,20,0,20,Rain
954,60,1551787200,30,0,30,Rain
955,61,1551787200,25,0,25,Rain
956,62,1551787200,0,40,40,Rain
957,63,1551787200,3,32,35,Rain
958,64,1551787200,2,38,40,Rain
959,65,1551787200,1,38,39,Rain
960,66,1551787200,0,39,39,Rain
961,67,1551787200,18,21,39,Rain
962,68,1551787200,10,28,38,Rain
963,69,1551787200,2,36,38,Rain
964,70,1551787200,0,28,28,Rain
965,71,1551787200,38,2,40,Rain
966,72,1551787200,25,0,25,Rain
967,73,1551787200,30,0,30,Rain
968,74,1551787200,30,0,30,Rain
969,75,1551787200,40,0,40,Rain
970,76,1551787200,38,0,38,Rain
971,77,1551787200,17,12,29,Rain
972,78,1551787200,26,14,40,Rain
973,79,1551787200,26,1,27,Rain
974,80,1551787200,40,0,40,Rain
975,81,1551787200,40,0,40,Rain
976,82,1551787200,22,0,22,Rain
977,83,1551787200,40,0,40,Rain
978,84,1551787200,30,0,30,Rain
979,85,1551787200,35,0,35,Rain
980,86,1551787200,38,0,38,Rain
981,87,1551787200,38,0,38,Rain
982,88,1551787200,30,0,30,Rain
983,89,1551787200,21,19,40,Rain
984,90,1551787200,0,40,40,Rain
985,91,1551787200,23,7,30,Rain
986,92,1551787200,40,0,40,Rain
987,93,1551787200,40,0,40,Rain
988,94,1551787200,40,0,40,Rain
989,95,1551787200,37,3,40,Rain
990,96,1551787200,30,0,30,Rain
991,97,1551787200,40,0,40,Rain
992,98,1551787200,29,10,39,Rain
993,99,1551787200,9,21,30,Rain
994,100,1551787200,10,15,25,Rain
995,101,1551787200,30,0,30,Rain
996,102,1551787200,40,0,40,Rain
997,103,1551787200,37,3,40,Rain
998,104,1551787200,39,1,40,Rain
999,105,1551787200,35,1,36,Rain
1000,106,1551787200,40,0,40,Rain
1001,107,1551787200,40,0,40,Rain
1002,108,1551787200,40,0,40,Rain
1003,109,1551787200,27,1,28,Rain
1004,110,1551787200,40,0,40,Rain
1005,111,1551787200,40,0,40,Rain
1006,112,1551787200,30,0,30,Rain
1007,113,1551787200,5,35,40,Rain
1008,114,1551787200,0,40,40,Rain
1009,115,1551787200,29,1,30,Rain
1010,2,1551790800,20,0,20,Clouds
1011,3,1551790800,20,0,20,Clouds
1012,4,1551790800,11,9,20,Clouds
1013,5,1551790800,38,2,40,Clouds
1014,6,1551790800,19,1,20,Clouds
1015,7,1551790800,29,0,29,Clouds
1016,8,1551790800,7,22,29,Clouds
1017,9,1551790800,9,15,24,Clouds
1018,10,1551790800,7,9,16,Clouds
1019,11,1551790800,17,13,30,Clouds
1020,12,1551790800,20,0,20,Clouds
1021,13,1551790800,5,25,30,Clouds
1022,14,1551790800,3,27,30,Clouds
1023,15,1551790800,16,0,16,Clouds
1024,16,1551790800,18,2,20,Clouds
1025,17,1551790800,16,4,20,Clouds
1026,18,1551790800,30,0,30,Clouds
1027,19,1551790800,1,29,30,Clouds
1028,21,1551790800,1,29,30,Clouds
1029,22,1551790800,10,10,20,Clouds
1030,23,1551790800,26,4,30,Clouds
1031,24,1551790800,19,1,20,Clouds
1032,25,1551790800,1,29,30,Clouds
1033,26,1551790800,0,20,20,Clouds
1034,27,1551790800,1,19,20,Clouds
1035,28,1551790800,30,0,30,Clouds
1036,29,1551790800,26,3,29,Clouds
1037,30,1551790800,17,3,20,Clouds
1038,31,1551790800,20,0,20,Clouds
1039,32,1551790800,20,10,30,Clouds
1040,33,1551790800,8,15,23,Clouds
1041,34,1551790800,28,2,30,Clouds
1042,35,1551790800,30,0,30,Clouds
1043,36,1551790800,18,22,40,Clouds
1044,37,1551790800,4,26,30,Clouds
1045,38,1551790800,38,2,40,Clouds
1046,39,1551790800,20,0,20,Clouds
1047,40,1551790800,14,7,21,Clouds
1048,41,1551790800,9,11,20,Clouds
1049,42,1551790800,28,2,30,Clouds
1050,43,1551790800,29,1,30,Clouds
1051,44,1551790800,28,2,30,Clouds
1052,45,1551790800,30,0,30,Clouds
1053,46,1551790800,17,2,19,Clouds
1054,47,1551790800,5,35,40,Clouds
1055,48,1551790800,0,40,40,Clouds
1056,49,1551790800,2,38,40,Clouds
1057,50,1551790800,39,1,40,Clouds
1058,51,1551790800,23,17,40,Clouds
1059,52,1551790800,12,20,32,Clouds
1060,53,1551790800,14,24,38,Clouds
1061,54,1551790800,8,25,33,Clouds
1062,55,1551790800,16,19,35,Clouds
1063,56,1551790800,21,19,40,Clouds
1064,57,1551790800,1,22,23,Clouds
1065,58,1551790800,10,30,40,Clouds
1066,59,1551790800,20,0,20,Clouds
1067,60,1551790800,30,0,30,Clouds
1068,61,1551790800,25,0,25,Clouds
1069,62,1551790800,0,40,40,Clouds
1070,63,1551790800,4,31,35,Clouds
1071,64,1551790800,0,40,40,Clouds
1072,65,1551790800,6,33,39,Clouds
1073,66,1551790800,5,34,39,Clouds
1074,67,1551790800,18,21,39,Clouds
1075,68,1551790800,6,32,38,Clouds
1076,69,1551790800,1,37,38,Clouds
1077,70,1551790800,4,24,28,Clouds
1078,71,1551790800,40,0,40,Clouds
1079,72,1551790800,24,1,25,Clouds
1080,73,1551790800,30,0,30,Clouds
1081,74,1551790800,30,0,30,Clouds
1082,75,1551790800,40,0,40,Clouds
1083,76,1551790800,38,0,38,Clouds
1084,77,1551790800,21,8,29,Clouds
1085,78,1551790800,32,8,40,Clouds
1086,79,1551790800,27,0,27,Clouds
1087,80,1551790800,39,1,40,Clouds
1088,81,1551790800,40,0,40,Clouds
1089,82,1551790800,22,0,22,Clouds
1090,83,1551790800,40,0,40,Clouds
1091,84,1551790800,30,0,30,Clouds
1092,85,1551790800,35,0,35,Clouds
1093,86,1551790800,35,3,38,Clouds
1094,87,1551790800,38,0,38,Clouds
1095,88,1551790800,30,0,30,Clouds
1096,89,1551790800,18,22,40,Clouds
1097,90,1551790800,6,34,40,Clouds
1098,91,1551790800,22,8,30,Clouds
1099,92,1551790800,40,0,40,Clouds
1100,93,1551790800,40,0,40,Clouds
1101,94,1551790800,40,0,40,Clouds
1102,95,1551790800,40,0,40,Clouds
1103,96,1551790800,30,0,30,Clouds
1104,97,1551790800,40,0,40,Clouds
1105,98,1551790800,24,15,39,Clouds
1106,99,1551790800,9,21,30,Clouds
1107,100,1551790800,11,14,25,Clouds
1108,101,1551790800,29,1,30,Clouds
1109,102,1551790800,40,0,40,Clouds
1110,103,1551790800,37,3,40,Clouds
1111,104,1551790800,39,1,40,Clouds
1112,105,1551790800,35,1,36,Clouds
1113,106,1551790800,38,2,40,Clouds
1114,107,1551790800,40,0,40,Clouds
1115,108,1551790800,34,6,40,Clouds
1116,109,1551790800,28,0,28,Clouds
1117,110,1551790800,40,0,40,Clouds
1118,111,1551790800,39,1,40,Clouds
1119,112,1551790800,28,2,30,Clouds
1120,113,1551790800,1,39,40,Clouds
1121,114,1551790800,1,39,40,Clouds
1122,115,1551790800,28,2,30,Clouds
1123,2,1551794400,20,0,20,Rain
1124,3,1551794400,20,0,20,Rain
1125,4,1551794400,19,1,20,Rain
1126,5,1551794400,39,1,40,Rain
1127,6,1551794400,18,2,20,Rain
1128,7,1551794400,29,0,29,Rain
1129,8,1551794400,12,17,29,Rain
1130,9,1551794400,4,20,24,Rain
1131,10,1551794400,13,3,16,Rain
1132,11,1551794400,28,2,30,Rain
1133,12,1551794400,19,1,20,Rain
1134,13,1551794400,9,21,30,Rain
1135,14,1551794400,5,25,30,Rain
1136,15,1551794400,16,0,16,Rain
1137,16,1551794400,20,0,20,Rain
1138,17,1551794400,20,0,20,Rain
1139,18,1551794400,27,3,30,Rain
1140,19,1551794400,5,25,30,Rain
1141,21,1551794400,17,13,30,Rain
1142,22,1551794400,16,4,20,Rain
1143,23,1551794400,29,1,30,Rain
1144,24,1551794400,18,2,20,Rain
1145,25,1551794400,1,29,30,Rain
1146,26,1551794400,3,17,20,Rain
1147,27,1551794400,1,19,20,Rain
1148,28,1551794400,23,7,30,Rain
1149,29,1551794400,27,2,29,Rain
1150,30,1551794400,20,0,20,Rain
1151,31,1551794400,13,7,20,Rain
1152,32,1551794400,22,8,30,Rain
1153,33,1551794400,11,12,23,Rain
1154,34,1551794400,29,1,30,Rain
1155,35,1551794400,29,1,30,Rain
1156,36,1551794400,15,25,40,Rain
1157,37,1551794400,5,25,30,Rain
1158,38,1551794400,39,1,40,Rain
1159,39,1551794400,15,5,20,Rain
1160,40,1551794400,16,5,21,Rain
1161,41,1551794400,9,11,20,Rain
1162,42,1551794400,25,5,30,Rain
1163,43,1551794400,24,6,30,Rain
1164,44,1551794400,30,0,30,Rain
1165,45,1551794400,28,2,30,Rain
1166,46,1551794400,13,6,19,Rain
1167,47,1551794400,8,32,40,Rain
1168,48,1551794400,9,31,40,Rain
1169,49,1551794400,9,31,40,Rain
1170,50,1551794400,36,4,40,Rain
1171,51,1551794400,18,22,40,Rain
1172,52,1551794400,9,23,32,Rain
1173,53,1551794400,13,27,40,Rain
1174,54,1551794400,9,24,33,Rain
1175,55,1551794400,20,15,35,Rain
1176,56,1551794400,28,12,40,Rain
1177,57,1551794400,2,21,23,Rain
1178,58,1551794400,12,28,40,Rain
1179,59,1551794400,20,0,20,Rain
1180,60,1551794400,29,1,30,Rain
1181,61,1551794400,21,4,25,Rain
1182,62,1551794400,5,35,40,Rain
1183,63,1551794400,6,29,35,Rain
1184,64,1551794400,15,25,40,Rain
1185,65,1551794400,22,17,39,Rain
1186,66,1551794400,18,21,39,Rain
1187,67,1551794400,18,21,39,Rain
1188,68,1551794400,2,36,38,Rain
1189,69,1551794400,4,34,38,Rain
1190,70,1551794400,1,27,28,Rain
1191,71,1551794400,38,2,40,Rain
1192,72,1551794400,24,1,25,Rain
1193,73,1551794400,30,0,30,Rain
1194,74,1551794400,28,2,30,Rain
1195,75,1551794400,40,0,40,Rain
1196,76,1551794400,36,2,38,Rain
1197,77,1551794400,22,7,29,Rain
1198,78,1551794400,32,8,40,Rain
1199,79,1551794400,23,4,27,Rain
1200,80,1551794400,40,0,40,Rain
1201,81,1551794400,40,0,40,Rain
1202,82,1551794400,22,0,22,Rain
1203,83,1551794400,40,0,40,Rain
1204,84,1551794400,29,1,30,Rain
1205,85,1551794400,35,0,35,Rain
1206,86,1551794400,38,0,38,Rain
1207,87,1551794400,38,0,38,Rain
1208,88,1551794400,30,0,30,Rain
1209,89,1551794400,21,19,40,Rain
1210,90,1551794400,11,29,40,Rain
1211,91,1551794400,20,10,30,Rain
1212,92,1551794400,39,1,40,Rain
1213,93,1551794400,40,0,40,Rain
1214,94,1551794400,40,0,40,Rain
1215,95,1551794400,40,0,40,Rain
1216,96,1551794400,30,0,30,Rain
1217,97,1551794400,39,1,40,Rain
1218,98,1551794400,25,15,40,Rain
1219,99,1551794400,10,20,30,Rain
1220,100,1551794400,14,11,25,Rain
1221,101,1551794400,30,0,30,Rain
1222,102,1551794400,40,0,40,Rain
1223,103,1551794400,35,5,40,Rain
1224,104,1551794400,39,1,40,Rain
1225,105,1551794400,36,0,36,Rain
1226,106,1551794400,35,5,40,Rain
1227,107,1551794400,40,0,40,Rain
1228,108,1551794400,37,3,40,Rain
1229,109,1551794400,26,2,28,Rain
1230,110,1551794400,40,0,40,Rain
1231,111,1551794400,33,7,40,Rain
1232,112,1551794400,26,4,30,Rain
1233,113,1551794400,2,38,40,Rain
1234,114,1551794400,6,34,40,Rain
1235,115,1551794400,27,3,30,Rain
1236,2,1551798000,18,2,20,Clouds
1237,3,1551798000,13,7,20,Clouds
1238,4,1551798000,18,2,20,Clouds
1239,5,1551798000,31,9,40,Clouds
1240,6,1551798000,20,0,20,Clouds
1241,7,1551798000,29,0,29,Clouds
1242,8,1551798000,19,10,29,Clouds
1243,9,1551798000,6,18,24,Clouds
1244,10,1551798000,11,5,16,Clouds
1245,11,1551798000,25,5,30,Clouds
1246,12,1551798000,17,3,20,Clouds
1247,13,1551798000,8,22,30,Clouds
1248,14,1551798000,4,26,30,Clouds
1249,15,1551798000,4,12,16,Clouds
1250,16,1551798000,14,6,20,Clouds
1251,17,1551798000,14,6,20,Clouds
1252,18,1551798000,29,1,30,Clouds
1253,19,1551798000,5,25,30,Clouds
1254,21,1551798000,12,18,30,Clouds
1255,22,1551798000,12,8,20,Clouds
1256,23,1551798000,22,8,30,Clouds
1257,24,1551798000,16,4,20,Clouds
1258,25,1551798000,5,25,30,Clouds
1259,26,1551798000,5,15,20,Clouds
1260,27,1551798000,4,16,20,Clouds
1261,28,1551798000,30,0,30,Clouds
1262,29,1551798000,26,3,29,Clouds
1263,30,1551798000,19,1,20,Clouds
1264,31,1551798000,16,4,20,Clouds
1265,32,1551798000,23,7,30,Clouds
1266,33,1551798000,12,11,23,Clouds
1267,34,1551798000,26,4,30,Clouds
1268,35,1551798000,29,1,30,Clouds
1269,36,1551798000,15,25,40,Clouds
1270,37,1551798000,9,21,30,Clouds
1271,38,1551798000,40,0,40,Clouds
1272,39,1551798000,18,2,20,Clouds
1273,40,1551798000,15,5,20,Clouds
1274,41,1551798000,12,8,20,Clouds
1275,42,1551798000,30,0,30,Clouds
1276,43,1551798000,28,2,30,Clouds
1277,44,1551798000,28,2,30,Clouds
1278,45,1551798000,29,1,30,Clouds
1279,46,1551798000,19,1,20,Clouds
1280,47,1551798000,9,31,40,Clouds
1281,48,1551798000,9,31,40,Clouds
1282,49,1551798000,16,24,40,Clouds
1283,50,1551798000,34,6,40,Clouds
1284,51,1551798000,26,14,40,Clouds
1285,52,1551798000,6,26,32,Clouds
1286,53,1551798000,16,24,40,Clouds
1287,54,1551798000,10,23,33,Clouds
1288,55,1551798000,24,12,36,Clouds
1289,56,1551798000,19,21,40,Clouds
1290,57,1551798000,5,18,23,Clouds
1291,58,1551798000,2,38,40,Clouds
1292,59,1551798000,17,3,20,Clouds
1293,60,1551798000,22,8,30,Clouds
1294,61,1551798000,25,0,25,Clouds
1295,62,1551798000,9,31,40,Clouds
1296,63,1551798000,1,34,35,Clouds
1297,64,1551798000,11,29,40,Clouds
1298,65,1551798000,24,15,39,Clouds
1299,66,1551798000,12,27,39,Clouds
1300,67,1551798000,15,24,39,Clouds
1301,68,1551798000,4,34,38,Clouds
1302,69,1551798000,7,31,38,Clouds
1303,70,1551798000,0,28,28,Clouds
1304,71,1551798000,36,4,40,Clouds
1305,72,1551798000,25,0,25,Clouds
1306,73,1551798000,20,10,30,Clouds
1307,74,1551798000,27,3,30,Clouds
1308,75,1551798000,40,0,40,Clouds
1309,76,1551798000,38,0,38,Clouds
1310,77,1551798000,9,20,29,Clouds
1311,78,1551798000,32,8,40,Clouds
1312,79,1551798000,25,2,27,Clouds
1313,80,1551798000,37,3,40,Clouds
1314,81,1551798000,40,0,40,Clouds
1315,82,1551798000,22,0,22,Clouds
1316,83,1551798000,39,1,40,Clouds
1317,84,1551798000,30,0,30,Clouds
1318,85,1551798000,35,0,35,Clouds
1319,86,1551798000,34,4,38,Clouds
1320,87,1551798000,35,3,38,Clouds
1321,88,1551798000,28,2,30,Clouds
1322,89,1551798000,23,17,40,Clouds
1323,90,1551798000,6,34,40,Clouds
1324,91,1551798000,19,11,30,Clouds
1325,92,1551798000,40,0,40,Clouds
1326,93,1551798000,40,0,40,Clouds
1327,94,1551798000,40,0,40,Clouds
1328,95,1551798000,39,1,40,Clouds
1329,96,1551798000,29,1,30,Clouds
1330,97,1551798000,39,1,40,Clouds
1331,98,1551798000,30,10,40,Clouds
1332,99,1551798000,14,16,30,Clouds
1333,100,1551798000,21,4,25,Clouds
1334,101,1551798000,29,1,30,Clouds
1335,102,1551798000,31,9,40,Clouds
1336,103,1551798000,35,5,40,Clouds
1337,104,1551798000,40,0,40,Clouds
1338,105,1551798000,36,0,36,Clouds
1339,106,1551798000,40,0,40,Clouds
1340,107,1551798000,32,8,40,Clouds
1341,108,1551798000,38,2,40,Clouds
1342,109,1551798000,25,3,28,Clouds
1343,110,1551798000,23,17,40,Clouds
1344,111,1551798000,37,3,40,Clouds
1345,112,1551798000,27,3,30,Clouds
1346,113,1551798000,7,33,40,Clouds
1347,114,1551798000,9,31,40,Clouds
1348,115,1551798000,28,2,30,Clouds
1349,2,1551801600,18,2,20,Clouds
1350,3,1551801600,19,1,20,Clouds
1351,4,1551801600,16,4,20,Clouds
1352,5,1551801600,33,7,40,Clouds
1353,6,1551801600,18,2,20,Clouds
1354,7,1551801600,28,1,29,Clouds
1355,8,1551801600,12,17,29,Clouds
1356,9,1551801600,4,20,24,Clouds
1357,10,1551801600,7,9,16,Clouds
1358,11,1551801600,23,7,30,Clouds
1359,12,1551801600,15,5,20,Clouds
1360,13,1551801600,4,26,30,Clouds
1361,14,1551801600,2,28,30,Clouds
1362,15,1551801600,5,11,16,Clouds
1363,16,1551801600,16,4,20,Clouds
1364,17,1551801600,13,7,20,Clouds
1365,18,1551801600,25,5,30,Clouds
1366,19,1551801600,19,11,30,Clouds
1367,21,1551801600,8,22,30,Clouds
1368,22,1551801600,15,5,20,Clouds
1369,23,1551801600,19,11,30,Clouds
1370,24,1551801600,12,8,20,Clouds
1371,25,1551801600,5,25,30,Clouds
1372,26,1551801600,7,13,20,Clouds
1373,27,1551801600,7,13,20,Clouds
1374,28,1551801600,12,18,30,Clouds
1375,29,1551801600,29,0,29,Clouds
1376,30,1551801600,19,1,20,Clouds
1377,31,1551801600,20,0,20,Clouds
1378,32,1551801600,20,10,30,Clouds
1379,33,1551801600,13,10,23,Clouds
1380,34,1551801600,27,3,30,Clouds
1381,35,1551801600,29,1,30,Clouds
1382,36,1551801600,12,28,40,Clouds
1383,37,1551801600,14,16,30,Clouds
1384,38,1551801600,32,8,40,Clouds
1385,39,1551801600,16,4,20,Clouds
1386,40,1551801600,15,5,20,Clouds
1387,41,1551801600,12,8,20,Clouds
1388,42,1551801600,24,6,30,Clouds
1389,43,1551801600,22,8,30,Clouds
1390,44,1551801600,28,2,30,Clouds
1391,45,1551801600,27,3,30,Clouds
1392,46,1551801600,18,2,20,Clouds
1393,47,1551801600,10,30,40,Clouds
1394,48,1551801600,13,27,40,Clouds
1395,49,1551801600,16,24,40,Clouds
1396,50,1551801600,30,10,40,Clouds
1397,51,1551801600,38,2,40,Clouds
1398,52,1551801600,6,26,32,Clouds
1399,53,1551801600,15,25,40,Clouds
1400,54,1551801600,7,26,33,Clouds
1401,55,1551801600,28,8,36,Clouds
1402,56,1551801600,19,21,40,Clouds
1403,57,1551801600,0,23,23,Clouds
1404,58,1551801600,4,36,40,Clouds
1405,59,1551801600,20,0,20,Clouds
1406,60,1551801600,25,5,30,Clouds
1407,61,1551801600,25,0,25,Clouds
1408,62,1551801600,10,30,40,Clouds
1409,63,1551801600,0,35,35,Clouds
1410,64,1551801600,7,33,40,Clouds
1411,65,1551801600,25,15,40,Clouds
1412,66,1551801600,10,29,39,Clouds
1413,67,1551801600,14,25,39,Clouds
1414,68,1551801600,2,36,38,Clouds
1415,69,1551801600,12,26,38,Clouds
1416,70,1551801600,0,28,28,Clouds
1417,71,1551801600,36,4,40,Clouds
1418,72,1551801600,25,0,25,Clouds
1419,73,1551801600,26,4,30,Clouds
1420,74,1551801600,29,1,30,Clouds
1421,75,1551801600,40,0,40,Clouds
1422,76,1551801600,38,0,38,Clouds
1423,77,1551801600,11,18,29,Clouds
1424,78,1551801600,34,6,40,Clouds
1425,79,1551801600,24,3,27,Clouds
1426,80,1551801600,37,3,40,Clouds
1427,81,1551801600,40,0,40,Clouds
1428,82,1551801600,22,0,22,Clouds
1429,83,1551801600,40,0,40,Clouds
1430,84,1551801600,27,3,30,Clouds
1431,85,1551801600,34,1,35,Clouds
1432,86,1551801600,36,2,38,Clouds
1433,87,1551801600,37,1,38,Clouds
1434,88,1551801600,29,1,30,Clouds
1435,89,1551801600,22,18,40,Clouds
1436,90,1551801600,9,31,40,Clouds
1437,91,1551801600,15,15,30,Clouds
1438,92,1551801600,37,3,40,Clouds
1439,93,1551801600,39,1,40,Clouds
1440,94,1551801600,40,0,40,Clouds
1441,95,1551801600,38,2,40,Clouds
1442,96,1551801600,29,1,30,Clouds
1443,97,1551801600,39,1,40,Clouds
1444,98,1551801600,28,12,40,Clouds
1445,99,1551801600,15,15,30,Clouds
1446,100,1551801600,18,7,25,Clouds
1447,101,1551801600,29,1,30,Clouds
1448,102,1551801600,31,9,40,Clouds
1449,103,1551801600,32,8,40,Clouds
1450,104,1551801600,40,0,40,Clouds
1451,105,1551801600,35,1,36,Clouds
1452,106,1551801600,40,0,40,Clouds
1453,107,1551801600,32,8,40,Clouds
1454,108,1551801600,39,1,40,Clouds
1455,109,1551801600,28,1,29,Clouds
1456,110,1551801600,24,16,40,Clouds
1457,111,1551801600,38,2,40,Clouds
1458,112,1551801600,26,4,30,Clouds
1459,113,1551801600,2,38,40,Clouds
1460,114,1551801600,10,30,40,Clouds
1461,115,1551801600,22,8,30,Clouds
1462,2,1551805200,20,0,20,Rain
1463,3,1551805200,19,1,20,Rain
1464,4,1551805200,17,3,20,Rain
1465,5,1551805200,32,8,40,Rain
1466,6,1551805200,19,1,20,Rain
1467,7,1551805200,29,0,29,Rain
1468,8,1551805200,23,16,39,Rain
1469,9,1551805200,9,15,24,Rain
1470,10,1551805200,8,8,16,Rain
1471,11,1551805200,27,3,30,Rain
1472,12,1551805200,20,0,20,Rain
1473,13,1551805200,4,26,30,Rain
1474,14,1551805200,1,29,30,Rain
1475,15,1551805200,9,7,16,Rain
1476,16,1551805200,19,1,20,Rain
1477,17,1551805200,10,10,20,Rain
1478,18,1551805200,27,3,30,Rain
1479,19,1551805200,10,20,30,Rain
1480,21,1551805200,4,26,30,Rain
1481,22,1551805200,16,4,20,Rain
1482,23,1551805200,12,18,30,Rain
1483,24,1551805200,15,5,20,Rain
1484,25,1551805200,9,21,30,Rain
1485,26,1551805200,4,16,20,Rain
1486,27,1551805200,4,16,20,Rain
1487,28,1551805200,21,9,30,Rain
1488,29,1551805200,26,3,29,Rain
1489,30,1551805200,20,0,20,Rain
1490,31,1551805200,18,2,20,Rain
1491,32,1551805200,25,5,30,Rain
1492,33,1551805200,6,17,23,Rain
1493,34,1551805200,21,9,30,Rain
1494,35,1551805200,27,3,30,Rain
1495,36,1551805200,16,24,40,Rain
1496,37,1551805200,20,10,30,Rain
1497,38,1551805200,29,11,40,Rain
1498,39,1551805200,19,1,20,Rain
1499,40,1551805200,11,9,20,Rain
1500,41,1551805200,11,9,20,Rain
1501,42,1551805200,21,9,30,Rain
1502,43,1551805200,18,12,30,Rain
1503,44,1551805200,25,5,30,Rain
1504,45,1551805200,26,4,30,Rain
1505,46,1551805200,16,4,20,Rain
1506,47,1551805200,13,27,40,Rain
1507,48,1551805200,6,34,40,Rain
1508,49,1551805200,14,26,40,Rain
1509,50,1551805200,31,9,40,Rain
1510,51,1551805200,40,0,40,Rain
1511,52,1551805200,13,19,32,Rain
1512,53,1551805200,15,25,40,Rain
1513,54,1551805200,11,22,33,Rain
1514,55,1551805200,33,3,36,Rain
1515,56,1551805200,12,28,40,Rain
1516,57,1551805200,1,22,23,Rain
1517,58,1551805200,7,33,40,Rain
1518,59,1551805200,20,0,20,Rain
1519,60,1551805200,14,16,30,Rain
1520,61,1551805200,25,0,25,Rain
1521,62,1551805200,12,28,40,Rain
1522,63,1551805200,5,30,35,Rain
1523,64,1551805200,7,33,40,Rain
1524,65,1551805200,10,30,40,Rain
1525,66,1551805200,18,22,40,Rain
1526,67,1551805200,9,31,40,Rain
1527,68,1551805200,9,31,40,Rain
1528,69,1551805200,19,21,40,Rain
1529,70,1551805200,2,26,28,Rain
1530,71,1551805200,38,2,40,Rain
1531,72,1551805200,22,3,25,Rain
1532,73,1551805200,30,0,30,Rain
1533,74,1551805200,27,3,30,Rain
1534,75,1551805200,37,3,40,Rain
1535,76,1551805200,37,1,38,Rain
1536,77,1551805200,11,18,29,Rain
1537,78,1551805200,32,8,40,Rain
1538,79,1551805200,27,0,27,Rain
1539,80,1551805200,40,0,40,Rain
1540,81,1551805200,40,0,40,Rain
1541,82,1551805200,22,0,22,Rain
1542,83,1551805200,40,0,40,Rain
1543,84,1551805200,28,2,30,Rain
1544,85,1551805200,33,2,35,Rain
1545,86,1551805200,37,1,38,Rain
1546,87,1551805200,38,0,38,Rain
1547,88,1551805200,30,0,30,Rain
1548,89,1551805200,23,17,40,Rain
1549,90,1551805200,16,24,40,Rain
1550,91,1551805200,18,12,30,Rain
1551,92,1551805200,40,0,40,Rain
1552,93,1551805200,37,3,40,Rain
1553,94,1551805200,39,1,40,Rain
1554,95,1551805200,40,0,40,Rain
1555,96,1551805200,30,0,30,Rain
1556,97,1551805200,37,3,40,Rain
1557,98,1551805200,30,10,40,Rain
1558,99,1551805200,16,14,30,Rain
1559,100,1551805200,25,0,25,Rain
1560,101,1551805200,27,3,30,Rain
1561,102,1551805200,31,9,40,Rain
1562,103,1551805200,33,7,40,Rain
1563,104,1551805200,40,0,40,Rain
1564,105,1551805200,34,2,36,Rain
1565,106,1551805200,39,1,40,Rain
1566,107,1551805200,33,7,40,Rain
1567,108,1551805200,39,1,40,Rain
1568,109,1551805200,26,3,29,Rain
1569,110,1551805200,25,15,40,Rain
1570,111,1551805200,38,2,40,Rain
1571,112,1551805200,21,9,30,Rain
1572,113,1551805200,1,39,40,Rain
1573,114,1551805200,17,23,40,Rain
1574,115,1551805200,19,11,30,Rain
1575,2,1551808800,20,0,20,Clouds
1576,3,1551808800,19,1,20,Clouds
1577,4,1551808800,20,0,20,Clouds
1578,5,1551808800,7,33,40,Clouds
1579,6,1551808800,19,1,20,Clouds
1580,7,1551808800,29,0,29,Clouds
1581,8,1551808800,5,34,39,Clouds
1582,9,1551808800,15,9,24,Clouds
1583,10,1551808800,16,0,16,Clouds
1584,11,1551808800,30,0,30,Clouds
1585,12,1551808800,20,0,20,Clouds
1586,13,1551808800,13,17,30,Clouds
1587,14,1551808800,0,30,30,Clouds
1588,15,1551808800,16,0,16,Clouds
1589,16,1551808800,10,10,20,Clouds
1590,17,1551808800,13,7,20,Clouds
1591,18,1551808800,30,0,30,Clouds
1592,19,1551808800,26,4,30,Clouds
1593,21,1551808800,4,26,30,Clouds
1594,22,1551808800,13,7,20,Clouds
1595,23,1551808800,0,30,30,Clouds
1596,24,1551808800,19,1,20,Clouds
1597,25,1551808800,21,9,30,Clouds
1598,26,1551808800,1,19,20,Clouds
1599,27,1551808800,3,17,20,Clouds
1600,28,1551808800,30,0,30,Clouds
1601,29,1551808800,29,0,29,Clouds
1602,30,1551808800,20,0,20,Clouds
1603,31,1551808800,20,0,20,Clouds
1604,32,1551808800,7,23,30,Clouds
1605,33,1551808800,3,20,23,Clouds
1606,34,1551808800,22,8,30,Clouds
1607,35,1551808800,29,1,30,Clouds
1608,36,1551808800,27,13,40,Clouds
1609,37,1551808800,17,13,30,Clouds
1610,38,1551808800,25,15,40,Clouds
1611,39,1551808800,18,2,20,Clouds
1612,40,1551808800,20,1,21,Clouds
1613,41,1551808800,20,0,20,Clouds
1614,42,1551808800,22,8,30,Clouds
1615,43,1551808800,20,10,30,Clouds
1616,44,1551808800,27,3,30,Clouds
1617,45,1551808800,22,8,30,Clouds
1618,46,1551808800,14,5,19,Clouds
1619,47,1551808800,25,15,40,Clouds
1620,48,1551808800,9,31,40,Clouds
1621,49,1551808800,5,35,40,Clouds
1622,50,1551808800,30,10,40,Clouds
1623,51,1551808800,37,3,40,Clouds
1624,52,1551808800,17,15,32,Clouds
1625,53,1551808800,19,21,40,Clouds
1626,54,1551808800,25,8,33,Clouds
1627,55,1551808800,35,1,36,Clouds
1628,56,1551808800,40,0,40,Clouds
1629,57,1551808800,8,15,23,Clouds
1630,58,1551808800,27,13,40,Clouds
1631,59,1551808800,20,0,20,Clouds
1632,60,1551808800,5,25,30,Clouds
1633,61,1551808800,24,1,25,Clouds
1634,62,1551808800,22,18,40,Clouds
1635,63,1551808800,1,34,35,Clouds
1636,64,1551808800,12,28,40,Clouds
1637,65,1551808800,36,4,40,Clouds
1638,66,1551808800,40,0,40,Clouds
1639,67,1551808800,9,31,40,Clouds
1640,68,1551808800,19,21,40,Clouds
1641,69,1551808800,31,9,40,Clouds
1642,70,1551808800,4,24,28,Clouds
1643,71,1551808800,40,0,40,Clouds
1644,72,1551808800,12,13,25,Clouds
1645,73,1551808800,28,2,30,Clouds
1646,74,1551808800,27,3,30,Clouds
1647,75,1551808800,39,1,40,Clouds
1648,76,1551808800,35,3,38,Clouds
1649,77,1551808800,17,12,29,Clouds
1650,78,1551808800,36,4,40,Clouds
1651,79,1551808800,27,0,27,Clouds
1652,80,1551808800,23,17,40,Clouds
1653,81,1551808800,40,0,40,Clouds
1654,82,1551808800,18,4,22,Clouds
1655,83,1551808800,35,5,40,Clouds
1656,84,1551808800,23,7,30,Clouds
1657,85,1551808800,31,4,35,Clouds
1658,86,1551808800,24,14,38,Clouds
1659,87,1551808800,35,3,38,Clouds
1660,88,1551808800,27,3,30,Clouds
1661,89,1551808800,37,3,40,Clouds
1662,90,1551808800,38,2,40,Clouds
1663,91,1551808800,24,6,30,Clouds
1664,92,1551808800,26,14,40,Clouds
1665,93,1551808800,18,22,40,Clouds
1666,94,1551808800,40,0,40,Clouds
1667,95,1551808800,40,0,40,Clouds
1668,96,1551808800,29,1,30,Clouds
1669,97,1551808800,35,5,40,Clouds
1670,98,1551808800,32,8,40,Clouds
1671,99,1551808800,14,16,30,Clouds
1672,100,1551808800,0,25,25,Clouds
1673,101,1551808800,29,1,30,Clouds
1674,102,1551808800,31,9,40,Clouds
1675,103,1551808800,40,0,40,Clouds
1676,104,1551808800,40,0,40,Clouds
1677,105,1551808800,34,2,36,Clouds
1678,106,1551808800,38,2,40,Clouds
1679,107,1551808800,33,7,40,Clouds
1680,108,1551808800,38,2,40,Clouds
1681,109,1551808800,27,2,29,Clouds
1682,110,1551808800,22,18,40,Clouds
1683,111,1551808800,36,4,40,Clouds
1684,112,1551808800,22,8,30,Clouds
1685,113,1551808800,2,38,40,Clouds
1686,114,1551808800,40,0,40,Clouds
1687,115,1551808800,14,16,30,Clouds
1688,2,1551812400,17,3,20,Clouds
1689,3,1551812400,20,0,20,Clouds
1690,4,1551812400,18,2,20,Clouds
1691,5,1551812400,23,17,40,Clouds
1692,6,1551812400,20,0,20,Clouds
1693,7,1551812400,26,3,29,Clouds
1694,8,1551812400,15,24,39,Clouds
1695,9,1551812400,18,6,24,Clouds
1696,10,1551812400,7,9,16,Clouds
1697,11,1551812400,30,0,30,Clouds
1698,12,1551812400,15,5,20,Clouds
1699,13,1551812400,30,0,30,Clouds
1700,14,1551812400,0,30,30,Clouds
1701,15,1551812400,15,1,16,Clouds
1702,16,1551812400,8,12,20,Clouds
1703,17,1551812400,19,1,20,Clouds
1704,18,1551812400,23,7,30,Clouds
1705,19,1551812400,28,2,30,Clouds
1706,21,1551812400,0,30,30,Clouds
1707,22,1551812400,3,17,20,Clouds
1708,23,1551812400,3,27,30,Clouds
1709,24,1551812400,16,4,20,Clouds
1710,25,1551812400,30,0,30,Clouds
1711,26,1551812400,7,13,20,Clouds
1712,27,1551812400,9,11,20,Clouds
1713,28,1551812400,25,5,30,Clouds
1714,29,1551812400,25,4,29,Clouds
1715,30,1551812400,19,1,20,Clouds
1716,31,1551812400,10,10,20,Clouds
1717,32,1551812400,0,30,30,Clouds
1718,33,1551812400,9,14,23,Clouds
1719,34,1551812400,7,23,30,Clouds
1720,35,1551812400,23,7,30,Clouds
1721,36,1551812400,39,1,40,Clouds
1722,37,1551812400,30,0,30,Clouds
1723,38,1551812400,36,4,40,Clouds
1724,39,1551812400,16,4,20,Clouds
1725,40,1551812400,15,6,21,Clouds
1726,41,1551812400,19,1,20,Clouds
1727,42,1551812400,11,19,30,Clouds
1728,43,1551812400,8,22,30,Clouds
1729,44,1551812400,16,14,30,Clouds
1730,45,1551812400,20,10,30,Clouds
1731,46,1551812400,12,8,20,Clouds
1732,47,1551812400,40,0,40,Clouds
1733,48,1551812400,31,9,40,Clouds
1734,49,1551812400,35,4,39,Clouds
1735,50,1551812400,20,20,40,Clouds
1736,51,1551812400,38,2,40,Clouds
1737,52,1551812400,31,1,32,Clouds
1738,53,1551812400,40,0,40,Clouds
1739,54,1551812400,31,2,33,Clouds
1740,55,1551812400,36,0,36,Clouds
1741,56,1551812400,40,0,40,Clouds
1742,57,1551812400,22,1,23,Clouds
1743,58,1551812400,39,1,40,Clouds
1744,59,1551812400,18,2,20,Clouds
1745,60,1551812400,1,29,30,Clouds
1746,61,1551812400,21,4,25,Clouds
1747,62,1551812400,40,0,40,Clouds
1748,63,1551812400,13,22,35,Clouds
1749,64,1551812400,19,21,40,Clouds
1750,65,1551812400,40,0,40,Clouds
1751,66,1551812400,40,0,40,Clouds
1752,67,1551812400,22,18,40,Clouds
1753,68,1551812400,40,0,40,Clouds
1754,69,1551812400,40,0,40,Clouds
1755,70,1551812400,21,7,28,Clouds
1756,71,1551812400,40,0,40,Clouds
1757,72,1551812400,20,5,25,Clouds
1758,73,1551812400,22,8,30,Clouds
1759,74,1551812400,12,18,30,Clouds
1760,75,1551812400,34,6,40,Clouds
1761,76,1551812400,25,13,38,Clouds
1762,77,1551812400,24,5,29,Clouds
1763,78,1551812400,22,18,40,Clouds
1764,79,1551812400,23,4,27,Clouds
1765,80,1551812400,25,15,40,Clouds
1766,81,1551812400,40,0,40,Clouds
1767,82,1551812400,10,12,22,Clouds
1768,83,1551812400,29,11,40,Clouds
1769,84,1551812400,17,13,30,Clouds
1770,85,1551812400,27,8,35,Clouds
1771,86,1551812400,11,27,38,Clouds
1772,87,1551812400,32,6,38,Clouds
1773,88,1551812400,18,12,30,Clouds
1774,89,1551812400,40,0,40,Clouds
1775,90,1551812400,40,0,40,Clouds
1776,91,1551812400,16,14,30,Clouds
1777,92,1551812400,0,40,40,Clouds
1778,93,1551812400,8,32,40,Clouds
1779,94,1551812400,8,32,40,Clouds
1780,95,1551812400,30,10,40,Clouds
1781,96,1551812400,25,5,30,Clouds
1782,97,1551812400,32,8,40,Clouds
1783,98,1551812400,38,2,40,Clouds
1784,99,1551812400,30,0,30,Clouds
1785,100,1551812400,5,20,25,Clouds
1786,101,1551812400,19,11,30,Clouds
1787,102,1551812400,31,9,40,Clouds
1788,103,1551812400,40,0,40,Clouds
1789,104,1551812400,40,0,40,Clouds
1790,105,1551812400,35,1,36,Clouds
1791,106,1551812400,37,3,40,Clouds
1792,107,1551812400,29,11,40,Clouds
1793,108,1551812400,32,8,40,Clouds
1794,109,1551812400,26,3,29,Clouds
1795,110,1551812400,22,18,40,Clouds
1796,111,1551812400,38,2,40,Clouds
1797,112,1551812400,17,13,30,Clouds
1798,113,1551812400,28,12,40,Clouds
1799,114,1551812400,40,0,40,Clouds
1800,115,1551812400,3,27,30,Clouds
1801,2,1551819600,10,10,20,Rain
1802,3,1551819600,20,0,20,Rain
1803,4,1551819600,20,0,20,Rain
1804,5,1551819600,7,33,40,Rain
1805,6,1551819600,16,4,20,Rain
1806,7,1551819600,16,13,29,Rain
1807,8,1551819600,20,10,30,Rain
1808,9,1551819600,17,7,24,Rain
1809,10,1551819600,1,15,16,Rain
1810,11,1551819600,30,0,30,Rain
1811,12,1551819600,10,10,20,Rain
1812,13,1551819600,28,2,30,Rain
1813,14,1551819600,10,20,30,Rain
1814,15,1551819600,16,0,16,Rain
1815,16,1551819600,12,8,20,Rain
1816,17,1551819600,19,1,20,Rain
1817,18,1551819600,24,6,30,Rain
1818,19,1551819600,28,2,30,Rain
1819,21,1551819600,7,23,30,Rain
1820,22,1551819600,1,19,20,Rain
1821,23,1551819600,3,27,30,Rain
1822,24,1551819600,16,4,20,Rain
1823,25,1551819600,21,9,30,Rain
1824,26,1551819600,14,6,20,Rain
1825,27,1551819600,20,0,20,Rain
1826,28,1551819600,22,8,30,Rain
1827,29,1551819600,25,4,29,Rain
1828,30,1551819600,18,2,20,Rain
1829,31,1551819600,18,2,20,Rain
1830,32,1551819600,12,18,30,Rain
1831,33,1551819600,20,3,23,Rain
1832,34,1551819600,18,12,30,Rain
1833,35,1551819600,13,17,30,Rain
1834,36,1551819600,32,8,40,Rain
1835,37,1551819600,25,5,30,Rain
1836,38,1551819600,37,3,40,Rain
1837,39,1551819600,16,4,20,Rain
1838,40,1551819600,20,1,21,Rain
1839,41,1551819600,17,3,20,Rain
1840,42,1551819600,0,30,30,Rain
1841,43,1551819600,0,30,30,Rain
1842,44,1551819600,0,30,30,Rain
1843,45,1551819600,19,11,30,Rain
1844,46,1551819600,14,6,20,Rain
1845,47,1551819600,39,1,40,Rain
1846,48,1551819600,35,5,40,Rain
1847,49,1551819600,38,1,39,Rain
1848,50,1551819600,10,30,40,Rain
1849,51,1551819600,40,0,40,Rain
1850,52,1551819600,31,1,32,Rain
1851,53,1551819600,40,0,40,Rain
1852,54,1551819600,32,1,33,Rain
1853,55,1551819600,36,0,36,Rain
1854,56,1551819600,32,8,40,Rain
1855,57,1551819600,22,1,23,Rain
1856,58,1551819600,39,1,40,Rain
1857,59,1551819600,20,0,20,Rain
1858,60,1551819600,0,30,30,Rain
1859,61,1551819600,23,2,25,Rain
1860,62,1551819600,40,0,40,Rain
1861,63,1551819600,24,11,35,Rain
1862,64,1551819600,24,16,40,Rain
1863,65,1551819600,40,0,40,Rain
1864,66,1551819600,30,10,40,Rain
1865,67,1551819600,25,15,40,Rain
1866,68,1551819600,38,2,40,Rain
1867,69,1551819600,38,2,40,Rain
1868,70,1551819600,25,3,28,Rain
1869,71,1551819600,39,1,40,Rain
1870,72,1551819600,5,20,25,Rain
1871,73,1551819600,20,10,30,Rain
1872,74,1551819600,15,15,30,Rain
1873,75,1551819600,32,8,40,Rain
1874,76,1551819600,24,14,38,Rain
1875,77,1551819600,27,2,29,Rain
1876,78,1551819600,12,28,40,Rain
1877,79,1551819600,23,4,27,Rain
1878,80,1551819600,22,18,40,Rain
1879,81,1551819600,39,1,40,Rain
1880,82,1551819600,3,19,22,Rain
1881,83,1551819600,17,23,40,Rain
1882,84,1551819600,2,28,30,Rain
1883,85,1551819600,20,15,35,Rain
1884,86,1551819600,5,33,38,Rain
1885,87,1551819600,16,22,38,Rain
1886,88,1551819600,2,28,30,Rain
1887,89,1551819600,40,0,40,Rain
1888,90,1551819600,40,0,40,Rain
1889,91,1551819600,3,27,30,Rain
1890,92,1551819600,5,35,40,Rain
1891,93,1551819600,0,40,40,Rain
1892,94,1551819600,0,40,40,Rain
1893,95,1551819600,5,35,40,Rain
1894,96,1551819600,24,6,30,Rain
1895,97,1551819600,14,26,40,Rain
1896,98,1551819600,40,0,40,Rain
1897,99,1551819600,30,0,30,Rain
1898,100,1551819600,0,25,25,Rain
1899,101,1551819600,8,22,30,Rain
1900,102,1551819600,27,13,40,Rain
1901,103,1551819600,40,0,40,Rain
1902,104,1551819600,40,0,40,Rain
1903,105,1551819600,32,4,36,Rain
1904,106,1551819600,33,7,40,Rain
1905,107,1551819600,26,14,40,Rain
1906,108,1551819600,28,12,40,Rain
1907,109,1551819600,18,11,29,Rain
1908,110,1551819600,25,15,40,Rain
1909,111,1551819600,28,12,40,Rain
1910,112,1551819600,7,23,30,Rain
1911,113,1551819600,40,0,40,Rain
1912,114,1551819600,40,0,40,Rain
1913,115,1551819600,1,29,30,Rain
1914,2,1551823200,12,8,20,Rain
1915,3,1551823200,20,0,20,Rain
1916,4,1551823200,20,0,20,Rain
1917,5,1551823200,2,38,40,Rain
1918,6,1551823200,17,3,20,Rain
1919,7,1551823200,17,12,29,Rain
1920,8,1551823200,27,3,30,Rain
1921,9,1551823200,24,0,24,Rain
1922,10,1551823200,4,12,16,Rain
1923,11,1551823200,30,0,30,Rain
1924,12,1551823200,10,10,20,Rain
1925,13,1551823200,30,0,30,Rain
1926,14,1551823200,13,17,30,Rain
1927,15,1551823200,16,0,16,Rain
1928,16,1551823200,15,5,20,Rain
1929,17,1551823200,16,4,20,Rain
1930,18,1551823200,24,6,30,Rain
1931,19,1551823200,21,9,30,Rain
1932,21,1551823200,11,19,30,Rain
1933,22,1551823200,1,19,20,Rain
1934,23,1551823200,1,29,30,Rain
1935,24,1551823200,12,8,20,Rain
1936,25,1551823200,23,7,30,Rain
1937,26,1551823200,14,6,20,Rain
1938,27,1551823200,20,0,20,Rain
1939,28,1551823200,18,12,30,Rain
1940,29,1551823200,26,3,29,Rain
1941,30,1551823200,20,0,20,Rain
1942,31,1551823200,17,3,20,Rain
1943,32,1551823200,19,11,30,Rain
1944,33,1551823200,21,2,23,Rain
1945,34,1551823200,15,15,30,Rain
1946,35,1551823200,12,18,30,Rain
1947,36,1551823200,33,7,40,Rain
1948,37,1551823200,27,3,30,Rain
1949,38,1551823200,38,2,40,Rain
1950,39,1551823200,19,1,20,Rain
1951,40,1551823200,21,0,21,Rain
1952,41,1551823200,18,2,20,Rain
1953,42,1551823200,0,30,30,Rain
1954,43,1551823200,1,29,30,Rain
1955,44,1551823200,3,27,30,Rain
1956,45,1551823200,18,12,30,Rain
1957,46,1551823200,12,8,20,Rain
1958,47,1551823200,38,2,40,Rain
1959,48,1551823200,38,2,40,Rain
1960,49,1551823200,39,0,39,Rain
1961,50,1551823200,4,36,40,Rain
1962,51,1551823200,40,0,40,Rain
1963,52,1551823200,32,0,32,Rain
1964,53,1551823200,40,0,40,Rain
1965,54,1551823200,32,1,33,Rain
1966,55,1551823200,35,1,36,Rain
1967,56,1551823200,33,7,40,Rain
1968,57,1551823200,23,0,23,Rain
1969,58,1551823200,34,6,40,Rain
1970,59,1551823200,20,0,20,Rain
1971,60,1551823200,0,30,30,Rain
1972,61,1551823200,23,2,25,Rain
1973,62,1551823200,40,0,40,Rain
1974,63,1551823200,25,10,35,Rain
1975,64,1551823200,28,12,40,Rain
1976,65,1551823200,40,0,40,Rain
1977,66,1551823200,27,13,40,Rain
1978,67,1551823200,23,17,40,Rain
1979,68,1551823200,39,1,40,Rain
1980,69,1551823200,40,0,40,Rain
1981,70,1551823200,21,7,28,Rain
1982,71,1551823200,40,0,40,Rain
1983,72,1551823200,3,22,25,Rain
1984,73,1551823200,21,9,30,Rain
1985,74,1551823200,12,18,30,Rain
1986,75,1551823200,29,11,40,Rain
1987,76,1551823200,22,16,38,Rain
1988,77,1551823200,25,4,29,Rain
1989,78,1551823200,9,31,40,Rain
1990,79,1551823200,22,5,27,Rain
1991,80,1551823200,22,18,40,Rain
1992,81,1551823200,39,1,40,Rain
1993,82,1551823200,3,19,22,Rain
1994,83,1551823200,15,25,40,Rain
1995,84,1551823200,0,30,30,Rain
1996,85,1551823200,17,18,35,Rain
1997,86,1551823200,3,35,38,Rain
1998,87,1551823200,11,27,38,Rain
1999,88,1551823200,0,30,30,Rain
2000,89,1551823200,34,6,40,Rain
2001,90,1551823200,40,0,40,Rain
2002,91,1551823200,3,27,30,Rain
2003,92,1551823200,2,38,40,Rain
2004,93,1551823200,0,40,40,Rain
2005,94,1551823200,0,40,40,Rain
2006,95,1551823200,4,36,40,Rain
2007,96,1551823200,23,7,30,Rain
2008,97,1551823200,13,27,40,Rain
2009,98,1551823200,40,0,40,Rain
2010,99,1551823200,30,0,30,Rain
2011,100,1551823200,0,25,25,Rain
2012,101,1551823200,3,27,30,Rain
2013,102,1551823200,26,14,40,Rain
2014,103,1551823200,40,0,40,Rain
2015,104,1551823200,40,0,40,Rain
2016,105,1551823200,34,2,36,Rain
2017,106,1551823200,33,7,40,Rain
2018,107,1551823200,27,13,40,Rain
2019,108,1551823200,28,12,40,Rain
2020,109,1551823200,15,14,29,Rain
2021,110,1551823200,24,16,40,Rain
2022,111,1551823200,25,15,40,Rain
2023,112,1551823200,0,30,30,Rain
2024,113,1551823200,40,0,40,Rain
2025,114,1551823200,39,1,40,Rain
2026,115,1551823200,0,30,30,Rain
2027,2,1551826800,10,10,20,Rain
2028,3,1551826800,18,2,20,Rain
2029,4,1551826800,19,1,20,Rain
2030,5,1551826800,1,39,40,Rain
2031,6,1551826800,17,3,20,Rain
2032,7,1551826800,17,12,29,Rain
2033,8,1551826800,28,2,30,Rain
2034,9,1551826800,24,0,24,Rain
2035,10,1551826800,4,12,16,Rain
2036,11,1551826800,30,0,30,Rain
2037,12,1551826800,11,9,20,Rain
2038,13,1551826800,29,1,30,Rain
2039,14,1551826800,16,14,30,Rain
2040,15,1551826800,15,1,16,Rain
2041,16,1551826800,13,7,20,Rain
2042,17,1551826800,18,2,20,Rain
2043,18,1551826800,25,5,30,Rain
2044,19,1551826800,26,4,30,Rain
2045,21,1551826800,15,15,30,Rain
2046,22,1551826800,4,16,20,Rain
2047,23,1551826800,0,30,30,Rain
2048,24,1551826800,12,8,20,Rain
2049,25,1551826800,23,7,30,Rain
2050,26,1551826800,15,5,20,Rain
2051,27,1551826800,20,0,20,Rain
2052,28,1551826800,16,14,30,Rain
2053,29,1551826800,25,4,29,Rain
2054,30,1551826800,19,1,20,Rain
2055,31,1551826800,20,0,20,Rain
2056,32,1551826800,21,9,30,Rain
2057,33,1551826800,23,0,23,Rain
2058,34,1551826800,12,18,30,Rain
2059,35,1551826800,10,20,30,Rain
2060,36,1551826800,34,6,40,Rain
2061,37,1551826800,27,3,30,Rain
2062,38,1551826800,39,1,40,Rain
2063,39,1551826800,17,3,20,Rain
2064,40,1551826800,21,0,21,Rain
2065,41,1551826800,17,3,20,Rain
2066,42,1551826800,9,21,30,Rain
2067,43,1551826800,2,28,30,Rain
2068,44,1551826800,3,27,30,Rain
2069,45,1551826800,18,12,30,Rain
2070,46,1551826800,12,8,20,Rain
2071,47,1551826800,38,2,40,Rain
2072,48,1551826800,39,1,40,Rain
2073,49,1551826800,39,0,39,Rain
2074,50,1551826800,2,38,40,Rain
2075,51,1551826800,40,0,40,Rain
2076,52,1551826800,32,0,32,Rain
2077,53,1551826800,40,0,40,Rain
2078,54,1551826800,31,2,33,Rain
2079,55,1551826800,36,0,36,Rain
2080,56,1551826800,28,12,40,Rain
2081,57,1551826800,22,1,23,Rain
2082,58,1551826800,34,6,40,Rain
2083,59,1551826800,20,0,20,Rain
2084,60,1551826800,0,30,30,Rain
2085,61,1551826800,23,2,25,Rain
2086,62,1551826800,40,0,40,Rain
2087,63,1551826800,27,8,35,Rain
2088,64,1551826800,28,12,40,Rain
2089,65,1551826800,39,1,40,Rain
2090,66,1551826800,30,10,40,Rain
2091,67,1551826800,22,18,40,Rain
2092,68,1551826800,37,3,40,Rain
2093,69,1551826800,38,2,40,Rain
2094,70,1551826800,24,4,28,Rain
2095,71,1551826800,37,3,40,Rain
2096,72,1551826800,2,23,25,Rain
2097,73,1551826800,19,11,30,Rain
2098,74,1551826800,11,19,30,Rain
2099,75,1551826800,27,13,40,Rain
2100,76,1551826800,22,16,38,Rain
2101,77,1551826800,29,0,29,Rain
2102,78,1551826800,10,30,40,Rain
2103,79,1551826800,22,5,27,Rain
2104,80,1551826800,21,19,40,Rain
2105,81,1551826800,39,1,40,Rain
2106,82,1551826800,3,19,22,Rain
2107,83,1551826800,16,24,40,Rain
2108,84,1551826800,0,30,30,Rain
2109,85,1551826800,14,21,35,Rain
2110,86,1551826800,3,35,38,Rain
2111,87,1551826800,10,28,38,Rain
2112,88,1551826800,10,20,30,Rain
2113,89,1551826800,34,6,40,Rain
2114,90,1551826800,40,0,40,Rain
2115,91,1551826800,2,28,30,Rain
2116,92,1551826800,2,38,40,Rain
2117,93,1551826800,0,40,40,Rain
2118,94,1551826800,0,40,40,Rain
2119,95,1551826800,3,37,40,Rain
2120,96,1551826800,23,7,30,Rain
2121,97,1551826800,11,29,40,Rain
2122,98,1551826800,40,0,40,Rain
2123,99,1551826800,30,0,30,Rain
2124,100,1551826800,0,25,25,Rain
2125,101,1551826800,2,28,30,Rain
2126,102,1551826800,26,14,40,Rain
2127,103,1551826800,40,0,40,Rain
2128,104,1551826800,40,0,40,Rain
2129,105,1551826800,34,2,36,Rain
2130,106,1551826800,33,7,40,Rain
2131,107,1551826800,27,13,40,Rain
2132,108,1551826800,29,11,40,Rain
2133,109,1551826800,12,17,29,Rain
2134,110,1551826800,23,17,40,Rain
2135,111,1551826800,23,17,40,Rain
2136,112,1551826800,1,29,30,Rain
2137,113,1551826800,40,0,40,Rain
2138,114,1551826800,39,1,40,Rain
2139,115,1551826800,1,29,30,Rain
2140,2,1551873600,19,1,20,Rain
2141,3,1551873600,16,4,20,Rain
2142,4,1551873600,17,3,20,Rain
2143,5,1551873600,33,7,40,Rain
2144,6,1551873600,19,1,20,Rain
2145,7,1551873600,29,0,29,Rain
2146,8,1551873600,10,20,30,Rain
2147,9,1551873600,0,24,24,Rain
2148,10,1551873600,13,2,15,Rain
2149,11,1551873600,18,12,30,Rain
2150,12,1551873600,20,0,20,Rain
2151,13,1551873600,5,25,30,Rain
2152,14,1551873600,15,15,30,Rain
2153,15,1551873600,15,1,16,Rain
2154,16,1551873600,17,3,20,Rain
2155,17,1551873600,14,6,20,Rain
2156,18,1551873600,30,0,30,Rain
2157,19,1551873600,8,22,30,Rain
2158,21,1551873600,5,25,30,Rain
2159,22,1551873600,17,3,20,Rain
2160,23,1551873600,24,6,30,Rain
2161,24,1551873600,15,4,19,Rain
2162,25,1551873600,4,26,30,Rain
2163,26,1551873600,0,20,20,Rain
2164,27,1551873600,7,13,20,Rain
2165,28,1551873600,30,0,30,Rain
2166,29,1551873600,26,3,29,Rain
2167,30,1551873600,17,3,20,Rain
2168,31,1551873600,13,7,20,Rain
2169,32,1551873600,9,21,30,Rain
2170,33,1551873600,9,14,23,Rain
2171,34,1551873600,14,16,30,Rain
2172,35,1551873600,30,0,30,Rain
2173,36,1551873600,16,23,39,Rain
2174,37,1551873600,28,2,30,Rain
2175,38,1551873600,38,2,40,Rain
2176,39,1551873600,20,0,20,Rain
2177,40,1551873600,19,2,21,Rain
2178,41,1551873600,13,7,20,Rain
2179,42,1551873600,28,2,30,Rain
2180,43,1551873600,30,0,30,Rain
2181,44,1551873600,30,0,30,Rain
2182,45,1551873600,28,2,30,Rain
2183,46,1551873600,14,6,20,Rain
2184,47,1551873600,8,32,40,Rain
2185,48,1551873600,5,35,40,Rain
2186,49,1551873600,11,29,40,Rain
2187,50,1551873600,38,2,40,Rain
2188,51,1551873600,27,13,40,Rain
2189,52,1551873600,5,26,31,Rain
2190,53,1551873600,18,21,39,Rain
2191,54,1551873600,16,17,33,Rain
2192,55,1551873600,10,25,35,Rain
2193,56,1551873600,4,35,39,Rain
2194,57,1551873600,5,17,22,Rain
2195,58,1551873600,8,32,40,Rain
2196,59,1551873600,20,0,20,Rain
2197,60,1551873600,30,0,30,Rain
2198,61,1551873600,23,2,25,Rain
2199,62,1551873600,0,40,40,Rain
2200,63,1551873600,1,34,35,Rain
2201,64,1551873600,1,38,39,Rain
2202,65,1551873600,9,31,40,Rain
2203,66,1551873600,12,28,40,Rain
2204,67,1551873600,19,21,40,Rain
2205,68,1551873600,0,40,40,Rain
2206,69,1551873600,0,37,37,Rain
2207,70,1551873600,1,27,28,Rain
2208,71,1551873600,35,5,40,Rain
2209,72,1551873600,25,0,25,Rain
2210,73,1551873600,30,0,30,Rain
2211,74,1551873600,30,0,30,Rain
2212,75,1551873600,39,1,40,Rain
2213,76,1551873600,38,0,38,Rain
2214,77,1551873600,25,4,29,Rain
2215,78,1551873600,40,0,40,Rain
2216,79,1551873600,27,0,27,Rain
2217,80,1551873600,40,0,40,Rain
2218,81,1551873600,40,0,40,Rain
2219,82,1551873600,22,0,22,Rain
2220,83,1551873600,40,0,40,Rain
2221,84,1551873600,30,0,30,Rain
2222,85,1551873600,35,0,35,Rain
2223,86,1551873600,32,5,37,Rain
2224,87,1551873600,36,2,38,Rain
2225,88,1551873600,30,0,30,Rain
2226,89,1551873600,19,21,40,Rain
2227,90,1551873600,0,40,40,Rain
2228,91,1551873600,3,26,29,Rain
2229,92,1551873600,40,0,40,Rain
2230,93,1551873600,40,0,40,Rain
2231,94,1551873600,39,1,40,Rain
2232,95,1551873600,39,1,40,Rain
2233,96,1551873600,30,0,30,Rain
2234,97,1551873600,40,0,40,Rain
2235,98,1551873600,30,9,39,Rain
2236,99,1551873600,0,30,30,Rain
2237,100,1551873600,23,2,25,Rain
2238,101,1551873600,27,3,30,Rain
2239,102,1551873600,38,2,40,Rain
2240,103,1551873600,40,0,40,Rain
2241,105,1551873600,36,0,36,Rain
2242,106,1551873600,40,0,40,Rain
2243,107,1551873600,40,0,40,Rain
2244,108,1551873600,40,0,40,Rain
2245,109,1551873600,29,0,29,Rain
2246,110,1551873600,40,0,40,Rain
2247,111,1551873600,40,0,40,Rain
2248,112,1551873600,18,12,30,Rain
2249,113,1551873600,13,27,40,Rain
2250,114,1551873600,5,34,39,Rain
2251,115,1551873600,30,0,30,Rain
2252,2,1551877200,20,0,20,Rain
2253,3,1551877200,19,1,20,Rain
2254,4,1551877200,18,2,20,Rain
2255,5,1551877200,38,2,40,Rain
2256,6,1551877200,20,0,20,Rain
2257,7,1551877200,29,0,29,Rain
2258,8,1551877200,8,22,30,Rain
2259,9,1551877200,1,23,24,Rain
2260,10,1551877200,11,5,16,Rain
2261,11,1551877200,16,14,30,Rain
2262,12,1551877200,20,0,20,Rain
2263,13,1551877200,4,26,30,Rain
2264,14,1551877200,9,21,30,Rain
2265,15,1551877200,16,0,16,Rain
2266,16,1551877200,16,4,20,Rain
2267,17,1551877200,11,9,20,Rain
2268,18,1551877200,28,2,30,Rain
2269,19,1551877200,9,21,30,Rain
2270,21,1551877200,5,25,30,Rain
2271,22,1551877200,15,5,20,Rain
2272,23,1551877200,25,5,30,Rain
2273,24,1551877200,18,1,19,Rain
2274,25,1551877200,5,25,30,Rain
2275,26,1551877200,1,19,20,Rain
2276,27,1551877200,3,17,20,Rain
2277,28,1551877200,21,9,30,Rain
2278,29,1551877200,25,4,29,Rain
2279,30,1551877200,15,5,20,Rain
2280,31,1551877200,16,4,20,Rain
2281,32,1551877200,9,21,30,Rain
2282,33,1551877200,12,11,23,Rain
2283,34,1551877200,18,12,30,Rain
2284,35,1551877200,30,0,30,Rain
2285,36,1551877200,19,21,40,Rain
2286,37,1551877200,29,1,30,Rain
2287,38,1551877200,35,5,40,Rain
2288,39,1551877200,20,0,20,Rain
2289,40,1551877200,21,0,21,Rain
2290,41,1551877200,11,9,20,Rain
2291,42,1551877200,29,1,30,Rain
2292,43,1551877200,30,0,30,Rain
2293,44,1551877200,30,0,30,Rain
2294,45,1551877200,26,4,30,Rain
2295,46,1551877200,17,3,20,Rain
2296,47,1551877200,8,32,40,Rain
2297,48,1551877200,0,40,40,Rain
2298,49,1551877200,5,35,40,Rain
2299,50,1551877200,37,3,40,Rain
2300,51,1551877200,30,10,40,Rain
2301,52,1551877200,8,23,31,Rain
2302,53,1551877200,18,21,39,Rain
2303,54,1551877200,17,16,33,Rain
2304,55,1551877200,10,25,35,Rain
2305,56,1551877200,9,30,39,Rain
2306,57,1551877200,4,19,23,Rain
2307,58,1551877200,11,29,40,Rain
2308,59,1551877200,20,0,20,Rain
2309,60,1551877200,27,3,30,Rain
2310,61,1551877200,6,19,25,Rain
2311,62,1551877200,2,38,40,Rain
2312,63,1551877200,0,35,35,Rain
2313,64,1551877200,0,39,39,Rain
2314,65,1551877200,11,29,40,Rain
2315,66,1551877200,11,29,40,Rain
2316,67,1551877200,20,20,40,Rain
2317,68,1551877200,0,40,40,Rain
2318,69,1551877200,1,36,37,Rain
2319,70,1551877200,3,25,28,Rain
2320,71,1551877200,36,4,40,Rain
2321,72,1551877200,25,0,25,Rain
2322,73,1551877200,30,0,30,Rain
2323,74,1551877200,30,0,30,Rain
2324,75,1551877200,39,1,40,Rain
2325,76,1551877200,38,0,38,Rain
2326,77,1551877200,27,2,29,Rain
2327,78,1551877200,40,0,40,Rain
2328,79,1551877200,27,0,27,Rain
2329,80,1551877200,39,1,40,Rain
2330,81,1551877200,40,0,40,Rain
2331,82,1551877200,22,0,22,Rain
2332,83,1551877200,39,1,40,Rain
2333,84,1551877200,30,0,30,Rain
2334,85,1551877200,35,0,35,Rain
2335,86,1551877200,33,5,38,Rain
2336,87,1551877200,37,1,38,Rain
2337,88,1551877200,28,2,30,Rain
2338,89,1551877200,16,24,40,Rain
2339,90,1551877200,1,39,40,Rain
2340,91,1551877200,7,22,29,Rain
2341,92,1551877200,21,18,39,Rain
2342,93,1551877200,40,0,40,Rain
2343,94,1551877200,39,1,40,Rain
2344,95,1551877200,40,0,40,Rain
2345,96,1551877200,30,0,30,Rain
2346,97,1551877200,40,0,40,Rain
2347,98,1551877200,31,8,39,Rain
2348,99,1551877200,0,30,30,Rain
2349,100,1551877200,24,1,25,Rain
2350,101,1551877200,29,1,30,Rain
2351,102,1551877200,31,9,40,Rain
2352,103,1551877200,40,0,40,Rain
2353,105,1551877200,36,0,36,Rain
2354,106,1551877200,40,0,40,Rain
2355,107,1551877200,40,0,40,Rain
2356,108,1551877200,40,0,40,Rain
2357,109,1551877200,28,1,29,Rain
2358,110,1551877200,40,0,40,Rain
2359,111,1551877200,40,0,40,Rain
2360,112,1551877200,19,11,30,Rain
2361,113,1551877200,7,33,40,Rain
2362,114,1551877200,6,33,39,Rain
2363,115,1551877200,29,1,30,Rain
2364,2,1551888000,20,0,20,Rain
2365,3,1551888000,15,5,20,Rain
2366,4,1551888000,18,2,20,Rain
2367,5,1551888000,38,2,40,Rain
2368,6,1551888000,17,3,20,Rain
2369,7,1551888000,29,0,29,Rain
2370,8,1551888000,10,20,30,Rain
2371,9,1551888000,10,14,24,Rain
2372,10,1551888000,14,2,16,Rain
2373,11,1551888000,10,20,30,Rain
2374,12,1551888000,19,1,20,Rain
2375,13,1551888000,1,29,30,Rain
2376,14,1551888000,25,5,30,Rain
2377,15,1551888000,4,12,16,Rain
2378,16,1551888000,10,10,20,Rain
2379,17,1551888000,11,9,20,Rain
2380,18,1551888000,28,2,30,Rain
2381,19,1551888000,0,29,29,Rain
2382,21,1551888000,15,15,30,Rain
2383,22,1551888000,12,8,20,Rain
2384,23,1551888000,21,9,30,Rain
2385,24,1551888000,17,2,19,Rain
2386,25,1551888000,6,24,30,Rain
2387,26,1551888000,7,13,20,Rain
2388,27,1551888000,10,10,20,Rain
2389,28,1551888000,24,6,30,Rain
2390,29,1551888000,28,1,29,Rain
2391,30,1551888000,12,8,20,Rain
2392,31,1551888000,5,15,20,Rain
2393,32,1551888000,13,17,30,Rain
2394,33,1551888000,11,12,23,Rain
2395,34,1551888000,30,0,30,Rain
2396,35,1551888000,27,3,30,Rain
2397,36,1551888000,19,21,40,Rain
2398,37,1551888000,25,5,30,Rain
2399,38,1551888000,36,4,40,Rain
2400,39,1551888000,19,1,20,Rain
2401,40,1551888000,21,0,21,Rain
2402,41,1551888000,16,4,20,Rain
2403,42,1551888000,30,0,30,Rain
2404,43,1551888000,27,3,30,Rain
2405,44,1551888000,30,0,30,Rain
2406,45,1551888000,26,4,30,Rain
2407,46,1551888000,20,0,20,Rain
2408,47,1551888000,1,39,40,Rain
2409,48,1551888000,12,27,39,Rain
2410,49,1551888000,5,35,40,Rain
2411,50,1551888000,34,6,40,Rain
2412,51,1551888000,23,17,40,Rain
2413,52,1551888000,0,32,32,Rain
2414,53,1551888000,21,19,40,Rain
2415,54,1551888000,20,13,33,Rain
2416,55,1551888000,13,23,36,Rain
2417,56,1551888000,11,29,40,Rain
2418,57,1551888000,9,14,23,Rain
2419,58,1551888000,11,29,40,Rain
2420,59,1551888000,12,8,20,Rain
2421,60,1551888000,30,0,30,Rain
2422,61,1551888000,18,7,25,Rain
2423,62,1551888000,2,38,40,Rain
2424,63,1551888000,8,27,35,Rain
2425,64,1551888000,1,38,39,Rain
2426,65,1551888000,12,28,40,Rain
2427,66,1551888000,5,35,40,Rain
2428,67,1551888000,23,17,40,Rain
2429,68,1551888000,1,39,40,Rain
2430,69,1551888000,8,29,37,Rain
2431,70,1551888000,2,26,28,Rain
2432,71,1551888000,34,6,40,Rain
2433,72,1551888000,24,1,25,Rain
2434,73,1551888000,26,4,30,Rain
2435,74,1551888000,16,14,30,Rain
2436,75,1551888000,39,1,40,Rain
2437,76,1551888000,35,3,38,Rain
2438,77,1551888000,27,2,29,Rain
2439,78,1551888000,36,4,40,Rain
2440,79,1551888000,21,6,27,Rain
2441,80,1551888000,35,5,40,Rain
2442,81,1551888000,40,0,40,Rain
2443,82,1551888000,22,0,22,Rain
2444,83,1551888000,40,0,40,Rain
2445,84,1551888000,30,0,30,Rain
2446,85,1551888000,34,1,35,Rain
2447,86,1551888000,31,7,38,Rain
2448,87,1551888000,34,4,38,Rain
2449,88,1551888000,30,0,30,Rain
2450,89,1551888000,23,17,40,Rain
2451,90,1551888000,1,39,40,Rain
2452,91,1551888000,0,29,29,Rain
2453,92,1551888000,22,18,40,Rain
2454,93,1551888000,40,0,40,Rain
2455,94,1551888000,40,0,40,Rain
2456,95,1551888000,39,1,40,Rain
2457,96,1551888000,29,1,30,Rain
2458,97,1551888000,38,2,40,Rain
2459,98,1551888000,26,14,40,Rain
2460,99,1551888000,1,29,30,Rain
2461,100,1551888000,20,5,25,Rain
2462,101,1551888000,30,0,30,Rain
2463,102,1551888000,40,0,40,Rain
2464,103,1551888000,37,3,40,Rain
2465,104,1551888000,40,0,40,Rain
2466,105,1551888000,36,0,36,Rain
2467,106,1551888000,39,1,40,Rain
2468,107,1551888000,40,0,40,Rain
2469,108,1551888000,40,0,40,Rain
2470,109,1551888000,28,1,29,Rain
2471,110,1551888000,38,2,40,Rain
2472,111,1551888000,33,7,40,Rain
2473,112,1551888000,27,3,30,Rain
2474,113,1551888000,5,35,40,Rain
2475,114,1551888000,10,30,40,Rain
2476,115,1551888000,18,12,30,Rain
2477,2,1551891600,17,3,20,Rain
2478,3,1551891600,14,6,20,Rain
2479,4,1551891600,17,3,20,Rain
2480,5,1551891600,30,10,40,Rain
2481,6,1551891600,20,0,20,Rain
2482,7,1551891600,28,1,29,Rain
2483,8,1551891600,8,22,30,Rain
2484,9,1551891600,17,7,24,Rain
2485,10,1551891600,16,0,16,Rain
2486,11,1551891600,16,14,30,Rain
2487,12,1551891600,20,0,20,Rain
2488,13,1551891600,2,28,30,Rain
2489,14,1551891600,30,0,30,Rain
2490,15,1551891600,2,14,16,Rain
2491,16,1551891600,10,10,20,Rain
2492,17,1551891600,11,9,20,Rain
2493,18,1551891600,28,2,30,Rain
2494,19,1551891600,5,25,30,Rain
2495,21,1551891600,19,11,30,Rain
2496,22,1551891600,15,5,20,Rain
2497,23,1551891600,18,12,30,Rain
2498,24,1551891600,17,2,19,Rain
2499,25,1551891600,5,25,30,Rain
2500,26,1551891600,7,13,20,Rain
2501,27,1551891600,20,0,20,Rain
2502,28,1551891600,22,8,30,Rain
2503,29,1551891600,25,4,29,Rain
2504,30,1551891600,12,8,20,Rain
2505,31,1551891600,13,7,20,Rain
2506,32,1551891600,27,3,30,Rain
2507,33,1551891600,10,13,23,Rain
2508,34,1551891600,26,4,30,Rain
2509,35,1551891600,24,6,30,Rain
2510,36,1551891600,17,23,40,Rain
2511,37,1551891600,24,6,30,Rain
2512,38,1551891600,31,9,40,Rain
2513,39,1551891600,20,0,20,Rain
2514,40,1551891600,20,1,21,Rain
2515,41,1551891600,17,3,20,Rain
2516,42,1551891600,26,4,30,Rain
2517,43,1551891600,27,3,30,Rain
2518,44,1551891600,27,3,30,Rain
2519,45,1551891600,23,7,30,Rain
2520,46,1551891600,20,0,20,Rain
2521,47,1551891600,3,37,40,Rain
2522,48,1551891600,18,22,40,Rain
2523,49,1551891600,3,37,40,Rain
2524,50,1551891600,35,5,40,Rain
2525,51,1551891600,23,17,40,Rain
2526,52,1551891600,2,30,32,Rain
2527,53,1551891600,23,17,40,Rain
2528,54,1551891600,23,10,33,Rain
2529,55,1551891600,16,20,36,Rain
2530,56,1551891600,11,29,40,Rain
2531,57,1551891600,9,14,23,Rain
2532,58,1551891600,5,35,40,Rain
2533,59,1551891600,10,10,20,Rain
2534,60,1551891600,26,4,30,Rain
2535,61,1551891600,16,9,25,Rain
2536,62,1551891600,5,35,40,Rain
2537,63,1551891600,12,23,35,Rain
2538,64,1551891600,1,39,40,Rain
2539,65,1551891600,9,31,40,Rain
2540,66,1551891600,14,26,40,Rain
2541,67,1551891600,18,22,40,Rain
2542,68,1551891600,7,33,40,Rain
2543,69,1551891600,16,24,40,Rain
2544,70,1551891600,2,26,28,Rain
2545,71,1551891600,38,2,40,Rain
2546,72,1551891600,29,1,30,Rain
2547,73,1551891600,27,3,30,Rain
2548,74,1551891600,11,19,30,Rain
2549,75,1551891600,35,5,40,Rain
2550,76,1551891600,37,1,38,Rain
2551,77,1551891600,28,1,29,Rain
2552,78,1551891600,32,8,40,Rain
2553,79,1551891600,25,2,27,Rain
2554,80,1551891600,34,6,40,Rain
2555,81,1551891600,40,0,40,Rain
2556,82,1551891600,22,0,22,Rain
2557,83,1551891600,37,3,40,Rain
2558,84,1551891600,30,0,30,Rain
2559,85,1551891600,34,1,35,Rain
2560,86,1551891600,32,6,38,Rain
2561,87,1551891600,34,4,38,Rain
2562,88,1551891600,28,2,30,Rain
2563,89,1551891600,9,31,40,Rain
2564,90,1551891600,9,31,40,Rain
2565,91,1551891600,5,25,30,Rain
2566,92,1551891600,21,19,40,Rain
2567,93,1551891600,39,1,40,Rain
2568,94,1551891600,39,1,40,Rain
2569,95,1551891600,37,3,40,Rain
2570,96,1551891600,30,0,30,Rain
2571,97,1551891600,40,0,40,Rain
2572,98,1551891600,30,10,40,Rain
2573,99,1551891600,2,28,30,Rain
2574,100,1551891600,7,18,25,Rain
2575,101,1551891600,28,2,30,Rain
2576,102,1551891600,39,1,40,Rain
2577,103,1551891600,39,1,40,Rain
2578,104,1551891600,40,0,40,Rain
2579,105,1551891600,35,1,36,Rain
2580,106,1551891600,40,0,40,Rain
2581,107,1551891600,37,3,40,Rain
2582,108,1551891600,39,1,40,Rain
2583,109,1551891600,29,0,29,Rain
2584,110,1551891600,39,1,40,Rain
2585,111,1551891600,36,4,40,Rain
2586,112,1551891600,19,11,30,Rain
2587,113,1551891600,7,33,40,Rain
2588,114,1551891600,21,19,40,Rain
2589,115,1551891600,19,11,30,Rain
2590,2,1551895200,20,0,20,Rain
2591,3,1551895200,19,1,20,Rain
2592,4,1551895200,20,0,20,Rain
2593,5,1551895200,10,30,40,Rain
2594,6,1551895200,20,0,20,Rain
2595,7,1551895200,29,0,29,Rain
2596,8,1551895200,8,22,30,Rain
2597,9,1551895200,21,3,24,Rain
2598,10,1551895200,16,0,16,Rain
2599,11,1551895200,30,0,30,Rain
2600,12,1551895200,20,0,20,Rain
2601,13,1551895200,13,17,30,Rain
2602,14,1551895200,23,7,30,Rain
2603,15,1551895200,16,0,16,Rain
2604,16,1551895200,6,14,20,Rain
2605,17,1551895200,20,0,20,Rain
2606,18,1551895200,30,0,30,Rain
2607,19,1551895200,16,14,30,Rain
2608,21,1551895200,18,12,30,Rain
2609,22,1551895200,5,15,20,Rain
2610,23,1551895200,1,29,30,Rain
2611,24,1551895200,14,5,19,Rain
2612,25,1551895200,23,7,30,Rain
2613,26,1551895200,1,19,20,Rain
2614,27,1551895200,20,0,20,Rain
2615,28,1551895200,29,1,30,Rain
2616,29,1551895200,29,0,29,Rain
2617,30,1551895200,12,8,20,Rain
2618,31,1551895200,19,1,20,Rain
2619,32,1551895200,1,29,30,Rain
2620,33,1551895200,6,17,23,Rain
2621,34,1551895200,18,12,30,Rain
2622,35,1551895200,30,0,30,Rain
2623,36,1551895200,32,8,40,Rain
2624,37,1551895200,28,2,30,Rain
2625,38,1551895200,23,17,40,Rain
2626,39,1551895200,15,5,20,Rain
2627,40,1551895200,21,0,21,Rain
2628,41,1551895200,17,3,20,Rain
2629,42,1551895200,17,13,30,Rain
2630,43,1551895200,13,17,30,Rain
2631,44,1551895200,26,4,30,Rain
2632,45,1551895200,19,11,30,Rain
2633,46,1551895200,20,0,20,Rain
2634,47,1551895200,5,35,40,Rain
2635,48,1551895200,17,23,40,Rain
2636,49,1551895200,0,40,40,Rain
2637,50,1551895200,34,6,40,Rain
2638,51,1551895200,26,14,40,Rain
2639,52,1551895200,3,29,32,Rain
2640,53,1551895200,27,13,40,Rain
2641,54,1551895200,33,0,33,Rain
2642,55,1551895200,36,0,36,Rain
2643,56,1551895200,23,17,40,Rain
2644,57,1551895200,20,3,23,Rain
2645,58,1551895200,18,22,40,Rain
2646,59,1551895200,18,2,20,Rain
2647,60,1551895200,18,12,30,Rain
2648,61,1551895200,24,1,25,Rain
2649,62,1551895200,9,31,40,Rain
2650,63,1551895200,5,30,35,Rain
2651,64,1551895200,14,26,40,Rain
2652,65,1551895200,16,24,40,Rain
2653,66,1551895200,29,11,40,Rain
2654,67,1551895200,14,26,40,Rain
2655,68,1551895200,25,15,40,Rain
2656,69,1551895200,28,12,40,Rain
2657,70,1551895200,3,25,28,Rain
2658,71,1551895200,39,1,40,Rain
2659,72,1551895200,23,2,25,Rain
2660,73,1551895200,29,1,30,Rain
2661,74,1551895200,9,21,30,Rain
2662,75,1551895200,26,14,40,Rain
2663,76,1551895200,36,2,38,Rain
2664,77,1551895200,26,3,29,Rain
2665,78,1551895200,38,2,40,Rain
2666,79,1551895200,27,0,27,Rain
2667,80,1551895200,23,17,40,Rain
2668,81,1551895200,40,0,40,Rain
2669,82,1551895200,22,0,22,Rain
2670,83,1551895200,34,6,40,Rain
2671,84,1551895200,27,3,30,Rain
2672,85,1551895200,28,7,35,Rain
2673,86,1551895200,19,19,38,Rain
2674,87,1551895200,34,4,38,Rain
2675,88,1551895200,26,4,30,Rain
2676,89,1551895200,17,23,40,Rain
2677,90,1551895200,31,9,40,Rain
2678,91,1551895200,5,25,30,Rain
2679,92,1551895200,22,18,40,Rain
2680,93,1551895200,33,7,40,Rain
2681,94,1551895200,40,0,40,Rain
2682,95,1551895200,34,6,40,Rain
2683,96,1551895200,29,1,30,Rain
2684,97,1551895200,40,0,40,Rain
2685,98,1551895200,32,8,40,Rain
2686,99,1551895200,3,27,30,Rain
2687,100,1551895200,2,23,25,Rain
2688,101,1551895200,26,4,30,Rain
2689,102,1551895200,39,1,40,Rain
2690,103,1551895200,40,0,40,Rain
2691,104,1551895200,40,0,40,Rain
2692,105,1551895200,36,0,36,Rain
2693,106,1551895200,38,2,40,Rain
2694,107,1551895200,38,2,40,Rain
2695,108,1551895200,38,2,40,Rain
2696,109,1551895200,24,5,29,Rain
2697,110,1551895200,40,0,40,Rain
2698,111,1551895200,33,7,40,Rain
2699,112,1551895200,26,4,30,Rain
2700,113,1551895200,14,26,40,Rain
2701,114,1551895200,40,0,40,Rain
2702,115,1551895200,26,4,30,Rain
2703,2,1551898800,17,3,20,Rain
2704,3,1551898800,19,1,20,Rain
2705,4,1551898800,17,3,20,Rain
2706,5,1551898800,16,24,40,Rain
2707,6,1551898800,19,1,20,Rain
2708,7,1551898800,29,0,29,Rain
2709,8,1551898800,2,28,30,Rain
2710,9,1551898800,22,2,24,Rain
2711,10,1551898800,13,3,16,Rain
2712,11,1551898800,29,1,30,Rain
2713,12,1551898800,17,3,20,Rain
2714,13,1551898800,30,0,30,Rain
2715,14,1551898800,22,8,30,Rain
2716,15,1551898800,14,2,16,Rain
2717,16,1551898800,0,19,19,Rain
2718,17,1551898800,20,0,20,Rain
2719,18,1551898800,24,6,30,Rain
2720,19,1551898800,30,0,30,Rain
2721,21,1551898800,14,16,30,Rain
2722,22,1551898800,0,20,20,Rain
2723,23,1551898800,0,30,30,Rain
2724,24,1551898800,17,2,19,Rain
2725,25,1551898800,29,1,30,Rain
2726,26,1551898800,0,20,20,Rain
2727,27,1551898800,16,4,20,Rain
2728,28,1551898800,26,4,30,Rain
2729,29,1551898800,6,23,29,Rain
2730,30,1551898800,18,2,20,Rain
2731,31,1551898800,18,2,20,Rain
2732,32,1551898800,0,30,30,Rain
2733,33,1551898800,5,18,23,Rain
2734,34,1551898800,6,24,30,Rain
2735,35,1551898800,28,2,30,Rain
2736,36,1551898800,40,0,40,Rain
2737,37,1551898800,30,0,30,Rain
2738,38,1551898800,10,29,39,Rain
2739,39,1551898800,18,2,20,Rain
2740,40,1551898800,17,4,21,Rain
2741,41,1551898800,19,1,20,Rain
2742,42,1551898800,17,13,30,Rain
2743,43,1551898800,5,25,30,Rain
2744,44,1551898800,26,4,30,Rain
2745,45,1551898800,10,20,30,Rain
2746,46,1551898800,16,4,20,Rain
2747,47,1551898800,40,0,40,Rain
2748,48,1551898800,1,39,40,Rain
2749,49,1551898800,23,17,40,Rain
2750,50,1551898800,33,7,40,Rain
2751,51,1551898800,31,9,40,Rain
2752,52,1551898800,18,14,32,Rain
2753,53,1551898800,37,3,40,Rain
2754,54,1551898800,33,0,33,Rain
2755,55,1551898800,36,0,36,Rain
2756,56,1551898800,40,0,40,Rain
2757,57,1551898800,22,1,23,Rain
2758,58,1551898800,38,2,40,Rain
2759,59,1551898800,16,4,20,Rain
2760,60,1551898800,0,30,30,Rain
2761,61,1551898800,23,2,25,Rain
2762,62,1551898800,35,5,40,Rain
2763,63,1551898800,15,20,35,Rain
2764,64,1551898800,12,28,40,Rain
2765,65,1551898800,40,0,40,Rain
2766,66,1551898800,40,0,40,Rain
2767,67,1551898800,27,13,40,Rain
2768,68,1551898800,38,2,40,Rain
2769,69,1551898800,35,5,40,Rain
2770,70,1551898800,19,9,28,Rain
2771,71,1551898800,39,1,40,Rain
2772,72,1551898800,22,3,25,Rain
2773,73,1551898800,30,0,30,Rain
2774,74,1551898800,21,9,30,Rain
2775,75,1551898800,12,28,40,Rain
2776,76,1551898800,32,6,38,Rain
2777,78,1551898800,26,14,40,Rain
2778,79,1551898800,24,3,27,Rain
2779,80,1551898800,24,16,40,Rain
2780,81,1551898800,40,0,40,Rain
2781,82,1551898800,14,8,22,Rain
2782,83,1551898800,21,19,40,Rain
2783,84,1551898800,24,6,30,Rain
2784,85,1551898800,23,12,35,Rain
2785,86,1551898800,0,38,38,Rain
2786,87,1551898800,28,10,38,Rain
2787,88,1551898800,22,8,30,Rain
2788,89,1551898800,38,2,40,Rain
2789,90,1551898800,39,1,40,Rain
2790,91,1551898800,0,30,30,Rain
2791,92,1551898800,7,33,40,Rain
2792,93,1551898800,0,40,40,Rain
2793,94,1551898800,13,27,40,Rain
2794,95,1551898800,29,11,40,Rain
2795,96,1551898800,28,2,30,Rain
2796,97,1551898800,30,10,40,Rain
2797,98,1551898800,37,3,40,Rain
2798,99,1551898800,18,12,30,Rain
2799,100,1551898800,7,18,25,Rain
2800,101,1551898800,20,10,30,Rain
2801,102,1551898800,35,5,40,Rain
2802,103,1551898800,40,0,40,Rain
2803,104,1551898800,40,0,40,Rain
2804,105,1551898800,36,0,36,Rain
2805,106,1551898800,36,4,40,Rain
2806,107,1551898800,38,2,40,Rain
2807,108,1551898800,31,9,40,Rain
2808,109,1551898800,20,9,29,Rain
2809,110,1551898800,37,3,40,Rain
2810,111,1551898800,32,8,40,Rain
2811,112,1551898800,25,5,30,Rain
2812,113,1551898800,26,14,40,Rain
2813,114,1551898800,40,0,40,Rain
2814,115,1551898800,10,20,30,Rain
2815,2,1551902400,15,5,20,Rain
2816,3,1551902400,20,0,20,Rain
2817,4,1551902400,20,0,20,Rain
2818,5,1551902400,30,10,40,Rain
2819,6,1551902400,16,4,20,Rain
2820,7,1551902400,29,0,29,Rain
2821,8,1551902400,9,21,30,Rain
2822,9,1551902400,21,3,24,Rain
2823,10,1551902400,12,4,16,Rain
2824,11,1551902400,27,3,30,Rain
2825,12,1551902400,16,4,20,Rain
2826,13,1551902400,30,0,30,Rain
2827,14,1551902400,13,17,30,Rain
2828,15,1551902400,13,3,16,Rain
2829,16,1551902400,4,16,20,Rain
2830,17,1551902400,15,5,20,Rain
2831,18,1551902400,9,21,30,Rain
2832,19,1551902400,27,3,30,Rain
2833,21,1551902400,14,16,30,Rain
2834,22,1551902400,2,18,20,Rain
2835,23,1551902400,7,23,30,Rain
2836,24,1551902400,17,2,19,Rain
2837,25,1551902400,30,0,30,Rain
2838,26,1551902400,4,16,20,Rain
2839,27,1551902400,19,1,20,Rain
2840,28,1551902400,24,6,30,Rain
2841,29,1551902400,14,15,29,Rain
2842,30,1551902400,14,6,20,Rain
2843,31,1551902400,18,2,20,Rain
2844,32,1551902400,13,17,30,Rain
2845,33,1551902400,6,17,23,Rain
2846,34,1551902400,7,23,30,Rain
2847,35,1551902400,20,10,30,Rain
2848,36,1551902400,33,7,40,Rain
2849,37,1551902400,30,0,30,Rain
2850,38,1551902400,14,25,39,Rain
2851,39,1551902400,20,0,20,Rain
2852,40,1551902400,19,2,21,Rain
2853,41,1551902400,18,2,20,Rain
2854,42,1551902400,18,12,30,Rain
2855,43,1551902400,17,13,30,Rain
2856,44,1551902400,7,23,30,Rain
2857,45,1551902400,9,21,30,Rain
2858,46,1551902400,17,3,20,Rain
2859,47,1551902400,40,0,40,Rain
2860,48,1551902400,13,27,40,Rain
2861,49,1551902400,26,14,40,Rain
2862,50,1551902400,27,13,40,Rain
2863,51,1551902400,36,4,40,Rain
2864,52,1551902400,22,10,32,Rain
2865,53,1551902400,31,9,40,Rain
2866,54,1551902400,32,1,33,Rain
2867,55,1551902400,35,1,36,Rain
2868,56,1551902400,40,0,40,Rain
2869,57,1551902400,21,2,23,Rain
2870,58,1551902400,40,0,40,Rain
2871,59,1551902400,19,1,20,Rain
2872,60,1551902400,0,30,30,Rain
2873,61,1551902400,21,4,25,Rain
2874,62,1551902400,35,5,40,Rain
2875,63,1551902400,24,11,35,Rain
2876,64,1551902400,9,31,40,Rain
2877,65,1551902400,40,0,40,Rain
2878,66,1551902400,40,0,40,Rain
2879,67,1551902400,31,9,40,Rain
2880,68,1551902400,38,2,40,Rain
2881,69,1551902400,40,0,40,Rain
2882,70,1551902400,27,1,28,Rain
2883,71,1551902400,38,2,40,Rain
2884,72,1551902400,23,2,25,Rain
2885,73,1551902400,27,3,30,Rain
2886,74,1551902400,22,8,30,Rain
2887,75,1551902400,5,35,40,Rain
2888,76,1551902400,30,8,38,Rain
2889,78,1551902400,18,22,40,Rain
2890,79,1551902400,22,5,27,Rain
2891,80,1551902400,24,16,40,Rain
2892,81,1551902400,40,0,40,Rain
2893,82,1551902400,14,8,22,Rain
2894,83,1551902400,15,25,40,Rain
2895,84,1551902400,13,17,30,Rain
2896,85,1551902400,16,19,35,Rain
2897,86,1551902400,0,38,38,Rain
2898,87,1551902400,25,13,38,Rain
2899,88,1551902400,19,11,30,Rain
2900,89,1551902400,40,0,40,Rain
2901,90,1551902400,40,0,40,Rain
2902,91,1551902400,0,30,30,Rain
2903,92,1551902400,1,39,40,Rain
2904,93,1551902400,0,40,40,Rain
2905,94,1551902400,6,34,40,Rain
2906,95,1551902400,22,18,40,Rain
2907,96,1551902400,24,6,30,Rain
2908,97,1551902400,16,24,40,Rain
2909,98,1551902400,40,0,40,Rain
2910,99,1551902400,26,4,30,Rain
2911,100,1551902400,1,24,25,Rain
2912,101,1551902400,15,15,30,Rain
2913,102,1551902400,40,0,40,Rain
2914,103,1551902400,40,0,40,Rain
2915,104,1551902400,40,0,40,Rain
2916,105,1551902400,36,0,36,Rain
2917,106,1551902400,35,5,40,Rain
2918,107,1551902400,32,8,40,Rain
2919,108,1551902400,30,10,40,Rain
2920,109,1551902400,19,10,29,Rain
2921,110,1551902400,31,9,40,Rain
2922,111,1551902400,25,15,40,Rain
2923,112,1551902400,20,10,30,Rain
2924,113,1551902400,39,1,40,Rain
2925,114,1551902400,40,0,40,Rain
2926,115,1551902400,13,17,30,Rain
2927,2,1551906000,16,4,20,Clouds
2928,3,1551906000,20,0,20,Clouds
2929,4,1551906000,18,2,20,Clouds
2930,5,1551906000,18,22,40,Clouds
2931,6,1551906000,13,7,20,Clouds
2932,7,1551906000,28,1,29,Clouds
2933,8,1551906000,19,11,30,Clouds
2934,9,1551906000,19,5,24,Clouds
2935,10,1551906000,11,5,16,Clouds
2936,11,1551906000,23,7,30,Clouds
2937,12,1551906000,16,4,20,Clouds
2938,13,1551906000,30,0,30,Clouds
2939,14,1551906000,14,16,30,Clouds
2940,15,1551906000,12,4,16,Clouds
2941,16,1551906000,6,14,20,Clouds
2942,17,1551906000,16,4,20,Clouds
2943,18,1551906000,15,15,30,Clouds
2944,19,1551906000,26,4,30,Clouds
2945,21,1551906000,22,8,30,Clouds
2946,22,1551906000,20,0,20,Clouds
2947,23,1551906000,19,11,30,Clouds
2948,24,1551906000,19,0,19,Clouds
2949,25,1551906000,25,5,30,Clouds
2950,26,1551906000,5,15,20,Clouds
2951,27,1551906000,19,1,20,Clouds
2952,28,1551906000,19,11,30,Clouds
2953,29,1551906000,13,16,29,Clouds
2954,30,1551906000,14,6,20,Clouds
2955,31,1551906000,14,6,20,Clouds
2956,32,1551906000,26,4,30,Clouds
2957,33,1551906000,4,19,23,Clouds
2958,34,1551906000,2,28,30,Clouds
2959,35,1551906000,17,13,30,Clouds
2960,36,1551906000,34,6,40,Clouds
2961,37,1551906000,30,0,30,Clouds
2962,38,1551906000,15,24,39,Clouds
2963,39,1551906000,14,6,20,Clouds
2964,40,1551906000,19,2,21,Clouds
2965,41,1551906000,19,1,20,Clouds
2966,42,1551906000,14,16,30,Clouds
2967,43,1551906000,9,21,30,Clouds
2968,44,1551906000,1,29,30,Clouds
2969,45,1551906000,12,18,30,Clouds
2970,46,1551906000,17,3,20,Clouds
2971,47,1551906000,40,0,40,Clouds
2972,48,1551906000,23,17,40,Clouds
2973,49,1551906000,36,4,40,Clouds
2974,50,1551906000,18,22,40,Clouds
2975,51,1551906000,35,5,40,Clouds
2976,52,1551906000,25,7,32,Clouds
2977,53,1551906000,39,1,40,Clouds
2978,54,1551906000,32,1,33,Clouds
2979,55,1551906000,36,0,36,Clouds
2980,56,1551906000,37,3,40,Clouds
2981,57,1551906000,21,2,23,Clouds
2982,58,1551906000,26,14,40,Clouds
2983,59,1551906000,17,3,20,Clouds
2984,60,1551906000,0,30,30,Clouds
2985,61,1551906000,21,4,25,Clouds
2986,62,1551906000,36,4,40,Clouds
2987,63,1551906000,29,6,35,Clouds
2988,64,1551906000,28,12,40,Clouds
2989,65,1551906000,37,3,40,Clouds
2990,66,1551906000,38,2,40,Clouds
2991,67,1551906000,20,20,40,Clouds
2992,68,1551906000,34,6,40,Clouds
2993,69,1551906000,40,0,40,Clouds
2994,70,1551906000,26,2,28,Clouds
2995,71,1551906000,39,1,40,Clouds
2996,72,1551906000,23,2,25,Clouds
2997,73,1551906000,21,9,30,Clouds
2998,74,1551906000,25,5,30,Clouds
2999,75,1551906000,3,37,40,Clouds
3000,76,1551906000,26,12,38,Clouds
3001,78,1551906000,13,27,40,Clouds
3002,79,1551906000,23,4,27,Clouds
3003,80,1551906000,26,14,40,Clouds
3004,81,1551906000,40,0,40,Clouds
3005,82,1551906000,12,10,22,Clouds
3006,83,1551906000,13,27,40,Clouds
3007,84,1551906000,11,19,30,Clouds
3008,85,1551906000,12,23,35,Clouds
3009,86,1551906000,3,35,38,Clouds
3010,87,1551906000,23,15,38,Clouds
3011,88,1551906000,11,19,30,Clouds
3012,89,1551906000,36,4,40,Clouds
3013,90,1551906000,39,1,40,Clouds
3014,91,1551906000,5,25,30,Clouds
3015,92,1551906000,0,40,40,Clouds
3016,93,1551906000,0,40,40,Clouds
3017,94,1551906000,2,38,40,Clouds
3018,95,1551906000,17,23,40,Clouds
3019,96,1551906000,22,8,30,Clouds
3020,97,1551906000,13,27,40,Clouds
3021,98,1551906000,40,0,40,Clouds
3022,99,1551906000,25,5,30,Clouds
3023,100,1551906000,0,25,25,Clouds
3024,101,1551906000,9,21,30,Clouds
3025,102,1551906000,40,0,40,Clouds
3026,103,1551906000,39,1,40,Clouds
3027,104,1551906000,40,0,40,Clouds
3028,105,1551906000,35,1,36,Clouds
3029,106,1551906000,31,9,40,Clouds
3030,107,1551906000,32,8,40,Clouds
3031,108,1551906000,29,11,40,Clouds
3032,109,1551906000,19,10,29,Clouds
3033,110,1551906000,31,9,40,Clouds
3034,111,1551906000,21,19,40,Clouds
3035,112,1551906000,10,20,30,Clouds
3036,113,1551906000,40,0,40,Clouds
3037,114,1551906000,40,0,40,Clouds
3038,115,1551906000,7,23,30,Clouds
3039,2,1551909600,13,7,20,Rain
3040,3,1551909600,18,2,20,Rain
3041,4,1551909600,17,3,20,Rain
3042,5,1551909600,13,27,40,Rain
3043,6,1551909600,11,9,20,Rain
3044,7,1551909600,27,2,29,Rain
3045,8,1551909600,25,5,30,Rain
3046,9,1551909600,24,0,24,Rain
3047,10,1551909600,13,3,16,Rain
3048,11,1551909600,28,2,30,Rain
3049,12,1551909600,7,13,20,Rain
3050,13,1551909600,24,6,30,Rain
3051,14,1551909600,20,10,30,Rain
3052,15,1551909600,10,6,16,Rain
3053,16,1551909600,8,12,20,Rain
3054,17,1551909600,16,4,20,Rain
3055,18,1551909600,19,11,30,Rain
3056,19,1551909600,29,1,30,Rain
3057,21,1551909600,27,3,30,Rain
3058,22,1551909600,19,1,20,Rain
3059,23,1551909600,21,9,30,Rain
3060,24,1551909600,17,2,19,Rain
3061,25,1551909600,25,5,30,Rain
3062,26,1551909600,6,14,20,Rain
3063,27,1551909600,20,0,20,Rain
3064,28,1551909600,10,20,30,Rain
3065,29,1551909600,16,13,29,Rain
3066,30,1551909600,14,6,20,Rain
3067,31,1551909600,17,3,20,Rain
3068,32,1551909600,27,3,30,Rain
3069,33,1551909600,13,10,23,Rain
3070,34,1551909600,3,27,30,Rain
3071,35,1551909600,13,17,30,Rain
3072,36,1551909600,38,2,40,Rain
3073,37,1551909600,30,0,30,Rain
3074,38,1551909600,12,28,40,Rain
3075,39,1551909600,12,8,20,Rain
3076,40,1551909600,21,0,21,Rain
3077,41,1551909600,18,2,20,Rain
3078,42,1551909600,9,21,30,Rain
3079,43,1551909600,5,25,30,Rain
3080,44,1551909600,0,30,30,Rain
3081,45,1551909600,12,18,30,Rain
3082,46,1551909600,19,1,20,Rain
3083,47,1551909600,33,7,40,Rain
3084,48,1551909600,23,17,40,Rain
3085,49,1551909600,37,3,40,Rain
3086,50,1551909600,17,23,40,Rain
3087,51,1551909600,40,0,40,Rain
3088,52,1551909600,32,0,32,Rain
3089,53,1551909600,39,1,40,Rain
3090,54,1551909600,33,0,33,Rain
3091,55,1551909600,36,0,36,Rain
3092,56,1551909600,28,12,40,Rain
3093,57,1551909600,21,2,23,Rain
3094,58,1551909600,28,12,40,Rain
3095,59,1551909600,18,2,20,Rain
3096,60,1551909600,0,30,30,Rain
3097,61,1551909600,13,12,25,Rain
3098,62,1551909600,39,1,40,Rain
3099,63,1551909600,30,5,35,Rain
3100,64,1551909600,31,9,40,Rain
3101,65,1551909600,37,3,40,Rain
3102,66,1551909600,35,5,40,Rain
3103,67,1551909600,12,28,40,Rain
3104,68,1551909600,39,1,40,Rain
3105,69,1551909600,40,0,40,Rain
3106,70,1551909600,28,0,28,Rain
3107,71,1551909600,40,0,40,Rain
3108,72,1551909600,16,9,25,Rain
3109,73,1551909600,21,9,30,Rain
3110,74,1551909600,22,8,30,Rain
3111,75,1551909600,4,36,40,Rain
3112,76,1551909600,26,12,38,Rain
3113,78,1551909600,14,26,40,Rain
3114,79,1551909600,21,6,27,Rain
3115,80,1551909600,31,9,40,Rain
3116,81,1551909600,40,0,40,Rain
3117,82,1551909600,8,14,22,Rain
3118,83,1551909600,12,28,40,Rain
3119,84,1551909600,9,21,30,Rain
3120,85,1551909600,10,25,35,Rain
3121,86,1551909600,2,36,38,Rain
3122,87,1551909600,17,21,38,Rain
3123,88,1551909600,6,24,30,Rain
3124,89,1551909600,38,2,40,Rain
3125,90,1551909600,39,1,40,Rain
3126,91,1551909600,2,28,30,Rain
3127,92,1551909600,0,40,40,Rain
3128,93,1551909600,0,40,40,Rain
3129,94,1551909600,1,39,40,Rain
3130,95,1551909600,11,29,40,Rain
3131,96,1551909600,22,8,30,Rain
3132,97,1551909600,14,26,40,Rain
3133,98,1551909600,40,0,40,Rain
3134,99,1551909600,30,0,30,Rain
3135,100,1551909600,1,24,25,Rain
3136,101,1551909600,0,30,30,Rain
3137,102,1551909600,38,2,40,Rain
3138,103,1551909600,40,0,40,Rain
3139,104,1551909600,40,0,40,Rain
3140,105,1551909600,33,3,36,Rain
3141,106,1551909600,30,10,40,Rain
3142,107,1551909600,27,13,40,Rain
3143,108,1551909600,26,14,40,Rain
3144,109,1551909600,18,11,29,Rain
3145,110,1551909600,30,10,40,Rain
3146,111,1551909600,16,24,40,Rain
3147,112,1551909600,8,22,30,Rain
3148,113,1551909600,40,0,40,Rain
3149,114,1551909600,38,2,40,Rain
3150,115,1551909600,1,29,30,Rain
3151,2,1551949200,13,7,20,Rain
3152,3,1551949200,18,2,20,Rain
3153,4,1551949200,19,1,20,Rain
3154,5,1551949200,40,0,40,Rain
3155,6,1551949200,20,0,20,Rain
3156,7,1551949200,29,0,29,Rain
3157,8,1551949200,27,3,30,Rain
3158,9,1551949200,20,4,24,Rain
3159,10,1551949200,15,1,16,Rain
3160,11,1551949200,21,9,30,Rain
3161,12,1551949200,9,11,20,Rain
3162,13,1551949200,23,7,30,Rain
3163,14,1551949200,29,1,30,Rain
3164,15,1551949200,15,1,16,Rain
3165,16,1551949200,15,4,19,Rain
3166,17,1551949200,20,0,20,Rain
3167,18,1551949200,23,7,30,Rain
3168,19,1551949200,16,14,30,Rain
3169,21,1551949200,23,7,30,Rain
3170,22,1551949200,15,5,20,Rain
3171,23,1551949200,27,3,30,Rain
3172,24,1551949200,14,5,19,Rain
3173,25,1551949200,11,19,30,Rain
3174,26,1551949200,18,2,20,Rain
3175,27,1551949200,15,5,20,Rain
3176,28,1551949200,22,8,30,Rain
3177,29,1551949200,26,3,29,Rain
3178,30,1551949200,7,13,20,Rain
3179,31,1551949200,5,15,20,Rain
3180,32,1551949200,19,11,30,Rain
3181,33,1551949200,5,18,23,Rain
3182,34,1551949200,25,5,30,Rain
3183,35,1551949200,22,8,30,Rain
3184,36,1551949200,31,9,40,Rain
3185,37,1551949200,30,0,30,Rain
3186,38,1551949200,19,21,40,Rain
3187,39,1551949200,19,1,20,Rain
3188,40,1551949200,8,13,21,Rain
3189,41,1551949200,19,1,20,Rain
3190,42,1551949200,24,6,30,Rain
3191,43,1551949200,26,3,29,Rain
3192,44,1551949200,22,8,30,Rain
3193,45,1551949200,20,10,30,Rain
3194,46,1551949200,18,2,20,Rain
3195,47,1551949200,34,6,40,Rain
3196,48,1551949200,24,16,40,Rain
3197,49,1551949200,34,6,40,Rain
3198,50,1551949200,35,5,40,Rain
3199,51,1551949200,33,7,40,Rain
3200,52,1551949200,20,12,32,Rain
3201,53,1551949200,33,7,40,Rain
3202,54,1551949200,27,6,33,Rain
3203,55,1551949200,29,7,36,Rain
3204,56,1551949200,25,15,40,Rain
3205,57,1551949200,15,8,23,Rain
3206,58,1551949200,16,24,40,Rain
3207,59,1551949200,19,1,20,Rain
3208,60,1551949200,23,7,30,Rain
3209,61,1551949200,9,16,25,Rain
3210,62,1551949200,32,8,40,Rain
3211,63,1551949200,22,13,35,Rain
3212,64,1551949200,28,12,40,Rain
3213,65,1551949200,30,10,40,Rain
3214,66,1551949200,22,17,39,Rain
3215,67,1551949200,29,11,40,Rain
3216,68,1551949200,14,26,40,Rain
3217,69,1551949200,4,35,39,Rain
3218,70,1551949200,10,18,28,Rain
3219,71,1551949200,40,0,40,Rain
3220,72,1551949200,24,1,25,Rain
3221,73,1551949200,30,0,30,Rain
3222,74,1551949200,28,2,30,Rain
3223,75,1551949200,9,31,40,Rain
3224,76,1551949200,34,4,38,Rain
3225,77,1551949200,0,29,29,Rain
3226,78,1551949200,12,28,40,Rain
3227,79,1551949200,18,9,27,Rain
3228,80,1551949200,32,8,40,Rain
3229,81,1551949200,36,4,40,Rain
3230,82,1551949200,11,11,22,Rain
3231,83,1551949200,18,22,40,Rain
3232,84,1551949200,18,12,30,Rain
3233,85,1551949200,23,12,35,Rain
3234,86,1551949200,13,25,38,Rain
3235,87,1551949200,27,10,37,Rain
3236,88,1551949200,14,16,30,Rain
3237,89,1551949200,31,9,40,Rain
3238,90,1551949200,0,40,40,Rain
3239,91,1551949200,15,15,30,Rain
3240,92,1551949200,32,8,40,Rain
3241,93,1551949200,17,23,40,Rain
3242,94,1551949200,9,31,40,Rain
3243,95,1551949200,26,14,40,Rain
3244,96,1551949200,30,0,30,Rain
3245,97,1551949200,36,4,40,Rain
3246,98,1551949200,33,7,40,Rain
3247,99,1551949200,27,3,30,Rain
3248,100,1551949200,15,10,25,Rain
3249,101,1551949200,24,6,30,Rain
3250,102,1551949200,40,0,40,Rain
3251,103,1551949200,39,1,40,Rain
3252,104,1551949200,39,1,40,Rain
3253,105,1551949200,36,0,36,Rain
3254,106,1551949200,40,0,40,Rain
3255,107,1551949200,40,0,40,Rain
3256,108,1551949200,38,2,40,Rain
3257,109,1551949200,14,15,29,Rain
3258,110,1551949200,29,11,40,Rain
3259,111,1551949200,21,19,40,Rain
3260,112,1551949200,30,0,30,Rain
3261,113,1551949200,36,4,40,Rain
3262,114,1551949200,18,22,40,Rain
3263,115,1551949200,21,9,30,Rain
3264,2,1551952800,20,0,20,Rain
3265,3,1551952800,15,5,20,Rain
3266,4,1551952800,19,1,20,Rain
3267,5,1551952800,39,1,40,Rain
3268,6,1551952800,20,0,20,Rain
3269,7,1551952800,29,0,29,Rain
3270,8,1551952800,16,14,30,Rain
3271,9,1551952800,13,11,24,Rain
3272,10,1551952800,9,7,16,Rain
3273,11,1551952800,0,30,30,Rain
3274,12,1551952800,20,0,20,Rain
3275,13,1551952800,14,16,30,Rain
3276,14,1551952800,22,8,30,Rain
3277,15,1551952800,14,2,16,Rain
3278,16,1551952800,14,5,19,Rain
3279,17,1551952800,20,0,20,Rain
3280,18,1551952800,29,1,30,Rain
3281,19,1551952800,0,29,29,Rain
3282,21,1551952800,13,17,30,Rain
3283,22,1551952800,20,0,20,Rain
3284,23,1551952800,23,7,30,Rain
3285,24,1551952800,9,10,19,Rain
3286,25,1551952800,1,29,30,Rain
3287,26,1551952800,6,14,20,Rain
3288,27,1551952800,10,10,20,Rain
3289,28,1551952800,30,0,30,Rain
3290,29,1551952800,28,1,29,Rain
3291,30,1551952800,13,7,20,Rain
3292,31,1551952800,2,18,20,Rain
3293,32,1551952800,30,0,30,Rain
3294,33,1551952800,8,15,23,Rain
3295,34,1551952800,28,2,30,Rain
3296,35,1551952800,29,1,30,Rain
3297,36,1551952800,18,22,40,Rain
3298,37,1551952800,28,1,29,Rain
3299,38,1551952800,27,13,40,Rain
3300,39,1551952800,20,0,20,Rain
3301,40,1551952800,15,6,21,Rain
3302,41,1551952800,12,8,20,Rain
3303,42,1551952800,27,3,30,Rain
3304,43,1551952800,29,1,30,Rain
3305,44,1551952800,29,1,30,Rain
3306,45,1551952800,30,0,30,Rain
3307,46,1551952800,17,3,20,Rain
3308,47,1551952800,2,38,40,Rain
3309,48,1551952800,11,28,39,Rain
3310,49,1551952800,21,18,39,Rain
3311,50,1551952800,39,1,40,Rain
3312,51,1551952800,37,3,40,Rain
3313,52,1551952800,26,6,32,Rain
3314,53,1551952800,22,18,40,Rain
3315,54,1551952800,17,15,32,Rain
3316,55,1551952800,6,30,36,Rain
3317,56,1551952800,1,37,38,Rain
3318,57,1551952800,1,22,23,Rain
3319,58,1551952800,1,39,40,Rain
3320,59,1551952800,19,1,20,Rain
3321,60,1551952800,30,0,30,Rain
3322,61,1551952800,15,10,25,Rain
3323,62,1551952800,4,36,40,Rain
3324,63,1551952800,1,34,35,Rain
3325,64,1551952800,17,23,40,Rain
3326,65,1551952800,27,13,40,Rain
3327,66,1551952800,17,22,39,Rain
3328,67,1551952800,37,3,40,Rain
3329,68,1551952800,0,40,40,Rain
3330,69,1551952800,0,37,37,Rain
3331,70,1551952800,1,25,26,Rain
3332,71,1551952800,39,1,40,Rain
3333,72,1551952800,25,0,25,Rain
3334,73,1551952800,27,3,30,Rain
3335,74,1551952800,30,0,30,Rain
3336,75,1551952800,39,1,40,Rain
3337,76,1551952800,37,1,38,Rain
3338,77,1551952800,6,23,29,Rain
3339,78,1551952800,37,3,40,Rain
3340,79,1551952800,21,6,27,Rain
3341,80,1551952800,38,2,40,Rain
3342,81,1551952800,40,0,40,Rain
3343,82,1551952800,22,0,22,Rain
3344,83,1551952800,40,0,40,Rain
3345,84,1551952800,30,0,30,Rain
3346,85,1551952800,35,0,35,Rain
3347,86,1551952800,28,10,38,Rain
3348,87,1551952800,37,0,37,Rain
3349,88,1551952800,29,1,30,Rain
3350,89,1551952800,34,6,40,Rain
3351,90,1551952800,0,40,40,Rain
3352,91,1551952800,19,10,29,Rain
3353,92,1551952800,40,0,40,Rain
3354,93,1551952800,40,0,40,Rain
3355,94,1551952800,40,0,40,Rain
3356,95,1551952800,39,1,40,Rain
3357,96,1551952800,30,0,30,Rain
3358,97,1551952800,40,0,40,Rain
3359,98,1551952800,32,8,40,Rain
3360,99,1551952800,17,13,30,Rain
3361,100,1551952800,19,6,25,Rain
3362,101,1551952800,30,0,30,Rain
3363,102,1551952800,40,0,40,Rain
3364,103,1551952800,39,1,40,Rain
3365,104,1551952800,40,0,40,Rain
3366,105,1551952800,36,0,36,Rain
3367,106,1551952800,40,0,40,Rain
3368,107,1551952800,40,0,40,Rain
3369,108,1551952800,40,0,40,Rain
3370,109,1551952800,27,2,29,Rain
3371,110,1551952800,37,3,40,Rain
3372,111,1551952800,37,3,40,Rain
3373,112,1551952800,30,0,30,Rain
3374,113,1551952800,37,3,40,Rain
3375,114,1551952800,20,20,40,Rain
3376,115,1551952800,28,2,30,Rain
3377,2,1551956400,18,2,20,Rain
3378,3,1551956400,19,1,20,Rain
3379,4,1551956400,14,6,20,Rain
3380,5,1551956400,38,2,40,Rain
3381,6,1551956400,19,1,20,Rain
3382,7,1551956400,29,0,29,Rain
3383,8,1551956400,5,25,30,Rain
3384,9,1551956400,11,13,24,Rain
3385,10,1551956400,12,4,16,Rain
3386,11,1551956400,17,12,29,Rain
3387,12,1551956400,20,0,20,Rain
3388,13,1551956400,13,17,30,Rain
3389,14,1551956400,14,16,30,Rain
3390,15,1551956400,15,1,16,Rain
3391,16,1551956400,8,11,19,Rain
3392,17,1551956400,17,3,20,Rain
3393,18,1551956400,29,1,30,Rain
3394,19,1551956400,0,30,30,Rain
3395,21,1551956400,2,28,30,Rain
3396,22,1551956400,19,1,20,Rain
3397,23,1551956400,27,3,30,Rain
3398,24,1551956400,4,15,19,Rain
3399,25,1551956400,0,30,30,Rain
3400,26,1551956400,0,20,20,Rain
3401,27,1551956400,4,15,19,Rain
3402,28,1551956400,21,9,30,Rain
3403,29,1551956400,27,2,29,Rain
3404,30,1551956400,14,6,20,Rain
3405,31,1551956400,2,18,20,Rain
3406,32,1551956400,28,2,30,Rain
3407,33,1551956400,1,22,23,Rain
3408,34,1551956400,30,0,30,Rain
3409,35,1551956400,27,3,30,Rain
3410,36,1551956400,13,27,40,Rain
3411,37,1551956400,22,7,29,Rain
3412,38,1551956400,27,13,40,Rain
3413,39,1551956400,15,5,20,Rain
3414,40,1551956400,14,7,21,Rain
3415,41,1551956400,13,7,20,Rain
3416,42,1551956400,30,0,30,Rain
3417,43,1551956400,21,9,30,Rain
3418,44,1551956400,30,0,30,Rain
3419,45,1551956400,29,1,30,Rain
3420,46,1551956400,17,3,20,Rain
3421,47,1551956400,0,40,40,Rain
3422,48,1551956400,17,22,39,Rain
3423,49,1551956400,5,34,39,Rain
3424,50,1551956400,39,1,40,Rain
3425,51,1551956400,35,5,40,Rain
3426,52,1551956400,27,5,32,Rain
3427,53,1551956400,16,23,39,Rain
3428,54,1551956400,17,15,32,Rain
3429,55,1551956400,2,34,36,Rain
3430,56,1551956400,9,29,38,Rain
3431,57,1551956400,0,23,23,Rain
3432,58,1551956400,1,39,40,Rain
3433,59,1551956400,16,4,20,Rain
3434,60,1551956400,29,1,30,Rain
3435,61,1551956400,10,15,25,Rain
3436,62,1551956400,1,39,40,Rain
3437,63,1551956400,0,35,35,Rain
3438,64,1551956400,2,38,40,Rain
3439,65,1551956400,13,27,40,Rain
3440,66,1551956400,1,38,39,Rain
3441,67,1551956400,36,4,40,Rain
3442,68,1551956400,6,34,40,Rain
3443,69,1551956400,0,38,38,Rain
3444,70,1551956400,2,24,26,Rain
3445,71,1551956400,34,6,40,Rain
3446,72,1551956400,24,1,25,Rain
3447,73,1551956400,28,2,30,Rain
3448,74,1551956400,30,0,30,Rain
3449,75,1551956400,40,0,40,Rain
3450,76,1551956400,38,0,38,Rain
3451,77,1551956400,6,23,29,Rain
3452,78,1551956400,40,0,40,Rain
3453,79,1551956400,27,0,27,Rain
3454,80,1551956400,38,2,40,Rain
3455,81,1551956400,40,0,40,Rain
3456,82,1551956400,22,0,22,Rain
3457,83,1551956400,40,0,40,Rain
3458,84,1551956400,30,0,30,Rain
3459,85,1551956400,35,0,35,Rain
3460,86,1551956400,36,2,38,Rain
3461,87,1551956400,36,1,37,Rain
3462,88,1551956400,30,0,30,Rain
3463,89,1551956400,24,16,40,Rain
3464,90,1551956400,0,40,40,Rain
3465,91,1551956400,3,25,28,Rain
3466,92,1551956400,39,1,40,Rain
3467,93,1551956400,40,0,40,Rain
3468,94,1551956400,40,0,40,Rain
3469,95,1551956400,40,0,40,Rain
3470,96,1551956400,30,0,30,Rain
3471,97,1551956400,40,0,40,Rain
3472,98,1551956400,28,12,40,Rain
3473,99,1551956400,9,21,30,Rain
3474,100,1551956400,25,0,25,Rain
3475,101,1551956400,30,0,30,Rain
3476,102,1551956400,22,18,40,Rain
3477,103,1551956400,40,0,40,Rain
3478,104,1551956400,40,0,40,Rain
3479,105,1551956400,36,0,36,Rain
3480,106,1551956400,40,0,40,Rain
3481,107,1551956400,39,1,40,Rain
3482,108,1551956400,40,0,40,Rain
3483,109,1551956400,28,1,29,Rain
3484,110,1551956400,39,1,40,Rain
3485,111,1551956400,40,0,40,Rain
3486,112,1551956400,30,0,30,Rain
3487,113,1551956400,21,19,40,Rain
3488,114,1551956400,0,40,40,Rain
3489,115,1551956400,30,0,30,Rain
3490,2,1551963600,20,0,20,Rain
3491,3,1551963600,15,5,20,Rain
3492,4,1551963600,17,3,20,Rain
3493,5,1551963600,39,1,40,Rain
3494,6,1551963600,20,0,20,Rain
3495,7,1551963600,29,0,29,Rain
3496,8,1551963600,14,16,30,Rain
3497,9,1551963600,7,17,24,Rain
3498,10,1551963600,6,10,16,Rain
3499,11,1551963600,15,14,29,Rain
3500,12,1551963600,20,0,20,Rain
3501,13,1551963600,11,19,30,Rain
3502,14,1551963600,9,21,30,Rain
3503,15,1551963600,16,0,16,Rain
3504,16,1551963600,13,7,20,Rain
3505,17,1551963600,16,4,20,Rain
3506,18,1551963600,30,0,30,Rain
3507,19,1551963600,0,30,30,Rain
3508,21,1551963600,0,30,30,Rain
3509,22,1551963600,20,0,20,Rain
3510,23,1551963600,27,3,30,Rain
3511,24,1551963600,10,9,19,Rain
3512,25,1551963600,0,30,30,Rain
3513,26,1551963600,0,20,20,Rain
3514,27,1551963600,1,18,19,Rain
3515,28,1551963600,29,0,29,Rain
3516,29,1551963600,21,8,29,Rain
3517,30,1551963600,16,4,20,Rain
3518,31,1551963600,2,18,20,Rain
3519,32,1551963600,22,8,30,Rain
3520,33,1551963600,6,17,23,Rain
3521,34,1551963600,29,1,30,Rain
3522,35,1551963600,30,0,30,Rain
3523,36,1551963600,8,32,40,Rain
3524,37,1551963600,23,6,29,Rain
3525,38,1551963600,33,7,40,Rain
3526,39,1551963600,14,6,20,Rain
3527,40,1551963600,13,8,21,Rain
3528,41,1551963600,9,11,20,Rain
3529,42,1551963600,29,1,30,Rain
3530,43,1551963600,30,0,30,Rain
3531,44,1551963600,29,1,30,Rain
3532,45,1551963600,28,2,30,Rain
3533,46,1551963600,10,10,20,Rain
3534,47,1551963600,1,39,40,Rain
3535,48,1551963600,3,37,40,Rain
3536,49,1551963600,5,35,40,Rain
3537,50,1551963600,37,3,40,Rain
3538,51,1551963600,35,5,40,Rain
3539,52,1551963600,28,4,32,Rain
3540,53,1551963600,12,27,39,Rain
3541,54,1551963600,21,11,32,Rain
3542,55,1551963600,3,33,36,Rain
3543,56,1551963600,10,30,40,Rain
3544,57,1551963600,1,22,23,Rain
3545,58,1551963600,7,33,40,Rain
3546,59,1551963600,19,1,20,Rain
3547,60,1551963600,28,2,30,Rain
3548,61,1551963600,18,7,25,Rain
3549,62,1551963600,7,33,40,Rain
3550,63,1551963600,0,35,35,Rain
3551,64,1551963600,5,35,40,Rain
3552,65,1551963600,10,30,40,Rain
3553,66,1551963600,15,25,40,Rain
3554,67,1551963600,35,5,40,Rain
3555,68,1551963600,3,37,40,Rain
3556,69,1551963600,5,35,40,Rain
3557,70,1551963600,4,24,28,Rain
3558,71,1551963600,39,1,40,Rain
3559,72,1551963600,25,0,25,Rain
3560,73,1551963600,30,0,30,Rain
3561,74,1551963600,30,0,30,Rain
3562,75,1551963600,40,0,40,Rain
3563,76,1551963600,38,0,38,Rain
3564,77,1551963600,10,19,29,Rain
3565,78,1551963600,39,1,40,Rain
3566,79,1551963600,27,0,27,Rain
3567,80,1551963600,40,0,40,Rain
3568,81,1551963600,40,0,40,Rain
3569,82,1551963600,22,0,22,Rain
3570,83,1551963600,40,0,40,Rain
3571,84,1551963600,30,0,30,Rain
3572,85,1551963600,35,0,35,Rain
3573,86,1551963600,38,0,38,Rain
3574,87,1551963600,37,0,37,Rain
3575,88,1551963600,30,0,30,Rain
3576,89,1551963600,21,19,40,Rain
3577,90,1551963600,5,35,40,Rain
3578,91,1551963600,5,25,30,Rain
3579,92,1551963600,40,0,40,Rain
3580,93,1551963600,40,0,40,Rain
3581,94,1551963600,40,0,40,Rain
3582,95,1551963600,39,1,40,Rain
3583,96,1551963600,30,0,30,Rain
3584,97,1551963600,40,0,40,Rain
3585,98,1551963600,23,17,40,Rain
3586,99,1551963600,10,20,30,Rain
3587,100,1551963600,25,0,25,Rain
3588,101,1551963600,25,5,30,Rain
3589,102,1551963600,22,18,40,Rain
3590,103,1551963600,35,5,40,Rain
3591,104,1551963600,34,6,40,Rain
3592,105,1551963600,36,0,36,Rain
3593,106,1551963600,34,6,40,Rain
3594,107,1551963600,40,0,40,Rain
3595,108,1551963600,40,0,40,Rain
3596,109,1551963600,29,0,29,Rain
3597,110,1551963600,22,18,40,Rain
3598,111,1551963600,34,6,40,Rain
3599,112,1551963600,29,1,30,Rain
3600,113,1551963600,6,33,39,Rain
3601,114,1551963600,8,32,40,Rain
3602,115,1551963600,28,2,30,Rain
3603,2,1551967200,19,1,20,Rain
3604,3,1551967200,20,0,20,Rain
3605,4,1551967200,20,0,20,Rain
3606,5,1551967200,37,3,40,Rain
3607,6,1551967200,19,1,20,Rain
3608,7,1551967200,28,1,29,Rain
3609,8,1551967200,22,8,30,Rain
3610,9,1551967200,9,15,24,Rain
3611,10,1551967200,14,2,16,Rain
3612,11,1551967200,23,6,29,Rain
3613,12,1551967200,18,2,20,Rain
3614,13,1551967200,16,14,30,Rain
3615,14,1551967200,10,20,30,Rain
3616,15,1551967200,13,3,16,Rain
3617,16,1551967200,18,2,20,Rain
3618,17,1551967200,17,3,20,Rain
3619,18,1551967200,29,1,30,Rain
3620,19,1551967200,1,29,30,Rain
3621,21,1551967200,22,8,30,Rain
3622,22,1551967200,17,3,20,Rain
3623,23,1551967200,30,0,30,Rain
3624,24,1551967200,15,4,19,Rain
3625,25,1551967200,0,30,30,Rain
3626,26,1551967200,2,18,20,Rain
3627,27,1551967200,5,14,19,Rain
3628,28,1551967200,28,1,29,Rain
3629,29,1551967200,29,0,29,Rain
3630,30,1551967200,18,2,20,Rain
3631,31,1551967200,7,13,20,Rain
3632,32,1551967200,22,8,30,Rain
3633,33,1551967200,2,21,23,Rain
3634,34,1551967200,28,2,30,Rain
3635,35,1551967200,27,3,30,Rain
3636,36,1551967200,15,25,40,Rain
3637,37,1551967200,19,10,29,Rain
3638,38,1551967200,37,3,40,Rain
3639,39,1551967200,20,0,20,Rain
3640,40,1551967200,9,12,21,Rain
3641,41,1551967200,19,1,20,Rain
3642,42,1551967200,30,0,30,Rain
3643,43,1551967200,30,0,30,Rain
3644,44,1551967200,29,1,30,Rain
3645,45,1551967200,30,0,30,Rain
3646,46,1551967200,3,17,20,Rain
3647,47,1551967200,5,35,40,Rain
3648,48,1551967200,12,28,40,Rain
3649,49,1551967200,6,34,40,Rain
3650,50,1551967200,39,1,40,Rain
3651,51,1551967200,36,4,40,Rain
3652,52,1551967200,25,7,32,Rain
3653,53,1551967200,10,29,39,Rain
3654,54,1551967200,22,10,32,Rain
3655,55,1551967200,14,22,36,Rain
3656,56,1551967200,9,31,40,Rain
3657,57,1551967200,1,22,23,Rain
3658,58,1551967200,12,28,40,Rain
3659,59,1551967200,20,0,20,Rain
3660,60,1551967200,30,0,30,Rain
3661,61,1551967200,23,2,25,Rain
3662,62,1551967200,11,29,40,Rain
3663,63,1551967200,3,32,35,Rain
3664,64,1551967200,5,35,40,Rain
3665,65,1551967200,16,24,40,Rain
3666,66,1551967200,24,16,40,Rain
3667,67,1551967200,33,7,40,Rain
3668,68,1551967200,10,30,40,Rain
3669,69,1551967200,1,39,40,Rain
3670,70,1551967200,0,28,28,Rain
3671,71,1551967200,34,6,40,Rain
3672,72,1551967200,25,0,25,Rain
3673,73,1551967200,30,0,30,Rain
3674,74,1551967200,17,13,30,Rain
3675,75,1551967200,40,0,40,Rain
3676,76,1551967200,28,10,38,Rain
3677,77,1551967200,0,29,29,Rain
3678,78,1551967200,40,0,40,Rain
3679,79,1551967200,27,0,27,Rain
3680,80,1551967200,27,13,40,Rain
3681,81,1551967200,29,11,40,Rain
3682,82,1551967200,22,0,22,Rain
3683,83,1551967200,39,1,40,Rain
3684,84,1551967200,30,0,30,Rain
3685,85,1551967200,29,6,35,Rain
3686,86,1551967200,38,0,38,Rain
3687,87,1551967200,37,0,37,Rain
3688,88,1551967200,28,2,30,Rain
3689,89,1551967200,18,22,40,Rain
3690,90,1551967200,10,30,40,Rain
3691,91,1551967200,9,21,30,Rain
3692,92,1551967200,40,0,40,Rain
3693,93,1551967200,40,0,40,Rain
3694,94,1551967200,40,0,40,Rain
3695,95,1551967200,40,0,40,Rain
3696,96,1551967200,23,7,30,Rain
3697,97,1551967200,40,0,40,Rain
3698,98,1551967200,19,21,40,Rain
3699,99,1551967200,5,25,30,Rain
3700,100,1551967200,24,1,25,Rain
3701,101,1551967200,28,2,30,Rain
3702,102,1551967200,30,10,40,Rain
3703,103,1551967200,40,0,40,Rain
3704,104,1551967200,38,2,40,Rain
3705,105,1551967200,35,1,36,Rain
3706,106,1551967200,40,0,40,Rain
3707,107,1551967200,40,0,40,Rain
3708,108,1551967200,40,0,40,Rain
3709,109,1551967200,28,1,29,Rain
3710,110,1551967200,25,15,40,Rain
3711,111,1551967200,40,0,40,Rain
3712,112,1551967200,25,5,30,Rain
3713,113,1551967200,9,31,40,Rain
3714,114,1551967200,6,34,40,Rain
3715,115,1551967200,21,9,30,Rain
3716,2,1551970800,20,0,20,Rain
3717,3,1551970800,12,8,20,Rain
3718,4,1551970800,18,2,20,Rain
3719,5,1551970800,37,3,40,Rain
3720,6,1551970800,20,0,20,Rain
3721,7,1551970800,29,0,29,Rain
3722,8,1551970800,25,5,30,Rain
3723,9,1551970800,11,13,24,Rain
3724,10,1551970800,13,3,16,Rain
3725,11,1551970800,18,11,29,Rain
3726,12,1551970800,19,1,20,Rain
3727,13,1551970800,15,15,30,Rain
3728,14,1551970800,19,11,30,Rain
3729,15,1551970800,9,7,16,Rain
3730,16,1551970800,14,6,20,Rain
3731,17,1551970800,15,5,20,Rain
3732,18,1551970800,28,2,30,Rain
3733,19,1551970800,2,28,30,Rain
3734,21,1551970800,13,17,30,Rain
3735,22,1551970800,13,7,20,Rain
3736,23,1551970800,22,8,30,Rain
3737,24,1551970800,17,2,19,Rain
3738,25,1551970800,0,30,30,Rain
3739,26,1551970800,4,16,20,Rain
3740,27,1551970800,8,11,19,Rain
3741,28,1551970800,29,0,29,Rain
3742,29,1551970800,27,2,29,Rain
3743,30,1551970800,19,1,20,Rain
3744,31,1551970800,7,13,20,Rain
3745,32,1551970800,18,12,30,Rain
3746,33,1551970800,7,16,23,Rain
3747,34,1551970800,30,0,30,Rain
3748,35,1551970800,30,0,30,Rain
3749,36,1551970800,18,22,40,Rain
3750,37,1551970800,17,12,29,Rain
3751,38,1551970800,37,3,40,Rain
3752,39,1551970800,17,3,20,Rain
3753,40,1551970800,7,14,21,Rain
3754,41,1551970800,14,6,20,Rain
3755,42,1551970800,29,1,30,Rain
3756,43,1551970800,30,0,30,Rain
3757,44,1551970800,28,2,30,Rain
3758,45,1551970800,30,0,30,Rain
3759,46,1551970800,7,13,20,Rain
3760,47,1551970800,5,35,40,Rain
3761,48,1551970800,8,32,40,Rain
3762,49,1551970800,5,35,40,Rain
3763,50,1551970800,35,5,40,Rain
3764,51,1551970800,36,4,40,Rain
3765,52,1551970800,25,7,32,Rain
3766,53,1551970800,10,29,39,Rain
3767,54,1551970800,27,5,32,Rain
3768,55,1551970800,13,23,36,Rain
3769,56,1551970800,8,32,40,Rain
3770,57,1551970800,1,22,23,Rain
3771,58,1551970800,10,30,40,Rain
3772,59,1551970800,20,0,20,Rain
3773,60,1551970800,29,1,30,Rain
3774,61,1551970800,25,0,25,Rain
3775,62,1551970800,5,35,40,Rain
3776,63,1551970800,3,32,35,Rain
3777,64,1551970800,1,39,40,Rain
3778,65,1551970800,14,26,40,Rain
3779,66,1551970800,21,19,40,Rain
3780,67,1551970800,32,8,40,Rain
3781,68,1551970800,7,33,40,Rain
3782,69,1551970800,8,32,40,Rain
3783,70,1551970800,3,25,28,Rain
3784,71,1551970800,31,9,40,Rain
3785,72,1551970800,24,1,25,Rain
3786,73,1551970800,28,2,30,Rain
3787,74,1551970800,20,10,30,Rain
3788,75,1551970800,40,0,40,Rain
3789,76,1551970800,17,21,38,Rain
3790,77,1551970800,1,28,29,Rain
3791,78,1551970800,39,1,40,Rain
3792,79,1551970800,25,2,27,Rain
3793,80,1551970800,28,12,40,Rain
3794,81,1551970800,30,10,40,Rain
3795,82,1551970800,22,0,22,Rain
3796,83,1551970800,40,0,40,Rain
3797,84,1551970800,28,2,30,Rain
3798,85,1551970800,30,5,35,Rain
3799,86,1551970800,37,1,38,Rain
3800,87,1551970800,36,1,37,Rain
3801,88,1551970800,29,1,30,Rain
3802,89,1551970800,14,26,40,Rain
3803,90,1551970800,7,33,40,Rain
3804,91,1551970800,10,20,30,Rain
3805,92,1551970800,40,0,40,Rain
3806,93,1551970800,40,0,40,Rain
3807,94,1551970800,39,1,40,Rain
3808,95,1551970800,38,2,40,Rain
3809,96,1551970800,21,9,30,Rain
3810,97,1551970800,40,0,40,Rain
3811,98,1551970800,23,17,40,Rain
3812,99,1551970800,5,25,30,Rain
3813,100,1551970800,24,1,25,Rain
3814,101,1551970800,30,0,30,Rain
3815,102,1551970800,33,7,40,Rain
3816,103,1551970800,39,1,40,Rain
3817,104,1551970800,38,2,40,Rain
3818,105,1551970800,36,0,36,Rain
3819,106,1551970800,40,0,40,Rain
3820,107,1551970800,39,1,40,Rain
3821,108,1551970800,38,2,40,Rain
3822,109,1551970800,28,1,29,Rain
3823,110,1551970800,27,13,40,Rain
3824,111,1551970800,40,0,40,Rain
3825,112,1551970800,30,0,30,Rain
3826,113,1551970800,9,31,40,Rain
3827,114,1551970800,4,36,40,Rain
3828,115,1551970800,19,11,30,Rain
3829,2,1551974400,20,0,20,Rain
3830,3,1551974400,11,9,20,Rain
3831,4,1551974400,20,0,20,Rain
3832,5,1551974400,37,3,40,Rain
3833,6,1551974400,10,10,20,Rain
3834,7,1551974400,29,0,29,Rain
3835,8,1551974400,22,8,30,Rain
3836,9,1551974400,9,15,24,Rain
3837,10,1551974400,14,2,16,Rain
3838,11,1551974400,4,26,30,Rain
3839,12,1551974400,18,2,20,Rain
3840,13,1551974400,15,15,30,Rain
3841,14,1551974400,20,10,30,Rain
3842,15,1551974400,12,4,16,Rain
3843,16,1551974400,13,7,20,Rain
3844,17,1551974400,16,4,20,Rain
3845,18,1551974400,27,3,30,Rain
3846,19,1551974400,3,27,30,Rain
3847,21,1551974400,9,21,30,Rain
3848,22,1551974400,16,4,20,Rain
3849,23,1551974400,24,6,30,Rain
3850,24,1551974400,17,3,20,Rain
3851,25,1551974400,9,21,30,Rain
3852,26,1551974400,0,20,20,Rain
3853,27,1551974400,14,5,19,Rain
3854,28,1551974400,25,5,30,Rain
3855,29,1551974400,25,4,29,Rain
3856,30,1551974400,15,5,20,Rain
3857,31,1551974400,13,7,20,Rain
3858,32,1551974400,20,10,30,Rain
3859,33,1551974400,5,18,23,Rain
3860,34,1551974400,28,2,30,Rain
3861,35,1551974400,26,4,30,Rain
3862,36,1551974400,14,26,40,Rain
3863,37,1551974400,23,6,29,Rain
3864,38,1551974400,25,15,40,Rain
3865,39,1551974400,15,5,20,Rain
3866,40,1551974400,10,11,21,Rain
3867,41,1551974400,19,1,20,Rain
3868,42,1551974400,24,6,30,Rain
3869,43,1551974400,28,2,30,Rain
3870,44,1551974400,28,2,30,Rain
3871,45,1551974400,30,0,30,Rain
3872,46,1551974400,12,8,20,Rain
3873,47,1551974400,2,38,40,Rain
3874,48,1551974400,3,37,40,Rain
3875,49,1551974400,6,34,40,Rain
3876,50,1551974400,37,3,40,Rain
3877,51,1551974400,35,5,40,Rain
3878,52,1551974400,26,6,32,Rain
3879,53,1551974400,7,32,39,Rain
3880,54,1551974400,31,1,32,Rain
3881,55,1551974400,16,20,36,Rain
3882,56,1551974400,8,32,40,Rain
3883,57,1551974400,1,22,23,Rain
3884,58,1551974400,6,34,40,Rain
3885,59,1551974400,15,5,20,Rain
3886,60,1551974400,29,1,30,Rain
3887,61,1551974400,23,2,25,Rain
3888,62,1551974400,1,39,40,Rain
3889,63,1551974400,0,35,35,Rain
3890,64,1551974400,7,33,40,Rain
3891,65,1551974400,12,28,40,Rain
3892,66,1551974400,17,23,40,Rain
3893,67,1551974400,29,11,40,Rain
3894,68,1551974400,9,31,40,Rain
3895,69,1551974400,8,32,40,Rain
3896,70,1551974400,4,24,28,Rain
3897,71,1551974400,31,9,40,Rain
3898,72,1551974400,23,2,25,Rain
3899,73,1551974400,29,1,30,Rain
3900,74,1551974400,23,7,30,Rain
3901,75,1551974400,40,0,40,Rain
3902,76,1551974400,20,18,38,Rain
3903,77,1551974400,3,26,29,Rain
3904,78,1551974400,39,1,40,Rain
3905,79,1551974400,27,0,27,Rain
3906,80,1551974400,29,11,40,Rain
3907,81,1551974400,30,10,40,Rain
3908,82,1551974400,22,0,22,Rain
3909,83,1551974400,39,1,40,Rain
3910,84,1551974400,26,4,30,Rain
3911,85,1551974400,34,1,35,Rain
3912,86,1551974400,35,3,38,Rain
3913,87,1551974400,37,0,37,Rain
3914,88,1551974400,29,1,30,Rain
3915,89,1551974400,12,28,40,Rain
3916,90,1551974400,5,35,40,Rain
3917,91,1551974400,8,22,30,Rain
3918,92,1551974400,39,1,40,Rain
3919,93,1551974400,40,0,40,Rain
3920,94,1551974400,39,1,40,Rain
3921,95,1551974400,35,5,40,Rain
3922,96,1551974400,25,5,30,Rain
3923,97,1551974400,38,2,40,Rain
3924,98,1551974400,22,18,40,Rain
3925,99,1551974400,4,26,30,Rain
3926,100,1551974400,10,15,25,Rain
3927,101,1551974400,27,3,30,Rain
3928,102,1551974400,36,4,40,Rain
3929,103,1551974400,38,2,40,Rain
3930,104,1551974400,39,1,40,Rain
3931,105,1551974400,36,0,36,Rain
3932,106,1551974400,39,1,40,Rain
3933,107,1551974400,38,2,40,Rain
3934,108,1551974400,40,0,40,Rain
3935,109,1551974400,27,2,29,Rain
3936,110,1551974400,28,12,40,Rain
3937,111,1551974400,39,1,40,Rain
3938,112,1551974400,18,12,30,Rain
3939,113,1551974400,6,34,40,Rain
3940,114,1551974400,10,30,40,Rain
3941,115,1551974400,21,9,30,Rain
3942,2,1551978000,17,3,20,Rain
3943,3,1551978000,20,0,20,Rain
3944,4,1551978000,19,1,20,Rain
3945,5,1551978000,31,9,40,Rain
3946,6,1551978000,13,7,20,Rain
3947,7,1551978000,29,0,29,Rain
3948,8,1551978000,18,12,30,Rain
3949,9,1551978000,12,12,24,Rain
3950,10,1551978000,8,8,16,Rain
3951,11,1551978000,6,24,30,Rain
3952,12,1551978000,17,3,20,Rain
3953,13,1551978000,15,15,30,Rain
3954,14,1551978000,18,12,30,Rain
3955,15,1551978000,13,3,16,Rain
3956,16,1551978000,11,9,20,Rain
3957,17,1551978000,19,1,20,Rain
3958,18,1551978000,28,2,30,Rain
3959,19,1551978000,10,20,30,Rain
3960,21,1551978000,6,24,30,Rain
3961,22,1551978000,14,6,20,Rain
3962,23,1551978000,28,2,30,Rain
3963,24,1551978000,10,10,20,Rain
3964,25,1551978000,18,12,30,Rain
3965,26,1551978000,4,16,20,Rain
3966,27,1551978000,14,6,20,Rain
3967,28,1551978000,30,0,30,Rain
3968,29,1551978000,29,0,29,Rain
3969,30,1551978000,16,4,20,Rain
3970,31,1551978000,15,5,20,Rain
3971,32,1551978000,15,15,30,Rain
3972,33,1551978000,5,18,23,Rain
3973,34,1551978000,29,1,30,Rain
3974,35,1551978000,29,1,30,Rain
3975,36,1551978000,15,25,40,Rain
3976,37,1551978000,28,2,30,Rain
3977,38,1551978000,18,22,40,Rain
3978,39,1551978000,19,1,20,Rain
3979,40,1551978000,16,5,21,Rain
3980,41,1551978000,20,0,20,Rain
3981,42,1551978000,28,2,30,Rain
3982,43,1551978000,24,6,30,Rain
3983,44,1551978000,30,0,30,Rain
3984,45,1551978000,26,4,30,Rain
3985,46,1551978000,11,9,20,Rain
3986,47,1551978000,1,39,40,Rain
3987,48,1551978000,2,38,40,Rain
3988,49,1551978000,4,36,40,Rain
3989,50,1551978000,34,6,40,Rain
3990,51,1551978000,34,6,40,Rain
3991,52,1551978000,30,2,32,Rain
3992,53,1551978000,10,30,40,Rain
3993,54,1551978000,31,2,33,Rain
3994,55,1551978000,17,19,36,Rain
3995,56,1551978000,17,23,40,Rain
3996,57,1551978000,3,20,23,Rain
3997,58,1551978000,15,25,40,Rain
3998,59,1551978000,19,1,20,Rain
3999,60,1551978000,27,3,30,Rain
4000,61,1551978000,24,1,25,Rain
4001,62,1551978000,3,37,40,Rain
4002,63,1551978000,3,32,35,Rain
4003,64,1551978000,9,31,40,Rain
4004,65,1551978000,7,33,40,Rain
4005,66,1551978000,10,30,40,Rain
4006,67,1551978000,25,15,40,Rain
4007,68,1551978000,3,37,40,Rain
4008,69,1551978000,16,24,40,Rain
4009,70,1551978000,4,24,28,Rain
4010,71,1551978000,37,3,40,Rain
4011,72,1551978000,22,3,25,Rain
4012,73,1551978000,29,1,30,Rain
4013,74,1551978000,18,12,30,Rain
4014,75,1551978000,38,2,40,Rain
4015,76,1551978000,22,16,38,Rain
4016,77,1551978000,4,25,29,Rain
4017,78,1551978000,39,1,40,Rain
4018,79,1551978000,27,0,27,Rain
4019,80,1551978000,37,3,40,Rain
4020,81,1551978000,30,10,40,Rain
4021,82,1551978000,22,0,22,Rain
4022,83,1551978000,40,0,40,Rain
4023,84,1551978000,26,4,30,Rain
4024,85,1551978000,31,4,35,Rain
4025,86,1551978000,37,1,38,Rain
4026,87,1551978000,34,4,38,Rain
4027,88,1551978000,29,1,30,Rain
4028,89,1551978000,16,24,40,Rain
4029,90,1551978000,6,34,40,Rain
4030,91,1551978000,8,22,30,Rain
4031,92,1551978000,40,0,40,Rain
4032,93,1551978000,40,0,40,Rain
4033,94,1551978000,39,1,40,Rain
4034,95,1551978000,36,4,40,Rain
4035,96,1551978000,24,6,30,Rain
4036,97,1551978000,35,5,40,Rain
4037,98,1551978000,28,12,40,Rain
4038,99,1551978000,6,24,30,Rain
4039,100,1551978000,22,3,25,Rain
4040,101,1551978000,27,3,30,Rain
4041,102,1551978000,37,3,40,Rain
4042,103,1551978000,39,1,40,Rain
4043,104,1551978000,39,1,40,Rain
4044,105,1551978000,36,0,36,Rain
4045,106,1551978000,38,2,40,Rain
4046,107,1551978000,39,1,40,Rain
4047,108,1551978000,39,1,40,Rain
4048,109,1551978000,25,4,29,Rain
4049,110,1551978000,33,7,40,Rain
4050,111,1551978000,38,2,40,Rain
4051,112,1551978000,25,5,30,Rain
4052,113,1551978000,6,34,40,Rain
4053,114,1551978000,18,22,40,Rain
4054,115,1551978000,25,5,30,Rain
4055,2,1552330800,15,5,20,Rain
4056,3,1552330800,17,3,20,Rain
4057,4,1552330800,19,1,20,Rain
4058,5,1552330800,25,15,40,Rain
4059,6,1552330800,19,1,20,Rain
4060,7,1552330800,29,0,29,Rain
4061,8,1552330800,30,0,30,Rain
4062,9,1552330800,18,6,24,Rain
4063,10,1552330800,13,3,16,Rain
4064,11,1552330800,29,1,30,Rain
4065,12,1552330800,16,4,20,Rain
4066,13,1552330800,23,6,29,Rain
4067,14,1552330800,17,13,30,Rain
4068,15,1552330800,15,1,16,Rain
4069,16,1552330800,1,19,20,Rain
4070,17,1552330800,18,2,20,Rain
4071,18,1552330800,27,3,30,Rain
4072,19,1552330800,30,0,30,Rain
4073,21,1552330800,18,12,30,Rain
4074,22,1552330800,1,19,20,Rain
4075,23,1552330800,3,27,30,Rain
4076,24,1552330800,15,5,20,Rain
4077,25,1552330800,23,6,29,Rain
4078,26,1552330800,11,9,20,Rain
4079,27,1552330800,18,2,20,Rain
4080,28,1552330800,27,3,30,Rain
4081,29,1552330800,29,0,29,Rain
4082,30,1552330800,17,3,20,Rain
4083,31,1552330800,10,10,20,Rain
4084,32,1552330800,5,25,30,Rain
4085,33,1552330800,5,18,23,Rain
4086,34,1552330800,0,30,30,Rain
4087,35,1552330800,28,2,30,Rain
4088,36,1552330800,40,0,40,Rain
4089,37,1552330800,29,1,30,Rain
4090,38,1552330800,21,19,40,Rain
4091,39,1552330800,15,5,20,Rain
4092,40,1552330800,18,3,21,Rain
4093,41,1552330800,18,2,20,Rain
4094,42,1552330800,0,30,30,Rain
4095,43,1552330800,0,30,30,Rain
4096,44,1552330800,19,11,30,Rain
4097,45,1552330800,20,10,30,Rain
4098,46,1552330800,16,4,20,Rain
4099,47,1552330800,40,0,40,Rain
4100,48,1552330800,20,20,40,Rain
4101,49,1552330800,38,2,40,Rain
4102,50,1552330800,30,10,40,Rain
4103,51,1552330800,35,5,40,Rain
4104,52,1552330800,28,4,32,Rain
4105,53,1552330800,40,0,40,Rain
4106,54,1552330800,33,0,33,Rain
4107,55,1552330800,35,1,36,Rain
4108,56,1552330800,40,0,40,Rain
4109,57,1552330800,21,2,23,Rain
4110,58,1552330800,34,6,40,Rain
4111,59,1552330800,19,1,20,Rain
4112,60,1552330800,0,30,30,Rain
4113,61,1552330800,23,2,25,Rain
4114,62,1552330800,35,5,40,Rain
4115,63,1552330800,19,16,35,Rain
4116,64,1552330800,6,34,40,Rain
4117,65,1552330800,40,0,40,Rain
4118,66,1552330800,40,0,40,Rain
4119,67,1552330800,37,3,40,Rain
4120,68,1552330800,40,0,40,Rain
4121,69,1552330800,38,2,40,Rain
4122,70,1552330800,17,11,28,Rain
4123,71,1552330800,40,0,40,Rain
4124,72,1552330800,24,1,25,Rain
4125,73,1552330800,15,15,30,Rain
4126,74,1552330800,20,10,30,Rain
4127,75,1552330800,22,18,40,Rain
4128,76,1552330800,13,25,38,Rain
4129,77,1552330800,25,4,29,Rain
4130,78,1552330800,26,14,40,Rain
4131,79,1552330800,25,2,27,Rain
4132,80,1552330800,6,34,40,Rain
4133,81,1552330800,40,0,40,Rain
4134,82,1552330800,18,4,22,Rain
4135,83,1552330800,23,17,40,Rain
4136,84,1552330800,16,14,30,Rain
4137,85,1552330800,22,13,35,Rain
4138,86,1552330800,20,18,38,Rain
4139,87,1552330800,31,7,38,Rain
4140,88,1552330800,20,10,30,Rain
4141,89,1552330800,36,4,40,Rain
4142,90,1552330800,39,1,40,Rain
4143,91,1552330800,3,27,30,Rain
4144,92,1552330800,7,33,40,Rain
4145,93,1552330800,0,40,40,Rain
4146,94,1552330800,11,29,40,Rain
4147,95,1552330800,24,16,40,Rain
4148,96,1552330800,27,3,30,Rain
4149,97,1552330800,25,15,40,Rain
4150,98,1552330800,40,0,40,Rain
4151,99,1552330800,8,22,30,Rain
4152,100,1552330800,4,21,25,Rain
4153,101,1552330800,24,6,30,Rain
4154,102,1552330800,37,3,40,Rain
4155,103,1552330800,40,0,40,Rain
4156,104,1552330800,40,0,40,Rain
4157,105,1552330800,36,0,36,Rain
4158,106,1552330800,39,1,40,Rain
4159,107,1552330800,33,7,40,Rain
4160,108,1552330800,38,2,40,Rain
4161,109,1552330800,19,10,29,Rain
4162,110,1552330800,37,3,40,Rain
4163,111,1552330800,36,4,40,Rain
4164,112,1552330800,11,19,30,Rain
4165,113,1552330800,21,19,40,Rain
4166,114,1552330800,40,0,40,Rain
4167,115,1552330800,8,22,30,Rain
4168,2,1552334400,20,0,20,Rain
4169,3,1552334400,20,0,20,Rain
4170,4,1552334400,19,1,20,Rain
4171,5,1552334400,7,33,40,Rain
4172,6,1552334400,18,2,20,Rain
4173,7,1552334400,28,1,29,Rain
4174,8,1552334400,30,0,30,Rain
4175,9,1552334400,24,0,24,Rain
4176,10,1552334400,6,10,16,Rain
4177,11,1552334400,30,0,30,Rain
4178,12,1552334400,10,10,20,Rain
4179,13,1552334400,26,3,29,Rain
4180,14,1552334400,12,18,30,Rain
4181,15,1552334400,12,4,16,Rain
4182,16,1552334400,5,15,20,Rain
4183,17,1552334400,15,5,20,Rain
4184,18,1552334400,9,20,29,Rain
4185,19,1552334400,29,1,30,Rain
4186,21,1552334400,25,5,30,Rain
4187,22,1552334400,5,15,20,Rain
4188,23,1552334400,4,26,30,Rain
4189,24,1552334400,18,2,20,Rain
4190,25,1552334400,24,5,29,Rain
4191,26,1552334400,14,6,20,Rain
4192,27,1552334400,20,0,20,Rain
4193,28,1552334400,28,2,30,Rain
4194,29,1552334400,25,4,29,Rain
4195,30,1552334400,19,1,20,Rain
4196,31,1552334400,12,8,20,Rain
4197,32,1552334400,4,26,30,Rain
4198,33,1552334400,6,17,23,Rain
4199,34,1552334400,14,16,30,Rain
4200,35,1552334400,26,4,30,Rain
4201,36,1552334400,40,0,40,Rain
4202,37,1552334400,30,0,30,Rain
4203,38,1552334400,24,16,40,Rain
4204,39,1552334400,18,2,20,Rain
4205,40,1552334400,18,3,21,Rain
4206,41,1552334400,14,6,20,Rain
4207,42,1552334400,1,29,30,Rain
4208,43,1552334400,16,14,30,Rain
4209,44,1552334400,5,25,30,Rain
4210,45,1552334400,21,9,30,Rain
4211,46,1552334400,17,3,20,Rain
4212,47,1552334400,40,0,40,Rain
4213,48,1552334400,30,10,40,Rain
4214,49,1552334400,37,3,40,Rain
4215,50,1552334400,23,17,40,Rain
4216,51,1552334400,37,3,40,Rain
4217,52,1552334400,32,0,32,Rain
4218,53,1552334400,40,0,40,Rain
4219,54,1552334400,33,0,33,Rain
4220,55,1552334400,36,0,36,Rain
4221,56,1552334400,37,3,40,Rain
4222,57,1552334400,22,1,23,Rain
4223,58,1552334400,40,0,40,Rain
4224,59,1552334400,11,9,20,Rain
4225,60,1552334400,1,29,30,Rain
4226,61,1552334400,22,3,25,Rain
4227,62,1552334400,40,0,40,Rain
4228,63,1552334400,18,17,35,Rain
4229,64,1552334400,10,30,40,Rain
4230,65,1552334400,40,0,40,Rain
4231,66,1552334400,40,0,40,Rain
4232,67,1552334400,35,5,40,Rain
4233,68,1552334400,40,0,40,Rain
4234,69,1552334400,40,0,40,Rain
4235,70,1552334400,27,1,28,Rain
4236,71,1552334400,38,2,40,Rain
4237,72,1552334400,23,2,25,Rain
4238,73,1552334400,12,18,30,Rain
4239,74,1552334400,5,25,30,Rain
4240,75,1552334400,16,24,40,Rain
4241,76,1552334400,10,28,38,Rain
4242,77,1552334400,25,4,29,Rain
4243,78,1552334400,21,19,40,Rain
4244,79,1552334400,26,1,27,Rain
4245,80,1552334400,4,36,40,Rain
4246,81,1552334400,40,0,40,Rain
4247,82,1552334400,15,7,22,Rain
4248,83,1552334400,11,29,40,Rain
4249,84,1552334400,12,18,30,Rain
4250,85,1552334400,16,19,35,Rain
4251,86,1552334400,10,28,38,Rain
4252,87,1552334400,24,14,38,Rain
4253,88,1552334400,17,13,30,Rain
4254,89,1552334400,40,0,40,Rain
4255,90,1552334400,40,0,40,Rain
4256,91,1552334400,0,30,30,Rain
4257,92,1552334400,4,36,40,Rain
4258,93,1552334400,0,40,40,Rain
4259,94,1552334400,9,31,40,Rain
4260,95,1552334400,16,24,40,Rain
4261,96,1552334400,24,6,30,Rain
4262,97,1552334400,16,24,40,Rain
4263,98,1552334400,40,0,40,Rain
4264,99,1552334400,17,13,30,Rain
4265,100,1552334400,5,20,25,Rain
4266,101,1552334400,25,5,30,Rain
4267,102,1552334400,40,0,40,Rain
4268,103,1552334400,38,2,40,Rain
4269,104,1552334400,40,0,40,Rain
4270,105,1552334400,36,0,36,Rain
4271,106,1552334400,35,5,40,Rain
4272,107,1552334400,30,10,40,Rain
4273,108,1552334400,32,8,40,Rain
4274,109,1552334400,21,8,29,Rain
4275,110,1552334400,33,7,40,Rain
4276,111,1552334400,36,4,40,Rain
4277,112,1552334400,7,23,30,Rain
4278,113,1552334400,26,14,40,Rain
4279,114,1552334400,40,0,40,Rain
4280,115,1552334400,4,26,30,Rain
4281,2,1552338000,17,3,20,Rain
4282,3,1552338000,17,3,20,Rain
4283,4,1552338000,18,2,20,Rain
4284,5,1552338000,7,33,40,Rain
4285,6,1552338000,20,0,20,Rain
4286,7,1552338000,28,1,29,Rain
4287,8,1552338000,28,2,30,Rain
4288,9,1552338000,24,0,24,Rain
4289,10,1552338000,16,0,16,Rain
4290,11,1552338000,30,0,30,Rain
4291,12,1552338000,11,9,20,Rain
4292,13,1552338000,30,0,30,Rain
4293,14,1552338000,20,10,30,Rain
4294,15,1552338000,9,7,16,Rain
4295,16,1552338000,3,17,20,Rain
4296,17,1552338000,17,3,20,Rain
4297,18,1552338000,15,15,30,Rain
4298,19,1552338000,17,13,30,Rain
4299,21,1552338000,28,2,30,Rain
4300,22,1552338000,8,12,20,Rain
4301,23,1552338000,1,29,30,Rain
4302,24,1552338000,19,1,20,Rain
4303,25,1552338000,28,1,29,Rain
4304,26,1552338000,16,4,20,Rain
4305,27,1552338000,20,0,20,Rain
4306,28,1552338000,26,4,30,Rain
4307,29,1552338000,24,5,29,Rain
4308,30,1552338000,15,5,20,Rain
4309,31,1552338000,15,5,20,Rain
4310,32,1552338000,0,30,30,Rain
4311,33,1552338000,6,17,23,Rain
4312,34,1552338000,1,29,30,Rain
4313,35,1552338000,23,7,30,Rain
4314,36,1552338000,38,2,40,Rain
4315,37,1552338000,30,0,30,Rain
4316,38,1552338000,27,13,40,Rain
4317,39,1552338000,18,2,20,Rain
4318,40,1552338000,19,2,21,Rain
4319,41,1552338000,20,0,20,Rain
4320,42,1552338000,1,29,30,Rain
4321,43,1552338000,13,17,30,Rain
4322,44,1552338000,0,30,30,Rain
4323,45,1552338000,21,9,30,Rain
4324,46,1552338000,17,3,20,Rain
4325,47,1552338000,40,0,40,Rain
4326,48,1552338000,39,1,40,Rain
4327,49,1552338000,39,1,40,Rain
4328,50,1552338000,19,21,40,Rain
4329,51,1552338000,39,1,40,Rain
4330,52,1552338000,32,0,32,Rain
4331,53,1552338000,40,0,40,Rain
4332,54,1552338000,33,0,33,Rain
4333,55,1552338000,36,0,36,Rain
4334,56,1552338000,28,12,40,Rain
4335,57,1552338000,23,0,23,Rain
4336,58,1552338000,29,11,40,Rain
4337,59,1552338000,13,7,20,Rain
4338,60,1552338000,1,29,30,Rain
4339,61,1552338000,22,3,25,Rain
4340,62,1552338000,40,0,40,Rain
4341,63,1552338000,23,12,35,Rain
4342,64,1552338000,16,24,40,Rain
4343,65,1552338000,40,0,40,Rain
4344,66,1552338000,36,4,40,Rain
4345,67,1552338000,33,7,40,Rain
4346,68,1552338000,40,0,40,Rain
4347,69,1552338000,39,1,40,Rain
4348,70,1552338000,21,7,28,Rain
4349,71,1552338000,40,0,40,Rain
4350,72,1552338000,17,8,25,Rain
4351,73,1552338000,9,21,30,Rain
4352,74,1552338000,3,27,30,Rain
4353,75,1552338000,17,23,40,Rain
4354,76,1552338000,14,24,38,Rain
4355,77,1552338000,27,2,29,Rain
4356,78,1552338000,18,22,40,Rain
4357,79,1552338000,26,1,27,Rain
4358,80,1552338000,1,39,40,Rain
4359,81,1552338000,39,1,40,Rain
4360,82,1552338000,10,12,22,Rain
4361,83,1552338000,2,38,40,Rain
4362,84,1552338000,9,21,30,Rain
4363,85,1552338000,13,22,35,Rain
4364,86,1552338000,12,26,38,Rain
4365,87,1552338000,18,20,38,Rain
4366,88,1552338000,13,17,30,Rain
4367,89,1552338000,40,0,40,Rain
4368,90,1552338000,39,1,40,Rain
4369,91,1552338000,5,25,30,Rain
4370,92,1552338000,1,39,40,Rain
4371,93,1552338000,0,40,40,Rain
4372,94,1552338000,8,32,40,Rain
4373,95,1552338000,15,25,40,Rain
4374,96,1552338000,23,7,30,Rain
4375,97,1552338000,15,25,40,Rain
4376,98,1552338000,40,0,40,Rain
4377,99,1552338000,29,1,30,Rain
4378,100,1552338000,1,24,25,Rain
4379,101,1552338000,23,7,30,Rain
4380,102,1552338000,28,12,40,Rain
4381,103,1552338000,39,1,40,Rain
4382,104,1552338000,40,0,40,Rain
4383,105,1552338000,36,0,36,Rain
4384,106,1552338000,35,5,40,Rain
4385,107,1552338000,29,11,40,Rain
4386,108,1552338000,31,9,40,Rain
4387,109,1552338000,21,8,29,Rain
4388,110,1552338000,32,8,40,Rain
4389,111,1552338000,28,12,40,Rain
4390,112,1552338000,1,29,30,Rain
4391,113,1552338000,29,11,40,Rain
4392,114,1552338000,39,1,40,Rain
4393,115,1552338000,1,29,30,Rain
4394,2,1552341600,17,3,20,Rain
4395,3,1552341600,17,3,20,Rain
4396,4,1552341600,19,1,20,Rain
4397,5,1552341600,3,37,40,Rain
4398,6,1552341600,20,0,20,Rain
4399,7,1552341600,29,0,29,Rain
4400,8,1552341600,30,0,30,Rain
4401,9,1552341600,23,1,24,Rain
4402,10,1552341600,16,0,16,Rain
4403,11,1552341600,30,0,30,Rain
4404,12,1552341600,10,10,20,Rain
4405,13,1552341600,30,0,30,Rain
4406,14,1552341600,24,6,30,Rain
4407,15,1552341600,9,7,16,Rain
4408,16,1552341600,5,15,20,Rain
4409,17,1552341600,17,3,20,Rain
4410,18,1552341600,21,9,30,Rain
4411,19,1552341600,20,10,30,Rain
4412,21,1552341600,30,0,30,Rain
4413,22,1552341600,15,5,20,Rain
4414,23,1552341600,3,27,30,Rain
4415,24,1552341600,19,1,20,Rain
4416,25,1552341600,25,4,29,Rain
4417,26,1552341600,16,4,20,Rain
4418,27,1552341600,19,1,20,Rain
4419,28,1552341600,21,9,30,Rain
4420,29,1552341600,24,5,29,Rain
4421,30,1552341600,18,2,20,Rain
4422,31,1552341600,17,3,20,Rain
4423,32,1552341600,7,23,30,Rain
4424,33,1552341600,10,13,23,Rain
4425,34,1552341600,4,26,30,Rain
4426,35,1552341600,17,13,30,Rain
4427,36,1552341600,40,0,40,Rain
4428,37,1552341600,30,0,30,Rain
4429,38,1552341600,30,10,40,Rain
4430,39,1552341600,19,1,20,Rain
4431,40,1552341600,18,3,21,Rain
4432,41,1552341600,20,0,20,Rain
4433,42,1552341600,1,29,30,Rain
4434,43,1552341600,9,21,30,Rain
4435,44,1552341600,0,30,30,Rain
4436,45,1552341600,23,7,30,Rain
4437,46,1552341600,11,9,20,Rain
4438,47,1552341600,38,2,40,Rain
4439,48,1552341600,40,0,40,Rain
4440,49,1552341600,39,1,40,Rain
4441,50,1552341600,14,26,40,Rain
4442,51,1552341600,39,1,40,Rain
4443,52,1552341600,32,0,32,Rain
4444,53,1552341600,40,0,40,Rain
4445,54,1552341600,32,1,33,Rain
4446,55,1552341600,36,0,36,Rain
4447,56,1552341600,28,12,40,Rain
4448,57,1552341600,22,1,23,Rain
4449,58,1552341600,37,3,40,Rain
4450,59,1552341600,12,8,20,Rain
4451,60,1552341600,0,30,30,Rain
4452,61,1552341600,7,18,25,Rain
4453,62,1552341600,39,1,40,Rain
4454,63,1552341600,26,9,35,Rain
4455,64,1552341600,16,24,40,Rain
4456,65,1552341600,40,0,40,Rain
4457,66,1552341600,40,0,40,Rain
4458,67,1552341600,27,13,40,Rain
4459,68,1552341600,40,0,40,Rain
4460,69,1552341600,39,1,40,Rain
4461,70,1552341600,25,3,28,Rain
4462,71,1552341600,40,0,40,Rain
4463,72,1552341600,15,10,25,Rain
4464,73,1552341600,4,26,30,Rain
4465,74,1552341600,1,29,30,Rain
4466,75,1552341600,18,22,40,Rain
4467,76,1552341600,12,26,38,Rain
4468,77,1552341600,27,2,29,Rain
4469,78,1552341600,11,29,40,Rain
4470,79,1552341600,27,0,27,Rain
4471,80,1552341600,0,40,40,Rain
4472,81,1552341600,40,0,40,Rain
4473,82,1552341600,7,15,22,Rain
4474,83,1552341600,0,40,40,Rain
4475,84,1552341600,5,25,30,Rain
4476,85,1552341600,8,27,35,Rain
4477,86,1552341600,4,34,38,Rain
4478,87,1552341600,19,19,38,Rain
4479,88,1552341600,11,19,30,Rain
4480,89,1552341600,40,0,40,Rain
4481,90,1552341600,40,0,40,Rain
4482,91,1552341600,15,15,30,Rain
4483,92,1552341600,0,40,40,Rain
4484,93,1552341600,0,40,40,Rain
4485,94,1552341600,7,33,40,Rain
4486,95,1552341600,10,30,40,Rain
4487,96,1552341600,22,8,30,Rain
4488,97,1552341600,11,29,40,Rain
4489,98,1552341600,40,0,40,Rain
4490,99,1552341600,30,0,30,Rain
4491,100,1552341600,0,25,25,Rain
4492,101,1552341600,20,10,30,Rain
4493,102,1552341600,27,13,40,Rain
4494,103,1552341600,40,0,40,Rain
4495,104,1552341600,40,0,40,Rain
4496,105,1552341600,36,0,36,Rain
4497,106,1552341600,36,4,40,Rain
4498,107,1552341600,31,9,40,Rain
4499,108,1552341600,28,12,40,Rain
4500,109,1552341600,19,10,29,Rain
4501,110,1552341600,34,6,40,Rain
4502,111,1552341600,27,13,40,Rain
4503,112,1552341600,15,15,30,Rain
4504,113,1552341600,30,10,40,Rain
4505,114,1552341600,39,1,40,Rain
4506,115,1552341600,1,29,30,Rain
4507,2,1552345200,13,7,20,Rain
4508,3,1552345200,17,3,20,Rain
4509,4,1552345200,18,2,20,Rain
4510,5,1552345200,3,37,40,Rain
4511,6,1552345200,20,0,20,Rain
4512,7,1552345200,29,0,29,Rain
4513,8,1552345200,30,0,30,Rain
4514,9,1552345200,24,0,24,Rain
4515,10,1552345200,15,1,16,Rain
4516,11,1552345200,30,0,30,Rain
4517,12,1552345200,10,10,20,Rain
4518,13,1552345200,30,0,30,Rain
4519,14,1552345200,30,0,30,Rain
4520,15,1552345200,9,7,16,Rain
4521,16,1552345200,11,9,20,Rain
4522,17,1552345200,20,0,20,Rain
4523,18,1552345200,18,12,30,Rain
4524,19,1552345200,22,8,30,Rain
4525,21,1552345200,30,0,30,Rain
4526,22,1552345200,20,0,20,Rain
4527,23,1552345200,4,26,30,Rain
4528,24,1552345200,20,0,20,Rain
4529,25,1552345200,28,1,29,Rain
4530,26,1552345200,11,9,20,Rain
4531,27,1552345200,18,2,20,Rain
4532,28,1552345200,17,13,30,Rain
4533,29,1552345200,27,2,29,Rain
4534,30,1552345200,16,4,20,Rain
4535,31,1552345200,20,0,20,Rain
4536,32,1552345200,17,13,30,Rain
4537,33,1552345200,9,14,23,Rain
4538,34,1552345200,2,28,30,Rain
4539,35,1552345200,14,16,30,Rain
4540,36,1552345200,40,0,40,Rain
4541,37,1552345200,30,0,30,Rain
4542,38,1552345200,30,10,40,Rain
4543,39,1552345200,17,3,20,Rain
4544,40,1552345200,21,0,21,Rain
4545,41,1552345200,20,0,20,Rain
4546,42,1552345200,1,29,30,Rain
4547,43,1552345200,8,22,30,Rain
4548,44,1552345200,0,30,30,Rain
4549,45,1552345200,22,8,30,Rain
4550,46,1552345200,19,1,20,Rain
4551,47,1552345200,38,2,40,Rain
4552,48,1552345200,39,1,40,Rain
4553,49,1552345200,40,0,40,Rain
4554,50,1552345200,12,28,40,Rain
4555,51,1552345200,40,0,40,Rain
4556,52,1552345200,32,0,32,Rain
4557,53,1552345200,40,0,40,Rain
4558,54,1552345200,33,0,33,Rain
4559,55,1552345200,36,0,36,Rain
4560,56,1552345200,25,15,40,Rain
4561,57,1552345200,22,1,23,Rain
4562,58,1552345200,34,6,40,Rain
4563,59,1552345200,14,6,20,Rain
4564,60,1552345200,16,14,30,Rain
4565,61,1552345200,8,17,25,Rain
4566,62,1552345200,40,0,40,Rain
4567,63,1552345200,31,4,35,Rain
4568,64,1552345200,18,22,40,Rain
4569,65,1552345200,40,0,40,Rain
4570,66,1552345200,37,3,40,Rain
4571,67,1552345200,30,10,40,Rain
4572,68,1552345200,38,2,40,Rain
4573,69,1552345200,39,1,40,Rain
4574,70,1552345200,28,0,28,Rain
4575,71,1552345200,39,1,40,Rain
4576,72,1552345200,15,10,25,Rain
4577,73,1552345200,2,28,30,Rain
4578,74,1552345200,0,30,30,Rain
4579,75,1552345200,15,25,40,Rain
4580,76,1552345200,12,26,38,Rain
4581,77,1552345200,25,4,29,Rain
4582,78,1552345200,6,34,40,Rain
4583,79,1552345200,27,0,27,Rain
4584,80,1552345200,2,38,40,Rain
4585,81,1552345200,39,1,40,Rain
4586,82,1552345200,6,16,22,Rain
4587,83,1552345200,0,40,40,Rain
4588,84,1552345200,2,28,30,Rain
4589,85,1552345200,7,28,35,Rain
4590,86,1552345200,2,36,38,Rain
4591,87,1552345200,16,22,38,Rain
4592,88,1552345200,8,22,30,Rain
4593,89,1552345200,40,0,40,Rain
4594,90,1552345200,40,0,40,Rain
4595,91,1552345200,2,28,30,Rain
4596,92,1552345200,0,40,40,Rain
4597,93,1552345200,0,40,40,Rain
4598,94,1552345200,7,33,40,Rain
4599,95,1552345200,8,32,40,Rain
4600,96,1552345200,20,10,30,Rain
4601,97,1552345200,6,34,40,Rain
4602,98,1552345200,40,0,40,Rain
4603,99,1552345200,30,0,30,Rain
4604,100,1552345200,2,23,25,Rain
4605,101,1552345200,19,11,30,Rain
4606,102,1552345200,28,12,40,Rain
4607,103,1552345200,40,0,40,Rain
4608,104,1552345200,40,0,40,Rain
4609,105,1552345200,36,0,36,Rain
4610,106,1552345200,36,4,40,Rain
4611,107,1552345200,31,9,40,Rain
4612,108,1552345200,27,13,40,Rain
4613,109,1552345200,16,13,29,Rain
4614,110,1552345200,35,5,40,Rain
4615,111,1552345200,27,13,40,Rain
4616,112,1552345200,11,19,30,Rain
4617,113,1552345200,30,10,40,Rain
4618,114,1552345200,40,0,40,Rain
4619,115,1552345200,5,25,30,Rain
4620,2,1552348800,11,9,20,Rain
4621,3,1552348800,13,7,20,Rain
4622,4,1552348800,17,3,20,Rain
4623,5,1552348800,2,38,40,Rain
4624,6,1552348800,20,0,20,Rain
4625,7,1552348800,9,20,29,Rain
4626,8,1552348800,30,0,30,Rain
4627,9,1552348800,24,0,24,Rain
4628,10,1552348800,15,1,16,Rain
4629,11,1552348800,30,0,30,Rain
4630,12,1552348800,8,12,20,Rain
4631,13,1552348800,29,1,30,Rain
4632,14,1552348800,30,0,30,Rain
4633,15,1552348800,6,10,16,Rain
4634,16,1552348800,13,7,20,Rain
4635,17,1552348800,20,0,20,Rain
4636,18,1552348800,17,13,30,Rain
4637,19,1552348800,21,9,30,Rain
4638,21,1552348800,29,1,30,Rain
4639,22,1552348800,20,0,20,Rain
4640,23,1552348800,8,22,30,Rain
4641,24,1552348800,18,2,20,Rain
4642,25,1552348800,20,10,30,Rain
4643,26,1552348800,12,8,20,Rain
4644,27,1552348800,20,0,20,Rain
4645,28,1552348800,15,15,30,Rain
4646,29,1552348800,29,0,29,Rain
4647,30,1552348800,16,4,20,Rain
4648,31,1552348800,19,1,20,Rain
4649,32,1552348800,25,5,30,Rain
4650,33,1552348800,17,6,23,Rain
4651,34,1552348800,2,28,30,Rain
4652,35,1552348800,14,16,30,Rain
4653,36,1552348800,40,0,40,Rain
4654,37,1552348800,30,0,30,Rain
4655,38,1552348800,31,9,40,Rain
4656,39,1552348800,16,4,20,Rain
4657,40,1552348800,20,1,21,Rain
4658,41,1552348800,20,0,20,Rain
4659,42,1552348800,5,25,30,Rain
4660,43,1552348800,6,24,30,Rain
4661,44,1552348800,1,29,30,Rain
4662,45,1552348800,22,8,30,Rain
4663,46,1552348800,20,0,20,Rain
4664,47,1552348800,38,2,40,Rain
4665,48,1552348800,39,1,40,Rain
4666,49,1552348800,40,0,40,Rain
4667,50,1552348800,7,33,40,Rain
4668,51,1552348800,39,1,40,Rain
4669,52,1552348800,32,0,32,Rain
4670,53,1552348800,40,0,40,Rain
4671,54,1552348800,33,0,33,Rain
4672,55,1552348800,35,1,36,Rain
4673,56,1552348800,26,14,40,Rain
4674,57,1552348800,21,2,23,Rain
4675,58,1552348800,37,3,40,Rain
4676,59,1552348800,13,7,20,Rain
4677,60,1552348800,13,17,30,Rain
4678,61,1552348800,9,16,25,Rain
4679,62,1552348800,40,0,40,Rain
4680,63,1552348800,33,2,35,Rain
4681,64,1552348800,18,22,40,Rain
4682,65,1552348800,40,0,40,Rain
4683,66,1552348800,40,0,40,Rain
4684,67,1552348800,31,9,40,Rain
4685,68,1552348800,40,0,40,Rain
4686,69,1552348800,40,0,40,Rain
4687,70,1552348800,28,0,28,Rain
4688,71,1552348800,36,4,40,Rain
4689,72,1552348800,11,14,25,Rain
4690,73,1552348800,1,29,30,Rain
4691,74,1552348800,0,30,30,Rain
4692,75,1552348800,12,28,40,Rain
4693,76,1552348800,12,26,38,Rain
4694,77,1552348800,29,0,29,Rain
4695,78,1552348800,6,34,40,Rain
4696,79,1552348800,27,0,27,Rain
4697,80,1552348800,5,35,40,Rain
4698,81,1552348800,39,1,40,Rain
4699,82,1552348800,4,18,22,Rain
4700,83,1552348800,13,27,40,Rain
4701,84,1552348800,0,30,30,Rain
4702,85,1552348800,10,25,35,Rain
4703,86,1552348800,3,35,38,Rain
4704,87,1552348800,14,24,38,Rain
4705,88,1552348800,8,22,30,Rain
4706,89,1552348800,40,0,40,Rain
4707,90,1552348800,40,0,40,Rain
4708,91,1552348800,5,25,30,Rain
4709,92,1552348800,0,40,40,Rain
4710,93,1552348800,0,40,40,Rain
4711,94,1552348800,7,33,40,Rain
4712,95,1552348800,8,32,40,Rain
4713,96,1552348800,19,11,30,Rain
4714,97,1552348800,4,36,40,Rain
4715,98,1552348800,40,0,40,Rain
4716,99,1552348800,30,0,30,Rain
4717,100,1552348800,2,23,25,Rain
4718,101,1552348800,19,11,30,Rain
4719,102,1552348800,28,12,40,Rain
4720,103,1552348800,40,0,40,Rain
4721,104,1552348800,40,0,40,Rain
4722,105,1552348800,35,1,36,Rain
4723,106,1552348800,36,4,40,Rain
4724,107,1552348800,28,12,40,Rain
4725,108,1552348800,27,13,40,Rain
4726,109,1552348800,16,13,29,Rain
4727,110,1552348800,18,22,40,Rain
4728,111,1552348800,22,18,40,Rain
4729,112,1552348800,7,23,30,Rain
4730,113,1552348800,31,9,40,Rain
4731,114,1552348800,40,0,40,Rain
4732,115,1552348800,3,27,30,Rain
4733,2,1552352400,10,10,20,Rain
4734,3,1552352400,12,8,20,Rain
4735,4,1552352400,17,3,20,Rain
4736,5,1552352400,10,30,40,Rain
4737,6,1552352400,20,0,20,Rain
4738,7,1552352400,10,19,29,Rain
4739,8,1552352400,30,0,30,Rain
4740,9,1552352400,24,0,24,Rain
4741,10,1552352400,16,0,16,Rain
4742,11,1552352400,30,0,30,Rain
4743,12,1552352400,8,12,20,Rain
4744,13,1552352400,30,0,30,Rain
4745,14,1552352400,30,0,30,Rain
4746,15,1552352400,7,9,16,Rain
4747,16,1552352400,16,4,20,Rain
4748,17,1552352400,20,0,20,Rain
4749,18,1552352400,18,12,30,Rain
4750,19,1552352400,23,7,30,Rain
4751,21,1552352400,30,0,30,Rain
4752,22,1552352400,20,0,20,Rain
4753,23,1552352400,7,23,30,Rain
4754,24,1552352400,20,0,20,Rain
4755,25,1552352400,20,10,30,Rain
4756,26,1552352400,12,8,20,Rain
4757,27,1552352400,20,0,20,Rain
4758,28,1552352400,17,13,30,Rain
4759,29,1552352400,29,0,29,Rain
4760,30,1552352400,17,3,20,Rain
4761,31,1552352400,20,0,20,Rain
4762,32,1552352400,25,5,30,Rain
4763,33,1552352400,23,0,23,Rain
4764,34,1552352400,9,21,30,Rain
4765,35,1552352400,16,14,30,Rain
4766,36,1552352400,40,0,40,Rain
4767,37,1552352400,30,0,30,Rain
4768,38,1552352400,34,6,40,Rain
4769,39,1552352400,19,1,20,Rain
4770,40,1552352400,21,0,21,Rain
4771,41,1552352400,19,1,20,Rain
4772,42,1552352400,4,26,30,Rain
4773,43,1552352400,1,29,30,Rain
4774,44,1552352400,0,30,30,Rain
4775,45,1552352400,22,8,30,Rain
4776,46,1552352400,20,0,20,Rain
4777,47,1552352400,37,3,40,Rain
4778,48,1552352400,39,1,40,Rain
4779,49,1552352400,40,0,40,Rain
4780,50,1552352400,5,35,40,Rain
4781,51,1552352400,40,0,40,Rain
4782,52,1552352400,32,0,32,Rain
4783,53,1552352400,40,0,40,Rain
4784,54,1552352400,33,0,33,Rain
4785,55,1552352400,36,0,36,Rain
4786,56,1552352400,27,13,40,Rain
4787,57,1552352400,21,2,23,Rain
4788,58,1552352400,40,0,40,Rain
4789,59,1552352400,13,7,20,Rain
4790,60,1552352400,5,25,30,Rain
4791,61,1552352400,9,16,25,Rain
4792,62,1552352400,40,0,40,Rain
4793,63,1552352400,33,2,35,Rain
4794,64,1552352400,21,19,40,Rain
4795,65,1552352400,40,0,40,Rain
4796,66,1552352400,33,7,40,Rain
4797,67,1552352400,30,10,40,Rain
4798,68,1552352400,40,0,40,Rain
4799,69,1552352400,38,2,40,Rain
4800,70,1552352400,26,2,28,Rain
4801,71,1552352400,40,0,40,Rain
4802,72,1552352400,12,13,25,Rain
4803,73,1552352400,0,30,30,Rain
4804,74,1552352400,0,30,30,Rain
4805,75,1552352400,9,31,40,Rain
4806,76,1552352400,13,25,38,Rain
4807,77,1552352400,28,1,29,Rain
4808,78,1552352400,4,36,40,Rain
4809,79,1552352400,27,0,27,Rain
4810,80,1552352400,5,35,40,Rain
4811,81,1552352400,38,2,40,Rain
4812,82,1552352400,4,18,22,Rain
4813,83,1552352400,12,28,40,Rain
4814,84,1552352400,0,30,30,Rain
4815,85,1552352400,9,26,35,Rain
4816,86,1552352400,2,36,38,Rain
4817,87,1552352400,14,24,38,Rain
4818,88,1552352400,7,23,30,Rain
4819,89,1552352400,40,0,40,Rain
4820,90,1552352400,40,0,40,Rain
4821,91,1552352400,5,25,30,Rain
4822,92,1552352400,0,40,40,Rain
4823,93,1552352400,0,40,40,Rain
4824,94,1552352400,7,33,40,Rain
4825,95,1552352400,8,32,40,Rain
4826,96,1552352400,19,11,30,Rain
4827,97,1552352400,2,38,40,Rain
4828,98,1552352400,39,1,40,Rain
4829,99,1552352400,30,0,30,Rain
4830,100,1552352400,1,24,25,Rain
4831,101,1552352400,19,11,30,Rain
4832,102,1552352400,27,13,40,Rain
4833,103,1552352400,40,0,40,Rain
4834,104,1552352400,40,0,40,Rain
4835,105,1552352400,36,0,36,Rain
4836,106,1552352400,36,4,40,Rain
4837,107,1552352400,27,13,40,Rain
4838,108,1552352400,27,13,40,Rain
4839,109,1552352400,17,12,29,Rain
4840,110,1552352400,18,22,40,Rain
4841,111,1552352400,18,22,40,Rain
4842,112,1552352400,2,28,30,Rain
4843,113,1552352400,31,9,40,Rain
4844,114,1552352400,40,0,40,Rain
4845,115,1552352400,0,30,30,Rain
4846,2,1552356000,10,10,20,Rain
4847,3,1552356000,12,8,20,Rain
4848,4,1552356000,17,3,20,Rain
4849,5,1552356000,11,29,40,Rain
4850,6,1552356000,19,1,20,Rain
4851,7,1552356000,10,19,29,Rain
4852,8,1552356000,30,0,30,Rain
4853,9,1552356000,23,1,24,Rain
4854,10,1552356000,16,0,16,Rain
4855,11,1552356000,30,0,30,Rain
4856,12,1552356000,8,12,20,Rain
4857,13,1552356000,30,0,30,Rain
4858,14,1552356000,30,0,30,Rain
4859,15,1552356000,7,9,16,Rain
4860,16,1552356000,16,4,20,Rain
4861,17,1552356000,19,1,20,Rain
4862,18,1552356000,18,12,30,Rain
4863,19,1552356000,24,6,30,Rain
4864,21,1552356000,30,0,30,Rain
4865,22,1552356000,20,0,20,Rain
4866,23,1552356000,8,22,30,Rain
4867,24,1552356000,20,0,20,Rain
4868,25,1552356000,20,10,30,Rain
4869,26,1552356000,14,6,20,Rain
4870,27,1552356000,20,0,20,Rain
4871,28,1552356000,16,14,30,Rain
4872,29,1552356000,29,0,29,Rain
4873,30,1552356000,17,3,20,Rain
4874,31,1552356000,20,0,20,Rain
4875,32,1552356000,25,5,30,Rain
4876,33,1552356000,22,1,23,Rain
4877,34,1552356000,10,20,30,Rain
4878,35,1552356000,16,14,30,Rain
4879,36,1552356000,39,1,40,Rain
4880,37,1552356000,30,0,30,Rain
4881,38,1552356000,35,5,40,Rain
4882,39,1552356000,19,1,20,Rain
4883,40,1552356000,21,0,21,Rain
4884,41,1552356000,19,1,20,Rain
4885,42,1552356000,3,27,30,Rain
4886,43,1552356000,1,29,30,Rain
4887,44,1552356000,0,30,30,Rain
4888,45,1552356000,22,8,30,Rain
4889,46,1552356000,20,0,20,Rain
4890,47,1552356000,37,3,40,Rain
4891,48,1552356000,39,1,40,Rain
4892,49,1552356000,39,1,40,Rain
4893,50,1552356000,6,34,40,Rain
4894,51,1552356000,40,0,40,Rain
4895,52,1552356000,32,0,32,Rain
4896,53,1552356000,40,0,40,Rain
4897,54,1552356000,33,0,33,Rain
4898,55,1552356000,36,0,36,Rain
4899,56,1552356000,26,14,40,Rain
4900,57,1552356000,23,0,23,Rain
4901,58,1552356000,40,0,40,Rain
4902,59,1552356000,13,7,20,Rain
4903,60,1552356000,0,30,30,Rain
4904,61,1552356000,10,15,25,Rain
4905,62,1552356000,40,0,40,Rain
4906,63,1552356000,33,2,35,Rain
4907,64,1552356000,21,19,40,Rain
4908,65,1552356000,40,0,40,Rain
4909,66,1552356000,32,8,40,Rain
4910,67,1552356000,29,11,40,Rain
4911,68,1552356000,40,0,40,Rain
4912,69,1552356000,38,2,40,Rain
4913,70,1552356000,26,2,28,Rain
4914,71,1552356000,39,1,40,Rain
4915,72,1552356000,13,12,25,Rain
4916,73,1552356000,1,29,30,Rain
4917,74,1552356000,0,30,30,Rain
4918,75,1552356000,9,31,40,Rain
4919,76,1552356000,13,25,38,Rain
4920,77,1552356000,29,0,29,Rain
4921,78,1552356000,4,36,40,Rain
4922,79,1552356000,27,0,27,Rain
4923,80,1552356000,5,35,40,Rain
4924,81,1552356000,38,2,40,Rain
4925,82,1552356000,4,18,22,Rain
4926,83,1552356000,12,28,40,Rain
4927,84,1552356000,0,30,30,Rain
4928,85,1552356000,9,26,35,Rain
4929,86,1552356000,2,36,38,Rain
4930,87,1552356000,15,23,38,Rain
4931,88,1552356000,7,23,30,Rain
4932,89,1552356000,40,0,40,Rain
4933,90,1552356000,40,0,40,Rain
4934,91,1552356000,5,25,30,Rain
4935,92,1552356000,0,40,40,Rain
4936,93,1552356000,0,40,40,Rain
4937,94,1552356000,7,33,40,Rain
4938,95,1552356000,8,32,40,Rain
4939,96,1552356000,19,11,30,Rain
4940,97,1552356000,2,38,40,Rain
4941,98,1552356000,40,0,40,Rain
4942,99,1552356000,30,0,30,Rain
4943,100,1552356000,1,24,25,Rain
4944,101,1552356000,19,11,30,Rain
4945,102,1552356000,27,13,40,Rain
4946,103,1552356000,40,0,40,Rain
4947,104,1552356000,40,0,40,Rain
4948,105,1552356000,36,0,36,Rain
4949,106,1552356000,37,3,40,Rain
4950,107,1552356000,27,13,40,Rain
4951,108,1552356000,25,15,40,Rain
4952,109,1552356000,17,12,29,Rain
4953,110,1552356000,18,22,40,Rain
4954,111,1552356000,18,22,40,Rain
4955,112,1552356000,1,29,30,Rain
4956,113,1552356000,31,9,40,Rain
4957,114,1552356000,40,0,40,Rain
4958,115,1552356000,1,29,30,Rain
4959,2,1552359600,10,10,20,Rain
4960,3,1552359600,12,8,20,Rain
4961,4,1552359600,17,3,20,Rain
4962,5,1552359600,11,29,40,Rain
4963,6,1552359600,19,1,20,Rain
4964,7,1552359600,10,19,29,Rain
4965,8,1552359600,30,0,30,Rain
4966,9,1552359600,23,1,24,Rain
4967,10,1552359600,16,0,16,Rain
4968,11,1552359600,30,0,30,Rain
4969,12,1552359600,8,12,20,Rain
4970,13,1552359600,30,0,30,Rain
4971,14,1552359600,30,0,30,Rain
4972,15,1552359600,7,9,16,Rain
4973,16,1552359600,16,4,20,Rain
4974,17,1552359600,19,1,20,Rain
4975,18,1552359600,18,12,30,Rain
4976,19,1552359600,24,6,30,Rain
4977,21,1552359600,30,0,30,Rain
4978,22,1552359600,20,0,20,Rain
4979,23,1552359600,8,22,30,Rain
4980,24,1552359600,20,0,20,Rain
4981,25,1552359600,20,10,30,Rain
4982,26,1552359600,14,6,20,Rain
4983,27,1552359600,20,0,20,Rain
4984,28,1552359600,16,14,30,Rain
4985,29,1552359600,29,0,29,Rain
4986,30,1552359600,17,3,20,Rain
4987,31,1552359600,20,0,20,Rain
4988,32,1552359600,25,5,30,Rain
4989,33,1552359600,22,1,23,Rain
4990,34,1552359600,10,20,30,Rain
4991,35,1552359600,16,14,30,Rain
4992,36,1552359600,39,1,40,Rain
4993,37,1552359600,30,0,30,Rain
4994,38,1552359600,35,5,40,Rain
4995,39,1552359600,19,1,20,Rain
4996,40,1552359600,21,0,21,Rain
4997,41,1552359600,19,1,20,Rain
4998,42,1552359600,3,27,30,Rain
4999,43,1552359600,1,29,30,Rain
5000,44,1552359600,0,30,30,Rain
5001,45,1552359600,22,8,30,Rain
5002,46,1552359600,20,0,20,Rain
5003,47,1552359600,37,3,40,Rain
5004,48,1552359600,39,1,40,Rain
5005,49,1552359600,39,1,40,Rain
5006,50,1552359600,6,34,40,Rain
5007,51,1552359600,40,0,40,Rain
5008,52,1552359600,32,0,32,Rain
5009,53,1552359600,40,0,40,Rain
5010,54,1552359600,33,0,33,Rain
5011,55,1552359600,36,0,36,Rain
5012,56,1552359600,26,14,40,Rain
5013,57,1552359600,23,0,23,Rain
5014,58,1552359600,40,0,40,Rain
5015,59,1552359600,13,7,20,Rain
5016,60,1552359600,0,30,30,Rain
5017,61,1552359600,10,15,25,Rain
5018,62,1552359600,40,0,40,Rain
5019,63,1552359600,33,2,35,Rain
5020,64,1552359600,21,19,40,Rain
5021,65,1552359600,40,0,40,Rain
5022,66,1552359600,32,8,40,Rain
5023,67,1552359600,29,11,40,Rain
5024,68,1552359600,40,0,40,Rain
5025,69,1552359600,38,2,40,Rain
5026,70,1552359600,26,2,28,Rain
5027,71,1552359600,39,1,40,Rain
5028,72,1552359600,13,12,25,Rain
5029,73,1552359600,1,29,30,Rain
5030,74,1552359600,0,30,30,Rain
5031,75,1552359600,9,31,40,Rain
5032,76,1552359600,13,25,38,Rain
5033,77,1552359600,29,0,29,Rain
5034,78,1552359600,4,36,40,Rain
5035,79,1552359600,27,0,27,Rain
5036,80,1552359600,5,35,40,Rain
5037,81,1552359600,38,2,40,Rain
5038,82,1552359600,4,18,22,Rain
5039,83,1552359600,12,28,40,Rain
5040,84,1552359600,0,30,30,Rain
5041,85,1552359600,9,26,35,Rain
5042,86,1552359600,2,36,38,Rain
5043,87,1552359600,15,23,38,Rain
5044,88,1552359600,7,23,30,Rain
5045,89,1552359600,40,0,40,Rain
5046,90,1552359600,40,0,40,Rain
5047,91,1552359600,5,25,30,Rain
5048,92,1552359600,0,40,40,Rain
5049,93,1552359600,0,40,40,Rain
5050,94,1552359600,7,33,40,Rain
5051,95,1552359600,8,32,40,Rain
5052,96,1552359600,19,11,30,Rain
5053,97,1552359600,2,38,40,Rain
5054,98,1552359600,40,0,40,Rain
5055,99,1552359600,30,0,30,Rain
5056,100,1552359600,1,24,25,Rain
5057,101,1552359600,19,11,30,Rain
5058,102,1552359600,27,13,40,Rain
5059,103,1552359600,40,0,40,Rain
5060,104,1552359600,40,0,40,Rain
5061,105,1552359600,36,0,36,Rain
5062,106,1552359600,37,3,40,Rain
5063,107,1552359600,27,13,40,Rain
5064,108,1552359600,25,15,40,Rain
5065,109,1552359600,17,12,29,Rain
5066,110,1552359600,18,22,40,Rain
5067,111,1552359600,18,22,40,Rain
5068,112,1552359600,0,30,30,Rain
5069,113,1552359600,31,9,40,Rain
5070,114,1552359600,40,0,40,Rain
5071,115,1552359600,1,29,30,Rain
5072,2,1552363200,10,10,20,Rain
5073,3,1552363200,12,8,20,Rain
5074,4,1552363200,17,3,20,Rain
5075,5,1552363200,11,29,40,Rain
5076,6,1552363200,19,1,20,Rain
5077,7,1552363200,10,19,29,Rain
5078,8,1552363200,30,0,30,Rain
5079,9,1552363200,23,1,24,Rain
5080,10,1552363200,16,0,16,Rain
5081,11,1552363200,30,0,30,Rain
5082,12,1552363200,8,12,20,Rain
5083,13,1552363200,30,0,30,Rain
5084,14,1552363200,30,0,30,Rain
5085,15,1552363200,7,9,16,Rain
5086,16,1552363200,16,4,20,Rain
5087,17,1552363200,19,1,20,Rain
5088,18,1552363200,18,12,30,Rain
5089,19,1552363200,24,6,30,Rain
5090,21,1552363200,30,0,30,Rain
5091,22,1552363200,20,0,20,Rain
5092,23,1552363200,8,22,30,Rain
5093,24,1552363200,20,0,20,Rain
5094,25,1552363200,20,10,30,Rain
5095,26,1552363200,14,6,20,Rain
5096,27,1552363200,20,0,20,Rain
5097,28,1552363200,15,15,30,Rain
5098,29,1552363200,29,0,29,Rain
5099,30,1552363200,17,3,20,Rain
5100,31,1552363200,20,0,20,Rain
5101,32,1552363200,25,5,30,Rain
5102,33,1552363200,22,1,23,Rain
5103,34,1552363200,10,20,30,Rain
5104,35,1552363200,16,14,30,Rain
5105,36,1552363200,39,1,40,Rain
5106,37,1552363200,30,0,30,Rain
5107,38,1552363200,35,5,40,Rain
5108,39,1552363200,19,1,20,Rain
5109,40,1552363200,21,0,21,Rain
5110,41,1552363200,19,1,20,Rain
5111,42,1552363200,3,27,30,Rain
5112,43,1552363200,1,29,30,Rain
5113,44,1552363200,0,30,30,Rain
5114,45,1552363200,22,8,30,Rain
5115,46,1552363200,20,0,20,Rain
5116,47,1552363200,37,3,40,Rain
5117,48,1552363200,39,1,40,Rain
5118,49,1552363200,39,1,40,Rain
5119,50,1552363200,6,34,40,Rain
5120,51,1552363200,40,0,40,Rain
5121,52,1552363200,32,0,32,Rain
5122,53,1552363200,40,0,40,Rain
5123,54,1552363200,33,0,33,Rain
5124,55,1552363200,36,0,36,Rain
5125,56,1552363200,26,14,40,Rain
5126,57,1552363200,23,0,23,Rain
5127,58,1552363200,40,0,40,Rain
5128,59,1552363200,13,7,20,Rain
5129,60,1552363200,0,30,30,Rain
5130,61,1552363200,10,15,25,Rain
5131,62,1552363200,40,0,40,Rain
5132,63,1552363200,33,2,35,Rain
5133,64,1552363200,21,19,40,Rain
5134,65,1552363200,40,0,40,Rain
5135,66,1552363200,32,8,40,Rain
5136,67,1552363200,29,11,40,Rain
5137,68,1552363200,40,0,40,Rain
5138,69,1552363200,38,2,40,Rain
5139,70,1552363200,26,2,28,Rain
5140,71,1552363200,39,1,40,Rain
5141,72,1552363200,13,12,25,Rain
5142,73,1552363200,1,29,30,Rain
5143,74,1552363200,0,30,30,Rain
5144,75,1552363200,9,31,40,Rain
5145,76,1552363200,13,25,38,Rain
5146,77,1552363200,29,0,29,Rain
5147,78,1552363200,4,36,40,Rain
5148,79,1552363200,27,0,27,Rain
5149,80,1552363200,5,35,40,Rain
5150,81,1552363200,38,2,40,Rain
5151,82,1552363200,4,18,22,Rain
5152,83,1552363200,12,28,40,Rain
5153,84,1552363200,0,30,30,Rain
5154,85,1552363200,9,26,35,Rain
5155,86,1552363200,2,36,38,Rain
5156,87,1552363200,15,23,38,Rain
5157,88,1552363200,7,23,30,Rain
5158,89,1552363200,40,0,40,Rain
5159,90,1552363200,40,0,40,Rain
5160,91,1552363200,5,25,30,Rain
5161,92,1552363200,0,40,40,Rain
5162,93,1552363200,0,40,40,Rain
5163,94,1552363200,7,33,40,Rain
5164,95,1552363200,8,32,40,Rain
5165,96,1552363200,19,11,30,Rain
5166,97,1552363200,2,38,40,Rain
5167,98,1552363200,40,0,40,Rain
5168,99,1552363200,30,0,30,Rain
5169,100,1552363200,1,24,25,Rain
5170,101,1552363200,19,11,30,Rain
5171,102,1552363200,27,13,40,Rain
5172,103,1552363200,40,0,40,Rain
5173,104,1552363200,40,0,40,Rain
5174,105,1552363200,36,0,36,Rain
5175,106,1552363200,37,3,40,Rain
5176,107,1552363200,27,13,40,Rain
5177,108,1552363200,25,15,40,Rain
5178,109,1552363200,17,12,29,Rain
5179,110,1552363200,18,22,40,Rain
5180,111,1552363200,18,22,40,Rain
5181,112,1552363200,0,30,30,Rain
5182,113,1552363200,31,9,40,Rain
5183,114,1552363200,40,0,40,Rain
5184,115,1552363200,1,29,30,Rain
5185,2,1552366800,10,10,20,Rain
5186,3,1552366800,12,8,20,Rain
5187,4,1552366800,17,3,20,Rain
5188,5,1552366800,11,29,40,Rain
5189,6,1552366800,19,1,20,Rain
5190,7,1552366800,10,19,29,Rain
5191,8,1552366800,30,0,30,Rain
5192,9,1552366800,23,1,24,Rain
5193,10,1552366800,16,0,16,Rain
5194,11,1552366800,30,0,30,Rain
5195,12,1552366800,8,12,20,Rain
5196,13,1552366800,30,0,30,Rain
5197,14,1552366800,30,0,30,Rain
5198,15,1552366800,7,9,16,Rain
5199,16,1552366800,16,4,20,Rain
5200,17,1552366800,19,1,20,Rain
5201,18,1552366800,18,12,30,Rain
5202,19,1552366800,24,6,30,Rain
5203,21,1552366800,30,0,30,Rain
5204,22,1552366800,20,0,20,Rain
5205,23,1552366800,8,22,30,Rain
5206,24,1552366800,20,0,20,Rain
5207,25,1552366800,20,10,30,Rain
5208,26,1552366800,14,6,20,Rain
5209,27,1552366800,20,0,20,Rain
5210,28,1552366800,15,15,30,Rain
5211,29,1552366800,29,0,29,Rain
5212,30,1552366800,17,3,20,Rain
5213,31,1552366800,20,0,20,Rain
5214,32,1552366800,25,5,30,Rain
5215,33,1552366800,22,1,23,Rain
5216,34,1552366800,10,20,30,Rain
5217,35,1552366800,16,14,30,Rain
5218,36,1552366800,39,1,40,Rain
5219,37,1552366800,30,0,30,Rain
5220,38,1552366800,35,5,40,Rain
5221,39,1552366800,19,1,20,Rain
5222,40,1552366800,21,0,21,Rain
5223,41,1552366800,19,1,20,Rain
5224,42,1552366800,3,27,30,Rain
5225,43,1552366800,1,29,30,Rain
5226,44,1552366800,0,30,30,Rain
5227,45,1552366800,22,8,30,Rain
5228,46,1552366800,20,0,20,Rain
5229,47,1552366800,37,3,40,Rain
5230,48,1552366800,39,1,40,Rain
5231,49,1552366800,39,1,40,Rain
5232,50,1552366800,6,34,40,Rain
5233,51,1552366800,40,0,40,Rain
5234,52,1552366800,32,0,32,Rain
5235,53,1552366800,40,0,40,Rain
5236,54,1552366800,33,0,33,Rain
5237,55,1552366800,36,0,36,Rain
5238,56,1552366800,26,14,40,Rain
5239,57,1552366800,23,0,23,Rain
5240,58,1552366800,40,0,40,Rain
5241,59,1552366800,13,7,20,Rain
5242,60,1552366800,0,30,30,Rain
5243,61,1552366800,10,15,25,Rain
5244,62,1552366800,40,0,40,Rain
5245,63,1552366800,33,2,35,Rain
5246,64,1552366800,21,19,40,Rain
5247,65,1552366800,40,0,40,Rain
5248,66,1552366800,32,8,40,Rain
5249,67,1552366800,29,11,40,Rain
5250,68,1552366800,40,0,40,Rain
5251,69,1552366800,38,2,40,Rain
5252,70,1552366800,26,2,28,Rain
5253,71,1552366800,39,1,40,Rain
5254,72,1552366800,13,12,25,Rain
5255,73,1552366800,1,29,30,Rain
5256,74,1552366800,0,30,30,Rain
5257,75,1552366800,9,31,40,Rain
5258,76,1552366800,13,25,38,Rain
5259,77,1552366800,29,0,29,Rain
5260,78,1552366800,4,36,40,Rain
5261,79,1552366800,27,0,27,Rain
5262,80,1552366800,5,35,40,Rain
5263,81,1552366800,38,2,40,Rain
5264,82,1552366800,4,18,22,Rain
5265,83,1552366800,12,28,40,Rain
5266,84,1552366800,0,30,30,Rain
5267,85,1552366800,9,26,35,Rain
5268,86,1552366800,2,36,38,Rain
5269,87,1552366800,15,23,38,Rain
5270,88,1552366800,7,23,30,Rain
5271,89,1552366800,40,0,40,Rain
5272,90,1552366800,40,0,40,Rain
5273,91,1552366800,5,25,30,Rain
5274,92,1552366800,0,40,40,Rain
5275,93,1552366800,0,40,40,Rain
5276,94,1552366800,7,33,40,Rain
5277,95,1552366800,8,32,40,Rain
5278,96,1552366800,19,11,30,Rain
5279,97,1552366800,2,38,40,Rain
5280,98,1552366800,40,0,40,Rain
5281,99,1552366800,30,0,30,Rain
5282,100,1552366800,1,24,25,Rain
5283,101,1552366800,19,11,30,Rain
5284,102,1552366800,27,13,40,Rain
5285,103,1552366800,40,0,40,Rain
5286,104,1552366800,40,0,40,Rain
5287,105,1552366800,36,0,36,Rain
5288,106,1552366800,37,3,40,Rain
5289,107,1552366800,27,13,40,Rain
5290,108,1552366800,25,15,40,Rain
5291,109,1552366800,17,12,29,Rain
5292,110,1552366800,18,22,40,Rain
5293,111,1552366800,18,22,40,Rain
5294,112,1552366800,0,30,30,Rain
5295,113,1552366800,31,9,40,Rain
5296,114,1552366800,40,0,40,Rain
5297,115,1552366800,1,29,30,Rain
5298,2,1552370400,10,10,20,Rain
5299,3,1552370400,12,8,20,Rain
5300,4,1552370400,17,3,20,Rain
5301,5,1552370400,11,29,40,Rain
5302,6,1552370400,19,1,20,Rain
5303,7,1552370400,10,19,29,Rain
5304,8,1552370400,30,0,30,Rain
5305,9,1552370400,23,1,24,Rain
5306,10,1552370400,16,0,16,Rain
5307,11,1552370400,30,0,30,Rain
5308,12,1552370400,8,12,20,Rain
5309,13,1552370400,30,0,30,Rain
5310,14,1552370400,30,0,30,Rain
5311,15,1552370400,7,9,16,Rain
5312,16,1552370400,16,4,20,Rain
5313,17,1552370400,19,1,20,Rain
5314,18,1552370400,18,12,30,Rain
5315,19,1552370400,24,6,30,Rain
5316,21,1552370400,30,0,30,Rain
5317,22,1552370400,20,0,20,Rain
5318,23,1552370400,8,22,30,Rain
5319,24,1552370400,20,0,20,Rain
5320,25,1552370400,20,10,30,Rain
5321,26,1552370400,14,6,20,Rain
5322,27,1552370400,20,0,20,Rain
5323,28,1552370400,15,15,30,Rain
5324,29,1552370400,29,0,29,Rain
5325,30,1552370400,17,3,20,Rain
5326,31,1552370400,20,0,20,Rain
5327,32,1552370400,25,5,30,Rain
5328,33,1552370400,22,1,23,Rain
5329,34,1552370400,11,19,30,Rain
5330,35,1552370400,16,14,30,Rain
5331,36,1552370400,39,1,40,Rain
5332,37,1552370400,30,0,30,Rain
5333,38,1552370400,35,5,40,Rain
5334,39,1552370400,19,1,20,Rain
5335,40,1552370400,21,0,21,Rain
5336,41,1552370400,19,1,20,Rain
5337,42,1552370400,3,27,30,Rain
5338,43,1552370400,2,28,30,Rain
5339,44,1552370400,0,30,30,Rain
5340,45,1552370400,22,8,30,Rain
5341,46,1552370400,20,0,20,Rain
5342,47,1552370400,37,3,40,Rain
5343,48,1552370400,39,1,40,Rain
5344,49,1552370400,39,1,40,Rain
5345,50,1552370400,6,34,40,Rain
5346,51,1552370400,40,0,40,Rain
5347,52,1552370400,32,0,32,Rain
5348,53,1552370400,40,0,40,Rain
5349,54,1552370400,33,0,33,Rain
5350,55,1552370400,36,0,36,Rain
5351,56,1552370400,26,14,40,Rain
5352,57,1552370400,23,0,23,Rain
5353,58,1552370400,40,0,40,Rain
5354,59,1552370400,13,7,20,Rain
5355,60,1552370400,0,30,30,Rain
5356,61,1552370400,10,15,25,Rain
5357,62,1552370400,40,0,40,Rain
5358,63,1552370400,33,2,35,Rain
5359,64,1552370400,21,19,40,Rain
5360,65,1552370400,40,0,40,Rain
5361,66,1552370400,32,8,40,Rain
5362,67,1552370400,29,11,40,Rain
5363,68,1552370400,40,0,40,Rain
5364,69,1552370400,38,2,40,Rain
5365,70,1552370400,26,2,28,Rain
5366,71,1552370400,39,1,40,Rain
5367,72,1552370400,13,12,25,Rain
5368,73,1552370400,1,29,30,Rain
5369,74,1552370400,0,30,30,Rain
5370,75,1552370400,9,31,40,Rain
5371,76,1552370400,13,25,38,Rain
5372,77,1552370400,29,0,29,Rain
5373,78,1552370400,4,36,40,Rain
5374,79,1552370400,27,0,27,Rain
5375,80,1552370400,8,32,40,Rain
5376,81,1552370400,38,2,40,Rain
5377,82,1552370400,4,18,22,Rain
5378,83,1552370400,12,28,40,Rain
5379,84,1552370400,1,29,30,Rain
5380,85,1552370400,9,26,35,Rain
5381,86,1552370400,2,36,38,Rain
5382,87,1552370400,15,23,38,Rain
5383,88,1552370400,7,23,30,Rain
5384,89,1552370400,40,0,40,Rain
5385,90,1552370400,40,0,40,Rain
5386,91,1552370400,5,25,30,Rain
5387,92,1552370400,0,40,40,Rain
5388,93,1552370400,0,40,40,Rain
5389,94,1552370400,7,33,40,Rain
5390,95,1552370400,8,32,40,Rain
5391,96,1552370400,19,11,30,Rain
5392,97,1552370400,2,38,40,Rain
5393,98,1552370400,40,0,40,Rain
5394,99,1552370400,30,0,30,Rain
5395,100,1552370400,1,24,25,Rain
5396,101,1552370400,19,11,30,Rain
5397,102,1552370400,27,13,40,Rain
5398,103,1552370400,40,0,40,Rain
5399,104,1552370400,40,0,40,Rain
5400,105,1552370400,36,0,36,Rain
5401,106,1552370400,37,3,40,Rain
5402,107,1552370400,27,13,40,Rain
5403,108,1552370400,25,15,40,Rain
5404,109,1552370400,17,12,29,Rain
5405,110,1552370400,18,22,40,Rain
5406,111,1552370400,18,22,40,Rain
5407,112,1552370400,0,30,30,Rain
5408,113,1552370400,31,9,40,Rain
5409,114,1552370400,40,0,40,Rain
5410,115,1552370400,1,29,30,Rain
5411,2,1552374000,11,9,20,Rain
5412,3,1552374000,13,7,20,Rain
5413,4,1552374000,18,2,20,Rain
5414,5,1552374000,11,29,40,Rain
5415,6,1552374000,19,1,20,Rain
5416,7,1552374000,11,18,29,Rain
5417,8,1552374000,30,0,30,Rain
5418,9,1552374000,19,5,24,Rain
5419,10,1552374000,16,0,16,Rain
5420,11,1552374000,30,0,30,Rain
5421,12,1552374000,10,10,20,Rain
5422,13,1552374000,29,1,30,Rain
5423,14,1552374000,27,3,30,Rain
5424,15,1552374000,7,9,16,Rain
5425,16,1552374000,16,4,20,Rain
5426,17,1552374000,18,2,20,Rain
5427,18,1552374000,18,12,30,Rain
5428,19,1552374000,20,10,30,Rain
5429,21,1552374000,29,1,30,Rain
5430,22,1552374000,17,3,20,Rain
5431,23,1552374000,25,5,30,Rain
5432,24,1552374000,16,4,20,Rain
5433,25,1552374000,19,11,30,Rain
5434,26,1552374000,14,6,20,Rain
5435,27,1552374000,20,0,20,Rain
5436,28,1552374000,15,15,30,Rain
5437,29,1552374000,25,4,29,Rain
5438,30,1552374000,15,5,20,Rain
5439,31,1552374000,6,14,20,Rain
5440,32,1552374000,21,9,30,Rain
5441,33,1552374000,16,7,23,Rain
5442,34,1552374000,10,20,30,Rain
5443,35,1552374000,22,8,30,Rain
5444,36,1552374000,40,0,40,Rain
5445,37,1552374000,30,0,30,Rain
5446,38,1552374000,36,4,40,Rain
5447,39,1552374000,19,1,20,Rain
5448,40,1552374000,21,0,21,Rain
5449,41,1552374000,19,1,20,Rain
5450,42,1552374000,7,23,30,Rain
5451,43,1552374000,5,25,30,Rain
5452,44,1552374000,5,25,30,Rain
5453,45,1552374000,22,8,30,Rain
5454,46,1552374000,19,1,20,Rain
5455,47,1552374000,38,2,40,Rain
5456,48,1552374000,39,1,40,Rain
5457,49,1552374000,37,3,40,Rain
5458,50,1552374000,8,32,40,Rain
5459,51,1552374000,40,0,40,Rain
5460,52,1552374000,26,6,32,Rain
5461,53,1552374000,40,0,40,Rain
5462,54,1552374000,31,2,33,Rain
5463,55,1552374000,36,0,36,Rain
5464,56,1552374000,26,14,40,Rain
5465,57,1552374000,22,1,23,Rain
5466,58,1552374000,38,2,40,Rain
5467,59,1552374000,13,7,20,Rain
5468,60,1552374000,3,27,30,Rain
5469,61,1552374000,10,15,25,Rain
5470,62,1552374000,38,2,40,Rain
5471,63,1552374000,32,3,35,Rain
5472,64,1552374000,33,7,40,Rain
5473,65,1552374000,40,0,40,Rain
5474,66,1552374000,30,10,40,Rain
5475,67,1552374000,27,13,40,Rain
5476,68,1552374000,34,6,40,Rain
5477,69,1552374000,36,4,40,Rain
5478,70,1552374000,22,6,28,Rain
5479,71,1552374000,40,0,40,Rain
5480,72,1552374000,13,12,25,Rain
5481,73,1552374000,2,28,30,Rain
5482,74,1552374000,1,29,30,Rain
5483,75,1552374000,11,29,40,Rain
5484,76,1552374000,17,21,38,Rain
5485,77,1552374000,27,2,29,Rain
5486,78,1552374000,5,35,40,Rain
5487,79,1552374000,9,18,27,Rain
5488,80,1552374000,8,32,40,Rain
5489,81,1552374000,20,20,40,Rain
5490,82,1552374000,5,17,22,Rain
5491,83,1552374000,14,26,40,Rain
5492,84,1552374000,4,26,30,Rain
5493,85,1552374000,9,26,35,Rain
5494,86,1552374000,3,35,38,Rain
5495,87,1552374000,17,21,38,Rain
5496,88,1552374000,5,25,30,Rain
5497,89,1552374000,40,0,40,Rain
5498,90,1552374000,40,0,40,Rain
5499,91,1552374000,24,6,30,Rain
5500,92,1552374000,3,37,40,Rain
5501,93,1552374000,0,40,40,Rain
5502,94,1552374000,7,33,40,Rain
5503,95,1552374000,8,32,40,Rain
5504,96,1552374000,19,11,30,Rain
5505,97,1552374000,6,34,40,Rain
5506,98,1552374000,40,0,40,Rain
5507,99,1552374000,27,3,30,Rain
5508,100,1552374000,2,23,25,Rain
5509,101,1552374000,21,9,30,Rain
5510,102,1552374000,27,13,40,Rain
5511,103,1552374000,40,0,40,Rain
5512,104,1552374000,40,0,40,Rain
5513,105,1552374000,36,0,36,Rain
5514,106,1552374000,37,3,40,Rain
5515,107,1552374000,32,8,40,Rain
5516,108,1552374000,27,13,40,Rain
5517,109,1552374000,21,8,29,Rain
5518,110,1552374000,18,22,40,Rain
5519,111,1552374000,19,21,40,Rain
5520,112,1552374000,5,25,30,Rain
5521,113,1552374000,31,9,40,Rain
5522,114,1552374000,39,1,40,Rain
5523,115,1552374000,0,30,30,Rain
5524,2,1552377600,16,4,20,Rain
5525,3,1552377600,15,5,20,Rain
5526,4,1552377600,15,5,20,Rain
5527,5,1552377600,5,35,40,Rain
5528,6,1552377600,20,0,20,Rain
5529,7,1552377600,13,16,29,Rain
5530,8,1552377600,19,11,30,Rain
5531,9,1552377600,11,13,24,Rain
5532,10,1552377600,13,3,16,Rain
5533,11,1552377600,27,3,30,Rain
5534,12,1552377600,6,14,20,Rain
5535,13,1552377600,30,0,30,Rain
5536,14,1552377600,25,5,30,Rain
5537,15,1552377600,12,4,16,Rain
5538,16,1552377600,17,3,20,Rain
5539,17,1552377600,16,4,20,Rain
5540,18,1552377600,15,15,30,Rain
5541,19,1552377600,20,10,30,Rain
5542,21,1552377600,25,5,30,Rain
5543,22,1552377600,17,3,20,Rain
5544,23,1552377600,25,5,30,Rain
5545,24,1552377600,12,8,20,Rain
5546,25,1552377600,29,1,30,Rain
5547,26,1552377600,8,12,20,Rain
5548,27,1552377600,16,4,20,Rain
5549,28,1552377600,28,2,30,Rain
5550,29,1552377600,24,5,29,Rain
5551,30,1552377600,11,9,20,Rain
5552,31,1552377600,5,15,20,Rain
5553,32,1552377600,20,10,30,Rain
5554,33,1552377600,8,15,23,Rain
5555,34,1552377600,10,20,30,Rain
5556,35,1552377600,30,0,30,Rain
5557,36,1552377600,37,3,40,Rain
5558,37,1552377600,28,2,30,Rain
5559,38,1552377600,31,9,40,Rain
5560,39,1552377600,17,3,20,Rain
5561,40,1552377600,17,4,21,Rain
5562,41,1552377600,17,3,20,Rain
5563,42,1552377600,12,18,30,Rain
5564,43,1552377600,21,9,30,Rain
5565,44,1552377600,17,13,30,Rain
5566,45,1552377600,26,4,30,Rain
5567,46,1552377600,18,2,20,Rain
5568,47,1552377600,35,5,40,Rain
5569,48,1552377600,38,2,40,Rain
5570,49,1552377600,33,7,40,Rain
5571,50,1552377600,12,28,40,Rain
5572,51,1552377600,37,3,40,Rain
5573,52,1552377600,22,10,32,Rain
5574,53,1552377600,39,1,40,Rain
5575,54,1552377600,28,5,33,Rain
5576,55,1552377600,32,4,36,Rain
5577,56,1552377600,39,1,40,Rain
5578,57,1552377600,22,1,23,Rain
5579,58,1552377600,34,6,40,Rain
5580,59,1552377600,15,5,20,Rain
5581,60,1552377600,18,12,30,Rain
5582,61,1552377600,14,11,25,Rain
5583,62,1552377600,35,5,40,Rain
5584,63,1552377600,31,4,35,Rain
5585,64,1552377600,36,4,40,Rain
5586,65,1552377600,32,8,40,Rain
5587,66,1552377600,25,15,40,Rain
5588,67,1552377600,35,5,40,Rain
5589,68,1552377600,38,2,40,Rain
5590,69,1552377600,24,16,40,Rain
5591,70,1552377600,18,10,28,Rain
5592,71,1552377600,40,0,40,Rain
5593,72,1552377600,18,7,25,Rain
5594,73,1552377600,9,21,30,Rain
5595,74,1552377600,5,25,30,Rain
5596,75,1552377600,10,30,40,Rain
5597,76,1552377600,22,16,38,Rain
5598,77,1552377600,26,3,29,Rain
5599,78,1552377600,8,32,40,Rain
5600,79,1552377600,9,18,27,Rain
5601,80,1552377600,11,29,40,Rain
5602,81,1552377600,20,20,40,Rain
5603,82,1552377600,7,15,22,Rain
5604,83,1552377600,17,23,40,Rain
5605,84,1552377600,7,23,30,Rain
5606,85,1552377600,12,23,35,Rain
5607,86,1552377600,8,30,38,Rain
5608,87,1552377600,18,20,38,Rain
5609,88,1552377600,7,23,30,Rain
5610,89,1552377600,40,0,40,Rain
5611,90,1552377600,27,13,40,Rain
5612,91,1552377600,27,3,30,Rain
5613,92,1552377600,2,38,40,Rain
5614,93,1552377600,8,32,40,Rain
5615,94,1552377600,8,32,40,Rain
5616,95,1552377600,12,28,40,Rain
5617,96,1552377600,22,8,30,Rain
5618,97,1552377600,13,27,40,Rain
5619,98,1552377600,37,3,40,Rain
5620,99,1552377600,24,6,30,Rain
5621,100,1552377600,11,14,25,Rain
5622,101,1552377600,24,6,30,Rain
5623,102,1552377600,30,10,40,Rain
5624,103,1552377600,39,1,40,Rain
5625,104,1552377600,40,0,40,Rain
5626,105,1552377600,35,1,36,Rain
5627,106,1552377600,39,1,40,Rain
5628,107,1552377600,33,7,40,Rain
5629,108,1552377600,29,11,40,Rain
5630,109,1552377600,29,0,29,Rain
5631,110,1552377600,20,20,40,Rain
5632,111,1552377600,27,13,40,Rain
5633,112,1552377600,20,10,30,Rain
5634,113,1552377600,38,2,40,Rain
5635,114,1552377600,35,5,40,Rain
5636,115,1552377600,7,23,30,Rain
5637,2,1552381200,20,0,20,Rain
5638,3,1552381200,17,3,20,Rain
5639,4,1552381200,11,9,20,Rain
5640,5,1552381200,27,13,40,Rain
5641,6,1552381200,18,2,20,Rain
5642,7,1552381200,22,7,29,Rain
5643,8,1552381200,27,3,30,Rain
5644,9,1552381200,15,8,23,Rain
5645,10,1552381200,14,2,16,Rain
5646,11,1552381200,23,6,29,Rain
5647,12,1552381200,6,14,20,Rain
5648,13,1552381200,25,5,30,Rain
5649,14,1552381200,16,14,30,Rain
5650,15,1552381200,14,2,16,Rain
5651,16,1552381200,18,2,20,Rain
5652,17,1552381200,14,6,20,Rain
5653,18,1552381200,16,14,30,Rain
5654,19,1552381200,5,24,29,Rain
5655,21,1552381200,22,8,30,Rain
5656,22,1552381200,14,6,20,Rain
5657,23,1552381200,23,7,30,Rain
5658,24,1552381200,17,3,20,Rain
5659,25,1552381200,14,14,28,Rain
5660,26,1552381200,0,20,20,Rain
5661,27,1552381200,11,9,20,Rain
5662,28,1552381200,17,13,30,Rain
5663,29,1552381200,29,0,29,Rain
5664,30,1552381200,12,8,20,Rain
5665,31,1552381200,5,15,20,Rain
5666,32,1552381200,27,3,30,Rain
5667,33,1552381200,2,21,23,Rain
5668,34,1552381200,30,0,30,Rain
5669,35,1552381200,24,6,30,Rain
5670,36,1552381200,32,8,40,Rain
5671,37,1552381200,27,3,30,Rain
5672,38,1552381200,38,2,40,Rain
5673,39,1552381200,19,1,20,Rain
5674,40,1552381200,12,9,21,Rain
5675,41,1552381200,17,3,20,Rain
5676,42,1552381200,21,9,30,Rain
5677,43,1552381200,30,0,30,Rain
5678,44,1552381200,28,2,30,Rain
5679,45,1552381200,26,4,30,Rain
5680,46,1552381200,17,3,20,Rain
5681,47,1552381200,31,9,40,Rain
5682,48,1552381200,36,4,40,Rain
5683,49,1552381200,37,3,40,Rain
5684,50,1552381200,35,5,40,Rain
5685,51,1552381200,34,6,40,Rain
5686,52,1552381200,14,18,32,Rain
5687,53,1552381200,35,5,40,Rain
5688,54,1552381200,27,6,33,Rain
5689,55,1552381200,30,6,36,Rain
5690,56,1552381200,33,7,40,Rain
5691,57,1552381200,15,8,23,Rain
5692,58,1552381200,18,22,40,Rain
5693,59,1552381200,14,6,20,Rain
5694,60,1552381200,29,1,30,Rain
5695,61,1552381200,14,11,25,Rain
5696,62,1552381200,35,5,40,Rain
5697,63,1552381200,25,10,35,Rain
5698,64,1552381200,31,9,40,Rain
5699,65,1552381200,29,11,40,Rain
5700,66,1552381200,21,18,39,Rain
5701,67,1552381200,30,10,40,Rain
5702,68,1552381200,23,17,40,Rain
5703,69,1552381200,29,11,40,Rain
5704,70,1552381200,10,18,28,Rain
5705,71,1552381200,36,4,40,Rain
5706,72,1552381200,24,1,25,Rain
5707,73,1552381200,25,5,30,Rain
5708,74,1552381200,9,21,30,Rain
5709,75,1552381200,19,21,40,Rain
5710,76,1552381200,32,6,38,Rain
5711,77,1552381200,27,2,29,Rain
5712,78,1552381200,7,33,40,Rain
5713,79,1552381200,7,20,27,Rain
5714,80,1552381200,13,27,40,Rain
5715,81,1552381200,16,24,40,Rain
5716,82,1552381200,10,12,22,Rain
5717,83,1552381200,19,21,40,Rain
5718,84,1552381200,20,10,30,Rain
5719,85,1552381200,23,12,35,Rain
5720,86,1552381200,35,3,38,Rain
5721,87,1552381200,26,12,38,Rain
5722,88,1552381200,18,12,30,Rain
5723,89,1552381200,36,4,40,Rain
5724,90,1552381200,7,33,40,Rain
5725,91,1552381200,30,0,30,Rain
5726,92,1552381200,15,25,40,Rain
5727,93,1552381200,25,15,40,Rain
5728,94,1552381200,14,26,40,Rain
5729,95,1552381200,27,13,40,Rain
5730,96,1552381200,26,4,30,Rain
5731,97,1552381200,26,14,40,Rain
5732,98,1552381200,35,5,40,Rain
5733,99,1552381200,25,5,30,Rain
5734,100,1552381200,25,0,25,Rain
5735,101,1552381200,30,0,30,Rain
5736,102,1552381200,34,6,40,Rain
5737,103,1552381200,39,1,40,Rain
5738,104,1552381200,40,0,40,Rain
5739,105,1552381200,36,0,36,Rain
5740,106,1552381200,40,0,40,Rain
5741,107,1552381200,40,0,40,Rain
5742,108,1552381200,36,4,40,Rain
5743,109,1552381200,28,1,29,Rain
5744,110,1552381200,24,16,40,Rain
5745,111,1552381200,38,2,40,Rain
5746,112,1552381200,30,0,30,Rain
5747,113,1552381200,36,4,40,Rain
5748,114,1552381200,33,7,40,Rain
5749,115,1552381200,21,9,30,Rain
5750,2,1552384800,19,1,20,Rain
5751,3,1552384800,15,5,20,Rain
5752,4,1552384800,18,2,20,Rain
5753,5,1552384800,40,0,40,Rain
5754,6,1552384800,19,1,20,Rain
5755,7,1552384800,29,0,29,Rain
5756,8,1552384800,6,24,30,Rain
5757,9,1552384800,7,17,24,Rain
5758,10,1552384800,14,2,16,Rain
5759,11,1552384800,13,16,29,Rain
5760,12,1552384800,20,0,20,Rain
5761,13,1552384800,18,12,30,Rain
5762,14,1552384800,15,15,30,Rain
5763,15,1552384800,15,1,16,Rain
5764,16,1552384800,16,4,20,Rain
5765,17,1552384800,14,6,20,Rain
5766,18,1552384800,24,6,30,Rain
5767,19,1552384800,3,26,29,Rain
5768,21,1552384800,7,23,30,Rain
5769,22,1552384800,18,2,20,Rain
5770,23,1552384800,16,14,30,Rain
5771,24,1552384800,12,8,20,Rain
5772,25,1552384800,0,28,28,Rain
5773,26,1552384800,4,16,20,Rain
5774,27,1552384800,10,10,20,Rain
5775,28,1552384800,25,5,30,Rain
5776,29,1552384800,29,0,29,Rain
5777,30,1552384800,13,7,20,Rain
5778,31,1552384800,6,14,20,Rain
5779,32,1552384800,18,12,30,Rain
5780,33,1552384800,10,13,23,Rain
5781,34,1552384800,30,0,30,Rain
5782,35,1552384800,29,1,30,Rain
5783,36,1552384800,8,32,40,Rain
5784,37,1552384800,24,6,30,Rain
5785,38,1552384800,39,1,40,Rain
5786,39,1552384800,17,2,19,Rain
5787,40,1552384800,3,18,21,Rain
5788,41,1552384800,16,4,20,Rain
5789,42,1552384800,30,0,30,Rain
5790,43,1552384800,30,0,30,Rain
5791,44,1552384800,30,0,30,Rain
5792,45,1552384800,30,0,30,Rain
5793,46,1552384800,20,0,20,Rain
5794,47,1552384800,7,33,40,Rain
5795,48,1552384800,21,19,40,Rain
5796,49,1552384800,31,9,40,Rain
5797,50,1552384800,39,0,39,Rain
5798,51,1552384800,31,9,40,Rain
5799,52,1552384800,4,28,32,Rain
5800,53,1552384800,20,19,39,Rain
5801,54,1552384800,26,7,33,Rain
5802,55,1552384800,18,18,36,Rain
5803,56,1552384800,13,27,40,Rain
5804,57,1552384800,0,23,23,Rain
5805,58,1552384800,14,26,40,Rain
5806,59,1552384800,20,0,20,Rain
5807,60,1552384800,29,1,30,Rain
5808,61,1552384800,24,1,25,Rain
5809,62,1552384800,6,34,40,Rain
5810,63,1552384800,12,23,35,Rain
5811,64,1552384800,18,21,39,Rain
5812,65,1552384800,35,5,40,Rain
5813,66,1552384800,22,16,38,Rain
5814,67,1552384800,39,1,40,Rain
5815,68,1552384800,1,37,38,Rain
5816,69,1552384800,17,22,39,Rain
5817,70,1552384800,9,19,28,Rain
5818,71,1552384800,38,2,40,Rain
5819,72,1552384800,22,3,25,Rain
5820,73,1552384800,28,2,30,Rain
5821,74,1552384800,28,2,30,Rain
5822,75,1552384800,40,0,40,Rain
5823,76,1552384800,37,1,38,Rain
5824,77,1552384800,29,0,29,Rain
5825,78,1552384800,28,12,40,Rain
5826,79,1552384800,20,7,27,Rain
5827,80,1552384800,33,7,40,Rain
5828,81,1552384800,28,12,40,Rain
5829,82,1552384800,22,0,22,Rain
5830,83,1552384800,39,1,40,Rain
5831,84,1552384800,30,0,30,Rain
5832,85,1552384800,34,1,35,Rain
5833,86,1552384800,37,1,38,Rain
5834,87,1552384800,38,0,38,Rain
5835,88,1552384800,29,1,30,Rain
5836,89,1552384800,32,7,39,Rain
5837,90,1552384800,0,39,39,Rain
5838,91,1552384800,23,7,30,Rain
5839,92,1552384800,39,1,40,Rain
5840,93,1552384800,40,0,40,Rain
5841,94,1552384800,40,0,40,Rain
5842,95,1552384800,39,1,40,Rain
5843,96,1552384800,30,0,30,Rain
5844,97,1552384800,40,0,40,Rain
5845,98,1552384800,38,2,40,Rain
5846,99,1552384800,9,21,30,Rain
5847,100,1552384800,25,0,25,Rain
5848,101,1552384800,30,0,30,Rain
5849,102,1552384800,40,0,40,Rain
5850,103,1552384800,38,2,40,Rain
5851,104,1552384800,40,0,40,Rain
5852,105,1552384800,36,0,36,Rain
5853,106,1552384800,40,0,40,Rain
5854,107,1552384800,40,0,40,Rain
5855,108,1552384800,39,1,40,Rain
5856,109,1552384800,29,0,29,Rain
5857,110,1552384800,34,6,40,Rain
5858,111,1552384800,39,1,40,Rain
5859,112,1552384800,29,1,30,Rain
5860,113,1552384800,19,21,40,Rain
5861,114,1552384800,20,20,40,Rain
5862,115,1552384800,29,1,30,Rain
5863,2,1552388400,20,0,20,Rain
5864,3,1552388400,13,7,20,Rain
5865,4,1552388400,15,5,20,Rain
5866,5,1552388400,24,16,40,Rain
5867,6,1552388400,16,4,20,Rain
5868,7,1552388400,29,0,29,Rain
5869,8,1552388400,8,22,30,Rain
5870,9,1552388400,1,23,24,Rain
5871,10,1552388400,13,3,16,Rain
5872,11,1552388400,8,21,29,Rain
5873,12,1552388400,20,0,20,Rain
5874,13,1552388400,12,18,30,Rain
5875,14,1552388400,13,17,30,Rain
5876,15,1552388400,15,1,16,Rain
5877,16,1552388400,16,4,20,Rain
5878,17,1552388400,14,6,20,Rain
5879,18,1552388400,24,6,30,Rain
5880,19,1552388400,5,24,29,Rain
5881,21,1552388400,9,21,30,Rain
5882,22,1552388400,17,3,20,Rain
5883,23,1552388400,12,18,30,Rain
5884,24,1552388400,14,6,20,Rain
5885,25,1552388400,12,18,30,Rain
5886,26,1552388400,1,19,20,Rain
5887,27,1552388400,1,19,20,Rain
5888,28,1552388400,30,0,30,Rain
5889,29,1552388400,27,2,29,Rain
5890,30,1552388400,15,5,20,Rain
5891,31,1552388400,5,15,20,Rain
5892,32,1552388400,22,8,30,Rain
5893,33,1552388400,10,13,23,Rain
5894,34,1552388400,30,0,30,Rain
5895,35,1552388400,29,1,30,Rain
5896,36,1552388400,0,40,40,Rain
5897,37,1552388400,27,3,30,Rain
5898,38,1552388400,38,2,40,Rain
5899,39,1552388400,17,2,19,Rain
5900,40,1552388400,2,19,21,Rain
5901,41,1552388400,15,5,20,Rain
5902,42,1552388400,30,0,30,Rain
5903,43,1552388400,30,0,30,Rain
5904,44,1552388400,30,0,30,Rain
5905,45,1552388400,30,0,30,Rain
5906,46,1552388400,19,1,20,Rain
5907,47,1552388400,1,39,40,Rain
5908,48,1552388400,9,31,40,Rain
5909,49,1552388400,16,24,40,Rain
5910,50,1552388400,40,0,40,Rain
5911,51,1552388400,25,15,40,Rain
5912,52,1552388400,6,25,31,Rain
5913,53,1552388400,15,23,38,Rain
5914,54,1552388400,19,13,32,Rain
5915,55,1552388400,11,25,36,Rain
5916,56,1552388400,1,39,40,Rain
5917,57,1552388400,0,23,23,Rain
5918,58,1552388400,1,39,40,Rain
5919,59,1552388400,20,0,20,Rain
5920,60,1552388400,29,1,30,Rain
5921,61,1552388400,17,8,25,Rain
5922,62,1552388400,1,39,40,Rain
5923,63,1552388400,1,34,35,Rain
5924,64,1552388400,10,29,39,Rain
5925,65,1552388400,11,29,40,Rain
5926,66,1552388400,8,30,38,Rain
5927,67,1552388400,32,8,40,Rain
5928,68,1552388400,9,29,38,Rain
5929,69,1552388400,1,38,39,Rain
5930,70,1552388400,11,17,28,Rain
5931,71,1552388400,37,3,40,Rain
5932,72,1552388400,24,1,25,Rain
5933,73,1552388400,30,0,30,Rain
5934,74,1552388400,29,1,30,Rain
5935,75,1552388400,39,1,40,Rain
5936,76,1552388400,37,1,38,Rain
5937,77,1552388400,29,0,29,Rain
5938,78,1552388400,37,3,40,Rain
5939,79,1552388400,22,5,27,Rain
5940,80,1552388400,39,1,40,Rain
5941,81,1552388400,32,8,40,Rain
5942,82,1552388400,22,0,22,Rain
5943,83,1552388400,40,0,40,Rain
5944,84,1552388400,30,0,30,Rain
5945,85,1552388400,35,0,35,Rain
5946,86,1552388400,37,1,38,Rain
5947,87,1552388400,38,0,38,Rain
5948,88,1552388400,30,0,30,Rain
5949,89,1552388400,22,18,40,Rain
5950,90,1552388400,1,38,39,Rain
5951,91,1552388400,27,3,30,Rain
5952,92,1552388400,39,1,40,Rain
5953,93,1552388400,40,0,40,Rain
5954,94,1552388400,39,1,40,Rain
5955,95,1552388400,40,0,40,Rain
5956,96,1552388400,30,0,30,Rain
5957,97,1552388400,40,0,40,Rain
5958,98,1552388400,35,5,40,Rain
5959,99,1552388400,2,28,30,Rain
5960,100,1552388400,15,10,25,Rain
5961,101,1552388400,29,1,30,Rain
5962,102,1552388400,40,0,40,Rain
5963,103,1552388400,38,2,40,Rain
5964,104,1552388400,40,0,40,Rain
5965,105,1552388400,36,0,36,Rain
5966,106,1552388400,40,0,40,Rain
5967,107,1552388400,40,0,40,Rain
5968,108,1552388400,40,0,40,Rain
5969,109,1552388400,29,0,29,Rain
5970,110,1552388400,40,0,40,Rain
5971,111,1552388400,40,0,40,Rain
5972,112,1552388400,30,0,30,Rain
5973,113,1552388400,0,40,40,Rain
5974,114,1552388400,0,40,40,Rain
5975,115,1552388400,29,1,30,Rain
5976,2,1552392000,20,0,20,Rain
5977,3,1552392000,12,8,20,Rain
5978,4,1552392000,19,1,20,Rain
5979,5,1552392000,29,11,40,Rain
5980,6,1552392000,17,3,20,Rain
5981,7,1552392000,22,7,29,Rain
5982,8,1552392000,12,18,30,Rain
5983,9,1552392000,0,24,24,Rain
5984,10,1552392000,9,7,16,Rain
5985,11,1552392000,7,22,29,Rain
5986,12,1552392000,20,0,20,Rain
5987,13,1552392000,6,24,30,Rain
5988,14,1552392000,11,19,30,Rain
5989,15,1552392000,16,0,16,Rain
5990,16,1552392000,15,5,20,Rain
5991,17,1552392000,11,9,20,Rain
5992,18,1552392000,27,3,30,Rain
5993,19,1552392000,7,22,29,Rain
5994,21,1552392000,4,26,30,Rain
5995,22,1552392000,16,4,20,Rain
5996,23,1552392000,11,18,29,Rain
5997,24,1552392000,16,4,20,Rain
5998,25,1552392000,3,27,30,Rain
5999,26,1552392000,2,18,20,Rain
6000,27,1552392000,2,18,20,Rain
6001,28,1552392000,26,4,30,Rain
6002,29,1552392000,27,2,29,Rain
6003,30,1552392000,14,6,20,Rain
6004,31,1552392000,7,13,20,Rain
6005,32,1552392000,14,16,30,Rain
6006,33,1552392000,10,13,23,Rain
6007,34,1552392000,19,11,30,Rain
6008,35,1552392000,30,0,30,Rain
6009,36,1552392000,0,40,40,Rain
6010,37,1552392000,27,3,30,Rain
6011,38,1552392000,39,1,40,Rain
6012,39,1552392000,18,1,19,Rain
6013,40,1552392000,1,19,20,Rain
6014,41,1552392000,11,9,20,Rain
6015,42,1552392000,30,0,30,Rain
6016,43,1552392000,29,1,30,Rain
6017,44,1552392000,30,0,30,Rain
6018,45,1552392000,30,0,30,Rain
6019,46,1552392000,19,1,20,Rain
6020,47,1552392000,1,39,40,Rain
6021,48,1552392000,3,37,40,Rain
6022,49,1552392000,10,30,40,Rain
6023,50,1552392000,40,0,40,Rain
6024,51,1552392000,27,13,40,Rain
6025,52,1552392000,15,16,31,Rain
6026,53,1552392000,15,23,38,Rain
6027,54,1552392000,17,15,32,Rain
6028,55,1552392000,9,27,36,Rain
6029,56,1552392000,19,21,40,Rain
6030,57,1552392000,1,22,23,Rain
6031,58,1552392000,4,36,40,Rain
6032,59,1552392000,17,3,20,Rain
6033,60,1552392000,30,0,30,Rain
6034,61,1552392000,23,2,25,Rain
6035,62,1552392000,1,39,40,Rain
6036,63,1552392000,0,35,35,Rain
6037,64,1552392000,3,36,39,Rain
6038,65,1552392000,10,30,40,Rain
6039,66,1552392000,20,18,38,Rain
6040,67,1552392000,32,8,40,Rain
6041,68,1552392000,0,38,38,Rain
6042,69,1552392000,0,39,39,Rain
6043,70,1552392000,11,16,27,Rain
6044,71,1552392000,33,7,40,Rain
6045,72,1552392000,24,1,25,Rain
6046,73,1552392000,30,0,30,Rain
6047,74,1552392000,20,10,30,Rain
6048,75,1552392000,40,0,40,Rain
6049,76,1552392000,37,1,38,Rain
6050,77,1552392000,24,5,29,Rain
6051,78,1552392000,40,0,40,Rain
6052,79,1552392000,23,4,27,Rain
6053,80,1552392000,40,0,40,Rain
6054,81,1552392000,34,6,40,Rain
6055,82,1552392000,22,0,22,Rain
6056,83,1552392000,40,0,40,Rain
6057,84,1552392000,28,2,30,Rain
6058,85,1552392000,35,0,35,Rain
6059,86,1552392000,34,4,38,Rain
6060,87,1552392000,38,0,38,Rain
6061,88,1552392000,30,0,30,Rain
6062,89,1552392000,21,19,40,Rain
6063,90,1552392000,0,39,39,Rain
6064,91,1552392000,28,2,30,Rain
6065,92,1552392000,38,2,40,Rain
6066,93,1552392000,40,0,40,Rain
6067,94,1552392000,39,1,40,Rain
6068,95,1552392000,40,0,40,Rain
6069,96,1552392000,30,0,30,Rain
6070,97,1552392000,39,1,40,Rain
6071,98,1552392000,34,6,40,Rain
6072,99,1552392000,0,30,30,Rain
6073,100,1552392000,21,4,25,Rain
6074,101,1552392000,29,1,30,Rain
6075,102,1552392000,40,0,40,Rain
6076,103,1552392000,39,1,40,Rain
6077,104,1552392000,40,0,40,Rain
6078,105,1552392000,36,0,36,Rain
6079,106,1552392000,40,0,40,Rain
6080,107,1552392000,40,0,40,Rain
6081,108,1552392000,40,0,40,Rain
6082,109,1552392000,29,0,29,Rain
6083,110,1552392000,39,1,40,Rain
6084,111,1552392000,40,0,40,Rain
6085,112,1552392000,30,0,30,Rain
6086,113,1552392000,2,38,40,Rain
6087,114,1552392000,17,23,40,Rain
6088,115,1552392000,30,0,30,Rain
6089,2,1552395600,20,0,20,Rain
6090,3,1552395600,11,9,20,Rain
6091,4,1552395600,18,2,20,Rain
6092,5,1552395600,30,10,40,Rain
6093,6,1552395600,20,0,20,Rain
6094,7,1552395600,27,2,29,Rain
6095,8,1552395600,5,25,30,Rain
6096,9,1552395600,0,24,24,Rain
6097,10,1552395600,11,5,16,Rain
6098,11,1552395600,7,22,29,Rain
6099,12,1552395600,20,0,20,Rain
6100,13,1552395600,8,22,30,Rain
6101,14,1552395600,2,28,30,Rain
6102,15,1552395600,16,0,16,Rain
6103,16,1552395600,16,4,20,Rain
6104,17,1552395600,9,11,20,Rain
6105,18,1552395600,28,2,30,Rain
6106,19,1552395600,6,23,29,Rain
6107,21,1552395600,2,28,30,Rain
6108,22,1552395600,16,4,20,Rain
6109,23,1552395600,11,18,29,Rain
6110,24,1552395600,15,5,20,Rain
6111,25,1552395600,4,26,30,Rain
6112,26,1552395600,1,19,20,Rain
6113,27,1552395600,2,18,20,Rain
6114,28,1552395600,17,13,30,Rain
6115,29,1552395600,28,1,29,Rain
6116,30,1552395600,17,3,20,Rain
6117,31,1552395600,11,9,20,Rain
6118,32,1552395600,8,22,30,Rain
6119,33,1552395600,5,18,23,Rain
6120,34,1552395600,28,2,30,Rain
6121,35,1552395600,26,4,30,Rain
6122,36,1552395600,4,36,40,Rain
6123,37,1552395600,28,2,30,Rain
6124,38,1552395600,39,1,40,Rain
6125,39,1552395600,17,2,19,Rain
6126,40,1552395600,8,12,20,Rain
6127,41,1552395600,14,6,20,Rain
6128,42,1552395600,26,4,30,Rain
6129,43,1552395600,30,0,30,Rain
6130,44,1552395600,30,0,30,Rain
6131,45,1552395600,30,0,30,Rain
6132,46,1552395600,20,0,20,Rain
6133,47,1552395600,0,40,40,Rain
6134,48,1552395600,12,28,40,Rain
6135,49,1552395600,15,25,40,Rain
6136,50,1552395600,37,3,40,Rain
6137,51,1552395600,26,14,40,Rain
6138,52,1552395600,13,18,31,Rain
6139,53,1552395600,16,22,38,Rain
6140,54,1552395600,19,13,32,Rain
6141,55,1552395600,10,26,36,Rain
6142,56,1552395600,22,18,40,Rain
6143,57,1552395600,1,22,23,Rain
6144,58,1552395600,1,39,40,Rain
6145,59,1552395600,19,1,20,Rain
6146,60,1552395600,25,5,30,Rain
6147,61,1552395600,21,4,25,Rain
6148,62,1552395600,3,37,40,Rain
6149,63,1552395600,1,34,35,Rain
6150,64,1552395600,5,34,39,Rain
6151,65,1552395600,13,27,40,Rain
6152,66,1552395600,24,14,38,Rain
6153,67,1552395600,34,6,40,Rain
6154,68,1552395600,0,38,38,Rain
6155,69,1552395600,3,36,39,Rain
6156,70,1552395600,11,16,27,Rain
6157,71,1552395600,34,6,40,Rain
6158,72,1552395600,25,0,25,Rain
6159,73,1552395600,30,0,30,Rain
6160,74,1552395600,22,8,30,Rain
6161,75,1552395600,38,2,40,Rain
6162,76,1552395600,37,1,38,Rain
6163,77,1552395600,26,3,29,Rain
6164,78,1552395600,39,1,40,Rain
6165,79,1552395600,26,1,27,Rain
6166,80,1552395600,40,0,40,Rain
6167,81,1552395600,38,2,40,Rain
6168,82,1552395600,22,0,22,Rain
6169,83,1552395600,40,0,40,Rain
6170,84,1552395600,28,2,30,Rain
6171,85,1552395600,35,0,35,Rain
6172,86,1552395600,36,2,38,Rain
6173,87,1552395600,38,0,38,Rain
6174,88,1552395600,30,0,30,Rain
6175,89,1552395600,20,20,40,Rain
6176,90,1552395600,3,36,39,Rain
6177,91,1552395600,28,2,30,Rain
6178,92,1552395600,38,2,40,Rain
6179,93,1552395600,40,0,40,Rain
6180,94,1552395600,38,2,40,Rain
6181,95,1552395600,40,0,40,Rain
6182,96,1552395600,30,0,30,Rain
6183,97,1552395600,40,0,40,Rain
6184,98,1552395600,31,9,40,Rain
6185,99,1552395600,1,29,30,Rain
6186,100,1552395600,23,2,25,Rain
6187,101,1552395600,29,1,30,Rain
6188,102,1552395600,40,0,40,Rain
6189,103,1552395600,40,0,40,Rain
6190,104,1552395600,40,0,40,Rain
6191,105,1552395600,36,0,36,Rain
6192,106,1552395600,40,0,40,Rain
6193,107,1552395600,40,0,40,Rain
6194,108,1552395600,40,0,40,Rain
6195,109,1552395600,29,0,29,Rain
6196,110,1552395600,39,1,40,Rain
6197,111,1552395600,39,1,40,Rain
6198,112,1552395600,19,11,30,Rain
6199,113,1552395600,3,37,40,Rain
6200,114,1552395600,15,25,40,Rain
6201,115,1552395600,27,3,30,Rain
6202,2,1552399200,20,0,20,Rain
6203,3,1552399200,20,0,20,Rain
6204,4,1552399200,20,0,20,Rain
6205,5,1552399200,33,7,40,Rain
6206,6,1552399200,20,0,20,Rain
6207,7,1552399200,29,0,29,Rain
6208,8,1552399200,6,24,30,Rain
6209,9,1552399200,2,22,24,Rain
6210,10,1552399200,8,8,16,Rain
6211,11,1552399200,12,17,29,Rain
6212,12,1552399200,19,1,20,Rain
6213,13,1552399200,9,21,30,Rain
6214,14,1552399200,16,14,30,Rain
6215,15,1552399200,15,1,16,Rain
6216,16,1552399200,19,1,20,Rain
6217,17,1552399200,14,6,20,Rain
6218,18,1552399200,28,2,30,Rain
6219,19,1552399200,10,19,29,Rain
6220,21,1552399200,1,29,30,Rain
6221,22,1552399200,13,7,20,Rain
6222,23,1552399200,14,15,29,Rain
6223,24,1552399200,16,4,20,Rain
6224,25,1552399200,4,26,30,Rain
6225,26,1552399200,3,17,20,Rain
6226,27,1552399200,0,20,20,Rain
6227,28,1552399200,26,4,30,Rain
6228,29,1552399200,27,2,29,Rain
6229,30,1552399200,19,1,20,Rain
6230,31,1552399200,11,9,20,Rain
6231,32,1552399200,14,16,30,Rain
6232,33,1552399200,0,23,23,Rain
6233,34,1552399200,26,4,30,Rain
6234,35,1552399200,29,1,30,Rain
6235,36,1552399200,8,32,40,Rain
6236,37,1552399200,28,2,30,Rain
6237,38,1552399200,36,4,40,Rain
6238,39,1552399200,18,1,19,Rain
6239,40,1552399200,10,10,20,Rain
6240,41,1552399200,14,6,20,Rain
6241,42,1552399200,30,0,30,Rain
6242,43,1552399200,30,0,30,Rain
6243,44,1552399200,30,0,30,Rain
6244,45,1552399200,25,5,30,Rain
6245,46,1552399200,14,6,20,Rain
6246,47,1552399200,1,39,40,Rain
6247,48,1552399200,0,40,40,Rain
6248,49,1552399200,19,21,40,Rain
6249,50,1552399200,40,0,40,Rain
6250,51,1552399200,22,18,40,Rain
6251,52,1552399200,9,22,31,Rain
6252,53,1552399200,11,27,38,Rain
6253,54,1552399200,15,17,32,Rain
6254,55,1552399200,18,18,36,Rain
6255,56,1552399200,25,15,40,Rain
6256,57,1552399200,6,17,23,Rain
6257,58,1552399200,10,30,40,Rain
6258,59,1552399200,20,0,20,Rain
6259,60,1552399200,30,0,30,Rain
6260,61,1552399200,25,0,25,Rain
6261,62,1552399200,4,36,40,Rain
6262,63,1552399200,11,24,35,Rain
6263,64,1552399200,5,34,39,Rain
6264,65,1552399200,19,21,40,Rain
6265,66,1552399200,29,11,40,Rain
6266,67,1552399200,21,19,40,Rain
6267,68,1552399200,2,38,40,Rain
6268,69,1552399200,2,38,40,Rain
6269,70,1552399200,12,15,27,Rain
6270,71,1552399200,34,6,40,Rain
6271,72,1552399200,23,2,25,Rain
6272,73,1552399200,28,2,30,Rain
6273,74,1552399200,23,7,30,Rain
6274,75,1552399200,39,1,40,Rain
6275,76,1552399200,34,4,38,Rain
6276,77,1552399200,28,1,29,Rain
6277,78,1552399200,40,0,40,Rain
6278,79,1552399200,26,1,27,Rain
6279,80,1552399200,32,8,40,Rain
6280,81,1552399200,40,0,40,Rain
6281,82,1552399200,21,1,22,Rain
6282,83,1552399200,39,1,40,Rain
6283,84,1552399200,30,0,30,Rain
6284,85,1552399200,35,0,35,Rain
6285,86,1552399200,38,0,38,Rain
6286,87,1552399200,38,0,38,Rain
6287,88,1552399200,30,0,30,Rain
6288,89,1552399200,19,21,40,Rain
6289,90,1552399200,4,36,40,Rain
6290,91,1552399200,24,6,30,Rain
6291,92,1552399200,40,0,40,Rain
6292,93,1552399200,40,0,40,Rain
6293,94,1552399200,38,2,40,Rain
6294,95,1552399200,40,0,40,Rain
6295,96,1552399200,29,1,30,Rain
6296,97,1552399200,40,0,40,Rain
6297,98,1552399200,29,11,40,Rain
6298,99,1552399200,2,28,30,Rain
6299,100,1552399200,23,2,25,Rain
6300,101,1552399200,29,1,30,Rain
6301,102,1552399200,40,0,40,Rain
6302,103,1552399200,40,0,40,Rain
6303,104,1552399200,40,0,40,Rain
6304,105,1552399200,36,0,36,Rain
6305,106,1552399200,40,0,40,Rain
6306,107,1552399200,40,0,40,Rain
6307,108,1552399200,40,0,40,Rain
6308,109,1552399200,29,0,29,Rain
6309,110,1552399200,40,0,40,Rain
6310,111,1552399200,36,4,40,Rain
6311,112,1552399200,16,14,30,Rain
6312,113,1552399200,2,38,40,Rain
6313,114,1552399200,28,12,40,Rain
6314,115,1552399200,20,10,30,Rain
6315,2,1552402800,20,0,20,Rain
6316,3,1552402800,12,8,20,Rain
6317,4,1552402800,19,1,20,Rain
6318,5,1552402800,29,11,40,Rain
6319,6,1552402800,17,3,20,Rain
6320,7,1552402800,27,2,29,Rain
6321,8,1552402800,8,22,30,Rain
6322,9,1552402800,6,18,24,Rain
6323,10,1552402800,6,10,16,Rain
6324,11,1552402800,19,11,30,Rain
6325,12,1552402800,20,0,20,Rain
6326,13,1552402800,13,17,30,Rain
6327,14,1552402800,10,20,30,Rain
6328,15,1552402800,12,4,16,Rain
6329,16,1552402800,16,4,20,Rain
6330,17,1552402800,18,2,20,Rain
6331,18,1552402800,29,1,30,Rain
6332,19,1552402800,6,24,30,Rain
6333,21,1552402800,5,25,30,Rain
6334,22,1552402800,17,3,20,Rain
6335,23,1552402800,17,12,29,Rain
6336,24,1552402800,7,13,20,Rain
6337,25,1552402800,7,23,30,Rain
6338,26,1552402800,3,17,20,Rain
6339,27,1552402800,6,14,20,Rain
6340,28,1552402800,30,0,30,Rain
6341,29,1552402800,28,1,29,Rain
6342,30,1552402800,15,5,20,Rain
6343,31,1552402800,8,12,20,Rain
6344,32,1552402800,11,19,30,Rain
6345,33,1552402800,3,20,23,Rain
6346,34,1552402800,21,9,30,Rain
6347,35,1552402800,24,6,30,Rain
6348,36,1552402800,7,33,40,Rain
6349,37,1552402800,28,2,30,Rain
6350,38,1552402800,33,7,40,Rain
6351,39,1552402800,20,0,20,Rain
6352,40,1552402800,0,20,20,Rain
6353,41,1552402800,14,6,20,Rain
6354,42,1552402800,30,0,30,Rain
6355,43,1552402800,23,7,30,Rain
6356,44,1552402800,30,0,30,Rain
6357,45,1552402800,22,8,30,Rain
6358,46,1552402800,19,1,20,Rain
6359,47,1552402800,8,32,40,Rain
6360,48,1552402800,1,39,40,Rain
6361,49,1552402800,13,27,40,Rain
6362,50,1552402800,39,1,40,Rain
6363,51,1552402800,21,19,40,Rain
6364,52,1552402800,13,19,32,Rain
6365,53,1552402800,22,18,40,Rain
6366,54,1552402800,13,20,33,Rain
6367,55,1552402800,17,19,36,Rain
6368,56,1552402800,28,12,40,Rain
6369,57,1552402800,0,23,23,Rain
6370,58,1552402800,5,35,40,Rain
6371,59,1552402800,19,1,20,Rain
6372,60,1552402800,30,0,30,Rain
6373,61,1552402800,24,1,25,Rain
6374,62,1552402800,5,35,40,Rain
6375,63,1552402800,4,31,35,Rain
6376,64,1552402800,0,39,39,Rain
6377,65,1552402800,24,16,40,Rain
6378,66,1552402800,24,16,40,Rain
6379,67,1552402800,21,19,40,Rain
6380,68,1552402800,3,37,40,Rain
6381,69,1552402800,1,39,40,Rain
6382,70,1552402800,12,16,28,Rain
6383,71,1552402800,35,5,40,Rain
6384,72,1552402800,25,0,25,Rain
6385,73,1552402800,28,2,30,Rain
6386,74,1552402800,23,7,30,Rain
6387,75,1552402800,37,3,40,Rain
6388,76,1552402800,33,5,38,Rain
6389,77,1552402800,28,1,29,Rain
6390,78,1552402800,37,3,40,Rain
6391,79,1552402800,27,0,27,Rain
6392,80,1552402800,32,8,40,Rain
6393,81,1552402800,39,1,40,Rain
6394,82,1552402800,21,1,22,Rain
6395,83,1552402800,40,0,40,Rain
6396,84,1552402800,30,0,30,Rain
6397,85,1552402800,35,0,35,Rain
6398,86,1552402800,36,2,38,Rain
6399,87,1552402800,38,0,38,Rain
6400,88,1552402800,28,2,30,Rain
6401,89,1552402800,20,20,40,Rain
6402,90,1552402800,6,34,40,Rain
6403,91,1552402800,14,16,30,Rain
6404,92,1552402800,38,2,40,Rain
6405,93,1552402800,40,0,40,Rain
6406,94,1552402800,38,2,40,Rain
6407,95,1552402800,39,1,40,Rain
6408,96,1552402800,30,0,30,Rain
6409,97,1552402800,40,0,40,Rain
6410,98,1552402800,25,15,40,Rain
6411,99,1552402800,1,29,30,Rain
6412,100,1552402800,23,2,25,Rain
6413,101,1552402800,30,0,30,Rain
6414,102,1552402800,37,3,40,Rain
6415,103,1552402800,30,10,40,Rain
6416,104,1552402800,40,0,40,Rain
6417,105,1552402800,36,0,36,Rain
6418,106,1552402800,40,0,40,Rain
6419,107,1552402800,38,2,40,Rain
6420,108,1552402800,40,0,40,Rain
6421,109,1552402800,25,4,29,Rain
6422,110,1552402800,40,0,40,Rain
6423,111,1552402800,39,1,40,Rain
6424,112,1552402800,23,7,30,Rain
6425,113,1552402800,4,36,40,Rain
6426,114,1552402800,27,13,40,Rain
6427,115,1552402800,23,7,30,Rain
6428,2,1552406400,19,1,20,Rain
6429,3,1552406400,17,3,20,Rain
6430,4,1552406400,20,0,20,Rain
6431,5,1552406400,27,13,40,Rain
6432,6,1552406400,15,5,20,Rain
6433,7,1552406400,26,3,29,Rain
6434,8,1552406400,9,21,30,Rain
6435,9,1552406400,10,14,24,Rain
6436,10,1552406400,6,10,16,Rain
6437,11,1552406400,15,15,30,Rain
6438,12,1552406400,20,0,20,Rain
6439,13,1552406400,14,16,30,Rain
6440,14,1552406400,4,26,30,Rain
6441,15,1552406400,13,3,16,Rain
6442,16,1552406400,13,7,20,Rain
6443,17,1552406400,18,2,20,Rain
6444,18,1552406400,29,1,30,Rain
6445,19,1552406400,7,23,30,Rain
6446,21,1552406400,5,25,30,Rain
6447,22,1552406400,14,6,20,Rain
6448,23,1552406400,19,11,30,Rain
6449,24,1552406400,5,15,20,Rain
6450,25,1552406400,0,30,30,Rain
6451,26,1552406400,3,17,20,Rain
6452,27,1552406400,6,14,20,Rain
6453,28,1552406400,30,0,30,Rain
6454,29,1552406400,27,2,29,Rain
6455,30,1552406400,16,4,20,Rain
6456,31,1552406400,15,5,20,Rain
6457,32,1552406400,25,5,30,Rain
6458,33,1552406400,1,22,23,Rain
6459,34,1552406400,24,6,30,Rain
6460,35,1552406400,19,11,30,Rain
6461,36,1552406400,18,22,40,Rain
6462,37,1552406400,28,2,30,Rain
6463,38,1552406400,39,1,40,Rain
6464,39,1552406400,12,8,20,Rain
6465,40,1552406400,5,16,21,Rain
6466,41,1552406400,17,3,20,Rain
6467,42,1552406400,28,2,30,Rain
6468,43,1552406400,20,10,30,Rain
6469,44,1552406400,28,2,30,Rain
6470,45,1552406400,22,8,30,Rain
6471,46,1552406400,20,0,20,Rain
6472,47,1552406400,9,31,40,Rain
6473,48,1552406400,0,40,40,Rain
6474,49,1552406400,14,26,40,Rain
6475,50,1552406400,40,0,40,Rain
6476,51,1552406400,24,16,40,Rain
6477,52,1552406400,11,21,32,Rain
6478,53,1552406400,20,20,40,Rain
6479,54,1552406400,13,20,33,Rain
6480,55,1552406400,20,16,36,Rain
6481,56,1552406400,5,35,40,Rain
6482,57,1552406400,2,21,23,Rain
6483,58,1552406400,5,35,40,Rain
6484,59,1552406400,20,0,20,Rain
6485,60,1552406400,25,5,30,Rain
6486,61,1552406400,19,6,25,Rain
6487,62,1552406400,4,36,40,Rain
6488,63,1552406400,0,35,35,Rain
6489,64,1552406400,6,34,40,Rain
6490,65,1552406400,23,17,40,Rain
6491,66,1552406400,23,17,40,Rain
6492,67,1552406400,24,16,40,Rain
6493,68,1552406400,1,39,40,Rain
6494,69,1552406400,0,40,40,Rain
6495,70,1552406400,6,22,28,Rain
6496,71,1552406400,36,4,40,Rain
6497,72,1552406400,25,0,25,Rain
6498,73,1552406400,28,2,30,Rain
6499,74,1552406400,22,8,30,Rain
6500,75,1552406400,33,7,40,Rain
6501,76,1552406400,35,3,38,Rain
6502,77,1552406400,26,3,29,Rain
6503,78,1552406400,38,2,40,Rain
6504,79,1552406400,26,1,27,Rain
6505,80,1552406400,32,8,40,Rain
6506,81,1552406400,40,0,40,Rain
6507,82,1552406400,21,1,22,Rain
6508,83,1552406400,40,0,40,Rain
6509,84,1552406400,30,0,30,Rain
6510,85,1552406400,35,0,35,Rain
6511,86,1552406400,35,3,38,Rain
6512,87,1552406400,38,0,38,Rain
6513,88,1552406400,29,1,30,Rain
6514,89,1552406400,20,20,40,Rain
6515,90,1552406400,5,35,40,Rain
6516,91,1552406400,10,20,30,Rain
6517,92,1552406400,37,3,40,Rain
6518,93,1552406400,40,0,40,Rain
6519,94,1552406400,38,2,40,Rain
6520,95,1552406400,39,1,40,Rain
6521,96,1552406400,30,0,30,Rain
6522,97,1552406400,40,0,40,Rain
6523,98,1552406400,28,12,40,Rain
6524,99,1552406400,2,28,30,Rain
6525,100,1552406400,22,3,25,Rain
6526,101,1552406400,30,0,30,Rain
6527,102,1552406400,40,0,40,Rain
6528,103,1552406400,32,8,40,Rain
6529,104,1552406400,40,0,40,Rain
6530,105,1552406400,36,0,36,Rain
6531,106,1552406400,39,1,40,Rain
6532,107,1552406400,38,2,40,Rain
6533,108,1552406400,39,1,40,Rain
6534,109,1552406400,25,4,29,Rain
6535,110,1552406400,39,1,40,Rain
6536,111,1552406400,37,3,40,Rain
6537,112,1552406400,11,19,30,Rain
6538,113,1552406400,4,36,40,Rain
6539,114,1552406400,29,11,40,Rain
6540,115,1552406400,23,7,30,Rain
6541,2,1552410000,20,0,20,Rain
6542,3,1552410000,20,0,20,Rain
6543,4,1552410000,18,2,20,Rain
6544,5,1552410000,33,7,40,Rain
6545,6,1552410000,15,5,20,Rain
6546,7,1552410000,27,2,29,Rain
6547,8,1552410000,17,13,30,Rain
6548,9,1552410000,16,8,24,Rain
6549,10,1552410000,5,11,16,Rain
6550,11,1552410000,18,12,30,Rain
6551,12,1552410000,20,0,20,Rain
6552,13,1552410000,5,25,30,Rain
6553,14,1552410000,6,24,30,Rain
6554,15,1552410000,11,5,16,Rain
6555,16,1552410000,10,10,20,Rain
6556,17,1552410000,17,3,20,Rain
6557,18,1552410000,29,1,30,Rain
6558,19,1552410000,15,15,30,Rain
6559,21,1552410000,1,29,30,Rain
6560,22,1552410000,14,6,20,Rain
6561,23,1552410000,13,17,30,Rain
6562,24,1552410000,12,8,20,Rain
6563,25,1552410000,1,29,30,Rain
6564,26,1552410000,1,19,20,Rain
6565,27,1552410000,7,13,20,Rain
6566,28,1552410000,30,0,30,Rain
6567,29,1552410000,25,4,29,Rain
6568,30,1552410000,19,1,20,Rain
6569,31,1552410000,20,0,20,Rain
6570,32,1552410000,24,6,30,Rain
6571,33,1552410000,2,21,23,Rain
6572,34,1552410000,28,2,30,Rain
6573,35,1552410000,18,12,30,Rain
6574,36,1552410000,18,22,40,Rain
6575,37,1552410000,28,2,30,Rain
6576,38,1552410000,31,9,40,Rain
6577,39,1552410000,4,16,20,Rain
6578,40,1552410000,2,19,21,Rain
6579,41,1552410000,17,3,20,Rain
6580,42,1552410000,28,2,30,Rain
6581,43,1552410000,29,1,30,Rain
6582,44,1552410000,25,5,30,Rain
6583,45,1552410000,18,12,30,Rain
6584,46,1552410000,16,4,20,Rain
6585,47,1552410000,11,29,40,Rain
6586,48,1552410000,0,40,40,Rain
6587,49,1552410000,10,30,40,Rain
6588,50,1552410000,40,0,40,Rain
6589,51,1552410000,24,16,40,Rain
6590,52,1552410000,13,19,32,Rain
6591,53,1552410000,23,17,40,Rain
6592,54,1552410000,16,17,33,Rain
6593,55,1552410000,24,12,36,Rain
6594,56,1552410000,8,32,40,Rain
6595,57,1552410000,3,20,23,Rain
6596,58,1552410000,7,33,40,Rain
6597,59,1552410000,20,0,20,Rain
6598,60,1552410000,26,4,30,Rain
6599,61,1552410000,23,2,25,Rain
6600,62,1552410000,7,33,40,Rain
6601,63,1552410000,2,33,35,Rain
6602,64,1552410000,3,37,40,Rain
6603,65,1552410000,21,19,40,Rain
6604,66,1552410000,26,14,40,Rain
6605,67,1552410000,19,21,40,Rain
6606,68,1552410000,7,33,40,Rain
6607,69,1552410000,4,36,40,Rain
6608,70,1552410000,17,11,28,Rain
6609,71,1552410000,37,3,40,Rain
6610,72,1552410000,23,2,25,Rain
6611,73,1552410000,30,0,30,Rain
6612,74,1552410000,24,6,30,Rain
6613,75,1552410000,34,6,40,Rain
6614,76,1552410000,34,4,38,Rain
6615,77,1552410000,27,2,29,Rain
6616,78,1552410000,39,1,40,Rain
6617,79,1552410000,27,0,27,Rain
6618,80,1552410000,37,3,40,Rain
6619,81,1552410000,40,0,40,Rain
6620,82,1552410000,22,0,22,Rain
6621,83,1552410000,39,1,40,Rain
6622,84,1552410000,30,0,30,Rain
6623,85,1552410000,34,1,35,Rain
6624,86,1552410000,38,0,38,Rain
6625,87,1552410000,37,1,38,Rain
6626,88,1552410000,29,1,30,Rain
6627,89,1552410000,15,25,40,Rain
6628,90,1552410000,20,20,40,Rain
6629,91,1552410000,17,13,30,Rain
6630,92,1552410000,38,2,40,Rain
6631,93,1552410000,40,0,40,Rain
6632,94,1552410000,37,3,40,Rain
6633,95,1552410000,38,2,40,Rain
6634,96,1552410000,30,0,30,Rain
6635,97,1552410000,39,1,40,Rain
6636,98,1552410000,27,13,40,Rain
6637,99,1552410000,1,29,30,Rain
6638,100,1552410000,20,5,25,Rain
6639,101,1552410000,26,4,30,Rain
6640,102,1552410000,40,0,40,Rain
6641,103,1552410000,33,7,40,Rain
6642,104,1552410000,40,0,40,Rain
6643,105,1552410000,36,0,36,Rain
6644,106,1552410000,38,2,40,Rain
6645,107,1552410000,38,2,40,Rain
6646,108,1552410000,40,0,40,Rain
6647,109,1552410000,24,5,29,Rain
6648,110,1552410000,40,0,40,Rain
6649,111,1552410000,40,0,40,Rain
6650,112,1552410000,9,21,30,Rain
6651,113,1552410000,3,37,40,Rain
6652,114,1552410000,6,34,40,Rain
6653,115,1552410000,22,8,30,Rain
6654,2,1552413600,20,0,20,Clouds
6655,3,1552413600,19,1,20,Clouds
6656,4,1552413600,19,1,20,Clouds
6657,5,1552413600,40,0,40,Clouds
6658,6,1552413600,19,1,20,Clouds
6659,7,1552413600,27,2,29,Clouds
6660,8,1552413600,3,27,30,Clouds
6661,9,1552413600,23,1,24,Clouds
6662,10,1552413600,11,5,16,Clouds
6663,11,1552413600,30,0,30,Clouds
6664,12,1552413600,20,0,20,Clouds
6665,13,1552413600,13,17,30,Clouds
6666,14,1552413600,0,30,30,Clouds
6667,15,1552413600,16,0,16,Clouds
6668,16,1552413600,12,8,20,Clouds
6669,17,1552413600,20,0,20,Clouds
6670,18,1552413600,30,0,30,Clouds
6671,19,1552413600,21,9,30,Clouds
6672,21,1552413600,0,30,30,Clouds
6673,22,1552413600,8,12,20,Clouds
6674,23,1552413600,0,30,30,Clouds
6675,24,1552413600,18,2,20,Clouds
6676,25,1552413600,10,20,30,Clouds
6677,26,1552413600,0,20,20,Clouds
6678,27,1552413600,9,11,20,Clouds
6679,28,1552413600,30,0,30,Clouds
6680,29,1552413600,28,1,29,Clouds
6681,30,1552413600,19,1,20,Clouds
6682,31,1552413600,20,0,20,Clouds
6683,32,1552413600,3,27,30,Clouds
6684,33,1552413600,1,22,23,Clouds
6685,34,1552413600,17,13,30,Clouds
6686,35,1552413600,30,0,30,Clouds
6687,36,1552413600,29,11,40,Clouds
6688,37,1552413600,29,1,30,Clouds
6689,38,1552413600,20,20,40,Clouds
6690,39,1552413600,2,18,20,Clouds
6691,40,1552413600,6,15,21,Clouds
6692,41,1552413600,20,0,20,Clouds
6693,42,1552413600,26,4,30,Clouds
6694,43,1552413600,24,6,30,Clouds
6695,44,1552413600,30,0,30,Clouds
6696,45,1552413600,18,12,30,Clouds
6697,46,1552413600,16,4,20,Clouds
6698,47,1552413600,19,21,40,Clouds
6699,48,1552413600,1,39,40,Clouds
6700,49,1552413600,1,39,40,Clouds
6701,50,1552413600,40,0,40,Clouds
6702,51,1552413600,24,16,40,Clouds
6703,52,1552413600,16,16,32,Clouds
6704,53,1552413600,28,12,40,Clouds
6705,54,1552413600,26,7,33,Clouds
6706,55,1552413600,34,2,36,Clouds
6707,56,1552413600,28,12,40,Clouds
6708,57,1552413600,17,6,23,Clouds
6709,58,1552413600,33,7,40,Clouds
6710,59,1552413600,20,0,20,Clouds
6711,60,1552413600,12,18,30,Clouds
6712,61,1552413600,25,0,25,Clouds
6713,62,1552413600,13,27,40,Clouds
6714,63,1552413600,1,34,35,Clouds
6715,64,1552413600,8,32,40,Clouds
6716,65,1552413600,24,16,40,Clouds
6717,66,1552413600,39,1,40,Clouds
6718,67,1552413600,13,27,40,Clouds
6719,68,1552413600,22,18,40,Clouds
6720,69,1552413600,17,23,40,Clouds
6721,70,1552413600,14,14,28,Clouds
6722,71,1552413600,39,1,40,Clouds
6723,72,1552413600,21,4,25,Clouds
6724,73,1552413600,25,5,30,Clouds
6725,74,1552413600,10,20,30,Clouds
6726,75,1552413600,36,4,40,Clouds
6727,76,1552413600,29,9,38,Clouds
6728,77,1552413600,27,2,29,Clouds
6729,78,1552413600,38,2,40,Clouds
6730,79,1552413600,27,0,27,Clouds
6731,80,1552413600,38,2,40,Clouds
6732,81,1552413600,39,1,40,Clouds
6733,82,1552413600,21,1,22,Clouds
6734,83,1552413600,36,4,40,Clouds
6735,84,1552413600,28,2,30,Clouds
6736,85,1552413600,33,2,35,Clouds
6737,86,1552413600,27,11,38,Clouds
6738,87,1552413600,35,3,38,Clouds
6739,88,1552413600,28,2,30,Clouds
6740,89,1552413600,23,17,40,Clouds
6741,90,1552413600,28,12,40,Clouds
6742,91,1552413600,29,1,30,Clouds
6743,92,1552413600,30,10,40,Clouds
6744,93,1552413600,32,8,40,Clouds
6745,94,1552413600,37,3,40,Clouds
6746,95,1552413600,35,5,40,Clouds
6747,96,1552413600,27,3,30,Clouds
6748,97,1552413600,39,1,40,Clouds
6749,98,1552413600,26,14,40,Clouds
6750,99,1552413600,0,30,30,Clouds
6751,100,1552413600,3,22,25,Clouds
6752,101,1552413600,25,5,30,Clouds
6753,102,1552413600,39,1,40,Clouds
6754,103,1552413600,34,6,40,Clouds
6755,104,1552413600,39,1,40,Clouds
6756,105,1552413600,34,2,36,Clouds
6757,106,1552413600,37,3,40,Clouds
6758,107,1552413600,37,3,40,Clouds
6759,108,1552413600,39,1,40,Clouds
6760,109,1552413600,22,7,29,Clouds
6761,110,1552413600,37,3,40,Clouds
6762,111,1552413600,39,1,40,Clouds
6763,112,1552413600,10,20,30,Clouds
6764,113,1552413600,9,31,40,Clouds
6765,114,1552413600,36,4,40,Clouds
6766,115,1552413600,13,17,30,Clouds
6767,2,1552417200,17,3,20,Rain
6768,3,1552417200,20,0,20,Rain
6769,4,1552417200,20,0,20,Rain
6770,5,1552417200,29,11,40,Rain
6771,6,1552417200,17,3,20,Rain
6772,7,1552417200,28,1,29,Rain
6773,8,1552417200,7,23,30,Rain
6774,9,1552417200,19,5,24,Rain
6775,10,1552417200,13,3,16,Rain
6776,11,1552417200,30,0,30,Rain
6777,12,1552417200,19,1,20,Rain
6778,13,1552417200,29,1,30,Rain
6779,14,1552417200,2,28,30,Rain
6780,15,1552417200,15,1,16,Rain
6781,16,1552417200,5,15,20,Rain
6782,17,1552417200,18,2,20,Rain
6783,18,1552417200,23,7,30,Rain
6784,19,1552417200,29,1,30,Rain
6785,21,1552417200,1,29,30,Rain
6786,22,1552417200,1,19,20,Rain
6787,23,1552417200,12,18,30,Rain
6788,24,1552417200,7,13,20,Rain
6789,25,1552417200,26,4,30,Rain
6790,26,1552417200,7,13,20,Rain
6791,27,1552417200,16,4,20,Rain
6792,28,1552417200,29,1,30,Rain
6793,29,1552417200,21,8,29,Rain
6794,30,1552417200,16,4,20,Rain
6795,31,1552417200,16,4,20,Rain
6796,32,1552417200,0,29,29,Rain
6797,33,1552417200,10,13,23,Rain
6798,34,1552417200,26,4,30,Rain
6799,35,1552417200,30,0,30,Rain
6800,36,1552417200,38,2,40,Rain
6801,37,1552417200,30,0,30,Rain
6802,38,1552417200,23,17,40,Rain
6803,39,1552417200,16,4,20,Rain
6804,40,1552417200,17,4,21,Rain
6805,41,1552417200,18,2,20,Rain
6806,42,1552417200,24,6,30,Rain
6807,43,1552417200,13,17,30,Rain
6808,44,1552417200,25,5,30,Rain
6809,45,1552417200,19,11,30,Rain
6810,46,1552417200,18,2,20,Rain
6811,47,1552417200,40,0,40,Rain
6812,48,1552417200,0,40,40,Rain
6813,49,1552417200,4,36,40,Rain
6814,50,1552417200,29,11,40,Rain
6815,51,1552417200,35,5,40,Rain
6816,52,1552417200,32,0,32,Rain
6817,53,1552417200,38,2,40,Rain
6818,54,1552417200,33,0,33,Rain
6819,55,1552417200,36,0,36,Rain
6820,56,1552417200,36,4,40,Rain
6821,57,1552417200,21,2,23,Rain
6822,58,1552417200,35,5,40,Rain
6823,59,1552417200,19,1,20,Rain
6824,60,1552417200,0,30,30,Rain
6825,61,1552417200,24,1,25,Rain
6826,62,1552417200,32,8,40,Rain
6827,63,1552417200,14,21,35,Rain
6828,64,1552417200,12,28,40,Rain
6829,65,1552417200,38,2,40,Rain
6830,66,1552417200,39,1,40,Rain
6831,67,1552417200,18,22,40,Rain
6832,68,1552417200,36,4,40,Rain
6833,69,1552417200,27,13,40,Rain
6834,70,1552417200,16,12,28,Rain
6835,71,1552417200,39,1,40,Rain
6836,72,1552417200,25,0,25,Rain
6837,73,1552417200,27,3,30,Rain
6838,74,1552417200,6,24,30,Rain
6839,75,1552417200,30,10,40,Rain
6840,76,1552417200,26,12,38,Rain
6841,77,1552417200,28,1,29,Rain
6842,78,1552417200,34,6,40,Rain
6843,79,1552417200,24,3,27,Rain
6844,80,1552417200,14,26,40,Rain
6845,81,1552417200,39,1,40,Rain
6846,82,1552417200,17,5,22,Rain
6847,83,1552417200,36,4,40,Rain
6848,84,1552417200,25,5,30,Rain
6849,85,1552417200,28,7,35,Rain
6850,86,1552417200,17,21,38,Rain
6851,87,1552417200,29,9,38,Rain
6852,88,1552417200,23,7,30,Rain
6853,89,1552417200,40,0,40,Rain
6854,90,1552417200,40,0,40,Rain
6855,91,1552417200,24,6,30,Rain
6856,92,1552417200,15,24,39,Rain
6857,93,1552417200,1,39,40,Rain
6858,94,1552417200,17,23,40,Rain
6859,95,1552417200,27,13,40,Rain
6860,96,1552417200,25,5,30,Rain
6861,97,1552417200,34,6,40,Rain
6862,98,1552417200,28,12,40,Rain
6863,99,1552417200,11,19,30,Rain
6864,100,1552417200,3,22,25,Rain
6865,101,1552417200,27,3,30,Rain
6866,102,1552417200,33,7,40,Rain
6867,103,1552417200,37,3,40,Rain
6868,104,1552417200,39,1,40,Rain
6869,105,1552417200,34,2,36,Rain
6870,106,1552417200,35,5,40,Rain
6871,107,1552417200,36,4,40,Rain
6872,108,1552417200,34,6,40,Rain
6873,109,1552417200,19,10,29,Rain
6874,110,1552417200,39,1,40,Rain
6875,111,1552417200,34,6,40,Rain
6876,112,1552417200,7,23,30,Rain
6877,113,1552417200,14,26,40,Rain
6878,114,1552417200,40,0,40,Rain
6879,115,1552417200,5,25,30,Rain
6880,2,1552420800,12,8,20,Rain
6881,3,1552420800,18,2,20,Rain
6882,4,1552420800,18,2,20,Rain
6883,5,1552420800,16,24,40,Rain
6884,6,1552420800,19,1,20,Rain
6885,7,1552420800,25,4,29,Rain
6886,8,1552420800,17,13,30,Rain
6887,9,1552420800,14,10,24,Rain
6888,10,1552420800,9,7,16,Rain
6889,11,1552420800,30,0,30,Rain
6890,12,1552420800,15,5,20,Rain
6891,13,1552420800,30,0,30,Rain
6892,14,1552420800,7,23,30,Rain
6893,15,1552420800,14,2,16,Rain
6894,16,1552420800,9,11,20,Rain
6895,17,1552420800,19,1,20,Rain
6896,18,1552420800,1,29,30,Rain
6897,19,1552420800,17,13,30,Rain
6898,21,1552420800,1,29,30,Rain
6899,22,1552420800,0,20,20,Rain
6900,23,1552420800,7,23,30,Rain
6901,24,1552420800,10,10,20,Rain
6902,25,1552420800,27,3,30,Rain
6903,26,1552420800,15,5,20,Rain
6904,27,1552420800,18,2,20,Rain
6905,28,1552420800,28,2,30,Rain
6906,29,1552420800,25,4,29,Rain
6907,30,1552420800,18,2,20,Rain
6908,31,1552420800,13,7,20,Rain
6909,32,1552420800,8,22,30,Rain
6910,33,1552420800,4,19,23,Rain
6911,34,1552420800,21,9,30,Rain
6912,35,1552420800,25,5,30,Rain
6913,36,1552420800,39,1,40,Rain
6914,37,1552420800,30,0,30,Rain
6915,38,1552420800,23,17,40,Rain
6916,39,1552420800,8,12,20,Rain
6917,40,1552420800,20,1,21,Rain
6918,41,1552420800,19,1,20,Rain
6919,42,1552420800,13,17,30,Rain
6920,43,1552420800,9,21,30,Rain
6921,44,1552420800,16,14,30,Rain
6922,45,1552420800,7,23,30,Rain
6923,46,1552420800,18,2,20,Rain
6924,47,1552420800,40,0,40,Rain
6925,48,1552420800,2,38,40,Rain
6926,49,1552420800,1,39,40,Rain
6927,50,1552420800,17,23,40,Rain
6928,51,1552420800,40,0,40,Rain
6929,52,1552420800,32,0,32,Rain
6930,53,1552420800,40,0,40,Rain
6931,54,1552420800,33,0,33,Rain
6932,55,1552420800,36,0,36,Rain
6933,56,1552420800,37,3,40,Rain
6934,57,1552420800,18,5,23,Rain
6935,58,1552420800,40,0,40,Rain
6936,59,1552420800,20,0,20,Rain
6937,60,1552420800,0,30,30,Rain
6938,61,1552420800,24,1,25,Rain
6939,62,1552420800,36,4,40,Rain
6940,63,1552420800,14,21,35,Rain
6941,64,1552420800,10,30,40,Rain
6942,65,1552420800,38,2,40,Rain
6943,66,1552420800,33,7,40,Rain
6944,67,1552420800,13,27,40,Rain
6945,68,1552420800,36,4,40,Rain
6946,69,1552420800,31,9,40,Rain
6947,70,1552420800,9,18,27,Rain
6948,71,1552420800,36,4,40,Rain
6949,72,1552420800,25,0,25,Rain
6950,73,1552420800,30,0,30,Rain
6951,74,1552420800,3,27,30,Rain
6952,75,1552420800,29,11,40,Rain
6953,76,1552420800,12,26,38,Rain
6954,77,1552420800,27,2,29,Rain
6955,78,1552420800,22,18,40,Rain
6956,79,1552420800,23,4,27,Rain
6957,80,1552420800,12,28,40,Rain
6958,81,1552420800,40,0,40,Rain
6959,82,1552420800,14,8,22,Rain
6960,83,1552420800,30,10,40,Rain
6961,84,1552420800,17,13,30,Rain
6962,85,1552420800,24,11,35,Rain
6963,86,1552420800,9,29,38,Rain
6964,87,1552420800,25,13,38,Rain
6965,88,1552420800,18,12,30,Rain
6966,89,1552420800,39,1,40,Rain
6967,90,1552420800,40,0,40,Rain
6968,91,1552420800,17,13,30,Rain
6969,92,1552420800,8,31,39,Rain
6970,93,1552420800,0,40,40,Rain
6971,94,1552420800,13,27,40,Rain
6972,95,1552420800,26,14,40,Rain
6973,96,1552420800,25,5,30,Rain
6974,97,1552420800,20,20,40,Rain
6975,98,1552420800,32,8,40,Rain
6976,99,1552420800,9,21,30,Rain
6977,100,1552420800,9,16,25,Rain
6978,101,1552420800,25,5,30,Rain
6979,102,1552420800,32,8,40,Rain
6980,103,1552420800,40,0,40,Rain
6981,104,1552420800,39,1,40,Rain
6982,105,1552420800,32,4,36,Rain
6983,106,1552420800,34,6,40,Rain
6984,107,1552420800,37,3,40,Rain
6985,108,1552420800,34,6,40,Rain
6986,109,1552420800,18,11,29,Rain
6987,110,1552420800,39,1,40,Rain
6988,111,1552420800,28,12,40,Rain
6989,112,1552420800,3,27,30,Rain
6990,113,1552420800,20,20,40,Rain
6991,114,1552420800,38,2,40,Rain
6992,115,1552420800,0,30,30,Rain
6993,2,1552424400,10,10,20,Rain
6994,3,1552424400,15,5,20,Rain
6995,4,1552424400,19,1,20,Rain
6996,5,1552424400,0,40,40,Rain
6997,6,1552424400,18,2,20,Rain
6998,7,1552424400,24,5,29,Rain
6999,8,1552424400,24,6,30,Rain
7000,9,1552424400,17,7,24,Rain
7001,10,1552424400,10,6,16,Rain
7002,11,1552424400,29,1,30,Rain
7003,12,1552424400,11,9,20,Rain
7004,13,1552424400,30,0,30,Rain
7005,14,1552424400,5,25,30,Rain
7006,15,1552424400,14,2,16,Rain
7007,16,1552424400,11,9,20,Rain
7008,17,1552424400,20,0,20,Rain
7009,18,1552424400,0,30,30,Rain
7010,19,1552424400,13,17,30,Rain
7011,21,1552424400,4,26,30,Rain
7012,22,1552424400,1,19,20,Rain
7013,23,1552424400,4,26,30,Rain
7014,24,1552424400,16,4,20,Rain
7015,25,1552424400,29,1,30,Rain
7016,26,1552424400,20,0,20,Rain
7017,27,1552424400,20,0,20,Rain
7018,28,1552424400,29,1,30,Rain
7019,29,1552424400,25,4,29,Rain
7020,30,1552424400,18,2,20,Rain
7021,31,1552424400,16,4,20,Rain
7022,32,1552424400,9,21,30,Rain
7023,33,1552424400,6,17,23,Rain
7024,34,1552424400,21,9,30,Rain
7025,35,1552424400,22,8,30,Rain
7026,36,1552424400,39,1,40,Rain
7027,37,1552424400,30,0,30,Rain
7028,38,1552424400,30,10,40,Rain
7029,39,1552424400,6,14,20,Rain
7030,40,1552424400,15,6,21,Rain
7031,41,1552424400,16,4,20,Rain
7032,42,1552424400,12,18,30,Rain
7033,43,1552424400,28,2,30,Rain
7034,44,1552424400,11,19,30,Rain
7035,45,1552424400,7,23,30,Rain
7036,46,1552424400,15,5,20,Rain
7037,47,1552424400,39,1,40,Rain
7038,48,1552424400,19,21,40,Rain
7039,49,1552424400,40,0,40,Rain
7040,50,1552424400,21,19,40,Rain
7041,51,1552424400,37,3,40,Rain
7042,52,1552424400,32,0,32,Rain
7043,53,1552424400,40,0,40,Rain
7044,54,1552424400,33,0,33,Rain
7045,55,1552424400,36,0,36,Rain
7046,56,1552424400,40,0,40,Rain
7047,57,1552424400,19,4,23,Rain
7048,58,1552424400,38,1,39,Rain
7049,59,1552424400,20,0,20,Rain
7050,60,1552424400,0,30,30,Rain
7051,61,1552424400,7,18,25,Rain
7052,62,1552424400,38,2,40,Rain
7053,63,1552424400,16,19,35,Rain
7054,64,1552424400,9,31,40,Rain
7055,65,1552424400,40,0,40,Rain
7056,66,1552424400,25,15,40,Rain
7057,67,1552424400,12,28,40,Rain
7058,68,1552424400,25,15,40,Rain
7059,69,1552424400,35,5,40,Rain
7060,70,1552424400,7,21,28,Rain
7061,71,1552424400,40,0,40,Rain
7062,72,1552424400,23,2,25,Rain
7063,73,1552424400,5,25,30,Rain
7064,74,1552424400,3,27,30,Rain
7065,75,1552424400,32,8,40,Rain
7066,76,1552424400,11,27,38,Rain
7067,77,1552424400,29,0,29,Rain
7068,78,1552424400,23,17,40,Rain
7069,79,1552424400,22,5,27,Rain
7070,80,1552424400,14,26,40,Rain
7071,81,1552424400,40,0,40,Rain
7072,82,1552424400,12,10,22,Rain
7073,83,1552424400,28,12,40,Rain
7074,84,1552424400,14,16,30,Rain
7075,85,1552424400,25,10,35,Rain
7076,86,1552424400,12,26,38,Rain
7077,87,1552424400,27,11,38,Rain
7078,88,1552424400,19,11,30,Rain
7079,89,1552424400,40,0,40,Rain
7080,90,1552424400,40,0,40,Rain
7081,91,1552424400,20,10,30,Rain
7082,92,1552424400,9,30,39,Rain
7083,93,1552424400,0,40,40,Rain
7084,94,1552424400,13,27,40,Rain
7085,95,1552424400,21,19,40,Rain
7086,96,1552424400,24,6,30,Rain
7087,97,1552424400,19,21,40,Rain
7088,98,1552424400,39,1,40,Rain
7089,99,1552424400,8,22,30,Rain
7090,100,1552424400,8,17,25,Rain
7091,101,1552424400,23,7,30,Rain
7092,102,1552424400,33,7,40,Rain
7093,103,1552424400,40,0,40,Rain
7094,104,1552424400,40,0,40,Rain
7095,105,1552424400,32,4,36,Rain
7096,106,1552424400,34,6,40,Rain
7097,107,1552424400,38,2,40,Rain
7098,108,1552424400,34,6,40,Rain
7099,109,1552424400,15,14,29,Rain
7100,110,1552424400,38,2,40,Rain
7101,111,1552424400,27,13,40,Rain
7102,112,1552424400,0,30,30,Rain
7103,113,1552424400,28,12,40,Rain
7104,114,1552424400,38,2,40,Rain
7105,115,1552424400,0,30,30,Rain
7106,2,1552428000,11,9,20,Clouds
7107,3,1552428000,15,5,20,Clouds
7108,4,1552428000,18,2,20,Clouds
7109,5,1552428000,1,39,40,Clouds
7110,6,1552428000,19,1,20,Clouds
7111,7,1552428000,24,5,29,Clouds
7112,8,1552428000,23,7,30,Clouds
7113,9,1552428000,21,3,24,Clouds
7114,10,1552428000,11,5,16,Clouds
7115,11,1552428000,30,0,30,Clouds
7116,12,1552428000,11,9,20,Clouds
7117,13,1552428000,30,0,30,Clouds
7118,14,1552428000,3,27,30,Clouds
7119,15,1552428000,13,3,16,Clouds
7120,16,1552428000,11,9,20,Clouds
7121,17,1552428000,20,0,20,Clouds
7122,18,1552428000,3,27,30,Clouds
7123,19,1552428000,21,9,30,Clouds
7124,21,1552428000,10,20,30,Clouds
7125,22,1552428000,5,15,20,Clouds
7126,23,1552428000,6,24,30,Clouds
7127,24,1552428000,18,2,20,Clouds
7128,25,1552428000,30,0,30,Clouds
7129,26,1552428000,20,0,20,Clouds
7130,27,1552428000,20,0,20,Clouds
7131,28,1552428000,25,5,30,Clouds
7132,29,1552428000,25,4,29,Clouds
7133,30,1552428000,20,0,20,Clouds
7134,31,1552428000,18,2,20,Clouds
7135,32,1552428000,10,20,30,Clouds
7136,33,1552428000,13,10,23,Clouds
7137,34,1552428000,11,19,30,Clouds
7138,35,1552428000,18,12,30,Clouds
7139,36,1552428000,40,0,40,Clouds
7140,37,1552428000,30,0,30,Clouds
7141,38,1552428000,35,5,40,Clouds
7142,39,1552428000,14,6,20,Clouds
7143,40,1552428000,18,3,21,Clouds
7144,41,1552428000,17,3,20,Clouds
7145,42,1552428000,11,19,30,Clouds
7146,43,1552428000,30,0,30,Clouds
7147,44,1552428000,8,22,30,Clouds
7148,45,1552428000,7,23,30,Clouds
7149,46,1552428000,18,2,20,Clouds
7150,47,1552428000,40,0,40,Clouds
7151,48,1552428000,33,7,40,Clouds
7152,49,1552428000,38,2,40,Clouds
7153,50,1552428000,12,28,40,Clouds
7154,51,1552428000,39,1,40,Clouds
7155,52,1552428000,32,0,32,Clouds
7156,53,1552428000,40,0,40,Clouds
7157,54,1552428000,33,0,33,Clouds
7158,55,1552428000,36,0,36,Clouds
7159,56,1552428000,36,4,40,Clouds
7160,57,1552428000,20,3,23,Clouds
7161,58,1552428000,31,8,39,Clouds
7162,59,1552428000,20,0,20,Clouds
7163,60,1552428000,9,21,30,Clouds
7164,61,1552428000,8,17,25,Clouds
7165,62,1552428000,40,0,40,Clouds
7166,63,1552428000,19,16,35,Clouds
7167,64,1552428000,13,27,40,Clouds
7168,65,1552428000,40,0,40,Clouds
7169,66,1552428000,20,20,40,Clouds
7170,67,1552428000,5,35,40,Clouds
7171,68,1552428000,30,10,40,Clouds
7172,69,1552428000,37,3,40,Clouds
7173,70,1552428000,8,20,28,Clouds
7174,71,1552428000,37,3,40,Clouds
7175,72,1552428000,22,3,25,Clouds
7176,73,1552428000,0,30,30,Clouds
7177,74,1552428000,3,27,30,Clouds
7178,75,1552428000,28,12,40,Clouds
7179,76,1552428000,11,27,38,Clouds
7180,77,1552428000,24,5,29,Clouds
7181,78,1552428000,23,17,40,Clouds
7182,79,1552428000,17,10,27,Clouds
7183,80,1552428000,16,24,40,Clouds
7184,81,1552428000,40,0,40,Clouds
7185,82,1552428000,11,11,22,Clouds
7186,83,1552428000,26,14,40,Clouds
7187,84,1552428000,10,20,30,Clouds
7188,85,1552428000,24,11,35,Clouds
7189,86,1552428000,11,27,38,Clouds
7190,87,1552428000,24,14,38,Clouds
7191,88,1552428000,10,20,30,Clouds
7192,89,1552428000,40,0,40,Clouds
7193,90,1552428000,39,1,40,Clouds
7194,91,1552428000,12,18,30,Clouds
7195,92,1552428000,7,33,40,Clouds
7196,93,1552428000,0,40,40,Clouds
7197,94,1552428000,13,27,40,Clouds
7198,95,1552428000,22,18,40,Clouds
7199,96,1552428000,23,7,30,Clouds
7200,97,1552428000,18,22,40,Clouds
7201,98,1552428000,40,0,40,Clouds
7202,99,1552428000,10,20,30,Clouds
7203,100,1552428000,2,23,25,Clouds
7204,101,1552428000,20,10,30,Clouds
7205,102,1552428000,32,8,40,Clouds
7206,103,1552428000,40,0,40,Clouds
7207,104,1552428000,40,0,40,Clouds
7208,105,1552428000,32,4,36,Clouds
7209,106,1552428000,33,7,40,Clouds
7210,107,1552428000,34,6,40,Clouds
7211,108,1552428000,31,9,40,Clouds
7212,109,1552428000,6,23,29,Clouds
7213,110,1552428000,21,19,40,Clouds
7214,111,1552428000,21,19,40,Clouds
7215,112,1552428000,0,30,30,Clouds
7216,113,1552428000,30,10,40,Clouds
7217,114,1552428000,37,3,40,Clouds
7218,115,1552428000,1,29,30,Clouds
7219,2,1552431600,6,14,20,Rain
7220,3,1552431600,18,2,20,Rain
7221,4,1552431600,19,1,20,Rain
7222,5,1552431600,0,40,40,Rain
7223,6,1552431600,19,1,20,Rain
7224,7,1552431600,24,5,29,Rain
7225,8,1552431600,27,3,30,Rain
7226,9,1552431600,24,0,24,Rain
7227,10,1552431600,16,0,16,Rain
7228,11,1552431600,30,0,30,Rain
7229,12,1552431600,9,11,20,Rain
7230,13,1552431600,24,6,30,Rain
7231,14,1552431600,14,16,30,Rain
7232,15,1552431600,14,2,16,Rain
7233,16,1552431600,13,7,20,Rain
7234,17,1552431600,20,0,20,Rain
7235,18,1552431600,6,24,30,Rain
7236,19,1552431600,23,7,30,Rain
7237,21,1552431600,19,11,30,Rain
7238,22,1552431600,9,11,20,Rain
7239,23,1552431600,5,25,30,Rain
7240,24,1552431600,17,3,20,Rain
7241,25,1552431600,24,6,30,Rain
7242,26,1552431600,20,0,20,Rain
7243,27,1552431600,20,0,20,Rain
7244,28,1552431600,20,10,30,Rain
7245,29,1552431600,23,6,29,Rain
7246,30,1552431600,19,1,20,Rain
7247,31,1552431600,17,3,20,Rain
7248,32,1552431600,16,14,30,Rain
7249,33,1552431600,14,9,23,Rain
7250,34,1552431600,9,21,30,Rain
7251,35,1552431600,20,10,30,Rain
7252,36,1552431600,40,0,40,Rain
7253,37,1552431600,30,0,30,Rain
7254,38,1552431600,39,1,40,Rain
7255,39,1552431600,13,7,20,Rain
7256,40,1552431600,18,3,21,Rain
7257,41,1552431600,15,5,20,Rain
7258,42,1552431600,15,15,30,Rain
7259,43,1552431600,28,2,30,Rain
7260,44,1552431600,7,23,30,Rain
7261,45,1552431600,7,23,30,Rain
7262,46,1552431600,17,3,20,Rain
7263,47,1552431600,39,1,40,Rain
7264,48,1552431600,32,8,40,Rain
7265,49,1552431600,34,6,40,Rain
7266,50,1552431600,10,30,40,Rain
7267,51,1552431600,40,0,40,Rain
7268,52,1552431600,31,1,32,Rain
7269,53,1552431600,40,0,40,Rain
7270,54,1552431600,32,1,33,Rain
7271,55,1552431600,36,0,36,Rain
7272,56,1552431600,33,7,40,Rain
7273,57,1552431600,21,2,23,Rain
7274,58,1552431600,33,7,40,Rain
7275,59,1552431600,20,0,20,Rain
7276,60,1552431600,6,24,30,Rain
7277,61,1552431600,8,17,25,Rain
7278,62,1552431600,40,0,40,Rain
7279,63,1552431600,21,14,35,Rain
7280,64,1552431600,15,25,40,Rain
7281,65,1552431600,40,0,40,Rain
7282,66,1552431600,23,17,40,Rain
7283,67,1552431600,5,34,39,Rain
7284,68,1552431600,32,8,40,Rain
7285,69,1552431600,38,2,40,Rain
7286,70,1552431600,9,19,28,Rain
7287,71,1552431600,40,0,40,Rain
7288,72,1552431600,17,8,25,Rain
7289,73,1552431600,0,30,30,Rain
7290,74,1552431600,1,29,30,Rain
7291,75,1552431600,25,15,40,Rain
7292,76,1552431600,9,29,38,Rain
7293,77,1552431600,24,5,29,Rain
7294,78,1552431600,21,19,40,Rain
7295,79,1552431600,6,21,27,Rain
7296,80,1552431600,18,22,40,Rain
7297,81,1552431600,38,2,40,Rain
7298,82,1552431600,11,11,22,Rain
7299,83,1552431600,25,15,40,Rain
7300,84,1552431600,7,23,30,Rain
7301,85,1552431600,22,13,35,Rain
7302,86,1552431600,9,29,38,Rain
7303,87,1552431600,24,14,38,Rain
7304,88,1552431600,6,24,30,Rain
7305,89,1552431600,34,6,40,Rain
7306,90,1552431600,40,0,40,Rain
7307,91,1552431600,5,25,30,Rain
7308,92,1552431600,6,34,40,Rain
7309,93,1552431600,0,40,40,Rain
7310,94,1552431600,13,27,40,Rain
7311,95,1552431600,22,18,40,Rain
7312,96,1552431600,23,7,30,Rain
7313,97,1552431600,19,21,40,Rain
7314,98,1552431600,40,0,40,Rain
7315,99,1552431600,10,20,30,Rain
7316,100,1552431600,2,23,25,Rain
7317,101,1552431600,20,10,30,Rain
7318,102,1552431600,32,8,40,Rain
7319,103,1552431600,40,0,40,Rain
7320,104,1552431600,40,0,40,Rain
7321,105,1552431600,32,4,36,Rain
7322,106,1552431600,33,7,40,Rain
7323,107,1552431600,32,8,40,Rain
7324,108,1552431600,31,9,40,Rain
7325,109,1552431600,4,25,29,Rain
7326,110,1552431600,21,19,40,Rain
7327,111,1552431600,17,22,39,Rain
7328,112,1552431600,10,20,30,Rain
7329,113,1552431600,31,9,40,Rain
7330,114,1552431600,36,4,40,Rain
7331,115,1552431600,0,30,30,Rain
7332,2,1552435200,5,15,20,Rain
7333,3,1552435200,14,6,20,Rain
7334,4,1552435200,19,1,20,Rain
7335,5,1552435200,10,30,40,Rain
7336,6,1552435200,20,0,20,Rain
7337,7,1552435200,29,0,29,Rain
7338,8,1552435200,27,3,30,Rain
7339,9,1552435200,16,8,24,Rain
7340,10,1552435200,15,1,16,Rain
7341,11,1552435200,30,0,30,Rain
7342,12,1552435200,8,12,20,Rain
7343,13,1552435200,24,6,30,Rain
7344,14,1552435200,19,11,30,Rain
7345,15,1552435200,13,3,16,Rain
7346,16,1552435200,16,4,20,Rain
7347,17,1552435200,20,0,20,Rain
7348,18,1552435200,13,17,30,Rain
7349,19,1552435200,20,10,30,Rain
7350,21,1552435200,22,8,30,Rain
7351,22,1552435200,13,7,20,Rain
7352,23,1552435200,16,14,30,Rain
7353,24,1552435200,15,5,20,Rain
7354,25,1552435200,24,6,30,Rain
7355,26,1552435200,20,0,20,Rain
7356,27,1552435200,20,0,20,Rain
7357,28,1552435200,20,10,30,Rain
7358,29,1552435200,26,3,29,Rain
7359,30,1552435200,18,2,20,Rain
7360,31,1552435200,17,3,20,Rain
7361,32,1552435200,23,6,29,Rain
7362,33,1552435200,19,4,23,Rain
7363,34,1552435200,10,20,30,Rain
7364,35,1552435200,21,9,30,Rain
7365,36,1552435200,40,0,40,Rain
7366,37,1552435200,29,1,30,Rain
7367,38,1552435200,36,4,40,Rain
7368,39,1552435200,17,3,20,Rain
7369,40,1552435200,21,0,21,Rain
7370,41,1552435200,15,5,20,Rain
7371,42,1552435200,17,13,30,Rain
7372,43,1552435200,22,8,30,Rain
7373,44,1552435200,6,24,30,Rain
7374,45,1552435200,5,25,30,Rain
7375,46,1552435200,17,3,20,Rain
7376,47,1552435200,39,1,40,Rain
7377,48,1552435200,33,7,40,Rain
7378,49,1552435200,34,6,40,Rain
7379,50,1552435200,8,32,40,Rain
7380,51,1552435200,40,0,40,Rain
7381,52,1552435200,31,1,32,Rain
7382,53,1552435200,40,0,40,Rain
7383,54,1552435200,33,0,33,Rain
7384,55,1552435200,35,1,36,Rain
7385,56,1552435200,32,8,40,Rain
7386,57,1552435200,22,1,23,Rain
7387,58,1552435200,32,8,40,Rain
7388,59,1552435200,20,0,20,Rain
7389,60,1552435200,0,30,30,Rain
7390,61,1552435200,8,17,25,Rain
7391,62,1552435200,40,0,40,Rain
7392,63,1552435200,21,14,35,Rain
7393,64,1552435200,12,28,40,Rain
7394,65,1552435200,39,1,40,Rain
7395,66,1552435200,23,17,40,Rain
7396,67,1552435200,6,33,39,Rain
7397,68,1552435200,31,9,40,Rain
7398,69,1552435200,36,4,40,Rain
7399,70,1552435200,2,26,28,Rain
7400,71,1552435200,40,0,40,Rain
7401,72,1552435200,17,8,25,Rain
7402,73,1552435200,0,30,30,Rain
7403,74,1552435200,0,30,30,Rain
7404,75,1552435200,26,14,40,Rain
7405,76,1552435200,7,31,38,Rain
7406,77,1552435200,24,5,29,Rain
7407,78,1552435200,21,19,40,Rain
7408,79,1552435200,6,21,27,Rain
7409,80,1552435200,18,22,40,Rain
7410,81,1552435200,38,2,40,Rain
7411,82,1552435200,12,10,22,Rain
7412,83,1552435200,23,17,40,Rain
7413,84,1552435200,5,25,30,Rain
7414,85,1552435200,20,15,35,Rain
7415,86,1552435200,9,29,38,Rain
7416,87,1552435200,23,15,38,Rain
7417,88,1552435200,4,26,30,Rain
7418,89,1552435200,34,6,40,Rain
7419,90,1552435200,34,6,40,Rain
7420,91,1552435200,22,8,30,Rain
7421,92,1552435200,6,34,40,Rain
7422,93,1552435200,0,40,40,Rain
7423,94,1552435200,13,27,40,Rain
7424,95,1552435200,21,19,40,Rain
7425,96,1552435200,23,7,30,Rain
7426,97,1552435200,18,22,40,Rain
7427,98,1552435200,40,0,40,Rain
7428,99,1552435200,10,20,30,Rain
7429,100,1552435200,0,25,25,Rain
7430,101,1552435200,19,11,30,Rain
7431,102,1552435200,31,9,40,Rain
7432,103,1552435200,40,0,40,Rain
7433,104,1552435200,40,0,40,Rain
7434,105,1552435200,32,4,36,Rain
7435,106,1552435200,33,7,40,Rain
7436,107,1552435200,30,10,40,Rain
7437,108,1552435200,31,9,40,Rain
7438,109,1552435200,1,28,29,Rain
7439,110,1552435200,20,20,40,Rain
7440,111,1552435200,10,30,40,Rain
7441,112,1552435200,4,26,30,Rain
7442,113,1552435200,31,9,40,Rain
7443,114,1552435200,38,2,40,Rain
7444,115,1552435200,0,30,30,Rain
7445,2,1552438800,3,17,20,Rain
7446,3,1552438800,12,8,20,Rain
7447,4,1552438800,18,2,20,Rain
7448,5,1552438800,9,31,40,Rain
7449,6,1552438800,20,0,20,Rain
7450,7,1552438800,28,1,29,Rain
7451,8,1552438800,26,4,30,Rain
7452,9,1552438800,24,0,24,Rain
7453,10,1552438800,15,1,16,Rain
7454,11,1552438800,30,0,30,Rain
7455,12,1552438800,8,12,20,Rain
7456,13,1552438800,24,6,30,Rain
7457,14,1552438800,23,7,30,Rain
7458,15,1552438800,15,1,16,Rain
7459,16,1552438800,17,3,20,Rain
7460,17,1552438800,20,0,20,Rain
7461,18,1552438800,14,16,30,Rain
7462,19,1552438800,22,8,30,Rain
7463,21,1552438800,28,2,30,Rain
7464,22,1552438800,14,6,20,Rain
7465,23,1552438800,17,13,30,Rain
7466,24,1552438800,19,1,20,Rain
7467,25,1552438800,24,6,30,Rain
7468,26,1552438800,20,0,20,Rain
7469,27,1552438800,20,0,20,Rain
7470,28,1552438800,20,10,30,Rain
7471,29,1552438800,26,3,29,Rain
7472,30,1552438800,19,1,20,Rain
7473,31,1552438800,16,4,20,Rain
7474,32,1552438800,25,5,30,Rain
7475,33,1552438800,23,0,23,Rain
7476,34,1552438800,9,21,30,Rain
7477,35,1552438800,20,10,30,Rain
7478,36,1552438800,40,0,40,Rain
7479,37,1552438800,30,0,30,Rain
7480,38,1552438800,40,0,40,Rain
7481,39,1552438800,18,2,20,Rain
7482,40,1552438800,19,2,21,Rain
7483,41,1552438800,15,5,20,Rain
7484,42,1552438800,18,12,30,Rain
7485,43,1552438800,9,21,30,Rain
7486,44,1552438800,3,27,30,Rain
7487,45,1552438800,4,26,30,Rain
7488,46,1552438800,19,1,20,Rain
7489,47,1552438800,39,1,40,Rain
7490,48,1552438800,33,7,40,Rain
7491,49,1552438800,32,8,40,Rain
7492,50,1552438800,6,34,40,Rain
7493,51,1552438800,40,0,40,Rain
7494,52,1552438800,32,0,32,Rain
7495,53,1552438800,40,0,40,Rain
7496,54,1552438800,33,0,33,Rain
7497,55,1552438800,35,1,36,Rain
7498,56,1552438800,32,8,40,Rain
7499,57,1552438800,22,1,23,Rain
7500,58,1552438800,33,7,40,Rain
7501,59,1552438800,18,2,20,Rain
7502,60,1552438800,8,22,30,Rain
7503,61,1552438800,7,18,25,Rain
7504,62,1552438800,40,0,40,Rain
7505,63,1552438800,22,13,35,Rain
7506,64,1552438800,10,30,40,Rain
7507,65,1552438800,38,2,40,Rain
7508,66,1552438800,21,19,40,Rain
7509,67,1552438800,7,32,39,Rain
7510,68,1552438800,31,9,40,Rain
7511,69,1552438800,36,4,40,Rain
7512,70,1552438800,0,28,28,Rain
7513,71,1552438800,39,1,40,Rain
7514,72,1552438800,16,9,25,Rain
7515,73,1552438800,0,30,30,Rain
7516,74,1552438800,0,30,30,Rain
7517,75,1552438800,24,16,40,Rain
7518,76,1552438800,5,33,38,Rain
7519,77,1552438800,23,6,29,Rain
7520,78,1552438800,16,24,40,Rain
7521,79,1552438800,6,21,27,Rain
7522,80,1552438800,18,22,40,Rain
7523,81,1552438800,39,1,40,Rain
7524,82,1552438800,12,10,22,Rain
7525,83,1552438800,24,16,40,Rain
7526,84,1552438800,3,27,30,Rain
7527,85,1552438800,18,17,35,Rain
7528,86,1552438800,8,30,38,Rain
7529,87,1552438800,21,17,38,Rain
7530,88,1552438800,4,26,30,Rain
7531,89,1552438800,34,6,40,Rain
7532,90,1552438800,33,7,40,Rain
7533,91,1552438800,23,7,30,Rain
7534,92,1552438800,5,35,40,Rain
7535,93,1552438800,0,40,40,Rain
7536,94,1552438800,13,27,40,Rain
7537,95,1552438800,21,19,40,Rain
7538,96,1552438800,22,8,30,Rain
7539,97,1552438800,18,22,40,Rain
7540,98,1552438800,39,1,40,Rain
7541,99,1552438800,11,19,30,Rain
7542,100,1552438800,1,24,25,Rain
7543,101,1552438800,19,11,30,Rain
7544,102,1552438800,33,7,40,Rain
7545,103,1552438800,40,0,40,Rain
7546,104,1552438800,40,0,40,Rain
7547,105,1552438800,33,3,36,Rain
7548,106,1552438800,33,7,40,Rain
7549,107,1552438800,28,12,40,Rain
7550,108,1552438800,30,10,40,Rain
7551,109,1552438800,0,29,29,Rain
7552,110,1552438800,18,22,40,Rain
7553,111,1552438800,9,31,40,Rain
7554,112,1552438800,9,21,30,Rain
7555,113,1552438800,32,8,40,Rain
7556,114,1552438800,39,1,40,Rain
7557,115,1552438800,0,30,30,Rain
7558,2,1552442400,3,17,20,Rain
7559,3,1552442400,12,8,20,Rain
7560,4,1552442400,18,2,20,Rain
7561,5,1552442400,9,31,40,Rain
7562,6,1552442400,19,1,20,Rain
7563,7,1552442400,27,2,29,Rain
7564,8,1552442400,26,4,30,Rain
7565,9,1552442400,24,0,24,Rain
7566,10,1552442400,14,2,16,Rain
7567,11,1552442400,30,0,30,Rain
7568,12,1552442400,8,12,20,Rain
7569,13,1552442400,25,5,30,Rain
7570,14,1552442400,25,5,30,Rain
7571,15,1552442400,14,2,16,Rain
7572,16,1552442400,17,3,20,Rain
7573,17,1552442400,19,1,20,Rain
7574,18,1552442400,16,14,30,Rain
7575,19,1552442400,22,8,30,Rain
7576,21,1552442400,29,1,30,Rain
7577,22,1552442400,16,4,20,Rain
7578,23,1552442400,18,12,30,Rain
7579,24,1552442400,17,3,20,Rain
7580,25,1552442400,24,6,30,Rain
7581,26,1552442400,20,0,20,Rain
7582,27,1552442400,20,0,20,Rain
7583,28,1552442400,19,11,30,Rain
7584,29,1552442400,27,2,29,Rain
7585,30,1552442400,19,1,20,Rain
7586,31,1552442400,16,4,20,Rain
7587,32,1552442400,25,5,30,Rain
7588,33,1552442400,23,0,23,Rain
7589,34,1552442400,10,20,30,Rain
7590,35,1552442400,21,9,30,Rain
7591,36,1552442400,40,0,40,Rain
7592,37,1552442400,30,0,30,Rain
7593,38,1552442400,38,2,40,Rain
7594,39,1552442400,17,3,20,Rain
7595,40,1552442400,19,2,21,Rain
7596,41,1552442400,15,5,20,Rain
7597,42,1552442400,19,11,30,Rain
7598,43,1552442400,8,22,30,Rain
7599,44,1552442400,2,28,30,Rain
7600,45,1552442400,3,27,30,Rain
7601,46,1552442400,20,0,20,Rain
7602,47,1552442400,39,1,40,Rain
7603,48,1552442400,35,5,40,Rain
7604,49,1552442400,33,7,40,Rain
7605,50,1552442400,7,33,40,Rain
7606,51,1552442400,40,0,40,Rain
7607,52,1552442400,32,0,32,Rain
7608,53,1552442400,40,0,40,Rain
7609,54,1552442400,33,0,33,Rain
7610,55,1552442400,35,1,36,Rain
7611,56,1552442400,31,9,40,Rain
7612,57,1552442400,22,1,23,Rain
7613,58,1552442400,33,7,40,Rain
7614,59,1552442400,18,2,20,Rain
7615,60,1552442400,8,22,30,Rain
7616,61,1552442400,7,18,25,Rain
7617,62,1552442400,40,0,40,Rain
7618,63,1552442400,22,13,35,Rain
7619,64,1552442400,9,31,40,Rain
7620,65,1552442400,38,2,40,Rain
7621,66,1552442400,21,19,40,Rain
7622,67,1552442400,7,32,39,Rain
7623,68,1552442400,34,6,40,Rain
7624,69,1552442400,35,5,40,Rain
7625,70,1552442400,0,28,28,Rain
7626,71,1552442400,39,1,40,Rain
7627,72,1552442400,15,10,25,Rain
7628,73,1552442400,2,28,30,Rain
7629,74,1552442400,1,29,30,Rain
7630,75,1552442400,24,16,40,Rain
7631,76,1552442400,4,34,38,Rain
7632,77,1552442400,23,6,29,Rain
7633,78,1552442400,17,23,40,Rain
7634,79,1552442400,6,21,27,Rain
7635,80,1552442400,18,22,40,Rain
7636,81,1552442400,39,1,40,Rain
7637,82,1552442400,11,11,22,Rain
7638,83,1552442400,24,16,40,Rain
7639,84,1552442400,3,27,30,Rain
7640,85,1552442400,17,18,35,Rain
7641,86,1552442400,8,30,38,Rain
7642,87,1552442400,21,17,38,Rain
7643,88,1552442400,4,26,30,Rain
7644,89,1552442400,34,6,40,Rain
7645,90,1552442400,34,6,40,Rain
7646,91,1552442400,23,7,30,Rain
7647,92,1552442400,5,35,40,Rain
7648,93,1552442400,0,40,40,Rain
7649,94,1552442400,13,27,40,Rain
7650,95,1552442400,20,20,40,Rain
7651,96,1552442400,22,8,30,Rain
7652,97,1552442400,18,22,40,Rain
7653,98,1552442400,40,0,40,Rain
7654,99,1552442400,11,19,30,Rain
7655,100,1552442400,1,24,25,Rain
7656,101,1552442400,18,12,30,Rain
7657,102,1552442400,33,7,40,Rain
7658,103,1552442400,40,0,40,Rain
7659,104,1552442400,40,0,40,Rain
7660,105,1552442400,33,3,36,Rain
7661,106,1552442400,33,7,40,Rain
7662,107,1552442400,25,15,40,Rain
7663,108,1552442400,30,10,40,Rain
7664,109,1552442400,0,29,29,Rain
7665,110,1552442400,18,22,40,Rain
7666,111,1552442400,9,31,40,Rain
7667,112,1552442400,8,22,30,Rain
7668,113,1552442400,32,8,40,Rain
7669,114,1552442400,39,1,40,Rain
7670,115,1552442400,0,30,30,Rain
7671,2,1552446000,3,17,20,Rain
7672,3,1552446000,12,8,20,Rain
7673,4,1552446000,18,2,20,Rain
7674,5,1552446000,9,31,40,Rain
7675,6,1552446000,19,1,20,Rain
7676,7,1552446000,27,2,29,Rain
7677,8,1552446000,26,4,30,Rain
7678,9,1552446000,24,0,24,Rain
7679,10,1552446000,14,2,16,Rain
7680,11,1552446000,30,0,30,Rain
7681,12,1552446000,8,12,20,Rain
7682,13,1552446000,25,5,30,Rain
7683,14,1552446000,25,5,30,Rain
7684,15,1552446000,14,2,16,Rain
7685,16,1552446000,17,3,20,Rain
7686,17,1552446000,19,1,20,Rain
7687,18,1552446000,16,14,30,Rain
7688,19,1552446000,22,8,30,Rain
7689,21,1552446000,29,1,30,Rain
7690,22,1552446000,16,4,20,Rain
7691,23,1552446000,18,12,30,Rain
7692,24,1552446000,17,3,20,Rain
7693,25,1552446000,24,6,30,Rain
7694,26,1552446000,20,0,20,Rain
7695,27,1552446000,20,0,20,Rain
7696,28,1552446000,19,11,30,Rain
7697,29,1552446000,27,2,29,Rain
7698,30,1552446000,19,1,20,Rain
7699,31,1552446000,16,4,20,Rain
7700,32,1552446000,25,5,30,Rain
7701,33,1552446000,23,0,23,Rain
7702,34,1552446000,10,20,30,Rain
7703,35,1552446000,21,9,30,Rain
7704,36,1552446000,40,0,40,Rain
7705,37,1552446000,30,0,30,Rain
7706,38,1552446000,38,2,40,Rain
7707,39,1552446000,17,3,20,Rain
7708,40,1552446000,19,2,21,Rain
7709,41,1552446000,15,5,20,Rain
7710,42,1552446000,19,11,30,Rain
7711,43,1552446000,8,22,30,Rain
7712,44,1552446000,2,28,30,Rain
7713,45,1552446000,3,27,30,Rain
7714,46,1552446000,20,0,20,Rain
7715,47,1552446000,39,1,40,Rain
7716,48,1552446000,35,5,40,Rain
7717,49,1552446000,33,7,40,Rain
7718,50,1552446000,7,33,40,Rain
7719,51,1552446000,40,0,40,Rain
7720,52,1552446000,32,0,32,Rain
7721,53,1552446000,40,0,40,Rain
7722,54,1552446000,33,0,33,Rain
7723,55,1552446000,35,1,36,Rain
7724,56,1552446000,31,9,40,Rain
7725,57,1552446000,22,1,23,Rain
7726,58,1552446000,33,7,40,Rain
7727,59,1552446000,18,2,20,Rain
7728,60,1552446000,8,22,30,Rain
7729,61,1552446000,7,18,25,Rain
7730,62,1552446000,40,0,40,Rain
7731,63,1552446000,22,13,35,Rain
7732,64,1552446000,9,31,40,Rain
7733,65,1552446000,38,2,40,Rain
7734,66,1552446000,21,19,40,Rain
7735,67,1552446000,7,32,39,Rain
7736,68,1552446000,34,6,40,Rain
7737,69,1552446000,35,5,40,Rain
7738,70,1552446000,0,28,28,Rain
7739,71,1552446000,39,1,40,Rain
7740,72,1552446000,15,10,25,Rain
7741,73,1552446000,2,28,30,Rain
7742,74,1552446000,1,29,30,Rain
7743,75,1552446000,24,16,40,Rain
7744,76,1552446000,4,34,38,Rain
7745,77,1552446000,23,6,29,Rain
7746,78,1552446000,17,23,40,Rain
7747,79,1552446000,6,21,27,Rain
7748,80,1552446000,18,22,40,Rain
7749,81,1552446000,39,1,40,Rain
7750,82,1552446000,11,11,22,Rain
7751,83,1552446000,24,16,40,Rain
7752,84,1552446000,3,27,30,Rain
7753,85,1552446000,17,18,35,Rain
7754,86,1552446000,8,30,38,Rain
7755,87,1552446000,21,17,38,Rain
7756,88,1552446000,4,26,30,Rain
7757,89,1552446000,34,6,40,Rain
7758,90,1552446000,34,6,40,Rain
7759,91,1552446000,23,7,30,Rain
7760,92,1552446000,5,35,40,Rain
7761,93,1552446000,0,40,40,Rain
7762,94,1552446000,13,27,40,Rain
7763,95,1552446000,20,20,40,Rain
7764,96,1552446000,22,8,30,Rain
7765,97,1552446000,18,22,40,Rain
7766,98,1552446000,40,0,40,Rain
7767,99,1552446000,11,19,30,Rain
7768,100,1552446000,1,24,25,Rain
7769,101,1552446000,18,12,30,Rain
7770,102,1552446000,33,7,40,Rain
7771,103,1552446000,40,0,40,Rain
7772,104,1552446000,40,0,40,Rain
7773,105,1552446000,33,3,36,Rain
7774,106,1552446000,33,7,40,Rain
7775,107,1552446000,25,15,40,Rain
7776,108,1552446000,30,10,40,Rain
7777,109,1552446000,0,29,29,Rain
7778,110,1552446000,18,22,40,Rain
7779,111,1552446000,9,31,40,Rain
7780,112,1552446000,7,23,30,Rain
7781,113,1552446000,32,8,40,Rain
7782,114,1552446000,39,1,40,Rain
7783,115,1552446000,0,30,30,Rain
7784,2,1552449600,3,17,20,Rain
7785,3,1552449600,12,8,20,Rain
7786,4,1552449600,18,2,20,Rain
7787,5,1552449600,9,31,40,Rain
7788,6,1552449600,19,1,20,Rain
7789,7,1552449600,27,2,29,Rain
7790,8,1552449600,26,4,30,Rain
7791,9,1552449600,24,0,24,Rain
7792,10,1552449600,14,2,16,Rain
7793,11,1552449600,30,0,30,Rain
7794,12,1552449600,8,12,20,Rain
7795,13,1552449600,25,5,30,Rain
7796,14,1552449600,25,5,30,Rain
7797,15,1552449600,14,2,16,Rain
7798,16,1552449600,17,3,20,Rain
7799,17,1552449600,19,1,20,Rain
7800,18,1552449600,16,14,30,Rain
7801,19,1552449600,22,8,30,Rain
7802,21,1552449600,29,1,30,Rain
7803,22,1552449600,16,4,20,Rain
7804,23,1552449600,18,12,30,Rain
7805,24,1552449600,17,3,20,Rain
7806,25,1552449600,24,6,30,Rain
7807,26,1552449600,20,0,20,Rain
7808,27,1552449600,20,0,20,Rain
7809,28,1552449600,19,11,30,Rain
7810,29,1552449600,27,2,29,Rain
7811,30,1552449600,19,1,20,Rain
7812,31,1552449600,16,4,20,Rain
7813,32,1552449600,25,5,30,Rain
7814,33,1552449600,23,0,23,Rain
7815,34,1552449600,10,20,30,Rain
7816,35,1552449600,21,9,30,Rain
7817,36,1552449600,40,0,40,Rain
7818,37,1552449600,30,0,30,Rain
7819,38,1552449600,38,2,40,Rain
7820,39,1552449600,17,3,20,Rain
7821,40,1552449600,19,2,21,Rain
7822,41,1552449600,15,5,20,Rain
7823,42,1552449600,19,11,30,Rain
7824,43,1552449600,7,23,30,Rain
7825,44,1552449600,2,28,30,Rain
7826,45,1552449600,3,27,30,Rain
7827,46,1552449600,20,0,20,Rain
7828,47,1552449600,38,2,40,Rain
7829,48,1552449600,35,5,40,Rain
7830,49,1552449600,33,7,40,Rain
7831,50,1552449600,7,33,40,Rain
7832,51,1552449600,40,0,40,Rain
7833,52,1552449600,32,0,32,Rain
7834,53,1552449600,40,0,40,Rain
7835,54,1552449600,33,0,33,Rain
7836,55,1552449600,35,1,36,Rain
7837,56,1552449600,31,9,40,Rain
7838,57,1552449600,22,1,23,Rain
7839,58,1552449600,33,7,40,Rain
7840,59,1552449600,18,2,20,Rain
7841,60,1552449600,8,22,30,Rain
7842,61,1552449600,7,18,25,Rain
7843,62,1552449600,40,0,40,Rain
7844,63,1552449600,22,13,35,Rain
7845,64,1552449600,9,31,40,Rain
7846,65,1552449600,38,2,40,Rain
7847,66,1552449600,21,19,40,Rain
7848,67,1552449600,7,32,39,Rain
7849,68,1552449600,34,6,40,Rain
7850,69,1552449600,35,5,40,Rain
7851,70,1552449600,0,28,28,Rain
7852,71,1552449600,39,1,40,Rain
7853,72,1552449600,15,10,25,Rain
7854,73,1552449600,2,28,30,Rain
7855,74,1552449600,1,29,30,Rain
7856,75,1552449600,24,16,40,Rain
7857,76,1552449600,4,34,38,Rain
7858,77,1552449600,23,6,29,Rain
7859,78,1552449600,17,23,40,Rain
7860,79,1552449600,6,21,27,Rain
7861,80,1552449600,18,22,40,Rain
7862,81,1552449600,39,1,40,Rain
7863,82,1552449600,11,11,22,Rain
7864,83,1552449600,24,16,40,Rain
7865,84,1552449600,3,27,30,Rain
7866,85,1552449600,17,18,35,Rain
7867,86,1552449600,8,30,38,Rain
7868,87,1552449600,21,17,38,Rain
7869,88,1552449600,4,26,30,Rain
7870,89,1552449600,34,6,40,Rain
7871,90,1552449600,34,6,40,Rain
7872,91,1552449600,23,7,30,Rain
7873,92,1552449600,5,35,40,Rain
7874,93,1552449600,0,40,40,Rain
7875,94,1552449600,13,27,40,Rain
7876,95,1552449600,20,20,40,Rain
7877,96,1552449600,22,8,30,Rain
7878,97,1552449600,18,22,40,Rain
7879,98,1552449600,40,0,40,Rain
7880,99,1552449600,11,19,30,Rain
7881,100,1552449600,1,24,25,Rain
7882,101,1552449600,18,12,30,Rain
7883,102,1552449600,33,7,40,Rain
7884,103,1552449600,40,0,40,Rain
7885,104,1552449600,40,0,40,Rain
7886,105,1552449600,33,3,36,Rain
7887,106,1552449600,33,7,40,Rain
7888,107,1552449600,25,15,40,Rain
7889,108,1552449600,30,10,40,Rain
7890,109,1552449600,0,29,29,Rain
7891,110,1552449600,18,22,40,Rain
7892,111,1552449600,9,31,40,Rain
7893,112,1552449600,7,23,30,Rain
7894,113,1552449600,32,8,40,Rain
7895,114,1552449600,39,1,40,Rain
7896,115,1552449600,0,30,30,Rain
7897,2,1552453200,3,17,20,Rain
7898,3,1552453200,12,8,20,Rain
7899,4,1552453200,18,2,20,Rain
7900,5,1552453200,9,31,40,Rain
7901,6,1552453200,19,1,20,Rain
7902,7,1552453200,27,2,29,Rain
7903,8,1552453200,26,4,30,Rain
7904,9,1552453200,24,0,24,Rain
7905,10,1552453200,14,2,16,Rain
7906,11,1552453200,30,0,30,Rain
7907,12,1552453200,8,12,20,Rain
7908,13,1552453200,25,5,30,Rain
7909,14,1552453200,25,5,30,Rain
7910,15,1552453200,14,2,16,Rain
7911,16,1552453200,17,3,20,Rain
7912,17,1552453200,19,1,20,Rain
7913,18,1552453200,16,14,30,Rain
7914,19,1552453200,22,8,30,Rain
7915,21,1552453200,29,1,30,Rain
7916,22,1552453200,16,4,20,Rain
7917,23,1552453200,18,12,30,Rain
7918,24,1552453200,17,3,20,Rain
7919,25,1552453200,24,6,30,Rain
7920,26,1552453200,20,0,20,Rain
7921,27,1552453200,20,0,20,Rain
7922,28,1552453200,19,11,30,Rain
7923,29,1552453200,27,2,29,Rain
7924,30,1552453200,19,1,20,Rain
7925,31,1552453200,16,4,20,Rain
7926,32,1552453200,25,5,30,Rain
7927,33,1552453200,23,0,23,Rain
7928,34,1552453200,10,20,30,Rain
7929,35,1552453200,21,9,30,Rain
7930,36,1552453200,40,0,40,Rain
7931,37,1552453200,30,0,30,Rain
7932,38,1552453200,38,2,40,Rain
7933,39,1552453200,17,3,20,Rain
7934,40,1552453200,19,2,21,Rain
7935,41,1552453200,15,5,20,Rain
7936,42,1552453200,19,11,30,Rain
7937,43,1552453200,7,23,30,Rain
7938,44,1552453200,2,28,30,Rain
7939,45,1552453200,3,27,30,Rain
7940,46,1552453200,20,0,20,Rain
7941,47,1552453200,38,2,40,Rain
7942,48,1552453200,35,5,40,Rain
7943,49,1552453200,33,7,40,Rain
7944,50,1552453200,7,33,40,Rain
7945,51,1552453200,40,0,40,Rain
7946,52,1552453200,32,0,32,Rain
7947,53,1552453200,40,0,40,Rain
7948,54,1552453200,33,0,33,Rain
7949,55,1552453200,35,1,36,Rain
7950,56,1552453200,31,9,40,Rain
7951,57,1552453200,22,1,23,Rain
7952,58,1552453200,33,7,40,Rain
7953,59,1552453200,18,2,20,Rain
7954,60,1552453200,8,22,30,Rain
7955,61,1552453200,7,18,25,Rain
7956,62,1552453200,40,0,40,Rain
7957,63,1552453200,22,13,35,Rain
7958,64,1552453200,9,31,40,Rain
7959,65,1552453200,38,2,40,Rain
7960,66,1552453200,21,19,40,Rain
7961,67,1552453200,7,32,39,Rain
7962,68,1552453200,34,6,40,Rain
7963,69,1552453200,35,5,40,Rain
7964,70,1552453200,0,28,28,Rain
7965,71,1552453200,39,1,40,Rain
7966,72,1552453200,15,10,25,Rain
7967,73,1552453200,2,28,30,Rain
7968,74,1552453200,1,29,30,Rain
7969,75,1552453200,24,16,40,Rain
7970,76,1552453200,4,34,38,Rain
7971,77,1552453200,23,6,29,Rain
7972,78,1552453200,17,23,40,Rain
7973,79,1552453200,6,21,27,Rain
7974,80,1552453200,18,22,40,Rain
7975,81,1552453200,39,1,40,Rain
7976,82,1552453200,11,11,22,Rain
7977,83,1552453200,24,16,40,Rain
7978,84,1552453200,3,27,30,Rain
7979,85,1552453200,17,18,35,Rain
7980,86,1552453200,8,30,38,Rain
7981,87,1552453200,21,17,38,Rain
7982,88,1552453200,4,26,30,Rain
7983,89,1552453200,34,6,40,Rain
7984,90,1552453200,34,6,40,Rain
7985,91,1552453200,23,7,30,Rain
7986,92,1552453200,5,35,40,Rain
7987,93,1552453200,0,40,40,Rain
7988,94,1552453200,13,27,40,Rain
7989,95,1552453200,20,20,40,Rain
7990,96,1552453200,22,8,30,Rain
7991,97,1552453200,18,22,40,Rain
7992,98,1552453200,40,0,40,Rain
7993,99,1552453200,11,19,30,Rain
7994,100,1552453200,1,24,25,Rain
7995,101,1552453200,18,12,30,Rain
7996,102,1552453200,33,7,40,Rain
7997,103,1552453200,40,0,40,Rain
7998,104,1552453200,40,0,40,Rain
7999,105,1552453200,33,3,36,Rain
8000,106,1552453200,33,7,40,Rain
8001,107,1552453200,25,15,40,Rain
8002,108,1552453200,30,10,40,Rain
8003,109,1552453200,0,29,29,Rain
8004,110,1552453200,18,22,40,Rain
8005,111,1552453200,9,31,40,Rain
8006,112,1552453200,7,23,30,Rain
8007,113,1552453200,32,8,40,Rain
8008,114,1552453200,39,1,40,Rain
8009,115,1552453200,0,30,30,Rain
8010,2,1552456800,3,17,20,Rain
8011,3,1552456800,12,8,20,Rain
8012,4,1552456800,18,2,20,Rain
8013,5,1552456800,9,31,40,Rain
8014,6,1552456800,19,1,20,Rain
8015,7,1552456800,27,2,29,Rain
8016,8,1552456800,26,4,30,Rain
8017,9,1552456800,24,0,24,Rain
8018,10,1552456800,14,2,16,Rain
8019,11,1552456800,30,0,30,Rain
8020,12,1552456800,8,12,20,Rain
8021,13,1552456800,25,5,30,Rain
8022,14,1552456800,25,5,30,Rain
8023,15,1552456800,14,2,16,Rain
8024,16,1552456800,17,3,20,Rain
8025,17,1552456800,19,1,20,Rain
8026,18,1552456800,16,14,30,Rain
8027,19,1552456800,22,8,30,Rain
8028,21,1552456800,29,1,30,Rain
8029,22,1552456800,16,4,20,Rain
8030,23,1552456800,18,12,30,Rain
8031,24,1552456800,17,3,20,Rain
8032,25,1552456800,24,6,30,Rain
8033,26,1552456800,20,0,20,Rain
8034,27,1552456800,20,0,20,Rain
8035,28,1552456800,19,11,30,Rain
8036,29,1552456800,27,2,29,Rain
8037,30,1552456800,19,1,20,Rain
8038,31,1552456800,16,4,20,Rain
8039,32,1552456800,25,5,30,Rain
8040,33,1552456800,23,0,23,Rain
8041,34,1552456800,10,20,30,Rain
8042,35,1552456800,21,9,30,Rain
8043,36,1552456800,40,0,40,Rain
8044,37,1552456800,30,0,30,Rain
8045,38,1552456800,38,2,40,Rain
8046,39,1552456800,17,3,20,Rain
8047,40,1552456800,19,2,21,Rain
8048,41,1552456800,15,5,20,Rain
8049,42,1552456800,19,11,30,Rain
8050,43,1552456800,7,23,30,Rain
8051,44,1552456800,2,28,30,Rain
8052,45,1552456800,3,27,30,Rain
8053,46,1552456800,20,0,20,Rain
8054,47,1552456800,38,2,40,Rain
8055,48,1552456800,35,5,40,Rain
8056,49,1552456800,33,7,40,Rain
8057,50,1552456800,7,33,40,Rain
8058,51,1552456800,40,0,40,Rain
8059,52,1552456800,32,0,32,Rain
8060,53,1552456800,40,0,40,Rain
8061,54,1552456800,33,0,33,Rain
8062,55,1552456800,35,1,36,Rain
8063,56,1552456800,31,9,40,Rain
8064,57,1552456800,22,1,23,Rain
8065,58,1552456800,33,7,40,Rain
8066,59,1552456800,18,2,20,Rain
8067,60,1552456800,8,22,30,Rain
8068,61,1552456800,7,18,25,Rain
8069,62,1552456800,40,0,40,Rain
8070,63,1552456800,22,13,35,Rain
8071,64,1552456800,9,31,40,Rain
8072,65,1552456800,38,2,40,Rain
8073,66,1552456800,21,19,40,Rain
8074,67,1552456800,7,32,39,Rain
8075,68,1552456800,34,6,40,Rain
8076,69,1552456800,35,5,40,Rain
8077,70,1552456800,0,28,28,Rain
8078,71,1552456800,39,1,40,Rain
8079,72,1552456800,15,10,25,Rain
8080,73,1552456800,2,28,30,Rain
8081,74,1552456800,1,29,30,Rain
8082,75,1552456800,24,16,40,Rain
8083,76,1552456800,4,34,38,Rain
8084,77,1552456800,23,6,29,Rain
8085,78,1552456800,17,23,40,Rain
8086,79,1552456800,6,21,27,Rain
8087,80,1552456800,20,20,40,Rain
8088,81,1552456800,39,1,40,Rain
8089,82,1552456800,11,11,22,Rain
8090,83,1552456800,24,16,40,Rain
8091,84,1552456800,3,27,30,Rain
8092,85,1552456800,17,18,35,Rain
8093,86,1552456800,8,30,38,Rain
8094,87,1552456800,21,17,38,Rain
8095,88,1552456800,4,26,30,Rain
8096,89,1552456800,34,6,40,Rain
8097,90,1552456800,34,6,40,Rain
8098,91,1552456800,23,7,30,Rain
8099,92,1552456800,5,35,40,Rain
8100,93,1552456800,0,40,40,Rain
8101,94,1552456800,13,27,40,Rain
8102,95,1552456800,20,20,40,Rain
8103,96,1552456800,22,8,30,Rain
8104,97,1552456800,18,22,40,Rain
8105,98,1552456800,40,0,40,Rain
8106,99,1552456800,11,19,30,Rain
8107,100,1552456800,1,24,25,Rain
8108,101,1552456800,18,12,30,Rain
8109,102,1552456800,33,7,40,Rain
8110,103,1552456800,40,0,40,Rain
8111,104,1552456800,40,0,40,Rain
8112,105,1552456800,33,3,36,Rain
8113,106,1552456800,33,7,40,Rain
8114,107,1552456800,25,15,40,Rain
8115,108,1552456800,30,10,40,Rain
8116,109,1552456800,0,29,29,Rain
8117,110,1552456800,18,22,40,Rain
8118,111,1552456800,9,31,40,Rain
8119,112,1552456800,7,23,30,Rain
8120,113,1552456800,32,8,40,Rain
8121,114,1552456800,39,1,40,Rain
8122,115,1552456800,0,30,30,Rain
8123,2,1552460400,3,17,20,Clouds
8124,3,1552460400,12,8,20,Clouds
8125,4,1552460400,20,0,20,Clouds
8126,5,1552460400,10,30,40,Clouds
8127,6,1552460400,19,1,20,Clouds
8128,7,1552460400,27,2,29,Clouds
8129,8,1552460400,26,4,30,Clouds
8130,9,1552460400,22,2,24,Clouds
8131,10,1552460400,12,4,16,Clouds
8132,11,1552460400,30,0,30,Clouds
8133,12,1552460400,9,11,20,Clouds
8134,13,1552460400,25,5,30,Clouds
8135,14,1552460400,17,13,30,Clouds
8136,15,1552460400,16,0,16,Clouds
8137,16,1552460400,17,3,20,Clouds
8138,17,1552460400,18,2,20,Clouds
8139,18,1552460400,17,13,30,Clouds
8140,19,1552460400,20,10,30,Clouds
8141,21,1552460400,29,1,30,Clouds
8142,22,1552460400,15,5,20,Clouds
8143,23,1552460400,20,10,30,Clouds
8144,24,1552460400,14,6,20,Clouds
8145,25,1552460400,23,7,30,Clouds
8146,26,1552460400,20,0,20,Clouds
8147,27,1552460400,19,1,20,Clouds
8148,28,1552460400,22,8,30,Clouds
8149,29,1552460400,23,6,29,Clouds
8150,30,1552460400,19,1,20,Clouds
8151,31,1552460400,17,3,20,Clouds
8152,32,1552460400,20,10,30,Clouds
8153,33,1552460400,16,7,23,Clouds
8154,34,1552460400,12,18,30,Clouds
8155,35,1552460400,29,1,30,Clouds
8156,36,1552460400,38,2,40,Clouds
8157,37,1552460400,30,0,30,Clouds
8158,38,1552460400,38,2,40,Clouds
8159,39,1552460400,20,0,20,Clouds
8160,40,1552460400,16,5,21,Clouds
8161,41,1552460400,14,6,20,Clouds
8162,42,1552460400,19,11,30,Clouds
8163,43,1552460400,12,18,30,Clouds
8164,44,1552460400,7,23,30,Clouds
8165,45,1552460400,3,27,30,Clouds
8166,46,1552460400,20,0,20,Clouds
8167,47,1552460400,39,1,40,Clouds
8168,48,1552460400,36,4,40,Clouds
8169,49,1552460400,30,10,40,Clouds
8170,50,1552460400,8,32,40,Clouds
8171,51,1552460400,39,1,40,Clouds
8172,52,1552460400,26,6,32,Clouds
8173,53,1552460400,39,1,40,Clouds
8174,54,1552460400,32,1,33,Clouds
8175,55,1552460400,35,1,36,Clouds
8176,56,1552460400,32,8,40,Clouds
8177,57,1552460400,20,3,23,Clouds
8178,58,1552460400,32,8,40,Clouds
8179,59,1552460400,18,2,20,Clouds
8180,60,1552460400,10,20,30,Clouds
8181,61,1552460400,8,17,25,Clouds
8182,62,1552460400,38,2,40,Clouds
8183,63,1552460400,22,13,35,Clouds
8184,64,1552460400,9,31,40,Clouds
8185,65,1552460400,39,1,40,Clouds
8186,66,1552460400,18,22,40,Clouds
8187,67,1552460400,24,16,40,Clouds
8188,68,1552460400,33,7,40,Clouds
8189,69,1552460400,32,8,40,Clouds
8190,70,1552460400,0,28,28,Clouds
8191,71,1552460400,38,2,40,Clouds
8192,72,1552460400,17,8,25,Clouds
8193,73,1552460400,3,27,30,Clouds
8194,74,1552460400,2,28,30,Clouds
8195,75,1552460400,25,15,40,Clouds
8196,76,1552460400,7,31,38,Clouds
8197,77,1552460400,22,7,29,Clouds
8198,78,1552460400,18,22,40,Clouds
8199,79,1552460400,6,21,27,Clouds
8200,80,1552460400,22,18,40,Clouds
8201,81,1552460400,39,1,40,Clouds
8202,82,1552460400,11,11,22,Clouds
8203,83,1552460400,25,15,40,Clouds
8204,84,1552460400,8,22,30,Clouds
8205,85,1552460400,17,18,35,Clouds
8206,86,1552460400,9,29,38,Clouds
8207,87,1552460400,22,16,38,Clouds
8208,88,1552460400,3,27,30,Clouds
8209,89,1552460400,35,5,40,Clouds
8210,90,1552460400,33,7,40,Clouds
8211,91,1552460400,23,7,30,Clouds
8212,92,1552460400,7,33,40,Clouds
8213,93,1552460400,0,40,40,Clouds
8214,94,1552460400,13,27,40,Clouds
8215,95,1552460400,21,19,40,Clouds
8216,96,1552460400,22,8,30,Clouds
8217,97,1552460400,22,18,40,Clouds
8218,98,1552460400,40,0,40,Clouds
8219,99,1552460400,9,21,30,Clouds
8220,100,1552460400,1,24,25,Clouds
8221,101,1552460400,21,9,30,Clouds
8222,102,1552460400,33,7,40,Clouds
8223,103,1552460400,40,0,40,Clouds
8224,104,1552460400,22,18,40,Clouds
8225,105,1552460400,34,2,36,Clouds
8226,106,1552460400,33,7,40,Clouds
8227,107,1552460400,31,9,40,Clouds
8228,108,1552460400,31,9,40,Clouds
8229,109,1552460400,3,26,29,Clouds
8230,110,1552460400,18,22,40,Clouds
8231,111,1552460400,11,29,40,Clouds
8232,112,1552460400,9,21,30,Clouds
8233,113,1552460400,31,9,40,Clouds
8234,114,1552460400,39,1,40,Clouds
8235,115,1552460400,1,29,30,Clouds
8236,2,1552464000,10,10,20,Rain
8237,3,1552464000,14,6,20,Rain
8238,4,1552464000,18,2,20,Rain
8239,5,1552464000,8,32,40,Rain
8240,6,1552464000,18,2,20,Rain
8241,7,1552464000,26,3,29,Rain
8242,8,1552464000,18,12,30,Rain
8243,9,1552464000,10,14,24,Rain
8244,10,1552464000,12,4,16,Rain
8245,11,1552464000,27,3,30,Rain
8246,12,1552464000,16,4,20,Rain
8247,13,1552464000,25,5,30,Rain
8248,14,1552464000,14,16,30,Rain
8249,15,1552464000,16,0,16,Rain
8250,16,1552464000,18,2,20,Rain
8251,17,1552464000,18,2,20,Rain
8252,18,1552464000,14,16,30,Rain
8253,19,1552464000,26,4,30,Rain
8254,21,1552464000,26,4,30,Rain
8255,22,1552464000,14,6,20,Rain
8256,23,1552464000,17,13,30,Rain
8257,24,1552464000,15,5,20,Rain
8258,25,1552464000,18,12,30,Rain
8259,26,1552464000,13,6,19,Rain
8260,27,1552464000,15,5,20,Rain
8261,28,1552464000,11,19,30,Rain
8262,29,1552464000,21,8,29,Rain
8263,30,1552464000,14,6,20,Rain
8264,31,1552464000,2,18,20,Rain
8265,32,1552464000,17,13,30,Rain
8266,33,1552464000,19,4,23,Rain
8267,34,1552464000,30,0,30,Rain
8268,35,1552464000,30,0,30,Rain
8269,36,1552464000,34,6,40,Rain
8270,37,1552464000,30,0,30,Rain
8271,38,1552464000,27,13,40,Rain
8272,39,1552464000,17,3,20,Rain
8273,40,1552464000,15,6,21,Rain
8274,41,1552464000,15,5,20,Rain
8275,42,1552464000,23,7,30,Rain
8276,43,1552464000,27,3,30,Rain
8277,44,1552464000,18,12,30,Rain
8278,45,1552464000,7,23,30,Rain
8279,46,1552464000,18,2,20,Rain
8280,47,1552464000,36,4,40,Rain
8281,48,1552464000,37,3,40,Rain
8282,49,1552464000,29,11,40,Rain
8283,50,1552464000,12,28,40,Rain
8284,51,1552464000,33,7,40,Rain
8285,52,1552464000,25,7,32,Rain
8286,53,1552464000,39,1,40,Rain
8287,54,1552464000,28,5,33,Rain
8288,55,1552464000,31,5,36,Rain
8289,56,1552464000,37,3,40,Rain
8290,57,1552464000,22,1,23,Rain
8291,58,1552464000,21,19,40,Rain
8292,59,1552464000,19,1,20,Rain
8293,60,1552464000,18,12,30,Rain
8294,61,1552464000,15,10,25,Rain
8295,62,1552464000,34,6,40,Rain
8296,63,1552464000,21,14,35,Rain
8297,64,1552464000,24,16,40,Rain
8298,65,1552464000,32,8,40,Rain
8299,66,1552464000,24,16,40,Rain
8300,67,1552464000,20,20,40,Rain
8301,68,1552464000,17,23,40,Rain
8302,69,1552464000,22,18,40,Rain
8303,70,1552464000,11,17,28,Rain
8304,71,1552464000,40,0,40,Rain
8305,72,1552464000,21,4,25,Rain
8306,73,1552464000,12,18,30,Rain
8307,74,1552464000,6,24,30,Rain
8308,75,1552464000,27,13,40,Rain
8309,76,1552464000,12,26,38,Rain
8310,77,1552464000,25,4,29,Rain
8311,78,1552464000,20,20,40,Rain
8312,79,1552464000,4,23,27,Rain
8313,80,1552464000,22,18,40,Rain
8314,81,1552464000,39,1,40,Rain
8315,82,1552464000,15,7,22,Rain
8316,83,1552464000,5,35,40,Rain
8317,84,1552464000,14,16,30,Rain
8318,85,1552464000,22,13,35,Rain
8319,86,1552464000,16,22,38,Rain
8320,87,1552464000,24,14,38,Rain
8321,88,1552464000,7,23,30,Rain
8322,89,1552464000,35,5,40,Rain
8323,90,1552464000,24,16,40,Rain
8324,91,1552464000,25,5,30,Rain
8325,92,1552464000,10,30,40,Rain
8326,93,1552464000,11,29,40,Rain
8327,94,1552464000,14,26,40,Rain
8328,95,1552464000,24,16,40,Rain
8329,96,1552464000,23,7,30,Rain
8330,97,1552464000,26,14,40,Rain
8331,98,1552464000,38,2,40,Rain
8332,99,1552464000,3,27,30,Rain
8333,100,1552464000,9,16,25,Rain
8334,101,1552464000,26,4,30,Rain
8335,102,1552464000,36,4,40,Rain
8336,103,1552464000,40,0,40,Rain
8337,104,1552464000,23,17,40,Rain
8338,105,1552464000,34,2,36,Rain
8339,106,1552464000,35,5,40,Rain
8340,107,1552464000,32,8,40,Rain
8341,108,1552464000,37,3,40,Rain
8342,109,1552464000,11,18,29,Rain
8343,110,1552464000,19,21,40,Rain
8344,111,1552464000,19,21,40,Rain
8345,112,1552464000,22,8,30,Rain
8346,113,1552464000,30,10,40,Rain
8347,114,1552464000,35,5,40,Rain
8348,115,1552464000,3,27,30,Rain
8349,2,1552467600,19,1,20,Rain
8350,3,1552467600,14,6,20,Rain
8351,4,1552467600,18,2,20,Rain
8352,5,1552467600,38,2,40,Rain
8353,6,1552467600,20,0,20,Rain
8354,7,1552467600,29,0,29,Rain
8355,8,1552467600,30,0,30,Rain
8356,9,1552467600,3,21,24,Rain
8357,10,1552467600,10,6,16,Rain
8358,11,1552467600,18,12,30,Rain
8359,12,1552467600,20,0,20,Rain
8360,13,1552467600,23,7,30,Rain
8361,14,1552467600,23,7,30,Rain
8362,15,1552467600,16,0,16,Rain
8363,16,1552467600,16,4,20,Rain
8364,17,1552467600,15,5,20,Rain
8365,18,1552467600,20,10,30,Rain
8366,19,1552467600,2,28,30,Rain
8367,21,1552467600,26,4,30,Rain
8368,22,1552467600,15,5,20,Rain
8369,23,1552467600,20,10,30,Rain
8370,24,1552467600,16,4,20,Rain
8371,25,1552467600,7,23,30,Rain
8372,26,1552467600,8,11,19,Rain
8373,27,1552467600,12,8,20,Rain
8374,28,1552467600,20,10,30,Rain
8375,29,1552467600,22,7,29,Rain
8376,30,1552467600,19,1,20,Rain
8377,31,1552467600,1,19,20,Rain
8378,32,1552467600,16,14,30,Rain
8379,33,1552467600,14,9,23,Rain
8380,34,1552467600,30,0,30,Rain
8381,35,1552467600,28,2,30,Rain
8382,36,1552467600,28,12,40,Rain
8383,37,1552467600,25,5,30,Rain
8384,38,1552467600,23,17,40,Rain
8385,39,1552467600,20,0,20,Rain
8386,40,1552467600,7,14,21,Rain
8387,41,1552467600,16,4,20,Rain
8388,42,1552467600,29,1,30,Rain
8389,43,1552467600,30,0,30,Rain
8390,44,1552467600,24,6,30,Rain
8391,45,1552467600,10,20,30,Rain
8392,46,1552467600,18,2,20,Rain
8393,47,1552467600,33,7,40,Rain
8394,48,1552467600,30,10,40,Rain
8395,49,1552467600,30,10,40,Rain
8396,50,1552467600,34,6,40,Rain
8397,51,1552467600,31,9,40,Rain
8398,52,1552467600,12,20,32,Rain
8399,53,1552467600,31,9,40,Rain
8400,54,1552467600,25,8,33,Rain
8401,55,1552467600,31,4,35,Rain
8402,56,1552467600,20,20,40,Rain
8403,57,1552467600,16,7,23,Rain
8404,58,1552467600,8,31,39,Rain
8405,59,1552467600,16,4,20,Rain
8406,60,1552467600,18,12,30,Rain
8407,61,1552467600,21,4,25,Rain
8408,62,1552467600,22,17,39,Rain
8409,63,1552467600,13,22,35,Rain
8410,64,1552467600,22,18,40,Rain
8411,65,1552467600,29,10,39,Rain
8412,66,1552467600,12,27,39,Rain
8413,67,1552467600,18,22,40,Rain
8414,68,1552467600,14,25,39,Rain
8415,69,1552467600,11,29,40,Rain
8416,70,1552467600,5,22,27,Rain
8417,71,1552467600,35,5,40,Rain
8418,72,1552467600,25,0,25,Rain
8419,73,1552467600,27,3,30,Rain
8420,74,1552467600,9,21,30,Rain
8421,75,1552467600,37,3,40,Rain
8422,76,1552467600,19,19,38,Rain
8423,77,1552467600,25,4,29,Rain
8424,78,1552467600,22,18,40,Rain
8425,79,1552467600,2,25,27,Rain
8426,80,1552467600,25,15,40,Rain
8427,81,1552467600,36,4,40,Rain
8428,82,1552467600,15,7,22,Rain
8429,83,1552467600,16,24,40,Rain
8430,84,1552467600,26,4,30,Rain
8431,85,1552467600,33,2,35,Rain
8432,86,1552467600,27,11,38,Rain
8433,87,1552467600,29,9,38,Rain
8434,88,1552467600,14,16,30,Rain
8435,89,1552467600,27,13,40,Rain
8436,90,1552467600,17,23,40,Rain
8437,91,1552467600,20,10,30,Rain
8438,92,1552467600,16,24,40,Rain
8439,93,1552467600,25,15,40,Rain
8440,94,1552467600,19,21,40,Rain
8441,95,1552467600,38,2,40,Rain
8442,96,1552467600,27,3,30,Rain
8443,97,1552467600,40,0,40,Rain
8444,98,1552467600,33,7,40,Rain
8445,99,1552467600,23,7,30,Rain
8446,100,1552467600,25,0,25,Rain
8447,101,1552467600,30,0,30,Rain
8448,102,1552467600,40,0,40,Rain
8449,103,1552467600,40,0,40,Rain
8450,104,1552467600,21,19,40,Rain
8451,105,1552467600,34,2,36,Rain
8452,106,1552467600,39,1,40,Rain
8453,107,1552467600,40,0,40,Rain
8454,108,1552467600,40,0,40,Rain
8455,109,1552467600,17,12,29,Rain
8456,110,1552467600,25,15,40,Rain
8457,111,1552467600,32,8,40,Rain
8458,112,1552467600,30,0,30,Rain
8459,113,1552467600,25,15,40,Rain
8460,114,1552467600,30,10,40,Rain
8461,115,1552467600,20,10,30,Rain
8462,2,1552471200,20,0,20,Rain
8463,3,1552471200,17,3,20,Rain
8464,4,1552471200,20,0,20,Rain
8465,5,1552471200,34,6,40,Rain
8466,6,1552471200,19,1,20,Rain
8467,7,1552471200,28,1,29,Rain
8468,8,1552471200,18,12,30,Rain
8469,9,1552471200,15,8,23,Rain
8470,10,1552471200,15,1,16,Rain
8471,11,1552471200,17,13,30,Rain
8472,12,1552471200,20,0,20,Rain
8473,13,1552471200,18,12,30,Rain
8474,14,1552471200,29,1,30,Rain
8475,15,1552471200,14,2,16,Rain
8476,16,1552471200,12,8,20,Rain
8477,17,1552471200,20,0,20,Rain
8478,18,1552471200,24,6,30,Rain
8479,19,1552471200,1,29,30,Rain
8480,21,1552471200,20,10,30,Rain
8481,22,1552471200,20,0,20,Rain
8482,23,1552471200,16,14,30,Rain
8483,24,1552471200,16,4,20,Rain
8484,25,1552471200,0,29,29,Rain
8485,26,1552471200,0,19,19,Rain
8486,27,1552471200,18,2,20,Rain
8487,28,1552471200,29,1,30,Rain
8488,29,1552471200,27,2,29,Rain
8489,30,1552471200,20,0,20,Rain
8490,31,1552471200,2,18,20,Rain
8491,32,1552471200,15,15,30,Rain
8492,33,1552471200,2,21,23,Rain
8493,34,1552471200,29,1,30,Rain
8494,35,1552471200,30,0,30,Rain
8495,36,1552471200,9,31,40,Rain
8496,37,1552471200,25,5,30,Rain
8497,38,1552471200,38,2,40,Rain
8498,39,1552471200,17,2,19,Rain
8499,40,1552471200,11,10,21,Rain
8500,41,1552471200,18,2,20,Rain
8501,42,1552471200,29,1,30,Rain
8502,43,1552471200,30,0,30,Rain
8503,44,1552471200,30,0,30,Rain
8504,45,1552471200,25,5,30,Rain
8505,46,1552471200,18,2,20,Rain
8506,47,1552471200,8,32,40,Rain
8507,48,1552471200,16,24,40,Rain
8508,49,1552471200,22,18,40,Rain
8509,50,1552471200,39,1,40,Rain
8510,51,1552471200,31,9,40,Rain
8511,52,1552471200,9,23,32,Rain
8512,53,1552471200,22,18,40,Rain
8513,54,1552471200,23,9,32,Rain
8514,55,1552471200,30,5,35,Rain
8515,56,1552471200,0,40,40,Rain
8516,57,1552471200,0,22,22,Rain
8517,58,1552471200,11,28,39,Rain
8518,59,1552471200,19,1,20,Rain
8519,60,1552471200,29,1,30,Rain
8520,61,1552471200,25,0,25,Rain
8521,62,1552471200,0,37,37,Rain
8522,63,1552471200,0,34,34,Rain
8523,64,1552471200,6,33,39,Rain
8524,65,1552471200,10,29,39,Rain
8525,66,1552471200,13,26,39,Rain
8526,67,1552471200,24,16,40,Rain
8527,68,1552471200,0,39,39,Rain
8528,69,1552471200,0,40,40,Rain
8529,70,1552471200,12,14,26,Rain
8530,71,1552471200,40,0,40,Rain
8531,72,1552471200,25,0,25,Rain
8532,73,1552471200,30,0,30,Rain
8533,74,1552471200,30,0,30,Rain
8534,75,1552471200,39,1,40,Rain
8535,76,1552471200,38,0,38,Rain
8536,77,1552471200,27,2,29,Rain
8537,78,1552471200,39,1,40,Rain
8538,79,1552471200,11,16,27,Rain
8539,80,1552471200,40,0,40,Rain
8540,81,1552471200,40,0,40,Rain
8541,82,1552471200,22,0,22,Rain
8542,83,1552471200,39,1,40,Rain
8543,84,1552471200,30,0,30,Rain
8544,85,1552471200,35,0,35,Rain
8545,86,1552471200,38,0,38,Rain
8546,87,1552471200,38,0,38,Rain
8547,88,1552471200,30,0,30,Rain
8548,89,1552471200,21,18,39,Rain
8549,90,1552471200,0,39,39,Rain
8550,91,1552471200,20,7,27,Rain
8551,92,1552471200,40,0,40,Rain
8552,93,1552471200,40,0,40,Rain
8553,94,1552471200,39,1,40,Rain
8554,95,1552471200,40,0,40,Rain
8555,96,1552471200,30,0,30,Rain
8556,97,1552471200,40,0,40,Rain
8557,98,1552471200,36,3,39,Rain
8558,99,1552471200,10,20,30,Rain
8559,100,1552471200,25,0,25,Rain
8560,101,1552471200,30,0,30,Rain
8561,102,1552471200,40,0,40,Rain
8562,103,1552471200,38,2,40,Rain
8563,104,1552471200,29,11,40,Rain
8564,105,1552471200,36,0,36,Rain
8565,106,1552471200,40,0,40,Rain
8566,107,1552471200,39,1,40,Rain
8567,108,1552471200,40,0,40,Rain
8568,109,1552471200,28,1,29,Rain
8569,110,1552471200,35,5,40,Rain
8570,111,1552471200,37,3,40,Rain
8571,112,1552471200,30,0,30,Rain
8572,113,1552471200,13,27,40,Rain
8573,114,1552471200,34,3,37,Rain
8574,115,1552471200,30,0,30,Rain
8575,2,1552474800,20,0,20,Clouds
8576,3,1552474800,13,7,20,Clouds
8577,4,1552474800,20,0,20,Clouds
8578,5,1552474800,23,17,40,Clouds
8579,6,1552474800,20,0,20,Clouds
8580,7,1552474800,28,1,29,Clouds
8581,8,1552474800,8,22,30,Clouds
8582,9,1552474800,5,18,23,Clouds
8583,10,1552474800,16,0,16,Clouds
8584,11,1552474800,12,18,30,Clouds
8585,12,1552474800,20,0,20,Clouds
8586,13,1552474800,12,18,30,Clouds
8587,14,1552474800,27,3,30,Clouds
8588,15,1552474800,16,0,16,Clouds
8589,16,1552474800,11,9,20,Clouds
8590,17,1552474800,16,4,20,Clouds
8591,18,1552474800,30,0,30,Clouds
8592,19,1552474800,2,28,30,Clouds
8593,21,1552474800,11,19,30,Clouds
8594,22,1552474800,19,1,20,Clouds
8595,23,1552474800,19,11,30,Clouds
8596,24,1552474800,19,1,20,Clouds
8597,25,1552474800,0,29,29,Clouds
8598,26,1552474800,0,19,19,Clouds
8599,27,1552474800,15,5,20,Clouds
8600,28,1552474800,30,0,30,Clouds
8601,29,1552474800,23,6,29,Clouds
8602,30,1552474800,18,2,20,Clouds
8603,31,1552474800,5,15,20,Clouds
8604,32,1552474800,17,13,30,Clouds
8605,33,1552474800,2,21,23,Clouds
8606,34,1552474800,30,0,30,Clouds
8607,35,1552474800,30,0,30,Clouds
8608,36,1552474800,0,40,40,Clouds
8609,37,1552474800,21,9,30,Clouds
8610,38,1552474800,40,0,40,Clouds
8611,39,1552474800,17,3,20,Clouds
8612,40,1552474800,11,9,20,Clouds
8613,41,1552474800,17,3,20,Clouds
8614,42,1552474800,27,3,30,Clouds
8615,43,1552474800,30,0,30,Clouds
8616,44,1552474800,30,0,30,Clouds
8617,45,1552474800,30,0,30,Clouds
8618,46,1552474800,19,1,20,Clouds
8619,47,1552474800,1,39,40,Clouds
8620,48,1552474800,1,38,39,Clouds
8621,49,1552474800,0,40,40,Clouds
8622,50,1552474800,40,0,40,Clouds
8623,51,1552474800,30,10,40,Clouds
8624,52,1552474800,10,22,32,Clouds
8625,53,1552474800,13,27,40,Clouds
8626,54,1552474800,11,21,32,Clouds
8627,55,1552474800,30,5,35,Clouds
8628,56,1552474800,1,38,39,Clouds
8629,57,1552474800,0,22,22,Clouds
8630,58,1552474800,0,38,38,Clouds
8631,59,1552474800,20,0,20,Clouds
8632,60,1552474800,30,0,30,Clouds
8633,61,1552474800,18,7,25,Clouds
8634,62,1552474800,8,29,37,Clouds
8635,63,1552474800,1,33,34,Clouds
8636,64,1552474800,10,29,39,Clouds
8637,65,1552474800,0,39,39,Clouds
8638,66,1552474800,7,32,39,Clouds
8639,67,1552474800,17,22,39,Clouds
8640,68,1552474800,7,32,39,Clouds
8641,69,1552474800,3,37,40,Clouds
8642,70,1552474800,0,25,25,Clouds
8643,71,1552474800,38,2,40,Clouds
8644,72,1552474800,24,1,25,Clouds
8645,73,1552474800,27,3,30,Clouds
8646,74,1552474800,29,1,30,Clouds
8647,75,1552474800,38,2,40,Clouds
8648,76,1552474800,38,0,38,Clouds
8649,77,1552474800,23,5,28,Clouds
8650,78,1552474800,40,0,40,Clouds
8651,79,1552474800,25,2,27,Clouds
8652,80,1552474800,36,4,40,Clouds
8653,81,1552474800,40,0,40,Clouds
8654,82,1552474800,22,0,22,Clouds
8655,83,1552474800,40,0,40,Clouds
8656,84,1552474800,30,0,30,Clouds
8657,85,1552474800,35,0,35,Clouds
8658,86,1552474800,38,0,38,Clouds
8659,87,1552474800,38,0,38,Clouds
8660,88,1552474800,30,0,30,Clouds
8661,89,1552474800,14,25,39,Clouds
8662,90,1552474800,0,39,39,Clouds
8663,91,1552474800,11,16,27,Clouds
8664,92,1552474800,40,0,40,Clouds
8665,93,1552474800,39,1,40,Clouds
8666,94,1552474800,40,0,40,Clouds
8667,95,1552474800,40,0,40,Clouds
8668,96,1552474800,30,0,30,Clouds
8669,97,1552474800,40,0,40,Clouds
8670,98,1552474800,34,5,39,Clouds
8671,99,1552474800,0,30,30,Clouds
8672,100,1552474800,25,0,25,Clouds
8673,101,1552474800,29,1,30,Clouds
8674,102,1552474800,40,0,40,Clouds
8675,103,1552474800,36,4,40,Clouds
8676,104,1552474800,34,6,40,Clouds
8677,105,1552474800,36,0,36,Clouds
8678,106,1552474800,40,0,40,Clouds
8679,107,1552474800,40,0,40,Clouds
8680,108,1552474800,40,0,40,Clouds
8681,109,1552474800,28,1,29,Clouds
8682,110,1552474800,40,0,40,Clouds
8683,111,1552474800,39,1,40,Clouds
8684,112,1552474800,30,0,30,Clouds
8685,113,1552474800,0,40,40,Clouds
8686,114,1552474800,20,17,37,Clouds
8687,115,1552474800,29,1,30,Clouds
8688,2,1552478400,13,7,20,Rain
8689,3,1552478400,15,5,20,Rain
8690,4,1552478400,20,0,20,Rain
8691,5,1552478400,35,5,40,Rain
8692,6,1552478400,19,1,20,Rain
8693,7,1552478400,28,1,29,Rain
8694,8,1552478400,6,23,29,Rain
8695,9,1552478400,2,21,23,Rain
8696,10,1552478400,16,0,16,Rain
8697,11,1552478400,13,17,30,Rain
8698,12,1552478400,20,0,20,Rain
8699,13,1552478400,12,18,30,Rain
8700,14,1552478400,25,5,30,Rain
8701,15,1552478400,15,1,16,Rain
8702,16,1552478400,9,11,20,Rain
8703,17,1552478400,19,1,20,Rain
8704,18,1552478400,30,0,30,Rain
8705,19,1552478400,0,30,30,Rain
8706,21,1552478400,4,26,30,Rain
8707,22,1552478400,19,1,20,Rain
8708,23,1552478400,23,7,30,Rain
8709,24,1552478400,14,6,20,Rain
8710,25,1552478400,10,19,29,Rain
8711,26,1552478400,0,19,19,Rain
8712,27,1552478400,16,4,20,Rain
8713,28,1552478400,17,13,30,Rain
8714,29,1552478400,23,6,29,Rain
8715,30,1552478400,20,0,20,Rain
8716,31,1552478400,2,18,20,Rain
8717,32,1552478400,12,18,30,Rain
8718,33,1552478400,2,21,23,Rain
8719,34,1552478400,13,17,30,Rain
8720,35,1552478400,28,2,30,Rain
8721,36,1552478400,4,36,40,Rain
8722,37,1552478400,22,8,30,Rain
8723,38,1552478400,40,0,40,Rain
8724,39,1552478400,15,5,20,Rain
8725,40,1552478400,6,14,20,Rain
8726,41,1552478400,14,6,20,Rain
8727,42,1552478400,30,0,30,Rain
8728,43,1552478400,16,14,30,Rain
8729,44,1552478400,30,0,30,Rain
8730,45,1552478400,29,1,30,Rain
8731,46,1552478400,18,2,20,Rain
8732,47,1552478400,0,40,40,Rain
8733,48,1552478400,7,32,39,Rain
8734,49,1552478400,7,33,40,Rain
8735,50,1552478400,39,1,40,Rain
8736,51,1552478400,31,9,40,Rain
8737,52,1552478400,11,21,32,Rain
8738,53,1552478400,12,28,40,Rain
8739,54,1552478400,11,21,32,Rain
8740,55,1552478400,30,5,35,Rain
8741,56,1552478400,8,31,39,Rain
8742,57,1552478400,1,22,23,Rain
8743,58,1552478400,10,28,38,Rain
8744,59,1552478400,20,0,20,Rain
8745,60,1552478400,28,2,30,Rain
8746,61,1552478400,25,0,25,Rain
8747,62,1552478400,4,35,39,Rain
8748,63,1552478400,0,34,34,Rain
8749,64,1552478400,11,29,40,Rain
8750,65,1552478400,1,38,39,Rain
8751,66,1552478400,5,34,39,Rain
8752,67,1552478400,18,21,39,Rain
8753,68,1552478400,9,30,39,Rain
8754,69,1552478400,1,39,40,Rain
8755,70,1552478400,3,22,25,Rain
8756,71,1552478400,38,2,40,Rain
8757,72,1552478400,25,0,25,Rain
8758,73,1552478400,29,1,30,Rain
8759,74,1552478400,30,0,30,Rain
8760,75,1552478400,40,0,40,Rain
8761,76,1552478400,37,1,38,Rain
8762,77,1552478400,24,4,28,Rain
8763,78,1552478400,39,1,40,Rain
8764,79,1552478400,19,8,27,Rain
8765,80,1552478400,40,0,40,Rain
8766,81,1552478400,39,1,40,Rain
8767,82,1552478400,22,0,22,Rain
8768,83,1552478400,40,0,40,Rain
8769,84,1552478400,30,0,30,Rain
8770,85,1552478400,35,0,35,Rain
8771,86,1552478400,38,0,38,Rain
8772,87,1552478400,37,1,38,Rain
8773,88,1552478400,30,0,30,Rain
8774,89,1552478400,14,25,39,Rain
8775,90,1552478400,0,39,39,Rain
8776,91,1552478400,12,15,27,Rain
8777,92,1552478400,40,0,40,Rain
8778,93,1552478400,40,0,40,Rain
8779,94,1552478400,40,0,40,Rain
8780,95,1552478400,40,0,40,Rain
8781,96,1552478400,30,0,30,Rain
8782,97,1552478400,40,0,40,Rain
8783,98,1552478400,33,6,39,Rain
8784,99,1552478400,0,30,30,Rain
8785,100,1552478400,25,0,25,Rain
8786,101,1552478400,30,0,30,Rain
8787,102,1552478400,38,2,40,Rain
8788,103,1552478400,35,5,40,Rain
8789,104,1552478400,34,6,40,Rain
8790,105,1552478400,36,0,36,Rain
8791,106,1552478400,40,0,40,Rain
8792,107,1552478400,40,0,40,Rain
8793,108,1552478400,40,0,40,Rain
8794,109,1552478400,29,0,29,Rain
8795,110,1552478400,40,0,40,Rain
8796,111,1552478400,40,0,40,Rain
8797,112,1552478400,30,0,30,Rain
8798,113,1552478400,1,39,40,Rain
8799,114,1552478400,15,22,37,Rain
8800,115,1552478400,30,0,30,Rain
8801,2,1552482000,13,7,20,Rain
8802,3,1552482000,18,2,20,Rain
8803,4,1552482000,20,0,20,Rain
8804,5,1552482000,40,0,40,Rain
8805,6,1552482000,20,0,20,Rain
8806,7,1552482000,27,2,29,Rain
8807,8,1552482000,11,18,29,Rain
8808,9,1552482000,2,21,23,Rain
8809,10,1552482000,16,0,16,Rain
8810,11,1552482000,10,20,30,Rain
8811,12,1552482000,20,0,20,Rain
8812,13,1552482000,6,24,30,Rain
8813,14,1552482000,21,9,30,Rain
8814,15,1552482000,16,0,16,Rain
8815,16,1552482000,11,9,20,Rain
8816,17,1552482000,19,1,20,Rain
8817,18,1552482000,29,1,30,Rain
8818,19,1552482000,5,25,30,Rain
8819,21,1552482000,0,30,30,Rain
8820,22,1552482000,15,5,20,Rain
8821,23,1552482000,25,5,30,Rain
8822,24,1552482000,20,0,20,Rain
8823,25,1552482000,14,15,29,Rain
8824,26,1552482000,0,19,19,Rain
8825,27,1552482000,17,3,20,Rain
8826,28,1552482000,27,3,30,Rain
8827,29,1552482000,23,6,29,Rain
8828,30,1552482000,20,0,20,Rain
8829,31,1552482000,1,19,20,Rain
8830,32,1552482000,7,23,30,Rain
8831,33,1552482000,8,15,23,Rain
8832,34,1552482000,20,10,30,Rain
8833,35,1552482000,30,0,30,Rain
8834,36,1552482000,10,30,40,Rain
8835,37,1552482000,22,8,30,Rain
8836,38,1552482000,34,6,40,Rain
8837,39,1552482000,20,0,20,Rain
8838,40,1552482000,9,11,20,Rain
8839,41,1552482000,16,4,20,Rain
8840,42,1552482000,30,0,30,Rain
8841,43,1552482000,17,13,30,Rain
8842,44,1552482000,30,0,30,Rain
8843,45,1552482000,28,2,30,Rain
8844,46,1552482000,20,0,20,Rain
8845,47,1552482000,5,35,40,Rain
8846,48,1552482000,0,39,39,Rain
8847,49,1552482000,3,37,40,Rain
8848,50,1552482000,39,1,40,Rain
8849,51,1552482000,33,7,40,Rain
8850,52,1552482000,14,18,32,Rain
8851,53,1552482000,10,30,40,Rain
8852,54,1552482000,13,19,32,Rain
8853,55,1552482000,31,5,36,Rain
8854,56,1552482000,1,38,39,Rain
8855,57,1552482000,1,22,23,Rain
8856,58,1552482000,9,31,40,Rain
8857,59,1552482000,19,1,20,Rain
8858,60,1552482000,21,9,30,Rain
8859,61,1552482000,24,1,25,Rain
8860,62,1552482000,3,36,39,Rain
8861,63,1552482000,1,33,34,Rain
8862,64,1552482000,15,30,45,Rain
8863,65,1552482000,1,38,39,Rain
8864,66,1552482000,3,36,39,Rain
8865,67,1552482000,23,16,39,Rain
8866,68,1552482000,4,36,40,Rain
8867,69,1552482000,2,38,40,Rain
8868,70,1552482000,4,22,26,Rain
8869,71,1552482000,39,1,40,Rain
8870,72,1552482000,24,1,25,Rain
8871,73,1552482000,30,0,30,Rain
8872,74,1552482000,30,0,30,Rain
8873,75,1552482000,40,0,40,Rain
8874,76,1552482000,38,0,38,Rain
8875,77,1552482000,24,4,28,Rain
8876,78,1552482000,40,0,40,Rain
8877,79,1552482000,25,2,27,Rain
8878,80,1552482000,37,3,40,Rain
8879,81,1552482000,39,1,40,Rain
8880,82,1552482000,22,0,22,Rain
8881,83,1552482000,40,0,40,Rain
8882,84,1552482000,30,0,30,Rain
8883,85,1552482000,35,0,35,Rain
8884,86,1552482000,38,0,38,Rain
8885,87,1552482000,37,1,38,Rain
8886,88,1552482000,30,0,30,Rain
8887,89,1552482000,15,24,39,Rain
8888,90,1552482000,1,38,39,Rain
8889,91,1552482000,15,12,27,Rain
8890,92,1552482000,40,0,40,Rain
8891,93,1552482000,40,0,40,Rain
8892,94,1552482000,40,0,40,Rain
8893,95,1552482000,40,0,40,Rain
8894,96,1552482000,30,0,30,Rain
8895,97,1552482000,40,0,40,Rain
8896,98,1552482000,33,6,39,Rain
8897,99,1552482000,0,30,30,Rain
8898,100,1552482000,25,0,25,Rain
8899,101,1552482000,30,0,30,Rain
8900,102,1552482000,40,0,40,Rain
8901,103,1552482000,35,5,40,Rain
8902,104,1552482000,36,4,40,Rain
8903,105,1552482000,36,0,36,Rain
8904,106,1552482000,40,0,40,Rain
8905,107,1552482000,40,0,40,Rain
8906,108,1552482000,39,1,40,Rain
8907,109,1552482000,17,12,29,Rain
8908,110,1552482000,40,0,40,Rain
8909,111,1552482000,20,20,40,Rain
8910,112,1552482000,28,2,30,Rain
8911,113,1552482000,1,39,40,Rain
8912,114,1552482000,18,22,40,Rain
8913,115,1552482000,19,11,30,Rain
8914,2,1552485600,13,7,20,Rain
8915,3,1552485600,19,1,20,Rain
8916,4,1552485600,20,0,20,Rain
8917,5,1552485600,38,2,40,Rain
8918,6,1552485600,20,0,20,Rain
8919,7,1552485600,29,0,29,Rain
8920,8,1552485600,29,1,30,Rain
8921,9,1552485600,3,20,23,Rain
8922,10,1552485600,15,1,16,Rain
8923,11,1552485600,28,2,30,Rain
8924,12,1552485600,20,0,20,Rain
8925,13,1552485600,8,22,30,Rain
8926,14,1552485600,12,18,30,Rain
8927,15,1552485600,15,1,16,Rain
8928,16,1552485600,9,11,20,Rain
8929,17,1552485600,19,1,20,Rain
8930,18,1552485600,28,2,30,Rain
8931,19,1552485600,5,25,30,Rain
8932,21,1552485600,0,30,30,Rain
8933,22,1552485600,11,9,20,Rain
8934,23,1552485600,28,2,30,Rain
8935,24,1552485600,20,0,20,Rain
8936,25,1552485600,12,18,30,Rain
8937,26,1552485600,7,13,20,Rain
8938,27,1552485600,12,8,20,Rain
8939,28,1552485600,28,2,30,Rain
8940,29,1552485600,28,1,29,Rain
8941,30,1552485600,20,0,20,Rain
8942,31,1552485600,18,2,20,Rain
8943,32,1552485600,0,30,30,Rain
8944,33,1552485600,15,8,23,Rain
8945,34,1552485600,21,9,30,Rain
8946,35,1552485600,27,3,30,Rain
8947,36,1552485600,10,30,40,Rain
8948,37,1552485600,25,5,30,Rain
8949,38,1552485600,32,8,40,Rain
8950,39,1552485600,19,1,20,Rain
8951,40,1552485600,10,10,20,Rain
8952,41,1552485600,20,0,20,Rain
8953,42,1552485600,30,0,30,Rain
8954,43,1552485600,23,7,30,Rain
8955,44,1552485600,29,1,30,Rain
8956,45,1552485600,30,0,30,Rain
8957,46,1552485600,20,0,20,Rain
8958,47,1552485600,7,33,40,Rain
8959,48,1552485600,6,34,40,Rain
8960,49,1552485600,9,31,40,Rain
8961,50,1552485600,40,0,40,Rain
8962,51,1552485600,32,8,40,Rain
8963,52,1552485600,14,18,32,Rain
8964,53,1552485600,10,30,40,Rain
8965,54,1552485600,10,22,32,Rain
8966,55,1552485600,36,0,36,Rain
8967,56,1552485600,5,35,40,Rain
8968,57,1552485600,1,22,23,Rain
8969,58,1552485600,23,17,40,Rain
8970,59,1552485600,20,0,20,Rain
8971,60,1552485600,24,6,30,Rain
8972,61,1552485600,25,0,25,Rain
8973,62,1552485600,9,31,40,Rain
8974,63,1552485600,6,29,35,Rain
8975,64,1552485600,12,28,40,Rain
8976,65,1552485600,21,19,40,Rain
8977,66,1552485600,17,23,40,Rain
8978,67,1552485600,20,20,40,Rain
8979,68,1552485600,1,39,40,Rain
8980,69,1552485600,7,33,40,Rain
8981,70,1552485600,5,23,28,Rain
8982,71,1552485600,37,3,40,Rain
8983,72,1552485600,25,0,25,Rain
8984,73,1552485600,30,0,30,Rain
8985,74,1552485600,27,3,30,Rain
8986,75,1552485600,38,2,40,Rain
8987,76,1552485600,37,1,38,Rain
8988,77,1552485600,28,0,28,Rain
8989,78,1552485600,40,0,40,Rain
8990,79,1552485600,27,0,27,Rain
8991,80,1552485600,25,15,40,Rain
8992,81,1552485600,40,0,40,Rain
8993,82,1552485600,22,0,22,Rain
8994,83,1552485600,40,0,40,Rain
8995,84,1552485600,29,1,30,Rain
8996,85,1552485600,35,0,35,Rain
8997,86,1552485600,38,0,38,Rain
8998,87,1552485600,35,3,38,Rain
8999,88,1552485600,27,3,30,Rain
9000,89,1552485600,13,27,40,Rain
9001,90,1552485600,7,33,40,Rain
9002,91,1552485600,15,15,30,Rain
9003,92,1552485600,39,1,40,Rain
9004,93,1552485600,40,0,40,Rain
9005,94,1552485600,40,0,40,Rain
9006,95,1552485600,40,0,40,Rain
9007,96,1552485600,29,1,30,Rain
9008,97,1552485600,40,0,40,Rain
9009,98,1552485600,30,9,39,Rain
9010,99,1552485600,1,29,30,Rain
9011,100,1552485600,22,3,25,Rain
9012,101,1552485600,27,3,30,Rain
9013,102,1552485600,40,0,40,Rain
9014,103,1552485600,36,4,40,Rain
9015,104,1552485600,40,0,40,Rain
9016,105,1552485600,36,0,36,Rain
9017,106,1552485600,40,0,40,Rain
9018,107,1552485600,40,0,40,Rain
9019,108,1552485600,40,0,40,Rain
9020,109,1552485600,17,12,29,Rain
9021,110,1552485600,40,0,40,Rain
9022,111,1552485600,22,18,40,Rain
9023,112,1552485600,28,2,30,Rain
9024,113,1552485600,6,34,40,Rain
9025,114,1552485600,17,23,40,Rain
9026,115,1552485600,14,16,30,Rain
9027,2,1552489200,18,2,20,Rain
9028,3,1552489200,8,12,20,Rain
9029,4,1552489200,16,4,20,Rain
9030,5,1552489200,29,11,40,Rain
9031,6,1552489200,19,1,20,Rain
9032,7,1552489200,28,1,29,Rain
9033,8,1552489200,23,7,30,Rain
9034,9,1552489200,7,17,24,Rain
9035,10,1552489200,10,6,16,Rain
9036,11,1552489200,27,3,30,Rain
9037,12,1552489200,20,0,20,Rain
9038,13,1552489200,6,24,30,Rain
9039,14,1552489200,23,7,30,Rain
9040,15,1552489200,6,10,16,Rain
9041,16,1552489200,13,7,20,Rain
9042,17,1552489200,19,1,20,Rain
9043,18,1552489200,28,2,30,Rain
9044,19,1552489200,12,18,30,Rain
9045,21,1552489200,3,27,30,Rain
9046,22,1552489200,13,7,20,Rain
9047,23,1552489200,27,3,30,Rain
9048,24,1552489200,17,3,20,Rain
9049,25,1552489200,10,20,30,Rain
9050,26,1552489200,6,14,20,Rain
9051,27,1552489200,20,0,20,Rain
9052,28,1552489200,29,1,30,Rain
9053,29,1552489200,28,1,29,Rain
9054,30,1552489200,16,4,20,Rain
9055,31,1552489200,12,7,19,Rain
9056,32,1552489200,3,27,30,Rain
9057,33,1552489200,5,18,23,Rain
9058,34,1552489200,26,4,30,Rain
9059,35,1552489200,29,1,30,Rain
9060,36,1552489200,16,24,40,Rain
9061,37,1552489200,24,6,30,Rain
9062,38,1552489200,32,8,40,Rain
9063,39,1552489200,19,1,20,Rain
9064,40,1552489200,15,5,20,Rain
9065,41,1552489200,16,4,20,Rain
9066,42,1552489200,28,2,30,Rain
9067,43,1552489200,26,4,30,Rain
9068,44,1552489200,28,2,30,Rain
9069,45,1552489200,28,2,30,Rain
9070,46,1552489200,20,0,20,Rain
9071,47,1552489200,5,35,40,Rain
9072,48,1552489200,14,26,40,Rain
9073,49,1552489200,6,34,40,Rain
9074,50,1552489200,34,6,40,Rain
9075,51,1552489200,29,11,40,Rain
9076,52,1552489200,12,20,32,Rain
9077,53,1552489200,12,28,40,Rain
9078,54,1552489200,10,23,33,Rain
9079,55,1552489200,35,1,36,Rain
9080,56,1552489200,1,39,40,Rain
9081,57,1552489200,3,20,23,Rain
9082,58,1552489200,14,26,40,Rain
9083,59,1552489200,13,7,20,Rain
9084,60,1552489200,30,0,30,Rain
9085,61,1552489200,17,8,25,Rain
9086,62,1552489200,6,34,40,Rain
9087,63,1552489200,2,33,35,Rain
9088,64,1552489200,1,39,40,Rain
9089,65,1552489200,19,21,40,Rain
9090,66,1552489200,15,25,40,Rain
9091,67,1552489200,17,23,40,Rain
9092,68,1552489200,4,36,40,Rain
9093,69,1552489200,2,38,40,Rain
9094,70,1552489200,5,23,28,Rain
9095,71,1552489200,39,1,40,Rain
9096,72,1552489200,22,3,25,Rain
9097,73,1552489200,25,5,30,Rain
9098,74,1552489200,28,2,30,Rain
9099,75,1552489200,40,0,40,Rain
9100,76,1552489200,38,0,38,Rain
9101,77,1552489200,28,0,28,Rain
9102,78,1552489200,40,0,40,Rain
9103,79,1552489200,19,8,27,Rain
9104,80,1552489200,29,11,40,Rain
9105,81,1552489200,39,1,40,Rain
9106,82,1552489200,22,0,22,Rain
9107,83,1552489200,34,6,40,Rain
9108,84,1552489200,30,0,30,Rain
9109,85,1552489200,30,5,35,Rain
9110,86,1552489200,36,2,38,Rain
9111,87,1552489200,38,0,38,Rain
9112,88,1552489200,28,2,30,Rain
9113,89,1552489200,14,26,40,Rain
9114,90,1552489200,2,38,40,Rain
9115,91,1552489200,17,13,30,Rain
9116,92,1552489200,39,1,40,Rain
9117,93,1552489200,40,0,40,Rain
9118,94,1552489200,39,1,40,Rain
9119,95,1552489200,40,0,40,Rain
9120,96,1552489200,30,0,30,Rain
9121,97,1552489200,32,8,40,Rain
9122,98,1552489200,33,6,39,Rain
9123,99,1552489200,1,29,30,Rain
9124,100,1552489200,22,3,25,Rain
9125,101,1552489200,26,4,30,Rain
9126,102,1552489200,39,1,40,Rain
9127,103,1552489200,40,0,40,Rain
9128,104,1552489200,40,0,40,Rain
9129,105,1552489200,36,0,36,Rain
9130,106,1552489200,40,0,40,Rain
9131,107,1552489200,40,0,40,Rain
9132,108,1552489200,40,0,40,Rain
9133,109,1552489200,17,12,29,Rain
9134,110,1552489200,40,0,40,Rain
9135,111,1552489200,29,11,40,Rain
9136,112,1552489200,26,4,30,Rain
9137,113,1552489200,4,36,40,Rain
9138,114,1552489200,20,20,40,Rain
9139,115,1552489200,15,15,30,Rain
9140,2,1552492800,20,0,20,Rain
9141,3,1552492800,11,9,20,Rain
9142,4,1552492800,15,5,20,Rain
9143,5,1552492800,27,13,40,Rain
9144,6,1552492800,15,5,20,Rain
9145,7,1552492800,7,22,29,Rain
9146,8,1552492800,16,14,30,Rain
9147,9,1552492800,5,19,24,Rain
9148,10,1552492800,9,7,16,Rain
9149,11,1552492800,7,23,30,Rain
9150,12,1552492800,20,0,20,Rain
9151,13,1552492800,4,26,30,Rain
9152,14,1552492800,22,8,30,Rain
9153,15,1552492800,7,9,16,Rain
9154,16,1552492800,9,11,20,Rain
9155,17,1552492800,20,0,20,Rain
9156,18,1552492800,30,0,30,Rain
9157,19,1552492800,5,25,30,Rain
9158,21,1552492800,3,27,30,Rain
9159,22,1552492800,15,5,20,Rain
9160,23,1552492800,24,6,30,Rain
9161,24,1552492800,15,5,20,Rain
9162,25,1552492800,13,17,30,Rain
9163,26,1552492800,8,12,20,Rain
9164,27,1552492800,18,2,20,Rain
9165,28,1552492800,7,23,30,Rain
9166,29,1552492800,28,1,29,Rain
9167,30,1552492800,17,3,20,Rain
9168,31,1552492800,12,7,19,Rain
9169,32,1552492800,0,30,30,Rain
9170,33,1552492800,1,22,23,Rain
9171,34,1552492800,28,2,30,Rain
9172,35,1552492800,28,2,30,Rain
9173,36,1552492800,16,24,40,Rain
9174,37,1552492800,25,5,30,Rain
9175,38,1552492800,24,16,40,Rain
9176,39,1552492800,16,4,20,Rain
9177,40,1552492800,16,5,21,Rain
9178,41,1552492800,13,7,20,Rain
9179,42,1552492800,29,1,30,Rain
9180,43,1552492800,25,5,30,Rain
9181,44,1552492800,30,0,30,Rain
9182,45,1552492800,28,2,30,Rain
9183,46,1552492800,20,0,20,Rain
9184,47,1552492800,8,32,40,Rain
9185,48,1552492800,18,22,40,Rain
9186,49,1552492800,12,28,40,Rain
9187,50,1552492800,39,1,40,Rain
9188,51,1552492800,32,8,40,Rain
9189,52,1552492800,11,21,32,Rain
9190,53,1552492800,13,27,40,Rain
9191,54,1552492800,9,24,33,Rain
9192,55,1552492800,35,1,36,Rain
9193,56,1552492800,4,36,40,Rain
9194,57,1552492800,1,22,23,Rain
9195,58,1552492800,10,30,40,Rain
9196,59,1552492800,17,3,20,Rain
9197,60,1552492800,28,2,30,Rain
9198,61,1552492800,17,8,25,Rain
9199,62,1552492800,4,36,40,Rain
9200,63,1552492800,0,35,35,Rain
9201,64,1552492800,1,39,40,Rain
9202,65,1552492800,16,24,40,Rain
9203,66,1552492800,14,26,40,Rain
9204,67,1552492800,16,24,40,Rain
9205,68,1552492800,4,36,40,Rain
9206,69,1552492800,6,34,40,Rain
9207,70,1552492800,11,17,28,Rain
9208,71,1552492800,38,2,40,Rain
9209,72,1552492800,23,2,25,Rain
9210,73,1552492800,25,5,30,Rain
9211,74,1552492800,29,1,30,Rain
9212,75,1552492800,40,0,40,Rain
9213,76,1552492800,37,1,38,Rain
9214,77,1552492800,29,0,29,Rain
9215,78,1552492800,39,1,40,Rain
9216,79,1552492800,26,1,27,Rain
9217,80,1552492800,33,7,40,Rain
9218,81,1552492800,40,0,40,Rain
9219,82,1552492800,22,0,22,Rain
9220,83,1552492800,34,6,40,Rain
9221,84,1552492800,29,1,30,Rain
9222,85,1552492800,29,6,35,Rain
9223,86,1552492800,32,6,38,Rain
9224,87,1552492800,38,0,38,Rain
9225,88,1552492800,30,0,30,Rain
9226,89,1552492800,14,26,40,Rain
9227,90,1552492800,2,38,40,Rain
9228,91,1552492800,16,14,30,Rain
9229,92,1552492800,38,2,40,Rain
9230,93,1552492800,40,0,40,Rain
9231,94,1552492800,39,1,40,Rain
9232,95,1552492800,38,2,40,Rain
9233,96,1552492800,30,0,30,Rain
9234,97,1552492800,36,4,40,Rain
9235,98,1552492800,40,0,40,Rain
9236,99,1552492800,1,29,30,Rain
9237,100,1552492800,22,3,25,Rain
9238,101,1552492800,30,0,30,Rain
9239,102,1552492800,40,0,40,Rain
9240,103,1552492800,40,0,40,Rain
9241,104,1552492800,40,0,40,Rain
9242,105,1552492800,36,0,36,Rain
9243,106,1552492800,40,0,40,Rain
9244,107,1552492800,40,0,40,Rain
9245,108,1552492800,38,2,40,Rain
9246,109,1552492800,17,12,29,Rain
9247,110,1552492800,40,0,40,Rain
9248,111,1552492800,32,8,40,Rain
9249,112,1552492800,21,9,30,Rain
9250,113,1552492800,3,37,40,Rain
9251,114,1552492800,22,18,40,Rain
9252,115,1552492800,15,15,30,Rain
9253,2,1552496400,20,0,20,Rain
9254,3,1552496400,20,0,20,Rain
9255,4,1552496400,18,2,20,Rain
9256,5,1552496400,28,12,40,Rain
9257,6,1552496400,20,0,20,Rain
9258,7,1552496400,12,17,29,Rain
9259,8,1552496400,11,18,29,Rain
9260,9,1552496400,13,11,24,Rain
9261,10,1552496400,6,10,16,Rain
9262,11,1552496400,16,14,30,Rain
9263,12,1552496400,20,0,20,Rain
9264,13,1552496400,5,25,30,Rain
9265,14,1552496400,17,13,30,Rain
9266,15,1552496400,8,8,16,Rain
9267,16,1552496400,14,6,20,Rain
9268,17,1552496400,18,2,20,Rain
9269,18,1552496400,24,6,30,Rain
9270,19,1552496400,10,20,30,Rain
9271,21,1552496400,1,29,30,Rain
9272,22,1552496400,14,6,20,Rain
9273,23,1552496400,26,4,30,Rain
9274,24,1552496400,16,4,20,Rain
9275,25,1552496400,13,17,30,Rain
9276,26,1552496400,8,12,20,Rain
9277,27,1552496400,20,0,20,Rain
9278,28,1552496400,12,18,30,Rain
9279,29,1552496400,25,4,29,Rain
9280,30,1552496400,20,0,20,Rain
9281,31,1552496400,8,11,19,Rain
9282,32,1552496400,13,17,30,Rain
9283,33,1552496400,2,21,23,Rain
9284,34,1552496400,24,6,30,Rain
9285,35,1552496400,26,4,30,Rain
9286,36,1552496400,19,21,40,Rain
9287,37,1552496400,26,4,30,Rain
9288,38,1552496400,17,23,40,Rain
9289,39,1552496400,16,4,20,Rain
9290,40,1552496400,16,5,21,Rain
9291,41,1552496400,14,6,20,Rain
9292,42,1552496400,30,0,30,Rain
9293,43,1552496400,21,9,30,Rain
9294,44,1552496400,28,2,30,Rain
9295,45,1552496400,22,8,30,Rain
9296,46,1552496400,19,1,20,Rain
9297,47,1552496400,7,33,40,Rain
9298,48,1552496400,18,22,40,Rain
9299,49,1552496400,9,31,40,Rain
9300,50,1552496400,39,1,40,Rain
9301,51,1552496400,33,7,40,Rain
9302,52,1552496400,15,17,32,Rain
9303,53,1552496400,12,28,40,Rain
9304,54,1552496400,14,19,33,Rain
9305,55,1552496400,36,0,36,Rain
9306,56,1552496400,6,34,40,Rain
9307,57,1552496400,4,19,23,Rain
9308,58,1552496400,17,23,40,Rain
9309,59,1552496400,20,0,20,Rain
9310,60,1552496400,26,4,30,Rain
9311,61,1552496400,21,4,25,Rain
9312,62,1552496400,8,32,40,Rain
9313,63,1552496400,0,35,35,Rain
9314,64,1552496400,20,20,40,Rain
9315,65,1552496400,15,25,40,Rain
9316,66,1552496400,16,24,40,Rain
9317,67,1552496400,11,29,40,Rain
9318,68,1552496400,3,37,40,Rain
9319,69,1552496400,12,28,40,Rain
9320,70,1552496400,9,19,28,Rain
9321,71,1552496400,38,2,40,Rain
9322,72,1552496400,24,1,25,Rain
9323,73,1552496400,24,6,30,Rain
9324,74,1552496400,28,2,30,Rain
9325,75,1552496400,39,1,40,Rain
9326,76,1552496400,37,1,38,Rain
9327,77,1552496400,26,3,29,Rain
9328,78,1552496400,40,0,40,Rain
9329,79,1552496400,27,0,27,Rain
9330,80,1552496400,22,18,40,Rain
9331,81,1552496400,40,0,40,Rain
9332,82,1552496400,22,0,22,Rain
9333,83,1552496400,29,11,40,Rain
9334,84,1552496400,28,2,30,Rain
9335,85,1552496400,27,8,35,Rain
9336,86,1552496400,34,4,38,Rain
9337,87,1552496400,38,0,38,Rain
9338,88,1552496400,27,3,30,Rain
9339,89,1552496400,13,27,40,Rain
9340,90,1552496400,9,31,40,Rain
9341,91,1552496400,20,10,30,Rain
9342,92,1552496400,35,5,40,Rain
9343,93,1552496400,39,1,40,Rain
9344,94,1552496400,38,2,40,Rain
9345,95,1552496400,35,5,40,Rain
9346,96,1552496400,29,1,30,Rain
9347,97,1552496400,35,5,40,Rain
9348,98,1552496400,40,0,40,Rain
9349,99,1552496400,0,30,30,Rain
9350,100,1552496400,14,11,25,Rain
9351,101,1552496400,30,0,30,Rain
9352,102,1552496400,40,0,40,Rain
9353,103,1552496400,34,6,40,Rain
9354,104,1552496400,34,6,40,Rain
9355,105,1552496400,30,6,36,Rain
9356,106,1552496400,37,3,40,Rain
9357,107,1552496400,38,2,40,Rain
9358,108,1552496400,38,2,40,Rain
9359,109,1552496400,17,12,29,Rain
9360,110,1552496400,40,0,40,Rain
9361,111,1552496400,40,0,40,Rain
9362,112,1552496400,20,10,30,Rain
9363,113,1552496400,1,39,40,Rain
9364,114,1552496400,9,31,40,Rain
9365,115,1552496400,12,18,30,Rain
9366,2,1552500000,16,4,20,Rain
9367,3,1552500000,20,0,20,Rain
9368,4,1552500000,19,1,20,Rain
9369,5,1552500000,23,17,40,Rain
9370,6,1552500000,18,2,20,Rain
9371,7,1552500000,15,14,29,Rain
9372,8,1552500000,7,22,29,Rain
9373,9,1552500000,20,4,24,Rain
9374,10,1552500000,14,2,16,Rain
9375,11,1552500000,30,0,30,Rain
9376,12,1552500000,17,3,20,Rain
9377,13,1552500000,13,17,30,Rain
9378,14,1552500000,21,9,30,Rain
9379,15,1552500000,16,0,16,Rain
9380,16,1552500000,8,12,20,Rain
9381,17,1552500000,18,2,20,Rain
9382,18,1552500000,30,0,30,Rain
9383,19,1552500000,29,1,30,Rain
9384,21,1552500000,3,27,30,Rain
9385,22,1552500000,9,11,20,Rain
9386,23,1552500000,1,29,30,Rain
9387,24,1552500000,15,5,20,Rain
9388,25,1552500000,24,6,30,Rain
9389,26,1552500000,0,20,20,Rain
9390,27,1552500000,17,3,20,Rain
9391,28,1552500000,22,8,30,Rain
9392,29,1552500000,16,13,29,Rain
9393,30,1552500000,20,0,20,Rain
9394,31,1552500000,13,7,20,Rain
9395,32,1552500000,11,19,30,Rain
9396,33,1552500000,9,14,23,Rain
9397,34,1552500000,27,2,29,Rain
9398,35,1552500000,28,2,30,Rain
9399,36,1552500000,29,11,40,Rain
9400,37,1552500000,30,0,30,Rain
9401,38,1552500000,1,39,40,Rain
9402,39,1552500000,17,3,20,Rain
9403,40,1552500000,19,2,21,Rain
9404,41,1552500000,19,1,20,Rain
9405,42,1552500000,30,0,30,Rain
9406,43,1552500000,17,13,30,Rain
9407,44,1552500000,29,1,30,Rain
9408,45,1552500000,16,14,30,Rain
9409,46,1552500000,18,2,20,Rain
9410,47,1552500000,20,20,40,Rain
9411,48,1552500000,22,18,40,Rain
9412,49,1552500000,6,34,40,Rain
9413,50,1552500000,40,0,40,Rain
9414,51,1552500000,33,7,40,Rain
9415,52,1552500000,18,14,32,Rain
9416,53,1552500000,20,20,40,Rain
9417,54,1552500000,32,1,33,Rain
9418,55,1552500000,36,0,36,Rain
9419,56,1552500000,28,12,40,Rain
9420,57,1552500000,12,11,23,Rain
9421,58,1552500000,9,31,40,Rain
9422,59,1552500000,20,0,20,Rain
9423,60,1552500000,21,9,30,Rain
9424,61,1552500000,25,0,25,Rain
9425,62,1552500000,13,27,40,Rain
9426,63,1552500000,2,33,35,Rain
9427,64,1552500000,26,14,40,Rain
9428,65,1552500000,20,20,40,Rain
9429,66,1552500000,35,5,40,Rain
9430,67,1552500000,15,25,40,Rain
9431,68,1552500000,24,16,40,Rain
9432,69,1552500000,9,31,40,Rain
9433,70,1552500000,5,23,28,Rain
9434,71,1552500000,40,0,40,Rain
9435,72,1552500000,24,1,25,Rain
9436,73,1552500000,22,8,30,Rain
9437,74,1552500000,27,3,30,Rain
9438,75,1552500000,38,2,40,Rain
9439,76,1552500000,38,0,38,Rain
9440,77,1552500000,29,0,29,Rain
9441,78,1552500000,37,3,40,Rain
9442,79,1552500000,26,1,27,Rain
9443,80,1552500000,24,16,40,Rain
9444,81,1552500000,40,0,40,Rain
9445,82,1552500000,21,1,22,Rain
9446,83,1552500000,26,14,40,Rain
9447,84,1552500000,27,3,30,Rain
9448,85,1552500000,28,7,35,Rain
9449,86,1552500000,27,11,38,Rain
9450,87,1552500000,38,0,38,Rain
9451,88,1552500000,30,0,30,Rain
9452,89,1552500000,22,18,40,Rain
9453,90,1552500000,30,10,40,Rain
9454,91,1552500000,22,8,30,Rain
9455,92,1552500000,20,20,40,Rain
9456,93,1552500000,12,28,40,Rain
9457,94,1552500000,40,0,40,Rain
9458,95,1552500000,32,8,40,Rain
9459,96,1552500000,30,0,30,Rain
9460,97,1552500000,36,4,40,Rain
9461,98,1552500000,39,1,40,Rain
9462,99,1552500000,5,25,30,Rain
9463,100,1552500000,2,23,25,Rain
9464,101,1552500000,27,3,30,Rain
9465,102,1552500000,37,3,40,Rain
9466,103,1552500000,40,0,40,Rain
9467,104,1552500000,34,6,40,Rain
9468,105,1552500000,30,6,36,Rain
9469,106,1552500000,36,4,40,Rain
9470,107,1552500000,38,2,40,Rain
9471,108,1552500000,37,3,40,Rain
9472,109,1552500000,18,11,29,Rain
9473,110,1552500000,40,0,40,Rain
9474,111,1552500000,38,2,40,Rain
9475,112,1552500000,18,12,30,Rain
9476,113,1552500000,1,39,40,Rain
9477,114,1552500000,29,11,40,Rain
9478,115,1552500000,10,20,30,Rain
9479,2,1552503600,18,2,20,Rain
9480,3,1552503600,20,0,20,Rain
9481,4,1552503600,20,0,20,Rain
9482,5,1552503600,15,25,40,Rain
9483,6,1552503600,19,1,20,Rain
9484,7,1552503600,27,2,29,Rain
9485,8,1552503600,13,16,29,Rain
9486,9,1552503600,22,2,24,Rain
9487,10,1552503600,13,3,16,Rain
9488,11,1552503600,30,0,30,Rain
9489,12,1552503600,18,2,20,Rain
9490,13,1552503600,30,0,30,Rain
9491,14,1552503600,23,7,30,Rain
9492,15,1552503600,15,1,16,Rain
9493,16,1552503600,0,20,20,Rain
9494,17,1552503600,19,1,20,Rain
9495,18,1552503600,24,6,30,Rain
9496,19,1552503600,29,1,30,Rain
9497,21,1552503600,8,22,30,Rain
9498,22,1552503600,0,20,20,Rain
9499,23,1552503600,1,29,30,Rain
9500,24,1552503600,3,17,20,Rain
9501,25,1552503600,30,0,30,Rain
9502,26,1552503600,3,17,20,Rain
9503,27,1552503600,20,0,20,Rain
9504,28,1552503600,19,11,30,Rain
9505,29,1552503600,23,6,29,Rain
9506,30,1552503600,19,1,20,Rain
9507,31,1552503600,18,2,20,Rain
9508,32,1552503600,2,28,30,Rain
9509,33,1552503600,1,22,23,Rain
9510,34,1552503600,9,21,30,Rain
9511,35,1552503600,30,0,30,Rain
9512,36,1552503600,40,0,40,Rain
9513,37,1552503600,30,0,30,Rain
9514,38,1552503600,7,33,40,Rain
9515,39,1552503600,16,4,20,Rain
9516,40,1552503600,13,8,21,Rain
9517,41,1552503600,20,0,20,Rain
9518,42,1552503600,20,10,30,Rain
9519,43,1552503600,10,20,30,Rain
9520,44,1552503600,21,9,30,Rain
9521,45,1552503600,5,25,30,Rain
9522,46,1552503600,11,9,20,Rain
9523,47,1552503600,40,0,40,Rain
9524,48,1552503600,13,27,40,Rain
9525,49,1552503600,30,10,40,Rain
9526,50,1552503600,31,9,40,Rain
9527,51,1552503600,38,2,40,Rain
9528,52,1552503600,32,0,32,Rain
9529,53,1552503600,39,1,40,Rain
9530,54,1552503600,33,0,33,Rain
9531,55,1552503600,36,0,36,Rain
9532,56,1552503600,34,6,40,Rain
9533,57,1552503600,23,0,23,Rain
9534,58,1552503600,39,1,40,Rain
9535,59,1552503600,20,0,20,Rain
9536,60,1552503600,6,24,30,Rain
9537,61,1552503600,24,1,25,Rain
9538,62,1552503600,36,4,40,Rain
9539,63,1552503600,5,30,35,Rain
9540,64,1552503600,23,17,40,Rain
9541,65,1552503600,40,0,40,Rain
9542,66,1552503600,38,2,40,Rain
9543,67,1552503600,29,11,40,Rain
9544,68,1552503600,40,0,40,Rain
9545,69,1552503600,37,3,40,Rain
9546,70,1552503600,7,21,28,Rain
9547,71,1552503600,33,7,40,Rain
9548,72,1552503600,23,2,25,Rain
9549,73,1552503600,30,0,30,Rain
9550,74,1552503600,15,15,30,Rain
9551,75,1552503600,23,17,40,Rain
9552,76,1552503600,32,6,38,Rain
9553,77,1552503600,27,2,29,Rain
9554,78,1552503600,33,7,40,Rain
9555,79,1552503600,24,3,27,Rain
9556,80,1552503600,25,15,40,Rain
9557,81,1552503600,40,0,40,Rain
9558,82,1552503600,16,6,22,Rain
9559,83,1552503600,22,18,40,Rain
9560,84,1552503600,23,7,30,Rain
9561,85,1552503600,17,18,35,Rain
9562,86,1552503600,11,27,38,Rain
9563,87,1552503600,34,4,38,Rain
9564,88,1552503600,27,3,30,Rain
9565,89,1552503600,37,3,40,Rain
9566,90,1552503600,40,0,40,Rain
9567,91,1552503600,10,20,30,Rain
9568,92,1552503600,2,38,40,Rain
9569,93,1552503600,1,39,40,Rain
9570,94,1552503600,10,30,40,Rain
9571,95,1552503600,23,17,40,Rain
9572,96,1552503600,28,2,30,Rain
9573,97,1552503600,28,12,40,Rain
9574,98,1552503600,40,0,40,Rain
9575,99,1552503600,10,20,30,Rain
9576,100,1552503600,6,19,25,Rain
9577,101,1552503600,28,2,30,Rain
9578,102,1552503600,33,7,40,Rain
9579,103,1552503600,37,3,40,Rain
9580,104,1552503600,40,0,40,Rain
9581,105,1552503600,29,7,36,Rain
9582,106,1552503600,33,7,40,Rain
9583,107,1552503600,36,4,40,Rain
9584,108,1552503600,33,7,40,Rain
9585,109,1552503600,14,15,29,Rain
9586,110,1552503600,37,3,40,Rain
9587,111,1552503600,38,2,40,Rain
9588,112,1552503600,14,16,30,Rain
9589,113,1552503600,16,24,40,Rain
9590,114,1552503600,40,0,40,Rain
9591,115,1552503600,2,28,30,Rain
9592,2,1552507200,17,3,20,Drizzle
9593,3,1552507200,16,4,20,Drizzle
9594,4,1552507200,17,3,20,Drizzle
9595,5,1552507200,24,16,40,Drizzle
9596,6,1552507200,13,7,20,Drizzle
9597,7,1552507200,25,4,29,Drizzle
9598,8,1552507200,29,1,30,Drizzle
9599,9,1552507200,21,3,24,Drizzle
9600,10,1552507200,7,9,16,Drizzle
9601,11,1552507200,30,0,30,Drizzle
9602,12,1552507200,16,4,20,Drizzle
9603,13,1552507200,25,5,30,Drizzle
9604,14,1552507200,26,4,30,Drizzle
9605,15,1552507200,8,8,16,Drizzle
9606,16,1552507200,2,18,20,Drizzle
9607,17,1552507200,17,3,20,Drizzle
9608,18,1552507200,20,10,30,Drizzle
9609,19,1552507200,28,2,30,Drizzle
9610,21,1552507200,18,12,30,Drizzle
9611,22,1552507200,3,17,20,Drizzle
9612,23,1552507200,2,28,30,Drizzle
9613,24,1552507200,7,13,20,Drizzle
9614,25,1552507200,30,0,30,Drizzle
9615,26,1552507200,10,10,20,Drizzle
9616,27,1552507200,18,2,20,Drizzle
9617,28,1552507200,19,11,30,Drizzle
9618,29,1552507200,27,2,29,Drizzle
9619,30,1552507200,18,2,20,Drizzle
9620,31,1552507200,20,0,20,Drizzle
9621,32,1552507200,1,29,30,Drizzle
9622,33,1552507200,0,21,21,Drizzle
9623,34,1552507200,0,30,30,Drizzle
9624,35,1552507200,30,0,30,Drizzle
9625,36,1552507200,39,1,40,Drizzle
9626,37,1552507200,28,2,30,Drizzle
9627,38,1552507200,9,31,40,Drizzle
9628,39,1552507200,19,1,20,Drizzle
9629,40,1552507200,17,4,21,Drizzle
9630,41,1552507200,20,0,20,Drizzle
9631,42,1552507200,20,10,30,Drizzle
9632,43,1552507200,11,19,30,Drizzle
9633,44,1552507200,6,24,30,Drizzle
9634,45,1552507200,3,27,30,Drizzle
9635,46,1552507200,20,0,20,Drizzle
9636,47,1552507200,40,0,40,Drizzle
9637,48,1552507200,33,7,40,Drizzle
9638,49,1552507200,40,0,40,Drizzle
9639,50,1552507200,20,20,40,Drizzle
9640,51,1552507200,38,2,40,Drizzle
9641,52,1552507200,31,1,32,Drizzle
9642,53,1552507200,39,1,40,Drizzle
9643,54,1552507200,33,0,33,Drizzle
9644,55,1552507200,36,0,36,Drizzle
9645,56,1552507200,40,0,40,Drizzle
9646,57,1552507200,22,1,23,Drizzle
9647,58,1552507200,39,1,40,Drizzle
9648,59,1552507200,19,1,20,Drizzle
9649,60,1552507200,0,30,30,Drizzle
9650,61,1552507200,22,3,25,Drizzle
9651,62,1552507200,40,0,40,Drizzle
9652,63,1552507200,13,22,35,Drizzle
9653,64,1552507200,19,21,40,Drizzle
9654,65,1552507200,39,1,40,Drizzle
9655,66,1552507200,39,1,40,Drizzle
9656,67,1552507200,31,9,40,Drizzle
9657,68,1552507200,39,1,40,Drizzle
9658,69,1552507200,37,3,40,Drizzle
9659,70,1552507200,17,11,28,Drizzle
9660,71,1552507200,34,6,40,Drizzle
9661,72,1552507200,1,24,25,Drizzle
9662,73,1552507200,27,3,30,Drizzle
9663,74,1552507200,10,20,30,Drizzle
9664,75,1552507200,24,16,40,Drizzle
9665,76,1552507200,35,3,38,Drizzle
9666,77,1552507200,27,2,29,Drizzle
9667,78,1552507200,24,16,40,Drizzle
9668,79,1552507200,24,3,27,Drizzle
9669,80,1552507200,23,17,40,Drizzle
9670,81,1552507200,40,0,40,Drizzle
9671,82,1552507200,15,7,22,Drizzle
9672,83,1552507200,8,32,40,Drizzle
9673,84,1552507200,17,13,30,Drizzle
9674,85,1552507200,9,26,35,Drizzle
9675,86,1552507200,0,38,38,Drizzle
9676,87,1552507200,25,13,38,Drizzle
9677,88,1552507200,21,9,30,Drizzle
9678,89,1552507200,31,9,40,Drizzle
9679,90,1552507200,38,2,40,Drizzle
9680,91,1552507200,2,28,30,Drizzle
9681,92,1552507200,0,40,40,Drizzle
9682,93,1552507200,0,40,40,Drizzle
9683,94,1552507200,2,38,40,Drizzle
9684,95,1552507200,14,26,40,Drizzle
9685,96,1552507200,24,6,30,Drizzle
9686,97,1552507200,24,16,40,Drizzle
9687,98,1552507200,40,0,40,Drizzle
9688,99,1552507200,21,9,30,Drizzle
9689,100,1552507200,7,18,25,Drizzle
9690,101,1552507200,27,3,30,Drizzle
9691,102,1552507200,32,8,40,Drizzle
9692,103,1552507200,39,1,40,Drizzle
9693,104,1552507200,40,0,40,Drizzle
9694,105,1552507200,33,3,36,Drizzle
9695,106,1552507200,34,6,40,Drizzle
9696,107,1552507200,29,11,40,Drizzle
9697,108,1552507200,34,6,40,Drizzle
9698,109,1552507200,11,18,29,Drizzle
9699,110,1552507200,36,4,40,Drizzle
9700,111,1552507200,31,9,40,Drizzle
9701,112,1552507200,7,23,30,Drizzle
9702,113,1552507200,31,9,40,Drizzle
9703,114,1552507200,40,0,40,Drizzle
9704,115,1552507200,0,30,30,Drizzle
9705,2,1552510800,17,3,20,Drizzle
9706,3,1552510800,17,3,20,Drizzle
9707,4,1552510800,17,3,20,Drizzle
9708,5,1552510800,29,11,40,Drizzle
9709,6,1552510800,18,2,20,Drizzle
9710,7,1552510800,22,7,29,Drizzle
9711,8,1552510800,30,0,30,Drizzle
9712,9,1552510800,22,2,24,Drizzle
9713,10,1552510800,15,1,16,Drizzle
9714,11,1552510800,30,0,30,Drizzle
9715,12,1552510800,15,5,20,Drizzle
9716,13,1552510800,25,5,30,Drizzle
9717,14,1552510800,30,0,30,Drizzle
9718,15,1552510800,10,6,16,Drizzle
9719,16,1552510800,11,9,20,Drizzle
9720,17,1552510800,20,0,20,Drizzle
9721,18,1552510800,18,12,30,Drizzle
9722,19,1552510800,26,4,30,Drizzle
9723,21,1552510800,30,0,30,Drizzle
9724,22,1552510800,13,7,20,Drizzle
9725,23,1552510800,7,23,30,Drizzle
9726,24,1552510800,6,14,20,Drizzle
9727,25,1552510800,30,0,30,Drizzle
9728,26,1552510800,9,11,20,Drizzle
9729,27,1552510800,20,0,20,Drizzle
9730,28,1552510800,10,20,30,Drizzle
9731,29,1552510800,19,10,29,Drizzle
9732,30,1552510800,17,3,20,Drizzle
9733,31,1552510800,15,5,20,Drizzle
9734,32,1552510800,1,29,30,Drizzle
9735,33,1552510800,1,20,21,Drizzle
9736,34,1552510800,1,29,30,Drizzle
9737,35,1552510800,27,3,30,Drizzle
9738,36,1552510800,40,0,40,Drizzle
9739,37,1552510800,27,3,30,Drizzle
9740,38,1552510800,7,33,40,Drizzle
9741,39,1552510800,19,1,20,Drizzle
9742,40,1552510800,17,4,21,Drizzle
9743,41,1552510800,20,0,20,Drizzle
9744,42,1552510800,22,8,30,Drizzle
9745,43,1552510800,8,22,30,Drizzle
9746,44,1552510800,1,29,30,Drizzle
9747,45,1552510800,2,28,30,Drizzle
9748,46,1552510800,20,0,20,Drizzle
9749,47,1552510800,40,0,40,Drizzle
9750,48,1552510800,40,0,40,Drizzle
9751,49,1552510800,39,1,40,Drizzle
9752,50,1552510800,15,25,40,Drizzle
9753,51,1552510800,39,1,40,Drizzle
9754,52,1552510800,29,3,32,Drizzle
9755,53,1552510800,39,1,40,Drizzle
9756,54,1552510800,33,0,33,Drizzle
9757,55,1552510800,36,0,36,Drizzle
9758,56,1552510800,35,5,40,Drizzle
9759,57,1552510800,23,0,23,Drizzle
9760,58,1552510800,35,5,40,Drizzle
9761,59,1552510800,16,4,20,Drizzle
9762,60,1552510800,1,29,30,Drizzle
9763,61,1552510800,14,11,25,Drizzle
9764,62,1552510800,39,1,40,Drizzle
9765,63,1552510800,17,18,35,Drizzle
9766,64,1552510800,22,18,40,Drizzle
9767,65,1552510800,39,1,40,Drizzle
9768,66,1552510800,37,3,40,Drizzle
9769,67,1552510800,28,12,40,Drizzle
9770,68,1552510800,38,2,40,Drizzle
9771,69,1552510800,39,1,40,Drizzle
9772,70,1552510800,10,18,28,Drizzle
9773,71,1552510800,36,4,40,Drizzle
9774,72,1552510800,2,23,25,Drizzle
9775,73,1552510800,21,9,30,Drizzle
9776,74,1552510800,9,21,30,Drizzle
9777,75,1552510800,21,19,40,Drizzle
9778,76,1552510800,33,5,38,Drizzle
9779,77,1552510800,25,4,29,Drizzle
9780,78,1552510800,18,22,40,Drizzle
9781,79,1552510800,16,11,27,Drizzle
9782,80,1552510800,19,21,40,Drizzle
9783,81,1552510800,40,0,40,Drizzle
9784,82,1552510800,7,15,22,Drizzle
9785,83,1552510800,1,39,40,Drizzle
9786,84,1552510800,19,11,30,Drizzle
9787,85,1552510800,7,28,35,Drizzle
9788,86,1552510800,0,38,38,Drizzle
9789,87,1552510800,17,20,37,Drizzle
9790,88,1552510800,18,12,30,Drizzle
9791,89,1552510800,35,5,40,Drizzle
9792,90,1552510800,39,1,40,Drizzle
9793,91,1552510800,3,27,30,Drizzle
9794,92,1552510800,0,40,40,Drizzle
9795,93,1552510800,0,40,40,Drizzle
9796,94,1552510800,0,40,40,Drizzle
9797,95,1552510800,12,28,40,Drizzle
9798,96,1552510800,19,11,30,Drizzle
9799,97,1552510800,19,21,40,Drizzle
9800,98,1552510800,40,0,40,Drizzle
9801,99,1552510800,30,0,30,Drizzle
9802,100,1552510800,0,25,25,Drizzle
9803,101,1552510800,26,4,30,Drizzle
9804,102,1552510800,29,11,40,Drizzle
9805,103,1552510800,40,0,40,Drizzle
9806,104,1552510800,40,0,40,Drizzle
9807,105,1552510800,33,3,36,Drizzle
9808,106,1552510800,33,7,40,Drizzle
9809,107,1552510800,29,11,40,Drizzle
9810,108,1552510800,28,12,40,Drizzle
9811,109,1552510800,2,27,29,Drizzle
9812,110,1552510800,36,4,40,Drizzle
9813,111,1552510800,18,22,40,Drizzle
9814,112,1552510800,0,30,30,Drizzle
9815,113,1552510800,36,4,40,Drizzle
9816,114,1552510800,37,3,40,Drizzle
9817,115,1552510800,1,29,30,Drizzle
9818,2,1552514400,17,3,20,Drizzle
9819,3,1552514400,20,0,20,Drizzle
9820,4,1552514400,15,5,20,Drizzle
9821,5,1552514400,18,22,40,Drizzle
9822,6,1552514400,20,0,20,Drizzle
9823,7,1552514400,25,4,29,Drizzle
9824,8,1552514400,29,1,30,Drizzle
9825,9,1552514400,21,3,24,Drizzle
9826,10,1552514400,16,0,16,Drizzle
9827,11,1552514400,30,0,30,Drizzle
9828,12,1552514400,15,5,20,Drizzle
9829,13,1552514400,27,3,30,Drizzle
9830,14,1552514400,29,1,30,Drizzle
9831,15,1552514400,10,6,16,Drizzle
9832,16,1552514400,19,1,20,Drizzle
9833,17,1552514400,19,1,20,Drizzle
9834,18,1552514400,10,19,29,Drizzle
9835,19,1552514400,30,0,30,Drizzle
9836,21,1552514400,29,1,30,Drizzle
9837,22,1552514400,20,0,20,Drizzle
9838,23,1552514400,11,19,30,Drizzle
9839,24,1552514400,3,17,20,Drizzle
9840,25,1552514400,30,0,30,Drizzle
9841,26,1552514400,10,10,20,Drizzle
9842,27,1552514400,20,0,20,Drizzle
9843,28,1552514400,1,29,30,Drizzle
9844,29,1552514400,15,14,29,Drizzle
9845,30,1552514400,19,1,20,Drizzle
9846,31,1552514400,20,0,20,Drizzle
9847,32,1552514400,7,23,30,Drizzle
9848,33,1552514400,5,16,21,Drizzle
9849,34,1552514400,3,27,30,Drizzle
9850,35,1552514400,21,9,30,Drizzle
9851,36,1552514400,40,0,40,Drizzle
9852,37,1552514400,30,0,30,Drizzle
9853,38,1552514400,11,29,40,Drizzle
9854,39,1552514400,19,1,20,Drizzle
9855,40,1552514400,18,3,21,Drizzle
9856,41,1552514400,20,0,20,Drizzle
9857,42,1552514400,18,12,30,Drizzle
9858,43,1552514400,2,28,30,Drizzle
9859,44,1552514400,0,30,30,Drizzle
9860,45,1552514400,1,29,30,Drizzle
9861,46,1552514400,19,1,20,Drizzle
9862,47,1552514400,40,0,40,Drizzle
9863,48,1552514400,39,1,40,Drizzle
9864,49,1552514400,40,0,40,Drizzle
9865,50,1552514400,11,29,40,Drizzle
9866,51,1552514400,40,0,40,Drizzle
9867,52,1552514400,32,0,32,Drizzle
9868,53,1552514400,39,1,40,Drizzle
9869,54,1552514400,33,0,33,Drizzle
9870,55,1552514400,36,0,36,Drizzle
9871,56,1552514400,40,0,40,Drizzle
9872,57,1552514400,23,0,23,Drizzle
9873,58,1552514400,40,0,40,Drizzle
9874,59,1552514400,18,2,20,Drizzle
9875,60,1552514400,0,30,30,Drizzle
9876,61,1552514400,14,11,25,Drizzle
9877,62,1552514400,40,0,40,Drizzle
9878,63,1552514400,18,17,35,Drizzle
9879,64,1552514400,27,13,40,Drizzle
9880,65,1552514400,40,0,40,Drizzle
9881,66,1552514400,34,6,40,Drizzle
9882,67,1552514400,22,18,40,Drizzle
9883,68,1552514400,37,3,40,Drizzle
9884,69,1552514400,39,1,40,Drizzle
9885,70,1552514400,12,16,28,Drizzle
9886,71,1552514400,40,0,40,Drizzle
9887,72,1552514400,2,23,25,Drizzle
9888,73,1552514400,14,16,30,Drizzle
9889,74,1552514400,10,20,30,Drizzle
9890,75,1552514400,22,18,40,Drizzle
9891,76,1552514400,34,4,38,Drizzle
9892,77,1552514400,25,4,29,Drizzle
9893,78,1552514400,20,20,40,Drizzle
9894,79,1552514400,15,12,27,Drizzle
9895,80,1552514400,20,20,40,Drizzle
9896,81,1552514400,40,0,40,Drizzle
9897,82,1552514400,5,17,22,Drizzle
9898,83,1552514400,0,40,40,Drizzle
9899,84,1552514400,14,16,30,Drizzle
9900,85,1552514400,5,30,35,Drizzle
9901,86,1552514400,6,32,38,Drizzle
9902,87,1552514400,14,24,38,Drizzle
9903,88,1552514400,15,15,30,Drizzle
9904,89,1552514400,38,2,40,Drizzle
9905,90,1552514400,39,1,40,Drizzle
9906,91,1552514400,4,26,30,Drizzle
9907,92,1552514400,0,40,40,Drizzle
9908,93,1552514400,0,40,40,Drizzle
9909,94,1552514400,0,40,40,Drizzle
9910,95,1552514400,9,31,40,Drizzle
9911,96,1552514400,17,13,30,Drizzle
9912,97,1552514400,16,24,40,Drizzle
9913,98,1552514400,40,0,40,Drizzle
9914,99,1552514400,30,0,30,Drizzle
9915,100,1552514400,0,25,25,Drizzle
9916,101,1552514400,19,11,30,Drizzle
9917,102,1552514400,28,12,40,Drizzle
9918,103,1552514400,40,0,40,Drizzle
9919,104,1552514400,40,0,40,Drizzle
9920,105,1552514400,32,4,36,Drizzle
9921,106,1552514400,32,8,40,Drizzle
9922,107,1552514400,27,13,40,Drizzle
9923,108,1552514400,27,13,40,Drizzle
9924,109,1552514400,0,29,29,Drizzle
9925,110,1552514400,33,7,40,Drizzle
9926,111,1552514400,9,31,40,Drizzle
9927,112,1552514400,0,30,30,Drizzle
9928,113,1552514400,38,2,40,Drizzle
9929,114,1552514400,38,2,40,Drizzle
9930,115,1552514400,1,29,30,Drizzle
9931,2,1552518000,11,7,18,Rain
9932,3,1552518000,17,3,20,Rain
9933,4,1552518000,18,2,20,Rain
9934,5,1552518000,15,25,40,Rain
9935,6,1552518000,20,0,20,Rain
9936,7,1552518000,23,6,29,Rain
9937,8,1552518000,30,0,30,Rain
9938,9,1552518000,15,9,24,Rain
9939,10,1552518000,16,0,16,Rain
9940,11,1552518000,29,1,30,Rain
9941,12,1552518000,18,2,20,Rain
9942,13,1552518000,30,0,30,Rain
9943,14,1552518000,30,0,30,Rain
9944,15,1552518000,10,6,16,Rain
9945,16,1552518000,20,0,20,Rain
9946,17,1552518000,20,0,20,Rain
9947,18,1552518000,13,16,29,Rain
9948,19,1552518000,29,1,30,Rain
9949,21,1552518000,30,0,30,Rain
9950,22,1552518000,18,2,20,Rain
9951,23,1552518000,10,20,30,Rain
9952,24,1552518000,5,15,20,Rain
9953,25,1552518000,30,0,30,Rain
9954,26,1552518000,19,1,20,Rain
9955,27,1552518000,20,0,20,Rain
9956,28,1552518000,0,30,30,Rain
9957,29,1552518000,20,9,29,Rain
9958,30,1552518000,20,0,20,Rain
9959,31,1552518000,20,0,20,Rain
9960,32,1552518000,8,22,30,Rain
9961,33,1552518000,11,12,23,Rain
9962,34,1552518000,1,29,30,Rain
9963,35,1552518000,20,10,30,Rain
9964,36,1552518000,40,0,40,Rain
9965,37,1552518000,30,0,30,Rain
9966,38,1552518000,17,23,40,Rain
9967,39,1552518000,16,4,20,Rain
9968,40,1552518000,21,0,21,Rain
9969,41,1552518000,20,0,20,Rain
9970,42,1552518000,15,15,30,Rain
9971,43,1552518000,1,29,30,Rain
9972,44,1552518000,1,29,30,Rain
9973,45,1552518000,2,28,30,Rain
9974,46,1552518000,19,1,20,Rain
9975,47,1552518000,40,0,40,Rain
9976,48,1552518000,39,1,40,Rain
9977,49,1552518000,38,2,40,Rain
9978,50,1552518000,2,38,40,Rain
9979,51,1552518000,40,0,40,Rain
9980,52,1552518000,32,0,32,Rain
9981,53,1552518000,40,0,40,Rain
9982,54,1552518000,33,0,33,Rain
9983,55,1552518000,36,0,36,Rain
9984,56,1552518000,40,0,40,Rain
9985,57,1552518000,23,0,23,Rain
9986,58,1552518000,36,4,40,Rain
9987,59,1552518000,20,0,20,Rain
9988,60,1552518000,13,17,30,Rain
9989,61,1552518000,13,12,25,Rain
9990,62,1552518000,39,1,40,Rain
9991,63,1552518000,17,18,35,Rain
9992,64,1552518000,32,8,40,Rain
9993,65,1552518000,40,0,40,Rain
9994,66,1552518000,37,3,40,Rain
9995,67,1552518000,18,22,40,Rain
9996,68,1552518000,26,14,40,Rain
9997,69,1552518000,40,0,40,Rain
9998,70,1552518000,19,9,28,Rain
9999,71,1552518000,40,0,40,Rain
10000,72,1552518000,2,23,25,Rain
10001,73,1552518000,12,18,30,Rain
10002,74,1552518000,10,20,30,Rain
10003,75,1552518000,22,18,40,Rain
10004,76,1552518000,33,5,38,Rain
10005,77,1552518000,23,6,29,Rain
10006,78,1552518000,19,21,40,Rain
10007,79,1552518000,16,11,27,Rain
10008,80,1552518000,19,21,40,Rain
10009,81,1552518000,37,3,40,Rain
10010,82,1552518000,4,18,22,Rain
10011,83,1552518000,0,40,40,Rain
10012,84,1552518000,14,16,30,Rain
10013,85,1552518000,1,34,35,Rain
10014,86,1552518000,6,32,38,Rain
10015,87,1552518000,14,24,38,Rain
10016,88,1552518000,13,17,30,Rain
10017,89,1552518000,40,0,40,Rain
10018,90,1552518000,34,6,40,Rain
10019,91,1552518000,1,29,30,Rain
10020,92,1552518000,0,40,40,Rain
10021,93,1552518000,0,40,40,Rain
10022,94,1552518000,9,31,40,Rain
10023,95,1552518000,7,33,40,Rain
10024,96,1552518000,17,13,30,Rain
10025,97,1552518000,11,29,40,Rain
10026,98,1552518000,40,0,40,Rain
10027,99,1552518000,30,0,30,Rain
10028,100,1552518000,7,18,25,Rain
10029,101,1552518000,15,15,30,Rain
10030,102,1552518000,27,13,40,Rain
10031,103,1552518000,40,0,40,Rain
10032,104,1552518000,40,0,40,Rain
10033,105,1552518000,33,3,36,Rain
10034,106,1552518000,31,9,40,Rain
10035,107,1552518000,26,14,40,Rain
10036,108,1552518000,27,13,40,Rain
10037,109,1552518000,0,29,29,Rain
10038,110,1552518000,34,6,40,Rain
10039,111,1552518000,4,36,40,Rain
10040,112,1552518000,0,30,30,Rain
10041,113,1552518000,38,2,40,Rain
10042,114,1552518000,40,0,40,Rain
10043,115,1552518000,6,24,30,Rain
10044,2,1552521600,9,11,20,Rain
10045,3,1552521600,17,3,20,Rain
10046,4,1552521600,19,1,20,Rain
10047,5,1552521600,12,28,40,Rain
10048,6,1552521600,17,3,20,Rain
10049,7,1552521600,24,5,29,Rain
10050,8,1552521600,28,2,30,Rain
10051,9,1552521600,24,0,24,Rain
10052,10,1552521600,14,2,16,Rain
10053,11,1552521600,29,1,30,Rain
10054,12,1552521600,16,4,20,Rain
10055,13,1552521600,29,1,30,Rain
10056,14,1552521600,29,1,30,Rain
10057,15,1552521600,8,8,16,Rain
10058,16,1552521600,19,1,20,Rain
10059,17,1552521600,20,0,20,Rain
10060,18,1552521600,16,14,30,Rain
10061,19,1552521600,30,0,30,Rain
10062,21,1552521600,30,0,30,Rain
10063,22,1552521600,18,2,20,Rain
10064,23,1552521600,15,15,30,Rain
10065,24,1552521600,14,6,20,Rain
10066,25,1552521600,29,1,30,Rain
10067,26,1552521600,20,0,20,Rain
10068,27,1552521600,20,0,20,Rain
10069,28,1552521600,0,30,30,Rain
10070,29,1552521600,23,6,29,Rain
10071,30,1552521600,20,0,20,Rain
10072,31,1552521600,18,2,20,Rain
10073,32,1552521600,25,5,30,Rain
10074,33,1552521600,15,8,23,Rain
10075,34,1552521600,2,28,30,Rain
10076,35,1552521600,18,12,30,Rain
10077,36,1552521600,40,0,40,Rain
10078,37,1552521600,30,0,30,Rain
10079,38,1552521600,19,21,40,Rain
10080,39,1552521600,20,0,20,Rain
10081,40,1552521600,18,3,21,Rain
10082,41,1552521600,20,0,20,Rain
10083,42,1552521600,7,23,30,Rain
10084,43,1552521600,1,29,30,Rain
10085,44,1552521600,0,30,30,Rain
10086,45,1552521600,2,28,30,Rain
10087,46,1552521600,20,0,20,Rain
10088,47,1552521600,40,0,40,Rain
10089,48,1552521600,40,0,40,Rain
10090,49,1552521600,39,1,40,Rain
10091,50,1552521600,0,40,40,Rain
10092,51,1552521600,40,0,40,Rain
10093,52,1552521600,32,0,32,Rain
10094,53,1552521600,40,0,40,Rain
10095,54,1552521600,31,2,33,Rain
10096,55,1552521600,36,0,36,Rain
10097,56,1552521600,39,1,40,Rain
10098,57,1552521600,23,0,23,Rain
10099,58,1552521600,37,3,40,Rain
10100,59,1552521600,9,11,20,Rain
10101,60,1552521600,7,23,30,Rain
10102,61,1552521600,17,8,25,Rain
10103,62,1552521600,38,2,40,Rain
10104,63,1552521600,20,15,35,Rain
10105,64,1552521600,33,7,40,Rain
10106,65,1552521600,39,1,40,Rain
10107,66,1552521600,35,5,40,Rain
10108,67,1552521600,14,26,40,Rain
10109,68,1552521600,26,14,40,Rain
10110,69,1552521600,40,0,40,Rain
10111,70,1552521600,18,10,28,Rain
10112,71,1552521600,39,1,40,Rain
10113,72,1552521600,2,23,25,Rain
10114,73,1552521600,10,20,30,Rain
10115,74,1552521600,13,17,30,Rain
10116,75,1552521600,22,18,40,Rain
10117,76,1552521600,32,6,38,Rain
10118,77,1552521600,22,7,29,Rain
10119,78,1552521600,15,25,40,Rain
10120,79,1552521600,15,12,27,Rain
10121,80,1552521600,20,20,40,Rain
10122,81,1552521600,37,3,40,Rain
10123,82,1552521600,4,18,22,Rain
10124,83,1552521600,2,38,40,Rain
10125,84,1552521600,8,22,30,Rain
10126,85,1552521600,0,35,35,Rain
10127,86,1552521600,4,34,38,Rain
10128,87,1552521600,13,25,38,Rain
10129,88,1552521600,11,19,30,Rain
10130,89,1552521600,40,0,40,Rain
10131,90,1552521600,34,6,40,Rain
10132,91,1552521600,2,28,30,Rain
10133,92,1552521600,0,40,40,Rain
10134,93,1552521600,0,40,40,Rain
10135,94,1552521600,9,31,40,Rain
10136,95,1552521600,4,36,40,Rain
10137,96,1552521600,17,13,30,Rain
10138,97,1552521600,11,29,40,Rain
10139,98,1552521600,40,0,40,Rain
10140,99,1552521600,30,0,30,Rain
10141,100,1552521600,6,19,25,Rain
10142,101,1552521600,14,16,30,Rain
10143,102,1552521600,14,26,40,Rain
10144,103,1552521600,40,0,40,Rain
10145,104,1552521600,40,0,40,Rain
10146,105,1552521600,33,3,36,Rain
10147,106,1552521600,31,9,40,Rain
10148,107,1552521600,25,15,40,Rain
10149,108,1552521600,27,13,40,Rain
10150,109,1552521600,0,29,29,Rain
10151,110,1552521600,34,6,40,Rain
10152,111,1552521600,0,40,40,Rain
10153,112,1552521600,0,30,30,Rain
10154,113,1552521600,39,1,40,Rain
10155,114,1552521600,40,0,40,Rain
10156,115,1552521600,2,28,30,Rain
10157,2,1552525200,9,11,20,Rain
10158,3,1552525200,16,4,20,Rain
10159,4,1552525200,19,1,20,Rain
10160,5,1552525200,11,29,40,Rain
10161,6,1552525200,20,0,20,Rain
10162,7,1552525200,28,1,29,Rain
10163,8,1552525200,30,0,30,Rain
10164,9,1552525200,24,0,24,Rain
10165,10,1552525200,16,0,16,Rain
10166,11,1552525200,30,0,30,Rain
10167,12,1552525200,17,3,20,Rain
10168,13,1552525200,30,0,30,Rain
10169,14,1552525200,30,0,30,Rain
10170,15,1552525200,5,11,16,Rain
10171,16,1552525200,19,1,20,Rain
10172,17,1552525200,20,0,20,Rain
10173,18,1552525200,19,11,30,Rain
10174,19,1552525200,30,0,30,Rain
10175,21,1552525200,30,0,30,Rain
10176,22,1552525200,20,0,20,Rain
10177,23,1552525200,17,13,30,Rain
10178,24,1552525200,15,5,20,Rain
10179,25,1552525200,28,2,30,Rain
10180,26,1552525200,20,0,20,Rain
10181,27,1552525200,20,0,20,Rain
10182,28,1552525200,0,30,30,Rain
10183,29,1552525200,26,3,29,Rain
10184,30,1552525200,20,0,20,Rain
10185,31,1552525200,14,6,20,Rain
10186,32,1552525200,28,2,30,Rain
10187,33,1552525200,14,9,23,Rain
10188,34,1552525200,0,30,30,Rain
10189,35,1552525200,19,11,30,Rain
10190,36,1552525200,40,0,40,Rain
10191,37,1552525200,30,0,30,Rain
10192,38,1552525200,22,18,40,Rain
10193,39,1552525200,19,1,20,Rain
10194,40,1552525200,20,1,21,Rain
10195,41,1552525200,20,0,20,Rain
10196,42,1552525200,10,20,30,Rain
10197,43,1552525200,0,30,30,Rain
10198,44,1552525200,1,29,30,Rain
10199,45,1552525200,0,30,30,Rain
10200,46,1552525200,20,0,20,Rain
10201,47,1552525200,40,0,40,Rain
10202,48,1552525200,40,0,40,Rain
10203,49,1552525200,38,2,40,Rain
10204,50,1552525200,1,39,40,Rain
10205,51,1552525200,40,0,40,Rain
10206,52,1552525200,31,1,32,Rain
10207,53,1552525200,40,0,40,Rain
10208,54,1552525200,27,6,33,Rain
10209,55,1552525200,36,0,36,Rain
10210,56,1552525200,38,2,40,Rain
10211,57,1552525200,22,1,23,Rain
10212,58,1552525200,40,0,40,Rain
10213,59,1552525200,8,12,20,Rain
10214,60,1552525200,1,29,30,Rain
10215,61,1552525200,17,8,25,Rain
10216,62,1552525200,39,1,40,Rain
10217,63,1552525200,22,13,35,Rain
10218,64,1552525200,33,7,40,Rain
10219,65,1552525200,39,1,40,Rain
10220,66,1552525200,31,9,40,Rain
10221,67,1552525200,17,23,40,Rain
10222,68,1552525200,29,11,40,Rain
10223,69,1552525200,38,2,40,Rain
10224,70,1552525200,9,19,28,Rain
10225,71,1552525200,40,0,40,Rain
10226,72,1552525200,3,22,25,Rain
10227,73,1552525200,9,21,30,Rain
10228,74,1552525200,12,18,30,Rain
10229,75,1552525200,22,18,40,Rain
10230,76,1552525200,32,6,38,Rain
10231,77,1552525200,21,8,29,Rain
10232,78,1552525200,14,26,40,Rain
10233,79,1552525200,14,13,27,Rain
10234,80,1552525200,18,22,40,Rain
10235,81,1552525200,39,1,40,Rain
10236,82,1552525200,3,19,22,Rain
10237,83,1552525200,3,37,40,Rain
10238,84,1552525200,7,23,30,Rain
10239,85,1552525200,0,35,35,Rain
10240,86,1552525200,2,36,38,Rain
10241,87,1552525200,12,26,38,Rain
10242,88,1552525200,15,15,30,Rain
10243,89,1552525200,40,0,40,Rain
10244,90,1552525200,34,6,40,Rain
10245,91,1552525200,0,30,30,Rain
10246,92,1552525200,0,40,40,Rain
10247,93,1552525200,0,40,40,Rain
10248,94,1552525200,9,31,40,Rain
10249,95,1552525200,4,36,40,Rain
10250,96,1552525200,17,13,30,Rain
10251,97,1552525200,12,28,40,Rain
10252,98,1552525200,39,1,40,Rain
10253,99,1552525200,30,0,30,Rain
10254,100,1552525200,4,21,25,Rain
10255,101,1552525200,13,17,30,Rain
10256,102,1552525200,14,26,40,Rain
10257,103,1552525200,40,0,40,Rain
10258,104,1552525200,40,0,40,Rain
10259,105,1552525200,33,3,36,Rain
10260,106,1552525200,30,10,40,Rain
10261,107,1552525200,25,15,40,Rain
10262,108,1552525200,27,13,40,Rain
10263,109,1552525200,0,29,29,Rain
10264,110,1552525200,33,7,40,Rain
10265,111,1552525200,0,40,40,Rain
10266,112,1552525200,0,30,30,Rain
10267,113,1552525200,40,0,40,Rain
10268,114,1552525200,40,0,40,Rain
10269,115,1552525200,2,28,30,Rain
10270,2,1552528800,9,11,20,Rain
10271,3,1552528800,16,4,20,Rain
10272,4,1552528800,19,1,20,Rain
10273,5,1552528800,12,28,40,Rain
10274,6,1552528800,20,0,20,Rain
10275,7,1552528800,29,0,29,Rain
10276,8,1552528800,29,1,30,Rain
10277,9,1552528800,24,0,24,Rain
10278,10,1552528800,16,0,16,Rain
10279,11,1552528800,30,0,30,Rain
10280,12,1552528800,17,3,20,Rain
10281,13,1552528800,30,0,30,Rain
10282,14,1552528800,30,0,30,Rain
10283,15,1552528800,5,11,16,Rain
10284,16,1552528800,20,0,20,Rain
10285,17,1552528800,20,0,20,Rain
10286,18,1552528800,20,10,30,Rain
10287,19,1552528800,28,2,30,Rain
10288,21,1552528800,30,0,30,Rain
10289,22,1552528800,20,0,20,Rain
10290,23,1552528800,18,12,30,Rain
10291,24,1552528800,15,5,20,Rain
10292,25,1552528800,28,2,30,Rain
10293,26,1552528800,20,0,20,Rain
10294,27,1552528800,20,0,20,Rain
10295,28,1552528800,0,30,30,Rain
10296,29,1552528800,26,3,29,Rain
10297,30,1552528800,20,0,20,Rain
10298,31,1552528800,14,6,20,Rain
10299,32,1552528800,28,2,30,Rain
10300,33,1552528800,17,6,23,Rain
10301,34,1552528800,2,28,30,Rain
10302,35,1552528800,18,12,30,Rain
10303,36,1552528800,40,0,40,Rain
10304,37,1552528800,30,0,30,Rain
10305,38,1552528800,23,17,40,Rain
10306,39,1552528800,19,1,20,Rain
10307,40,1552528800,20,1,21,Rain
10308,41,1552528800,19,1,20,Rain
10309,42,1552528800,8,22,30,Rain
10310,43,1552528800,0,30,30,Rain
10311,44,1552528800,0,30,30,Rain
10312,45,1552528800,0,30,30,Rain
10313,46,1552528800,20,0,20,Rain
10314,47,1552528800,40,0,40,Rain
10315,48,1552528800,40,0,40,Rain
10316,49,1552528800,39,1,40,Rain
10317,50,1552528800,1,39,40,Rain
10318,51,1552528800,40,0,40,Rain
10319,52,1552528800,31,1,32,Rain
10320,53,1552528800,40,0,40,Rain
10321,54,1552528800,28,5,33,Rain
10322,55,1552528800,36,0,36,Rain
10323,56,1552528800,38,2,40,Rain
10324,57,1552528800,22,1,23,Rain
10325,58,1552528800,40,0,40,Rain
10326,59,1552528800,6,14,20,Rain
10327,60,1552528800,0,30,30,Rain
10328,61,1552528800,17,8,25,Rain
10329,62,1552528800,39,1,40,Rain
10330,63,1552528800,22,13,35,Rain
10331,64,1552528800,33,7,40,Rain
10332,65,1552528800,39,1,40,Rain
10333,66,1552528800,30,10,40,Rain
10334,67,1552528800,18,22,40,Rain
10335,68,1552528800,29,11,40,Rain
10336,69,1552528800,38,2,40,Rain
10337,70,1552528800,8,20,28,Rain
10338,71,1552528800,40,0,40,Rain
10339,72,1552528800,3,22,25,Rain
10340,73,1552528800,9,21,30,Rain
10341,74,1552528800,12,18,30,Rain
10342,75,1552528800,22,18,40,Rain
10343,76,1552528800,31,7,38,Rain
10344,77,1552528800,21,8,29,Rain
10345,78,1552528800,12,28,40,Rain
10346,79,1552528800,14,13,27,Rain
10347,80,1552528800,18,22,40,Rain
10348,81,1552528800,39,1,40,Rain
10349,82,1552528800,1,21,22,Rain
10350,83,1552528800,3,37,40,Rain
10351,84,1552528800,7,23,30,Rain
10352,85,1552528800,0,35,35,Rain
10353,86,1552528800,2,36,38,Rain
10354,87,1552528800,12,26,38,Rain
10355,88,1552528800,15,15,30,Rain
10356,89,1552528800,40,0,40,Rain
10357,90,1552528800,34,6,40,Rain
10358,91,1552528800,0,30,30,Rain
10359,92,1552528800,1,39,40,Rain
10360,93,1552528800,0,40,40,Rain
10361,94,1552528800,9,31,40,Rain
10362,95,1552528800,4,36,40,Rain
10363,96,1552528800,17,13,30,Rain
10364,97,1552528800,11,29,40,Rain
10365,98,1552528800,39,1,40,Rain
10366,99,1552528800,30,0,30,Rain
10367,100,1552528800,4,21,25,Rain
10368,101,1552528800,13,17,30,Rain
10369,102,1552528800,14,26,40,Rain
10370,103,1552528800,40,0,40,Rain
10371,104,1552528800,40,0,40,Rain
10372,105,1552528800,33,3,36,Rain
10373,106,1552528800,30,10,40,Rain
10374,107,1552528800,25,15,40,Rain
10375,108,1552528800,26,14,40,Rain
10376,109,1552528800,0,29,29,Rain
10377,110,1552528800,32,8,40,Rain
10378,111,1552528800,0,40,40,Rain
10379,112,1552528800,0,30,30,Rain
10380,113,1552528800,40,0,40,Rain
10381,114,1552528800,40,0,40,Rain
10382,115,1552528800,2,28,30,Rain
10383,2,1552532400,9,11,20,Rain
10384,3,1552532400,16,4,20,Rain
10385,4,1552532400,19,1,20,Rain
10386,5,1552532400,12,28,40,Rain
10387,6,1552532400,20,0,20,Rain
10388,7,1552532400,29,0,29,Rain
10389,8,1552532400,29,1,30,Rain
10390,9,1552532400,24,0,24,Rain
10391,10,1552532400,16,0,16,Rain
10392,11,1552532400,30,0,30,Rain
10393,12,1552532400,17,3,20,Rain
10394,13,1552532400,30,0,30,Rain
10395,14,1552532400,30,0,30,Rain
10396,15,1552532400,5,11,16,Rain
10397,16,1552532400,20,0,20,Rain
10398,17,1552532400,20,0,20,Rain
10399,18,1552532400,20,10,30,Rain
10400,19,1552532400,27,3,30,Rain
10401,21,1552532400,30,0,30,Rain
10402,22,1552532400,20,0,20,Rain
10403,23,1552532400,18,12,30,Rain
10404,24,1552532400,15,5,20,Rain
10405,25,1552532400,28,2,30,Rain
10406,26,1552532400,20,0,20,Rain
10407,27,1552532400,20,0,20,Rain
10408,28,1552532400,0,30,30,Rain
10409,29,1552532400,26,3,29,Rain
10410,30,1552532400,20,0,20,Rain
10411,31,1552532400,14,6,20,Rain
10412,32,1552532400,28,2,30,Rain
10413,33,1552532400,17,6,23,Rain
10414,34,1552532400,2,28,30,Rain
10415,35,1552532400,18,12,30,Rain
10416,36,1552532400,40,0,40,Rain
10417,37,1552532400,30,0,30,Rain
10418,38,1552532400,23,17,40,Rain
10419,39,1552532400,19,1,20,Rain
10420,40,1552532400,20,1,21,Rain
10421,41,1552532400,19,1,20,Rain
10422,42,1552532400,8,22,30,Rain
10423,43,1552532400,0,30,30,Rain
10424,44,1552532400,0,30,30,Rain
10425,45,1552532400,0,30,30,Rain
10426,46,1552532400,20,0,20,Rain
10427,47,1552532400,40,0,40,Rain
10428,48,1552532400,40,0,40,Rain
10429,49,1552532400,39,1,40,Rain
10430,50,1552532400,1,39,40,Rain
10431,51,1552532400,40,0,40,Rain
10432,52,1552532400,31,1,32,Rain
10433,53,1552532400,40,0,40,Rain
10434,54,1552532400,28,5,33,Rain
10435,55,1552532400,36,0,36,Rain
10436,56,1552532400,38,2,40,Rain
10437,57,1552532400,22,1,23,Rain
10438,58,1552532400,40,0,40,Rain
10439,59,1552532400,6,14,20,Rain
10440,60,1552532400,0,30,30,Rain
10441,61,1552532400,17,8,25,Rain
10442,62,1552532400,39,1,40,Rain
10443,63,1552532400,22,13,35,Rain
10444,64,1552532400,33,7,40,Rain
10445,65,1552532400,39,1,40,Rain
10446,66,1552532400,29,11,40,Rain
10447,67,1552532400,18,22,40,Rain
10448,68,1552532400,29,11,40,Rain
10449,69,1552532400,38,2,40,Rain
10450,70,1552532400,8,20,28,Rain
10451,71,1552532400,40,0,40,Rain
10452,72,1552532400,3,22,25,Rain
10453,73,1552532400,9,21,30,Rain
10454,74,1552532400,12,18,30,Rain
10455,75,1552532400,22,18,40,Rain
10456,76,1552532400,31,7,38,Rain
10457,77,1552532400,21,8,29,Rain
10458,78,1552532400,12,28,40,Rain
10459,79,1552532400,14,13,27,Rain
10460,80,1552532400,18,22,40,Rain
10461,81,1552532400,39,1,40,Rain
10462,82,1552532400,1,21,22,Rain
10463,83,1552532400,3,37,40,Rain
10464,84,1552532400,7,23,30,Rain
10465,85,1552532400,0,35,35,Rain
10466,86,1552532400,2,36,38,Rain
10467,87,1552532400,12,26,38,Rain
10468,88,1552532400,15,15,30,Rain
10469,89,1552532400,40,0,40,Rain
10470,90,1552532400,34,6,40,Rain
10471,91,1552532400,0,30,30,Rain
10472,92,1552532400,1,39,40,Rain
10473,93,1552532400,0,40,40,Rain
10474,94,1552532400,9,31,40,Rain
10475,95,1552532400,4,36,40,Rain
10476,96,1552532400,17,13,30,Rain
10477,97,1552532400,11,29,40,Rain
10478,98,1552532400,39,1,40,Rain
10479,99,1552532400,30,0,30,Rain
10480,100,1552532400,4,21,25,Rain
10481,101,1552532400,13,17,30,Rain
10482,102,1552532400,14,26,40,Rain
10483,103,1552532400,40,0,40,Rain
10484,104,1552532400,40,0,40,Rain
10485,105,1552532400,33,3,36,Rain
10486,106,1552532400,30,10,40,Rain
10487,107,1552532400,25,15,40,Rain
10488,108,1552532400,26,14,40,Rain
10489,109,1552532400,0,29,29,Rain
10490,110,1552532400,32,8,40,Rain
10491,111,1552532400,0,40,40,Rain
10492,112,1552532400,0,30,30,Rain
10493,113,1552532400,40,0,40,Rain
10494,114,1552532400,40,0,40,Rain
10495,115,1552532400,2,28,30,Rain
10496,2,1552536000,9,11,20,Rain
10497,3,1552536000,16,4,20,Rain
10498,4,1552536000,19,1,20,Rain
10499,5,1552536000,12,28,40,Rain
10500,6,1552536000,20,0,20,Rain
10501,7,1552536000,29,0,29,Rain
10502,8,1552536000,29,1,30,Rain
10503,9,1552536000,24,0,24,Rain
10504,10,1552536000,16,0,16,Rain
10505,11,1552536000,30,0,30,Rain
10506,12,1552536000,17,3,20,Rain
10507,13,1552536000,30,0,30,Rain
10508,14,1552536000,30,0,30,Rain
10509,15,1552536000,5,11,16,Rain
10510,16,1552536000,20,0,20,Rain
10511,17,1552536000,20,0,20,Rain
10512,18,1552536000,20,10,30,Rain
10513,19,1552536000,27,3,30,Rain
10514,21,1552536000,30,0,30,Rain
10515,22,1552536000,20,0,20,Rain
10516,23,1552536000,18,12,30,Rain
10517,24,1552536000,15,5,20,Rain
10518,25,1552536000,28,2,30,Rain
10519,26,1552536000,20,0,20,Rain
10520,27,1552536000,20,0,20,Rain
10521,28,1552536000,0,30,30,Rain
10522,29,1552536000,26,3,29,Rain
10523,30,1552536000,20,0,20,Rain
10524,31,1552536000,14,6,20,Rain
10525,32,1552536000,28,2,30,Rain
10526,33,1552536000,17,6,23,Rain
10527,34,1552536000,2,28,30,Rain
10528,35,1552536000,18,12,30,Rain
10529,36,1552536000,40,0,40,Rain
10530,37,1552536000,30,0,30,Rain
10531,38,1552536000,23,17,40,Rain
10532,39,1552536000,19,1,20,Rain
10533,40,1552536000,20,1,21,Rain
10534,41,1552536000,19,1,20,Rain
10535,42,1552536000,8,22,30,Rain
10536,43,1552536000,0,30,30,Rain
10537,44,1552536000,0,30,30,Rain
10538,45,1552536000,0,30,30,Rain
10539,46,1552536000,20,0,20,Rain
10540,47,1552536000,40,0,40,Rain
10541,48,1552536000,40,0,40,Rain
10542,49,1552536000,39,1,40,Rain
10543,50,1552536000,1,39,40,Rain
10544,51,1552536000,40,0,40,Rain
10545,52,1552536000,31,1,32,Rain
10546,53,1552536000,40,0,40,Rain
10547,54,1552536000,28,5,33,Rain
10548,55,1552536000,36,0,36,Rain
10549,56,1552536000,38,2,40,Rain
10550,57,1552536000,22,1,23,Rain
10551,58,1552536000,40,0,40,Rain
10552,59,1552536000,5,15,20,Rain
10553,60,1552536000,0,30,30,Rain
10554,61,1552536000,17,8,25,Rain
10555,62,1552536000,39,1,40,Rain
10556,63,1552536000,22,13,35,Rain
10557,64,1552536000,33,7,40,Rain
10558,65,1552536000,39,1,40,Rain
10559,66,1552536000,29,11,40,Rain
10560,67,1552536000,18,22,40,Rain
10561,68,1552536000,29,11,40,Rain
10562,69,1552536000,38,2,40,Rain
10563,70,1552536000,8,20,28,Rain
10564,71,1552536000,40,0,40,Rain
10565,72,1552536000,3,22,25,Rain
10566,73,1552536000,9,21,30,Rain
10567,74,1552536000,12,18,30,Rain
10568,75,1552536000,22,18,40,Rain
10569,76,1552536000,31,7,38,Rain
10570,77,1552536000,21,8,29,Rain
10571,78,1552536000,12,28,40,Rain
10572,79,1552536000,14,13,27,Rain
10573,80,1552536000,18,22,40,Rain
10574,81,1552536000,39,1,40,Rain
10575,82,1552536000,1,21,22,Rain
10576,83,1552536000,3,37,40,Rain
10577,84,1552536000,7,23,30,Rain
10578,85,1552536000,0,35,35,Rain
10579,86,1552536000,2,36,38,Rain
10580,87,1552536000,12,26,38,Rain
10581,88,1552536000,15,15,30,Rain
10582,89,1552536000,40,0,40,Rain
10583,90,1552536000,34,6,40,Rain
10584,91,1552536000,0,30,30,Rain
10585,92,1552536000,1,39,40,Rain
10586,93,1552536000,0,40,40,Rain
10587,94,1552536000,9,31,40,Rain
10588,95,1552536000,4,36,40,Rain
10589,96,1552536000,17,13,30,Rain
10590,97,1552536000,11,29,40,Rain
10591,98,1552536000,39,1,40,Rain
10592,99,1552536000,30,0,30,Rain
10593,100,1552536000,4,21,25,Rain
10594,101,1552536000,13,17,30,Rain
10595,102,1552536000,14,26,40,Rain
10596,103,1552536000,40,0,40,Rain
10597,104,1552536000,40,0,40,Rain
10598,105,1552536000,33,3,36,Rain
10599,106,1552536000,30,10,40,Rain
10600,107,1552536000,25,15,40,Rain
10601,108,1552536000,26,14,40,Rain
10602,109,1552536000,0,29,29,Rain
10603,110,1552536000,32,8,40,Rain
10604,111,1552536000,0,40,40,Rain
10605,112,1552536000,0,30,30,Rain
10606,113,1552536000,40,0,40,Rain
10607,114,1552536000,40,0,40,Rain
10608,115,1552536000,2,28,30,Rain
10609,2,1552539600,9,11,20,Rain
10610,3,1552539600,16,4,20,Rain
10611,4,1552539600,19,1,20,Rain
10612,5,1552539600,12,28,40,Rain
10613,6,1552539600,20,0,20,Rain
10614,7,1552539600,29,0,29,Rain
10615,8,1552539600,29,1,30,Rain
10616,9,1552539600,24,0,24,Rain
10617,10,1552539600,16,0,16,Rain
10618,11,1552539600,30,0,30,Rain
10619,12,1552539600,17,3,20,Rain
10620,13,1552539600,30,0,30,Rain
10621,14,1552539600,30,0,30,Rain
10622,15,1552539600,5,11,16,Rain
10623,16,1552539600,20,0,20,Rain
10624,17,1552539600,20,0,20,Rain
10625,18,1552539600,20,10,30,Rain
10626,19,1552539600,27,3,30,Rain
10627,21,1552539600,30,0,30,Rain
10628,22,1552539600,20,0,20,Rain
10629,23,1552539600,18,12,30,Rain
10630,24,1552539600,15,5,20,Rain
10631,25,1552539600,28,2,30,Rain
10632,26,1552539600,20,0,20,Rain
10633,27,1552539600,20,0,20,Rain
10634,28,1552539600,0,30,30,Rain
10635,29,1552539600,26,3,29,Rain
10636,30,1552539600,20,0,20,Rain
10637,31,1552539600,14,6,20,Rain
10638,32,1552539600,28,2,30,Rain
10639,33,1552539600,17,6,23,Rain
10640,34,1552539600,2,28,30,Rain
10641,35,1552539600,18,12,30,Rain
10642,36,1552539600,40,0,40,Rain
10643,37,1552539600,30,0,30,Rain
10644,38,1552539600,23,17,40,Rain
10645,39,1552539600,19,1,20,Rain
10646,40,1552539600,20,1,21,Rain
10647,41,1552539600,19,1,20,Rain
10648,42,1552539600,8,22,30,Rain
10649,43,1552539600,0,30,30,Rain
10650,44,1552539600,0,30,30,Rain
10651,45,1552539600,0,30,30,Rain
10652,46,1552539600,20,0,20,Rain
10653,47,1552539600,40,0,40,Rain
10654,48,1552539600,40,0,40,Rain
10655,49,1552539600,39,1,40,Rain
10656,50,1552539600,1,39,40,Rain
10657,51,1552539600,40,0,40,Rain
10658,52,1552539600,31,1,32,Rain
10659,53,1552539600,40,0,40,Rain
10660,54,1552539600,28,5,33,Rain
10661,55,1552539600,36,0,36,Rain
10662,56,1552539600,38,2,40,Rain
10663,57,1552539600,22,1,23,Rain
10664,58,1552539600,40,0,40,Rain
10665,59,1552539600,5,15,20,Rain
10666,60,1552539600,0,30,30,Rain
10667,61,1552539600,17,8,25,Rain
10668,62,1552539600,39,1,40,Rain
10669,63,1552539600,22,13,35,Rain
10670,64,1552539600,33,7,40,Rain
10671,65,1552539600,39,1,40,Rain
10672,66,1552539600,29,11,40,Rain
10673,67,1552539600,18,22,40,Rain
10674,68,1552539600,29,11,40,Rain
10675,69,1552539600,38,2,40,Rain
10676,70,1552539600,8,20,28,Rain
10677,71,1552539600,40,0,40,Rain
10678,72,1552539600,3,22,25,Rain
10679,73,1552539600,9,21,30,Rain
10680,74,1552539600,12,18,30,Rain
10681,75,1552539600,22,18,40,Rain
10682,76,1552539600,31,7,38,Rain
10683,77,1552539600,21,8,29,Rain
10684,78,1552539600,12,28,40,Rain
10685,79,1552539600,14,13,27,Rain
10686,80,1552539600,18,22,40,Rain
10687,81,1552539600,39,1,40,Rain
10688,82,1552539600,1,21,22,Rain
10689,83,1552539600,3,37,40,Rain
10690,84,1552539600,7,23,30,Rain
10691,85,1552539600,0,35,35,Rain
10692,86,1552539600,2,36,38,Rain
10693,87,1552539600,12,26,38,Rain
10694,88,1552539600,15,15,30,Rain
10695,89,1552539600,40,0,40,Rain
10696,90,1552539600,34,6,40,Rain
10697,91,1552539600,0,30,30,Rain
10698,92,1552539600,1,39,40,Rain
10699,93,1552539600,0,40,40,Rain
10700,94,1552539600,9,31,40,Rain
10701,95,1552539600,4,36,40,Rain
10702,96,1552539600,17,13,30,Rain
10703,97,1552539600,11,29,40,Rain
10704,98,1552539600,39,1,40,Rain
10705,99,1552539600,30,0,30,Rain
10706,100,1552539600,4,21,25,Rain
10707,101,1552539600,13,17,30,Rain
10708,102,1552539600,14,26,40,Rain
10709,103,1552539600,40,0,40,Rain
10710,104,1552539600,40,0,40,Rain
10711,105,1552539600,33,3,36,Rain
10712,106,1552539600,30,10,40,Rain
10713,107,1552539600,25,15,40,Rain
10714,108,1552539600,26,14,40,Rain
10715,109,1552539600,0,29,29,Rain
10716,110,1552539600,32,8,40,Rain
10717,111,1552539600,0,40,40,Rain
10718,112,1552539600,0,30,30,Rain
10719,113,1552539600,40,0,40,Rain
10720,114,1552539600,40,0,40,Rain
10721,115,1552539600,2,28,30,Rain
10722,2,1552543200,9,11,20,Rain
10723,3,1552543200,16,4,20,Rain
10724,4,1552543200,19,1,20,Rain
10725,5,1552543200,12,28,40,Rain
10726,6,1552543200,20,0,20,Rain
10727,7,1552543200,29,0,29,Rain
10728,8,1552543200,29,1,30,Rain
10729,9,1552543200,24,0,24,Rain
10730,10,1552543200,16,0,16,Rain
10731,11,1552543200,30,0,30,Rain
10732,12,1552543200,17,3,20,Rain
10733,13,1552543200,30,0,30,Rain
10734,14,1552543200,30,0,30,Rain
10735,15,1552543200,5,11,16,Rain
10736,16,1552543200,20,0,20,Rain
10737,17,1552543200,20,0,20,Rain
10738,18,1552543200,20,10,30,Rain
10739,19,1552543200,27,3,30,Rain
10740,21,1552543200,30,0,30,Rain
10741,22,1552543200,20,0,20,Rain
10742,23,1552543200,18,12,30,Rain
10743,24,1552543200,15,5,20,Rain
10744,25,1552543200,28,2,30,Rain
10745,26,1552543200,20,0,20,Rain
10746,27,1552543200,20,0,20,Rain
10747,28,1552543200,0,30,30,Rain
10748,29,1552543200,26,3,29,Rain
10749,30,1552543200,20,0,20,Rain
10750,31,1552543200,14,6,20,Rain
10751,32,1552543200,28,2,30,Rain
10752,33,1552543200,17,6,23,Rain
10753,34,1552543200,2,28,30,Rain
10754,35,1552543200,18,12,30,Rain
10755,36,1552543200,40,0,40,Rain
10756,37,1552543200,30,0,30,Rain
10757,38,1552543200,23,17,40,Rain
10758,39,1552543200,19,1,20,Rain
10759,40,1552543200,20,1,21,Rain
10760,41,1552543200,19,1,20,Rain
10761,42,1552543200,8,22,30,Rain
10762,43,1552543200,0,30,30,Rain
10763,44,1552543200,0,30,30,Rain
10764,45,1552543200,0,30,30,Rain
10765,46,1552543200,20,0,20,Rain
10766,47,1552543200,40,0,40,Rain
10767,48,1552543200,40,0,40,Rain
10768,49,1552543200,39,1,40,Rain
10769,50,1552543200,1,39,40,Rain
10770,51,1552543200,40,0,40,Rain
10771,52,1552543200,31,1,32,Rain
10772,53,1552543200,40,0,40,Rain
10773,54,1552543200,28,5,33,Rain
10774,55,1552543200,36,0,36,Rain
10775,56,1552543200,38,2,40,Rain
10776,57,1552543200,22,1,23,Rain
10777,58,1552543200,40,0,40,Rain
10778,59,1552543200,5,15,20,Rain
10779,60,1552543200,0,30,30,Rain
10780,61,1552543200,17,8,25,Rain
10781,62,1552543200,39,1,40,Rain
10782,63,1552543200,22,13,35,Rain
10783,64,1552543200,33,7,40,Rain
10784,65,1552543200,39,1,40,Rain
10785,66,1552543200,29,11,40,Rain
10786,67,1552543200,18,22,40,Rain
10787,68,1552543200,29,11,40,Rain
10788,69,1552543200,38,2,40,Rain
10789,70,1552543200,8,20,28,Rain
10790,71,1552543200,40,0,40,Rain
10791,72,1552543200,3,22,25,Rain
10792,73,1552543200,9,21,30,Rain
10793,74,1552543200,12,18,30,Rain
10794,75,1552543200,22,18,40,Rain
10795,76,1552543200,31,7,38,Rain
10796,77,1552543200,21,8,29,Rain
10797,78,1552543200,12,28,40,Rain
10798,79,1552543200,14,13,27,Rain
10799,80,1552543200,19,21,40,Rain
10800,81,1552543200,39,1,40,Rain
10801,82,1552543200,1,21,22,Rain
10802,83,1552543200,3,37,40,Rain
10803,84,1552543200,7,23,30,Rain
10804,85,1552543200,0,35,35,Rain
10805,86,1552543200,2,36,38,Rain
10806,87,1552543200,12,26,38,Rain
10807,88,1552543200,15,15,30,Rain
10808,89,1552543200,40,0,40,Rain
10809,90,1552543200,34,6,40,Rain
10810,91,1552543200,0,30,30,Rain
10811,92,1552543200,1,39,40,Rain
10812,93,1552543200,0,40,40,Rain
10813,94,1552543200,9,31,40,Rain
10814,95,1552543200,4,36,40,Rain
10815,96,1552543200,17,13,30,Rain
10816,97,1552543200,11,29,40,Rain
10817,98,1552543200,39,1,40,Rain
10818,99,1552543200,30,0,30,Rain
10819,100,1552543200,4,21,25,Rain
10820,101,1552543200,13,17,30,Rain
10821,102,1552543200,14,26,40,Rain
10822,103,1552543200,40,0,40,Rain
10823,104,1552543200,40,0,40,Rain
10824,105,1552543200,33,3,36,Rain
10825,106,1552543200,30,10,40,Rain
10826,107,1552543200,25,15,40,Rain
10827,108,1552543200,26,14,40,Rain
10828,109,1552543200,0,29,29,Rain
10829,110,1552543200,32,8,40,Rain
10830,111,1552543200,0,40,40,Rain
10831,112,1552543200,0,30,30,Rain
10832,113,1552543200,40,0,40,Rain
10833,114,1552543200,40,0,40,Rain
10834,115,1552543200,2,28,30,Rain
10835,2,1552546800,11,9,20,Rain
10836,3,1552546800,16,4,20,Rain
10837,4,1552546800,20,0,20,Rain
10838,5,1552546800,13,27,40,Rain
10839,6,1552546800,20,0,20,Rain
10840,7,1552546800,29,0,29,Rain
10841,8,1552546800,26,4,30,Rain
10842,9,1552546800,23,1,24,Rain
10843,10,1552546800,14,2,16,Rain
10844,11,1552546800,30,0,30,Rain
10845,12,1552546800,17,3,20,Rain
10846,13,1552546800,30,0,30,Rain
10847,14,1552546800,24,6,30,Rain
10848,15,1552546800,6,10,16,Rain
10849,16,1552546800,20,0,20,Rain
10850,17,1552546800,19,1,20,Rain
10851,18,1552546800,18,12,30,Rain
10852,19,1552546800,28,2,30,Rain
10853,21,1552546800,30,0,30,Rain
10854,22,1552546800,19,1,20,Rain
10855,23,1552546800,20,10,30,Rain
10856,24,1552546800,14,6,20,Rain
10857,25,1552546800,27,3,30,Rain
10858,26,1552546800,20,0,20,Rain
10859,27,1552546800,20,0,20,Rain
10860,28,1552546800,2,28,30,Rain
10861,29,1552546800,26,3,29,Rain
10862,30,1552546800,14,6,20,Rain
10863,31,1552546800,2,18,20,Rain
10864,32,1552546800,24,6,30,Rain
10865,33,1552546800,11,12,23,Rain
10866,34,1552546800,3,27,30,Rain
10867,35,1552546800,21,9,30,Rain
10868,36,1552546800,38,2,40,Rain
10869,37,1552546800,30,0,30,Rain
10870,38,1552546800,25,15,40,Rain
10871,39,1552546800,20,0,20,Rain
10872,40,1552546800,19,2,21,Rain
10873,41,1552546800,20,0,20,Rain
10874,42,1552546800,7,23,30,Rain
10875,43,1552546800,4,26,30,Rain
10876,44,1552546800,4,26,30,Rain
10877,45,1552546800,1,29,30,Rain
10878,46,1552546800,20,0,20,Rain
10879,47,1552546800,40,0,40,Rain
10880,48,1552546800,39,1,40,Rain
10881,49,1552546800,39,1,40,Rain
10882,50,1552546800,5,35,40,Rain
10883,51,1552546800,38,2,40,Rain
10884,52,1552546800,25,7,32,Rain
10885,53,1552546800,40,0,40,Rain
10886,54,1552546800,28,5,33,Rain
10887,55,1552546800,36,0,36,Rain
10888,56,1552546800,40,0,40,Rain
10889,57,1552546800,22,1,23,Rain
10890,58,1552546800,37,3,40,Rain
10891,59,1552546800,5,15,20,Rain
10892,60,1552546800,5,25,30,Rain
10893,61,1552546800,18,7,25,Rain
10894,62,1552546800,37,3,40,Rain
10895,63,1552546800,22,13,35,Rain
10896,64,1552546800,34,6,40,Rain
10897,65,1552546800,39,1,40,Rain
10898,66,1552546800,26,14,40,Rain
10899,67,1552546800,36,4,40,Rain
10900,68,1552546800,27,13,40,Rain
10901,69,1552546800,34,6,40,Rain
10902,70,1552546800,6,22,28,Rain
10903,71,1552546800,38,2,40,Rain
10904,72,1552546800,3,22,25,Rain
10905,73,1552546800,10,20,30,Rain
10906,74,1552546800,13,17,30,Rain
10907,75,1552546800,25,15,40,Rain
10908,76,1552546800,33,5,38,Rain
10909,77,1552546800,20,9,29,Rain
10910,78,1552546800,13,27,40,Rain
10911,79,1552546800,14,13,27,Rain
10912,80,1552546800,21,19,40,Rain
10913,81,1552546800,39,1,40,Rain
10914,82,1552546800,1,21,22,Rain
10915,83,1552546800,3,37,40,Rain
10916,84,1552546800,10,20,30,Rain
10917,85,1552546800,0,35,35,Rain
10918,86,1552546800,0,38,38,Rain
10919,87,1552546800,13,25,38,Rain
10920,88,1552546800,13,17,30,Rain
10921,89,1552546800,39,0,39,Rain
10922,90,1552546800,34,6,40,Rain
10923,91,1552546800,18,12,30,Rain
10924,92,1552546800,1,39,40,Rain
10925,93,1552546800,0,40,40,Rain
10926,94,1552546800,9,31,40,Rain
10927,95,1552546800,4,36,40,Rain
10928,96,1552546800,17,13,30,Rain
10929,97,1552546800,17,23,40,Rain
10930,98,1552546800,40,0,40,Rain
10931,99,1552546800,27,3,30,Rain
10932,100,1552546800,3,22,25,Rain
10933,101,1552546800,14,16,30,Rain
10934,102,1552546800,14,26,40,Rain
10935,103,1552546800,40,0,40,Rain
10936,104,1552546800,40,0,40,Rain
10937,105,1552546800,34,2,36,Rain
10938,106,1552546800,30,10,40,Rain
10939,107,1552546800,28,12,40,Rain
10940,108,1552546800,27,13,40,Rain
10941,109,1552546800,5,24,29,Rain
10942,110,1552546800,32,8,40,Rain
10943,111,1552546800,0,40,40,Rain
10944,112,1552546800,3,27,30,Rain
10945,113,1552546800,39,1,40,Rain
10946,114,1552546800,39,1,40,Rain
10947,115,1552546800,2,28,30,Rain
10948,2,1552550400,10,10,20,Rain
10949,3,1552550400,15,5,20,Rain
10950,4,1552550400,18,2,20,Rain
10951,5,1552550400,5,35,40,Rain
10952,6,1552550400,20,0,20,Rain
10953,7,1552550400,29,0,29,Rain
10954,8,1552550400,24,6,30,Rain
10955,9,1552550400,14,10,24,Rain
10956,10,1552550400,16,0,16,Rain
10957,11,1552550400,30,0,30,Rain
10958,12,1552550400,12,8,20,Rain
10959,13,1552550400,28,2,30,Rain
10960,14,1552550400,23,7,30,Rain
10961,15,1552550400,6,10,16,Rain
10962,16,1552550400,19,1,20,Rain
10963,17,1552550400,19,1,20,Rain
10964,18,1552550400,20,10,30,Rain
10965,19,1552550400,25,5,30,Rain
10966,21,1552550400,29,1,30,Rain
10967,22,1552550400,20,0,20,Rain
10968,23,1552550400,21,9,30,Rain
10969,24,1552550400,14,6,20,Rain
10970,25,1552550400,24,6,30,Rain
10971,26,1552550400,15,5,20,Rain
10972,27,1552550400,18,2,20,Rain
10973,28,1552550400,12,18,30,Rain
10974,29,1552550400,27,2,29,Rain
10975,30,1552550400,12,8,20,Rain
10976,31,1552550400,2,18,20,Rain
10977,32,1552550400,26,4,30,Rain
10978,33,1552550400,7,16,23,Rain
10979,34,1552550400,12,18,30,Rain
10980,35,1552550400,28,2,30,Rain
10981,36,1552550400,38,2,40,Rain
10982,37,1552550400,29,1,30,Rain
10983,38,1552550400,22,18,40,Rain
10984,39,1552550400,17,3,20,Rain
10985,40,1552550400,13,8,21,Rain
10986,41,1552550400,18,2,20,Rain
10987,42,1552550400,15,15,30,Rain
10988,43,1552550400,14,16,30,Rain
10989,44,1552550400,14,16,30,Rain
10990,45,1552550400,3,27,30,Rain
10991,46,1552550400,18,2,20,Rain
10992,47,1552550400,40,0,40,Rain
10993,48,1552550400,40,0,40,Rain
10994,49,1552550400,35,5,40,Rain
10995,50,1552550400,10,30,40,Rain
10996,51,1552550400,36,4,40,Rain
10997,52,1552550400,27,5,32,Rain
10998,53,1552550400,40,0,40,Rain
10999,54,1552550400,25,8,33,Rain
11000,55,1552550400,32,4,36,Rain
11001,56,1552550400,39,1,40,Rain
11002,57,1552550400,23,0,23,Rain
11003,58,1552550400,34,6,40,Rain
11004,59,1552550400,5,15,20,Rain
11005,60,1552550400,14,16,30,Rain
11006,61,1552550400,21,4,25,Rain
11007,62,1552550400,33,7,40,Rain
11008,63,1552550400,35,0,35,Rain
11009,64,1552550400,31,9,40,Rain
11010,65,1552550400,32,8,40,Rain
11011,66,1552550400,14,26,40,Rain
11012,67,1552550400,34,6,40,Rain
11013,68,1552550400,30,10,40,Rain
11014,69,1552550400,28,12,40,Rain
11015,70,1552550400,17,11,28,Rain
11016,71,1552550400,39,1,40,Rain
11017,72,1552550400,7,18,25,Rain
11018,73,1552550400,19,11,30,Rain
11019,74,1552550400,15,15,30,Rain
11020,75,1552550400,26,14,40,Rain
11021,76,1552550400,36,2,38,Rain
11022,77,1552550400,21,8,29,Rain
11023,78,1552550400,19,21,40,Rain
11024,79,1552550400,15,12,27,Rain
11025,80,1552550400,24,16,40,Rain
11026,81,1552550400,39,1,40,Rain
11027,82,1552550400,2,20,22,Rain
11028,83,1552550400,5,35,40,Rain
11029,84,1552550400,15,15,30,Rain
11030,85,1552550400,3,32,35,Rain
11031,86,1552550400,3,35,38,Rain
11032,87,1552550400,15,23,38,Rain
11033,88,1552550400,16,14,30,Rain
11034,89,1552550400,38,1,39,Rain
11035,90,1552550400,23,17,40,Rain
11036,91,1552550400,15,15,30,Rain
11037,92,1552550400,3,37,40,Rain
11038,93,1552550400,4,36,40,Rain
11039,94,1552550400,11,29,40,Rain
11040,95,1552550400,6,34,40,Rain
11041,96,1552550400,18,12,30,Rain
11042,97,1552550400,22,18,40,Rain
11043,98,1552550400,39,1,40,Rain
11044,99,1552550400,24,6,30,Rain
11045,100,1552550400,13,12,25,Rain
11046,101,1552550400,17,13,30,Rain
11047,102,1552550400,17,23,40,Rain
11048,103,1552550400,39,1,40,Rain
11049,104,1552550400,40,0,40,Rain
11050,105,1552550400,33,3,36,Rain
11051,106,1552550400,14,26,40,Rain
11052,107,1552550400,31,9,40,Rain
11053,108,1552550400,29,11,40,Rain
11054,109,1552550400,9,20,29,Rain
11055,110,1552550400,35,5,40,Rain
11056,111,1552550400,5,35,40,Rain
11057,112,1552550400,19,11,30,Rain
11058,113,1552550400,37,3,40,Rain
11059,114,1552550400,33,7,40,Rain
11060,115,1552550400,2,28,30,Rain
11061,2,1552554000,16,4,20,Rain
11062,3,1552554000,20,0,20,Rain
11063,4,1552554000,18,2,20,Rain
11064,5,1552554000,40,0,40,Rain
11065,6,1552554000,20,0,20,Rain
11066,7,1552554000,29,0,29,Rain
11067,8,1552554000,28,2,30,Rain
11068,9,1552554000,13,11,24,Rain
11069,10,1552554000,11,5,16,Rain
11070,11,1552554000,17,12,29,Rain
11071,12,1552554000,20,0,20,Rain
11072,13,1552554000,27,3,30,Rain
11073,14,1552554000,28,2,30,Rain
11074,15,1552554000,7,9,16,Rain
11075,16,1552554000,18,2,20,Rain
11076,17,1552554000,18,2,20,Rain
11077,18,1552554000,13,17,30,Rain
11078,19,1552554000,12,18,30,Rain
11079,21,1552554000,26,3,29,Rain
11080,22,1552554000,18,2,20,Rain
11081,23,1552554000,20,10,30,Rain
11082,24,1552554000,16,4,20,Rain
11083,25,1552554000,15,15,30,Rain
11084,26,1552554000,15,5,20,Rain
11085,27,1552554000,11,8,19,Rain
11086,28,1552554000,19,11,30,Rain
11087,29,1552554000,24,5,29,Rain
11088,30,1552554000,6,14,20,Rain
11089,31,1552554000,1,19,20,Rain
11090,32,1552554000,30,0,30,Rain
11091,33,1552554000,5,18,23,Rain
11092,34,1552554000,30,0,30,Rain
11093,35,1552554000,30,0,30,Rain
11094,36,1552554000,35,5,40,Rain
11095,37,1552554000,26,4,30,Rain
11096,38,1552554000,25,14,39,Rain
11097,39,1552554000,17,3,20,Rain
11098,40,1552554000,5,16,21,Rain
11099,41,1552554000,16,4,20,Rain
11100,42,1552554000,26,4,30,Rain
11101,43,1552554000,30,0,30,Rain
11102,44,1552554000,26,4,30,Rain
11103,45,1552554000,4,26,30,Rain
11104,46,1552554000,19,1,20,Rain
11105,47,1552554000,35,5,40,Rain
11106,48,1552554000,38,2,40,Rain
11107,49,1552554000,39,1,40,Rain
11108,50,1552554000,33,7,40,Rain
11109,51,1552554000,35,5,40,Rain
11110,52,1552554000,15,17,32,Rain
11111,53,1552554000,34,6,40,Rain
11112,54,1552554000,23,10,33,Rain
11113,55,1552554000,28,8,36,Rain
11114,56,1552554000,18,21,39,Rain
11115,57,1552554000,18,5,23,Rain
11116,58,1552554000,24,15,39,Rain
11117,59,1552554000,5,15,20,Rain
11118,60,1552554000,11,19,30,Rain
11119,61,1552554000,5,20,25,Rain
11120,62,1552554000,22,18,40,Rain
11121,63,1552554000,28,7,35,Rain
11122,64,1552554000,32,8,40,Rain
11123,65,1552554000,33,6,39,Rain
11124,66,1552554000,2,36,38,Rain
11125,67,1552554000,37,3,40,Rain
11126,68,1552554000,20,20,40,Rain
11127,69,1552554000,20,20,40,Rain
11128,70,1552554000,25,3,28,Rain
11129,71,1552554000,35,5,40,Rain
11130,72,1552554000,19,6,25,Rain
11131,73,1552554000,30,0,30,Rain
11132,74,1552554000,19,11,30,Rain
11133,75,1552554000,40,0,40,Rain
11134,76,1552554000,38,0,38,Rain
11135,77,1552554000,26,3,29,Rain
11136,78,1552554000,18,22,40,Rain
11137,79,1552554000,11,16,27,Rain
11138,80,1552554000,23,17,40,Rain
11139,81,1552554000,37,3,40,Rain
11140,82,1552554000,6,16,22,Rain
11141,83,1552554000,16,24,40,Rain
11142,84,1552554000,23,7,30,Rain
11143,85,1552554000,13,22,35,Rain
11144,86,1552554000,13,25,38,Rain
11145,87,1552554000,20,18,38,Rain
11146,88,1552554000,23,7,30,Rain
11147,89,1552554000,33,6,39,Rain
11148,90,1552554000,0,39,39,Rain
11149,91,1552554000,16,14,30,Rain
11150,92,1552554000,10,30,40,Rain
11151,93,1552554000,18,22,40,Rain
11152,94,1552554000,14,26,40,Rain
11153,95,1552554000,18,22,40,Rain
11154,96,1552554000,20,10,30,Rain
11155,97,1552554000,40,0,40,Rain
11156,98,1552554000,37,3,40,Rain
11157,99,1552554000,26,4,30,Rain
11158,100,1552554000,25,0,25,Rain
11159,101,1552554000,26,4,30,Rain
11160,102,1552554000,22,18,40,Rain
11161,103,1552554000,38,2,40,Rain
11162,104,1552554000,39,1,40,Rain
11163,105,1552554000,31,5,36,Rain
11164,106,1552554000,18,22,40,Rain
11165,107,1552554000,40,0,40,Rain
11166,108,1552554000,35,5,40,Rain
11167,109,1552554000,16,13,29,Rain
11168,110,1552554000,37,3,40,Rain
11169,111,1552554000,14,26,40,Rain
11170,112,1552554000,30,0,30,Rain
11171,113,1552554000,34,6,40,Rain
11172,114,1552554000,22,18,40,Rain
11173,115,1552554000,14,16,30,Rain
11174,2,1552557600,20,0,20,Clouds
11175,3,1552557600,18,2,20,Clouds
11176,4,1552557600,15,5,20,Clouds
11177,5,1552557600,36,4,40,Clouds
11178,6,1552557600,18,2,20,Clouds
11179,7,1552557600,29,0,29,Clouds
11180,8,1552557600,17,13,30,Clouds
11181,9,1552557600,10,14,24,Clouds
11182,10,1552557600,14,2,16,Clouds
11183,11,1552557600,4,25,29,Clouds
11184,12,1552557600,20,0,20,Clouds
11185,13,1552557600,20,10,30,Clouds
11186,14,1552557600,29,1,30,Clouds
11187,15,1552557600,13,3,16,Clouds
11188,16,1552557600,17,3,20,Clouds
11189,17,1552557600,16,4,20,Clouds
11190,18,1552557600,27,3,30,Clouds
11191,19,1552557600,3,27,30,Clouds
11192,21,1552557600,12,17,29,Clouds
11193,22,1552557600,20,0,20,Clouds
11194,23,1552557600,13,17,30,Clouds
11195,24,1552557600,8,12,20,Clouds
11196,25,1552557600,0,30,30,Clouds
11197,26,1552557600,9,11,20,Clouds
11198,27,1552557600,13,6,19,Clouds
11199,28,1552557600,15,15,30,Clouds
11200,29,1552557600,25,4,29,Clouds
11201,30,1552557600,6,14,20,Clouds
11202,31,1552557600,1,19,20,Clouds
11203,32,1552557600,24,6,30,Clouds
11204,33,1552557600,6,17,23,Clouds
11205,34,1552557600,30,0,30,Clouds
11206,35,1552557600,26,4,30,Clouds
11207,36,1552557600,23,16,39,Clouds
11208,37,1552557600,25,5,30,Clouds
11209,38,1552557600,19,20,39,Clouds
11210,39,1552557600,17,3,20,Clouds
11211,40,1552557600,1,20,21,Clouds
11212,41,1552557600,18,2,20,Clouds
11213,42,1552557600,30,0,30,Clouds
11214,43,1552557600,30,0,30,Clouds
11215,44,1552557600,30,0,30,Clouds
11216,45,1552557600,7,23,30,Clouds
11217,46,1552557600,18,2,20,Clouds
11218,47,1552557600,10,30,40,Clouds
11219,48,1552557600,16,23,39,Clouds
11220,49,1552557600,21,18,39,Clouds
11221,50,1552557600,40,0,40,Clouds
11222,51,1552557600,36,4,40,Clouds
11223,52,1552557600,24,8,32,Clouds
11224,53,1552557600,28,12,40,Clouds
11225,54,1552557600,23,10,33,Clouds
11226,55,1552557600,17,19,36,Clouds
11227,56,1552557600,17,20,37,Clouds
11228,57,1552557600,5,18,23,Clouds
11229,58,1552557600,0,39,39,Clouds
11230,59,1552557600,8,12,20,Clouds
11231,60,1552557600,30,0,30,Clouds
11232,61,1552557600,12,13,25,Clouds
11233,62,1552557600,0,40,40,Clouds
11234,63,1552557600,19,14,33,Clouds
11235,64,1552557600,16,24,40,Clouds
11236,65,1552557600,30,8,38,Clouds
11237,66,1552557600,13,25,38,Clouds
11238,67,1552557600,38,2,40,Clouds
11239,68,1552557600,0,37,37,Clouds
11240,69,1552557600,0,39,39,Clouds
11241,70,1552557600,17,10,27,Clouds
11242,71,1552557600,38,2,40,Clouds
11243,72,1552557600,25,0,25,Clouds
11244,73,1552557600,30,0,30,Clouds
11245,74,1552557600,30,0,30,Clouds
11246,75,1552557600,39,1,40,Clouds
11247,76,1552557600,37,1,38,Clouds
11248,77,1552557600,26,3,29,Clouds
11249,78,1552557600,37,3,40,Clouds
11250,79,1552557600,16,11,27,Clouds
11251,80,1552557600,36,4,40,Clouds
11252,81,1552557600,40,0,40,Clouds
11253,82,1552557600,20,2,22,Clouds
11254,83,1552557600,40,0,40,Clouds
11255,84,1552557600,30,0,30,Clouds
11256,85,1552557600,27,8,35,Clouds
11257,86,1552557600,38,0,38,Clouds
11258,87,1552557600,38,0,38,Clouds
11259,88,1552557600,30,0,30,Clouds
11260,89,1552557600,29,11,40,Clouds
11261,90,1552557600,0,39,39,Clouds
11262,91,1552557600,18,12,30,Clouds
11263,92,1552557600,40,0,40,Clouds
11264,93,1552557600,40,0,40,Clouds
11265,94,1552557600,40,0,40,Clouds
11266,95,1552557600,40,0,40,Clouds
11267,96,1552557600,30,0,30,Clouds
11268,97,1552557600,40,0,40,Clouds
11269,98,1552557600,37,3,40,Clouds
11270,99,1552557600,14,16,30,Clouds
11271,100,1552557600,17,8,25,Clouds
11272,101,1552557600,30,0,30,Clouds
11273,102,1552557600,36,4,40,Clouds
11274,103,1552557600,38,2,40,Clouds
11275,104,1552557600,40,0,40,Clouds
11276,105,1552557600,36,0,36,Clouds
11277,106,1552557600,40,0,40,Clouds
11278,107,1552557600,40,0,40,Clouds
11279,108,1552557600,40,0,40,Clouds
11280,109,1552557600,21,8,29,Clouds
11281,110,1552557600,39,1,40,Clouds
11282,111,1552557600,36,4,40,Clouds
11283,112,1552557600,30,0,30,Clouds
11284,113,1552557600,28,12,40,Clouds
11285,114,1552557600,30,10,40,Clouds
11286,115,1552557600,30,0,30,Clouds
11287,2,1552561200,11,9,20,Clouds
11288,3,1552561200,18,2,20,Clouds
11289,4,1552561200,15,5,20,Clouds
11290,5,1552561200,30,10,40,Clouds
11291,6,1552561200,19,1,20,Clouds
11292,7,1552561200,28,1,29,Clouds
11293,8,1552561200,1,29,30,Clouds
11294,9,1552561200,13,11,24,Clouds
11295,10,1552561200,15,1,16,Clouds
11296,11,1552561200,13,17,30,Clouds
11297,12,1552561200,14,6,20,Clouds
11298,13,1552561200,15,15,30,Clouds
11299,14,1552561200,21,9,30,Clouds
11300,15,1552561200,15,1,16,Clouds
11301,16,1552561200,13,7,20,Clouds
11302,17,1552561200,19,1,20,Clouds
11303,18,1552561200,30,0,30,Clouds
11304,19,1552561200,6,23,29,Clouds
11305,21,1552561200,3,26,29,Clouds
11306,22,1552561200,14,6,20,Clouds
11307,23,1552561200,12,18,30,Clouds
11308,24,1552561200,14,6,20,Clouds
11309,25,1552561200,2,28,30,Clouds
11310,26,1552561200,0,20,20,Clouds
11311,27,1552561200,7,12,19,Clouds
11312,28,1552561200,22,8,30,Clouds
11313,29,1552561200,29,0,29,Clouds
11314,30,1552561200,3,17,20,Clouds
11315,31,1552561200,2,18,20,Clouds
11316,32,1552561200,23,7,30,Clouds
11317,33,1552561200,1,22,23,Clouds
11318,34,1552561200,29,1,30,Clouds
11319,35,1552561200,28,2,30,Clouds
11320,36,1552561200,16,23,39,Clouds
11321,37,1552561200,22,8,30,Clouds
11322,38,1552561200,24,14,38,Clouds
11323,39,1552561200,16,3,19,Clouds
11324,40,1552561200,2,19,21,Clouds
11325,41,1552561200,11,9,20,Clouds
11326,42,1552561200,30,0,30,Clouds
11327,43,1552561200,29,1,30,Clouds
11328,44,1552561200,28,2,30,Clouds
11329,45,1552561200,8,22,30,Clouds
11330,46,1552561200,18,2,20,Clouds
11331,47,1552561200,0,40,40,Clouds
11332,48,1552561200,16,23,39,Clouds
11333,49,1552561200,7,32,39,Clouds
11334,50,1552561200,39,1,40,Clouds
11335,51,1552561200,35,5,40,Clouds
11336,52,1552561200,22,10,32,Clouds
11337,53,1552561200,25,15,40,Clouds
11338,54,1552561200,10,23,33,Clouds
11339,55,1552561200,9,27,36,Clouds
11340,56,1552561200,1,36,37,Clouds
11341,57,1552561200,1,22,23,Clouds
11342,58,1552561200,10,29,39,Clouds
11343,59,1552561200,15,5,20,Clouds
11344,60,1552561200,30,0,30,Clouds
11345,61,1552561200,22,3,25,Clouds
11346,62,1552561200,0,40,40,Clouds
11347,63,1552561200,2,32,34,Clouds
11348,64,1552561200,7,33,40,Clouds
11349,65,1552561200,21,17,38,Clouds
11350,66,1552561200,5,33,38,Clouds
11351,67,1552561200,28,12,40,Clouds
11352,68,1552561200,4,33,37,Clouds
11353,69,1552561200,1,38,39,Clouds
11354,70,1552561200,3,24,27,Clouds
11355,71,1552561200,36,4,40,Clouds
11356,72,1552561200,25,0,25,Clouds
11357,73,1552561200,30,0,30,Clouds
11358,74,1552561200,28,2,30,Clouds
11359,75,1552561200,40,0,40,Clouds
11360,76,1552561200,37,1,38,Clouds
11361,77,1552561200,24,5,29,Clouds
11362,78,1552561200,40,0,40,Clouds
11363,79,1552561200,21,6,27,Clouds
11364,80,1552561200,36,4,40,Clouds
11365,81,1552561200,40,0,40,Clouds
11366,82,1552561200,22,0,22,Clouds
11367,83,1552561200,40,0,40,Clouds
11368,84,1552561200,30,0,30,Clouds
11369,85,1552561200,30,5,35,Clouds
11370,86,1552561200,38,0,38,Clouds
11371,87,1552561200,38,0,38,Clouds
11372,88,1552561200,29,1,30,Clouds
11373,89,1552561200,22,17,39,Clouds
11374,90,1552561200,1,38,39,Clouds
11375,91,1552561200,7,23,30,Clouds
11376,92,1552561200,40,0,40,Clouds
11377,93,1552561200,40,0,40,Clouds
11378,94,1552561200,40,0,40,Clouds
11379,95,1552561200,38,2,40,Clouds
11380,96,1552561200,30,0,30,Clouds
11381,97,1552561200,40,0,40,Clouds
11382,98,1552561200,35,5,40,Clouds
11383,99,1552561200,4,26,30,Clouds
11384,100,1552561200,25,0,25,Clouds
11385,101,1552561200,30,0,30,Clouds
11386,102,1552561200,40,0,40,Clouds
11387,103,1552561200,38,2,40,Clouds
11388,104,1552561200,40,0,40,Clouds
11389,105,1552561200,36,0,36,Clouds
11390,106,1552561200,40,0,40,Clouds
11391,107,1552561200,40,0,40,Clouds
11392,108,1552561200,40,0,40,Clouds
11393,109,1552561200,28,1,29,Clouds
11394,110,1552561200,40,0,40,Clouds
11395,111,1552561200,40,0,40,Clouds
11396,112,1552561200,30,0,30,Clouds
11397,113,1552561200,11,28,39,Clouds
11398,114,1552561200,12,28,40,Clouds
11399,115,1552561200,29,1,30,Clouds
11400,2,1552564800,11,9,20,Rain
11401,3,1552564800,20,0,20,Rain
11402,4,1552564800,13,7,20,Rain
11403,5,1552564800,35,5,40,Rain
11404,6,1552564800,20,0,20,Rain
11405,7,1552564800,28,1,29,Rain
11406,8,1552564800,1,29,30,Rain
11407,9,1552564800,9,15,24,Rain
11408,10,1552564800,8,8,16,Rain
11409,11,1552564800,9,21,30,Rain
11410,12,1552564800,13,7,20,Rain
11411,13,1552564800,13,17,30,Rain
11412,14,1552564800,17,13,30,Rain
11413,15,1552564800,16,0,16,Rain
11414,16,1552564800,10,10,20,Rain
11415,17,1552564800,18,2,20,Rain
11416,18,1552564800,29,1,30,Rain
11417,19,1552564800,0,30,30,Rain
11418,21,1552564800,1,28,29,Rain
11419,22,1552564800,14,6,20,Rain
11420,23,1552564800,18,12,30,Rain
11421,24,1552564800,7,12,19,Rain
11422,25,1552564800,9,21,30,Rain
11423,26,1552564800,5,15,20,Rain
11424,27,1552564800,5,15,20,Rain
11425,28,1552564800,15,15,30,Rain
11426,29,1552564800,29,0,29,Rain
11427,30,1552564800,3,17,20,Rain
11428,31,1552564800,7,13,20,Rain
11429,32,1552564800,15,15,30,Rain
11430,33,1552564800,1,22,23,Rain
11431,34,1552564800,20,10,30,Rain
11432,35,1552564800,30,0,30,Rain
11433,36,1552564800,18,22,40,Rain
11434,37,1552564800,20,10,30,Rain
11435,38,1552564800,32,7,39,Rain
11436,39,1552564800,19,1,20,Rain
11437,40,1552564800,2,18,20,Rain
11438,41,1552564800,9,11,20,Rain
11439,42,1552564800,30,0,30,Rain
11440,43,1552564800,28,2,30,Rain
11441,44,1552564800,30,0,30,Rain
11442,45,1552564800,8,22,30,Rain
11443,46,1552564800,19,1,20,Rain
11444,47,1552564800,0,40,40,Rain
11445,48,1552564800,16,24,40,Rain
11446,49,1552564800,4,36,40,Rain
11447,50,1552564800,39,1,40,Rain
11448,51,1552564800,37,3,40,Rain
11449,52,1552564800,23,9,32,Rain
11450,53,1552564800,25,15,40,Rain
11451,54,1552564800,12,21,33,Rain
11452,55,1552564800,12,24,36,Rain
11453,56,1552564800,10,30,40,Rain
11454,57,1552564800,0,23,23,Rain
11455,58,1552564800,6,34,40,Rain
11456,59,1552564800,20,0,20,Rain
11457,60,1552564800,29,1,30,Rain
11458,61,1552564800,25,0,25,Rain
11459,62,1552564800,1,39,40,Rain
11460,63,1552564800,7,28,35,Rain
11461,64,1552564800,10,30,40,Rain
11462,65,1552564800,22,18,40,Rain
11463,66,1552564800,20,20,40,Rain
11464,67,1552564800,25,15,40,Rain
11465,68,1552564800,0,37,37,Rain
11466,69,1552564800,1,39,40,Rain
11467,70,1552564800,6,21,27,Rain
11468,71,1552564800,26,14,40,Rain
11469,72,1552564800,15,10,25,Rain
11470,73,1552564800,29,1,30,Rain
11471,74,1552564800,21,9,30,Rain
11472,75,1552564800,40,0,40,Rain
11473,76,1552564800,37,1,38,Rain
11474,77,1552564800,25,4,29,Rain
11475,78,1552564800,31,9,40,Rain
11476,79,1552564800,23,4,27,Rain
11477,80,1552564800,40,0,40,Rain
11478,81,1552564800,40,0,40,Rain
11479,82,1552564800,22,0,22,Rain
11480,83,1552564800,40,0,40,Rain
11481,84,1552564800,29,1,30,Rain
11482,85,1552564800,33,2,35,Rain
11483,86,1552564800,38,0,38,Rain
11484,87,1552564800,38,0,38,Rain
11485,88,1552564800,29,1,30,Rain
11486,89,1552564800,21,19,40,Rain
11487,90,1552564800,3,36,39,Rain
11488,91,1552564800,8,21,29,Rain
11489,92,1552564800,38,2,40,Rain
11490,93,1552564800,40,0,40,Rain
11491,94,1552564800,40,0,40,Rain
11492,95,1552564800,40,0,40,Rain
11493,96,1552564800,30,0,30,Rain
11494,97,1552564800,40,0,40,Rain
11495,98,1552564800,34,6,40,Rain
11496,99,1552564800,2,28,30,Rain
11497,100,1552564800,25,0,25,Rain
11498,101,1552564800,30,0,30,Rain
11499,102,1552564800,38,2,40,Rain
11500,103,1552564800,40,0,40,Rain
11501,104,1552564800,40,0,40,Rain
11502,105,1552564800,36,0,36,Rain
11503,106,1552564800,40,0,40,Rain
11504,107,1552564800,40,0,40,Rain
11505,108,1552564800,40,0,40,Rain
11506,109,1552564800,29,0,29,Rain
11507,110,1552564800,40,0,40,Rain
11508,111,1552564800,39,1,40,Rain
11509,112,1552564800,23,7,30,Rain
11510,113,1552564800,12,28,40,Rain
11511,114,1552564800,8,32,40,Rain
11512,115,1552564800,30,0,30,Rain
11513,2,1552568400,18,2,20,Clouds
11514,3,1552568400,20,0,20,Clouds
11515,4,1552568400,15,5,20,Clouds
11516,5,1552568400,35,5,40,Clouds
11517,6,1552568400,20,0,20,Clouds
11518,7,1552568400,28,1,29,Clouds
11519,8,1552568400,0,30,30,Clouds
11520,9,1552568400,5,19,24,Clouds
11521,10,1552568400,5,11,16,Clouds
11522,11,1552568400,10,20,30,Clouds
11523,12,1552568400,16,4,20,Clouds
11524,13,1552568400,13,17,30,Clouds
11525,14,1552568400,13,17,30,Clouds
11526,15,1552568400,16,0,16,Clouds
11527,16,1552568400,8,12,20,Clouds
11528,17,1552568400,19,1,20,Clouds
11529,18,1552568400,27,3,30,Clouds
11530,19,1552568400,2,28,30,Clouds
11531,21,1552568400,2,27,29,Clouds
11532,22,1552568400,15,5,20,Clouds
11533,23,1552568400,16,14,30,Clouds
11534,24,1552568400,10,10,20,Clouds
11535,25,1552568400,9,21,30,Clouds
11536,26,1552568400,5,15,20,Clouds
11537,27,1552568400,3,17,20,Clouds
11538,28,1552568400,26,4,30,Clouds
11539,29,1552568400,24,5,29,Clouds
11540,30,1552568400,4,16,20,Clouds
11541,31,1552568400,6,14,20,Clouds
11542,32,1552568400,17,13,30,Clouds
11543,33,1552568400,0,23,23,Clouds
11544,34,1552568400,26,4,30,Clouds
11545,35,1552568400,30,0,30,Clouds
11546,36,1552568400,18,22,40,Clouds
11547,37,1552568400,24,6,30,Clouds
11548,38,1552568400,39,1,40,Clouds
11549,39,1552568400,19,1,20,Clouds
11550,40,1552568400,3,18,21,Clouds
11551,41,1552568400,6,14,20,Clouds
11552,42,1552568400,30,0,30,Clouds
11553,43,1552568400,27,3,30,Clouds
11554,44,1552568400,30,0,30,Clouds
11555,45,1552568400,7,23,30,Clouds
11556,46,1552568400,19,1,20,Clouds
11557,47,1552568400,0,40,40,Clouds
11558,48,1552568400,12,28,40,Clouds
11559,49,1552568400,4,36,40,Clouds
11560,50,1552568400,40,0,40,Clouds
11561,51,1552568400,33,7,40,Clouds
11562,52,1552568400,20,12,32,Clouds
11563,53,1552568400,25,15,40,Clouds
11564,54,1552568400,12,21,33,Clouds
11565,55,1552568400,11,25,36,Clouds
11566,56,1552568400,4,36,40,Clouds
11567,57,1552568400,2,21,23,Clouds
11568,58,1552568400,9,31,40,Clouds
11569,59,1552568400,20,0,20,Clouds
11570,60,1552568400,30,0,30,Clouds
11571,61,1552568400,25,0,25,Clouds
11572,62,1552568400,4,36,40,Clouds
11573,63,1552568400,2,33,35,Clouds
11574,64,1552568400,12,28,40,Clouds
11575,65,1552568400,26,14,40,Clouds
11576,66,1552568400,18,22,40,Clouds
11577,67,1552568400,26,14,40,Clouds
11578,68,1552568400,3,37,40,Clouds
11579,69,1552568400,0,39,39,Clouds
11580,70,1552568400,7,21,28,Clouds
11581,71,1552568400,27,13,40,Clouds
11582,72,1552568400,19,6,25,Clouds
11583,73,1552568400,29,1,30,Clouds
11584,74,1552568400,25,5,30,Clouds
11585,75,1552568400,40,0,40,Clouds
11586,76,1552568400,36,2,38,Clouds
11587,77,1552568400,23,6,29,Clouds
11588,78,1552568400,32,8,40,Clouds
11589,79,1552568400,24,3,27,Clouds
11590,80,1552568400,39,1,40,Clouds
11591,81,1552568400,40,0,40,Clouds
11592,82,1552568400,22,0,22,Clouds
11593,83,1552568400,40,0,40,Clouds
11594,84,1552568400,28,2,30,Clouds
11595,85,1552568400,35,0,35,Clouds
11596,86,1552568400,37,1,38,Clouds
11597,87,1552568400,38,0,38,Clouds
11598,88,1552568400,28,2,30,Clouds
11599,89,1552568400,19,21,40,Clouds
11600,90,1552568400,2,38,40,Clouds
11601,91,1552568400,8,22,30,Clouds
11602,92,1552568400,40,0,40,Clouds
11603,93,1552568400,40,0,40,Clouds
11604,94,1552568400,40,0,40,Clouds
11605,95,1552568400,40,0,40,Clouds
11606,96,1552568400,30,0,30,Clouds
11607,97,1552568400,39,1,40,Clouds
11608,98,1552568400,35,5,40,Clouds
11609,99,1552568400,2,28,30,Clouds
11610,100,1552568400,23,2,25,Clouds
11611,101,1552568400,30,0,30,Clouds
11612,102,1552568400,38,2,40,Clouds
11613,103,1552568400,39,1,40,Clouds
11614,104,1552568400,40,0,40,Clouds
11615,105,1552568400,36,0,36,Clouds
11616,106,1552568400,40,0,40,Clouds
11617,107,1552568400,39,1,40,Clouds
11618,108,1552568400,40,0,40,Clouds
11619,109,1552568400,29,0,29,Clouds
11620,110,1552568400,40,0,40,Clouds
11621,111,1552568400,39,1,40,Clouds
11622,112,1552568400,18,12,30,Clouds
11623,113,1552568400,10,30,40,Clouds
11624,114,1552568400,8,32,40,Clouds
11625,115,1552568400,30,0,30,Clouds
11626,2,1552572000,20,0,20,Rain
11627,3,1552572000,19,1,20,Rain
11628,4,1552572000,19,1,20,Rain
11629,5,1552572000,39,1,40,Rain
11630,6,1552572000,20,0,20,Rain
11631,7,1552572000,29,0,29,Rain
11632,8,1552572000,12,18,30,Rain
11633,9,1552572000,10,14,24,Rain
11634,10,1552572000,8,8,16,Rain
11635,11,1552572000,17,13,30,Rain
11636,12,1552572000,17,3,20,Rain
11637,13,1552572000,18,12,30,Rain
11638,14,1552572000,21,9,30,Rain
11639,15,1552572000,14,2,16,Rain
11640,16,1552572000,9,11,20,Rain
11641,17,1552572000,20,0,20,Rain
11642,18,1552572000,27,3,30,Rain
11643,19,1552572000,4,26,30,Rain
11644,21,1552572000,14,15,29,Rain
11645,22,1552572000,12,8,20,Rain
11646,23,1552572000,23,7,30,Rain
11647,24,1552572000,16,4,20,Rain
11648,25,1552572000,9,21,30,Rain
11649,26,1552572000,1,19,20,Rain
11650,27,1552572000,1,19,20,Rain
11651,28,1552572000,28,2,30,Rain
11652,29,1552572000,28,1,29,Rain
11653,30,1552572000,11,9,20,Rain
11654,31,1552572000,5,15,20,Rain
11655,32,1552572000,17,13,30,Rain
11656,33,1552572000,0,23,23,Rain
11657,34,1552572000,28,2,30,Rain
11658,35,1552572000,28,2,30,Rain
11659,36,1552572000,21,19,40,Rain
11660,37,1552572000,24,6,30,Rain
11661,38,1552572000,36,4,40,Rain
11662,39,1552572000,17,3,20,Rain
11663,40,1552572000,1,20,21,Rain
11664,41,1552572000,9,11,20,Rain
11665,42,1552572000,30,0,30,Rain
11666,43,1552572000,29,1,30,Rain
11667,44,1552572000,27,3,30,Rain
11668,45,1552572000,10,20,30,Rain
11669,46,1552572000,18,2,20,Rain
11670,47,1552572000,0,40,40,Rain
11671,48,1552572000,13,27,40,Rain
11672,49,1552572000,1,39,40,Rain
11673,50,1552572000,40,0,40,Rain
11674,51,1552572000,28,12,40,Rain
11675,52,1552572000,17,15,32,Rain
11676,53,1552572000,23,17,40,Rain
11677,54,1552572000,12,21,33,Rain
11678,55,1552572000,19,17,36,Rain
11679,56,1552572000,11,29,40,Rain
11680,57,1552572000,6,17,23,Rain
11681,58,1552572000,13,27,40,Rain
11682,59,1552572000,19,1,20,Rain
11683,60,1552572000,27,3,30,Rain
11684,61,1552572000,24,1,25,Rain
11685,62,1552572000,3,37,40,Rain
11686,63,1552572000,7,28,35,Rain
11687,64,1552572000,24,16,40,Rain
11688,65,1552572000,35,5,40,Rain
11689,66,1552572000,22,18,40,Rain
11690,67,1552572000,24,16,40,Rain
11691,68,1552572000,3,37,40,Rain
11692,69,1552572000,0,39,39,Rain
11693,70,1552572000,9,19,28,Rain
11694,71,1552572000,30,10,40,Rain
11695,72,1552572000,18,7,25,Rain
11696,73,1552572000,27,3,30,Rain
11697,74,1552572000,25,5,30,Rain
11698,75,1552572000,39,1,40,Rain
11699,76,1552572000,34,4,38,Rain
11700,77,1552572000,28,1,29,Rain
11701,78,1552572000,37,3,40,Rain
11702,79,1552572000,24,3,27,Rain
11703,80,1552572000,25,15,40,Rain
11704,81,1552572000,40,0,40,Rain
11705,82,1552572000,19,3,22,Rain
11706,83,1552572000,40,0,40,Rain
11707,84,1552572000,29,1,30,Rain
11708,85,1552572000,35,0,35,Rain
11709,86,1552572000,38,0,38,Rain
11710,87,1552572000,38,0,38,Rain
11711,88,1552572000,28,2,30,Rain
11712,89,1552572000,22,18,40,Rain
11713,90,1552572000,7,33,40,Rain
11714,91,1552572000,4,26,30,Rain
11715,92,1552572000,40,0,40,Rain
11716,93,1552572000,40,0,40,Rain
11717,94,1552572000,40,0,40,Rain
11718,95,1552572000,40,0,40,Rain
11719,96,1552572000,29,1,30,Rain
11720,97,1552572000,40,0,40,Rain
11721,98,1552572000,33,7,40,Rain
11722,99,1552572000,5,25,30,Rain
11723,100,1552572000,23,2,25,Rain
11724,101,1552572000,27,3,30,Rain
11725,102,1552572000,40,0,40,Rain
11726,103,1552572000,40,0,40,Rain
11727,104,1552572000,39,1,40,Rain
11728,105,1552572000,36,0,36,Rain
11729,106,1552572000,40,0,40,Rain
11730,107,1552572000,40,0,40,Rain
11731,108,1552572000,40,0,40,Rain
11732,109,1552572000,29,0,29,Rain
11733,110,1552572000,38,2,40,Rain
11734,111,1552572000,37,3,40,Rain
11735,112,1552572000,21,9,30,Rain
11736,113,1552572000,11,29,40,Rain
11737,114,1552572000,6,34,40,Rain
11738,115,1552572000,29,1,30,Rain
11739,2,1552575600,20,0,20,Clouds
11740,3,1552575600,12,8,20,Clouds
11741,4,1552575600,20,0,20,Clouds
11742,5,1552575600,38,2,40,Clouds
11743,6,1552575600,18,2,20,Clouds
11744,7,1552575600,29,0,29,Clouds
11745,8,1552575600,12,18,30,Clouds
11746,9,1552575600,11,13,24,Clouds
11747,10,1552575600,10,6,16,Clouds
11748,11,1552575600,20,10,30,Clouds
11749,12,1552575600,19,1,20,Clouds
11750,13,1552575600,15,15,30,Clouds
11751,14,1552575600,18,12,30,Clouds
11752,15,1552575600,14,2,16,Clouds
11753,16,1552575600,18,2,20,Clouds
11754,17,1552575600,17,3,20,Clouds
11755,18,1552575600,30,0,30,Clouds
11756,19,1552575600,0,30,30,Clouds
11757,21,1552575600,9,20,29,Clouds
11758,22,1552575600,15,5,20,Clouds
11759,23,1552575600,19,11,30,Clouds
11760,24,1552575600,17,3,20,Clouds
11761,25,1552575600,6,24,30,Clouds
11762,26,1552575600,2,18,20,Clouds
11763,27,1552575600,10,10,20,Clouds
11764,28,1552575600,30,0,30,Clouds
11765,29,1552575600,21,8,29,Clouds
11766,30,1552575600,7,13,20,Clouds
11767,31,1552575600,0,20,20,Clouds
11768,32,1552575600,16,14,30,Clouds
11769,33,1552575600,7,16,23,Clouds
11770,34,1552575600,27,3,30,Clouds
11771,35,1552575600,23,7,30,Clouds
11772,36,1552575600,16,24,40,Clouds
11773,37,1552575600,27,3,30,Clouds
11774,38,1552575600,26,14,40,Clouds
11775,39,1552575600,19,1,20,Clouds
11776,40,1552575600,4,17,21,Clouds
11777,41,1552575600,10,10,20,Clouds
11778,42,1552575600,27,3,30,Clouds
11779,43,1552575600,30,0,30,Clouds
11780,44,1552575600,27,3,30,Clouds
11781,45,1552575600,11,19,30,Clouds
11782,46,1552575600,18,2,20,Clouds
11783,47,1552575600,0,40,40,Clouds
11784,48,1552575600,10,30,40,Clouds
11785,49,1552575600,1,39,40,Clouds
11786,50,1552575600,30,10,40,Clouds
11787,51,1552575600,30,10,40,Clouds
11788,52,1552575600,16,16,32,Clouds
11789,53,1552575600,21,19,40,Clouds
11790,54,1552575600,12,21,33,Clouds
11791,55,1552575600,15,21,36,Clouds
11792,56,1552575600,12,28,40,Clouds
11793,57,1552575600,3,20,23,Clouds
11794,58,1552575600,11,29,40,Clouds
11795,59,1552575600,19,0,19,Clouds
11796,60,1552575600,29,1,30,Clouds
11797,61,1552575600,25,0,25,Clouds
11798,62,1552575600,1,39,40,Clouds
11799,63,1552575600,8,27,35,Clouds
11800,64,1552575600,18,22,40,Clouds
11801,65,1552575600,31,9,40,Clouds
11802,66,1552575600,20,20,40,Clouds
11803,67,1552575600,21,19,40,Clouds
11804,68,1552575600,1,39,40,Clouds
11805,69,1552575600,2,38,40,Clouds
11806,70,1552575600,8,20,28,Clouds
11807,71,1552575600,35,5,40,Clouds
11808,72,1552575600,17,8,25,Clouds
11809,73,1552575600,27,3,30,Clouds
11810,74,1552575600,26,4,30,Clouds
11811,75,1552575600,40,0,40,Clouds
11812,76,1552575600,36,2,38,Clouds
11813,77,1552575600,20,9,29,Clouds
11814,78,1552575600,37,3,40,Clouds
11815,79,1552575600,24,3,27,Clouds
11816,80,1552575600,31,9,40,Clouds
11817,81,1552575600,40,0,40,Clouds
11818,82,1552575600,22,0,22,Clouds
11819,83,1552575600,39,1,40,Clouds
11820,84,1552575600,30,0,30,Clouds
11821,85,1552575600,34,1,35,Clouds
11822,86,1552575600,34,4,38,Clouds
11823,87,1552575600,35,3,38,Clouds
11824,88,1552575600,27,3,30,Clouds
11825,89,1552575600,24,16,40,Clouds
11826,90,1552575600,2,38,40,Clouds
11827,91,1552575600,7,23,30,Clouds
11828,92,1552575600,38,2,40,Clouds
11829,93,1552575600,40,0,40,Clouds
11830,94,1552575600,40,0,40,Clouds
11831,95,1552575600,37,3,40,Clouds
11832,96,1552575600,30,0,30,Clouds
11833,97,1552575600,40,0,40,Clouds
11834,98,1552575600,35,5,40,Clouds
11835,99,1552575600,6,24,30,Clouds
11836,100,1552575600,21,4,25,Clouds
11837,101,1552575600,30,0,30,Clouds
11838,102,1552575600,32,8,40,Clouds
11839,103,1552575600,34,6,40,Clouds
11840,104,1552575600,40,0,40,Clouds
11841,105,1552575600,36,0,36,Clouds
11842,106,1552575600,33,7,40,Clouds
11843,107,1552575600,40,0,40,Clouds
11844,108,1552575600,33,7,40,Clouds
11845,109,1552575600,26,3,29,Clouds
11846,110,1552575600,40,0,40,Clouds
11847,111,1552575600,39,1,40,Clouds
11848,112,1552575600,25,5,30,Clouds
11849,113,1552575600,12,28,40,Clouds
11850,114,1552575600,15,25,40,Clouds
11851,115,1552575600,29,1,30,Clouds
11852,2,1552579200,20,0,20,Clouds
11853,3,1552579200,13,7,20,Clouds
11854,4,1552579200,20,0,20,Clouds
11855,5,1552579200,37,3,40,Clouds
11856,6,1552579200,16,4,20,Clouds
11857,7,1552579200,29,0,29,Clouds
11858,8,1552579200,10,20,30,Clouds
11859,9,1552579200,11,13,24,Clouds
11860,10,1552579200,8,8,16,Clouds
11861,11,1552579200,19,11,30,Clouds
11862,12,1552579200,19,1,20,Clouds
11863,13,1552579200,17,13,30,Clouds
11864,14,1552579200,17,13,30,Clouds
11865,15,1552579200,15,1,16,Clouds
11866,16,1552579200,14,6,20,Clouds
11867,17,1552579200,20,0,20,Clouds
11868,18,1552579200,30,0,30,Clouds
11869,19,1552579200,0,30,30,Clouds
11870,21,1552579200,14,15,29,Clouds
11871,22,1552579200,13,7,20,Clouds
11872,23,1552579200,22,8,30,Clouds
11873,24,1552579200,13,7,20,Clouds
11874,25,1552579200,8,22,30,Clouds
11875,26,1552579200,3,17,20,Clouds
11876,27,1552579200,15,5,20,Clouds
11877,28,1552579200,30,0,30,Clouds
11878,29,1552579200,21,8,29,Clouds
11879,30,1552579200,4,16,20,Clouds
11880,31,1552579200,6,14,20,Clouds
11881,32,1552579200,27,3,30,Clouds
11882,33,1552579200,8,15,23,Clouds
11883,34,1552579200,24,6,30,Clouds
11884,35,1552579200,25,5,30,Clouds
11885,36,1552579200,20,20,40,Clouds
11886,37,1552579200,29,1,30,Clouds
11887,38,1552579200,26,14,40,Clouds
11888,39,1552579200,19,1,20,Clouds
11889,40,1552579200,6,15,21,Clouds
11890,41,1552579200,8,12,20,Clouds
11891,42,1552579200,30,0,30,Clouds
11892,43,1552579200,26,4,30,Clouds
11893,44,1552579200,29,1,30,Clouds
11894,45,1552579200,12,18,30,Clouds
11895,46,1552579200,19,1,20,Clouds
11896,47,1552579200,0,40,40,Clouds
11897,48,1552579200,12,28,40,Clouds
11898,49,1552579200,8,32,40,Clouds
11899,50,1552579200,30,10,40,Clouds
11900,51,1552579200,35,5,40,Clouds
11901,52,1552579200,19,13,32,Clouds
11902,53,1552579200,21,19,40,Clouds
11903,54,1552579200,13,20,33,Clouds
11904,55,1552579200,16,20,36,Clouds
11905,56,1552579200,4,36,40,Clouds
11906,57,1552579200,3,20,23,Clouds
11907,58,1552579200,1,39,40,Clouds
11908,59,1552579200,19,1,20,Clouds
11909,60,1552579200,27,3,30,Clouds
11910,61,1552579200,25,0,25,Clouds
11911,62,1552579200,1,39,40,Clouds
11912,63,1552579200,7,28,35,Clouds
11913,64,1552579200,11,29,40,Clouds
11914,65,1552579200,28,12,40,Clouds
11915,66,1552579200,19,21,40,Clouds
11916,67,1552579200,14,26,40,Clouds
11917,68,1552579200,1,39,40,Clouds
11918,69,1552579200,0,40,40,Clouds
11919,70,1552579200,3,25,28,Clouds
11920,71,1552579200,32,8,40,Clouds
11921,72,1552579200,21,4,25,Clouds
11922,73,1552579200,30,0,30,Clouds
11923,74,1552579200,22,8,30,Clouds
11924,75,1552579200,39,1,40,Clouds
11925,76,1552579200,35,3,38,Clouds
11926,77,1552579200,26,3,29,Clouds
11927,78,1552579200,38,2,40,Clouds
11928,79,1552579200,26,1,27,Clouds
11929,80,1552579200,29,11,40,Clouds
11930,81,1552579200,39,1,40,Clouds
11931,82,1552579200,21,1,22,Clouds
11932,83,1552579200,39,1,40,Clouds
11933,84,1552579200,30,0,30,Clouds
11934,85,1552579200,34,1,35,Clouds
11935,86,1552579200,38,0,38,Clouds
11936,87,1552579200,35,3,38,Clouds
11937,88,1552579200,23,7,30,Clouds
11938,89,1552579200,1,39,40,Clouds
11939,90,1552579200,0,40,40,Clouds
11940,91,1552579200,22,8,30,Clouds
11941,92,1552579200,37,3,40,Clouds
11942,93,1552579200,40,0,40,Clouds
11943,94,1552579200,40,0,40,Clouds
11944,95,1552579200,37,3,40,Clouds
11945,96,1552579200,28,2,30,Clouds
11946,97,1552579200,40,0,40,Clouds
11947,98,1552579200,35,5,40,Clouds
11948,99,1552579200,6,24,30,Clouds
11949,100,1552579200,11,14,25,Clouds
11950,101,1552579200,28,2,30,Clouds
11951,102,1552579200,32,8,40,Clouds
11952,103,1552579200,34,6,40,Clouds
11953,104,1552579200,39,1,40,Clouds
11954,105,1552579200,36,0,36,Clouds
11955,106,1552579200,34,6,40,Clouds
11956,107,1552579200,40,0,40,Clouds
11957,108,1552579200,34,6,40,Clouds
11958,109,1552579200,25,4,29,Clouds
11959,110,1552579200,38,2,40,Clouds
11960,111,1552579200,39,1,40,Clouds
11961,112,1552579200,25,5,30,Clouds
11962,113,1552579200,8,32,40,Clouds
11963,114,1552579200,14,26,40,Clouds
11964,115,1552579200,27,3,30,Clouds
11965,2,1552582800,15,5,20,Clouds
11966,3,1552582800,20,0,20,Clouds
11967,4,1552582800,20,0,20,Clouds
11968,5,1552582800,34,6,40,Clouds
11969,6,1552582800,16,4,20,Clouds
11970,7,1552582800,29,0,29,Clouds
11971,8,1552582800,5,25,30,Clouds
11972,9,1552582800,18,6,24,Clouds
11973,10,1552582800,7,9,16,Clouds
11974,11,1552582800,6,24,30,Clouds
11975,12,1552582800,20,0,20,Clouds
11976,13,1552582800,15,15,30,Clouds
11977,14,1552582800,12,18,30,Clouds
11978,15,1552582800,15,1,16,Clouds
11979,16,1552582800,17,3,20,Clouds
11980,17,1552582800,17,3,20,Clouds
11981,18,1552582800,30,0,30,Clouds
11982,19,1552582800,13,17,30,Clouds
11983,21,1552582800,8,21,29,Clouds
11984,22,1552582800,11,9,20,Clouds
11985,23,1552582800,16,14,30,Clouds
11986,24,1552582800,13,7,20,Clouds
11987,25,1552582800,13,17,30,Clouds
11988,26,1552582800,3,17,20,Clouds
11989,27,1552582800,17,3,20,Clouds
11990,28,1552582800,29,1,30,Clouds
11991,29,1552582800,23,6,29,Clouds
11992,30,1552582800,8,12,20,Clouds
11993,31,1552582800,13,7,20,Clouds
11994,32,1552582800,28,2,30,Clouds
11995,33,1552582800,0,23,23,Clouds
11996,34,1552582800,27,3,30,Clouds
11997,35,1552582800,29,1,30,Clouds
11998,36,1552582800,17,23,40,Clouds
11999,37,1552582800,30,0,30,Clouds
12000,38,1552582800,24,16,40,Clouds
12001,39,1552582800,18,2,20,Clouds
12002,40,1552582800,2,19,21,Clouds
12003,41,1552582800,10,10,20,Clouds
12004,42,1552582800,27,3,30,Clouds
12005,43,1552582800,27,3,30,Clouds
12006,44,1552582800,26,4,30,Clouds
12007,45,1552582800,9,21,30,Clouds
12008,46,1552582800,20,0,20,Clouds
12009,47,1552582800,3,37,40,Clouds
12010,48,1552582800,11,29,40,Clouds
12011,49,1552582800,6,34,40,Clouds
12012,50,1552582800,32,8,40,Clouds
12013,51,1552582800,34,6,40,Clouds
12014,52,1552582800,19,13,32,Clouds
12015,53,1552582800,23,17,40,Clouds
12016,54,1552582800,14,19,33,Clouds
12017,55,1552582800,25,11,36,Clouds
12018,56,1552582800,10,30,40,Clouds
12019,57,1552582800,5,18,23,Clouds
12020,58,1552582800,9,31,40,Clouds
12021,59,1552582800,20,0,20,Clouds
12022,60,1552582800,22,8,30,Clouds
12023,61,1552582800,23,2,25,Clouds
12024,62,1552582800,2,38,40,Clouds
12025,63,1552582800,2,33,35,Clouds
12026,64,1552582800,28,12,40,Clouds
12027,65,1552582800,29,11,40,Clouds
12028,66,1552582800,21,19,40,Clouds
12029,67,1552582800,13,27,40,Clouds
12030,68,1552582800,2,38,40,Clouds
12031,69,1552582800,0,40,40,Clouds
12032,70,1552582800,2,26,28,Clouds
12033,71,1552582800,38,2,40,Clouds
12034,72,1552582800,25,0,25,Clouds
12035,73,1552582800,29,1,30,Clouds
12036,74,1552582800,24,6,30,Clouds
12037,75,1552582800,37,3,40,Clouds
12038,76,1552582800,36,2,38,Clouds
12039,77,1552582800,22,7,29,Clouds
12040,78,1552582800,40,0,40,Clouds
12041,79,1552582800,27,0,27,Clouds
12042,80,1552582800,35,5,40,Clouds
12043,81,1552582800,39,1,40,Clouds
12044,82,1552582800,22,0,22,Clouds
12045,83,1552582800,40,0,40,Clouds
12046,84,1552582800,30,0,30,Clouds
12047,85,1552582800,33,2,35,Clouds
12048,86,1552582800,35,3,38,Clouds
12049,87,1552582800,34,4,38,Clouds
12050,88,1552582800,20,10,30,Clouds
12051,89,1552582800,5,35,40,Clouds
12052,90,1552582800,10,30,40,Clouds
12053,91,1552582800,27,3,30,Clouds
12054,92,1552582800,40,0,40,Clouds
12055,93,1552582800,40,0,40,Clouds
12056,94,1552582800,39,1,40,Clouds
12057,95,1552582800,37,3,40,Clouds
12058,96,1552582800,28,2,30,Clouds
12059,97,1552582800,40,0,40,Clouds
12060,98,1552582800,36,4,40,Clouds
12061,99,1552582800,3,27,30,Clouds
12062,100,1552582800,17,8,25,Clouds
12063,101,1552582800,30,0,30,Clouds
12064,102,1552582800,34,6,40,Clouds
12065,103,1552582800,37,3,40,Clouds
12066,104,1552582800,39,1,40,Clouds
12067,105,1552582800,18,18,36,Clouds
12068,106,1552582800,35,5,40,Clouds
12069,107,1552582800,39,1,40,Clouds
12070,108,1552582800,35,5,40,Clouds
12071,109,1552582800,25,4,29,Clouds
12072,110,1552582800,39,1,40,Clouds
12073,111,1552582800,38,2,40,Clouds
12074,112,1552582800,22,8,30,Clouds
12075,113,1552582800,7,33,40,Clouds
12076,114,1552582800,25,15,40,Clouds
12077,115,1552582800,27,3,30,Clouds
12078,2,1552586400,19,1,20,Clouds
12079,3,1552586400,17,3,20,Clouds
12080,4,1552586400,20,0,20,Clouds
12081,5,1552586400,28,12,40,Clouds
12082,6,1552586400,20,0,20,Clouds
12083,7,1552586400,20,9,29,Clouds
12084,8,1552586400,8,22,30,Clouds
12085,9,1552586400,20,4,24,Clouds
12086,10,1552586400,14,2,16,Clouds
12087,11,1552586400,24,6,30,Clouds
12088,12,1552586400,20,0,20,Clouds
12089,13,1552586400,22,8,30,Clouds
12090,14,1552586400,0,30,30,Clouds
12091,15,1552586400,16,0,16,Clouds
12092,16,1552586400,9,11,20,Clouds
12093,17,1552586400,20,0,20,Clouds
12094,18,1552586400,29,1,30,Clouds
12095,19,1552586400,23,7,30,Clouds
12096,21,1552586400,5,24,29,Clouds
12097,22,1552586400,3,17,20,Clouds
12098,23,1552586400,1,29,30,Clouds
12099,24,1552586400,10,10,20,Clouds
12100,25,1552586400,24,5,29,Clouds
12101,26,1552586400,8,12,20,Clouds
12102,27,1552586400,18,2,20,Clouds
12103,28,1552586400,25,4,29,Clouds
12104,29,1552586400,11,18,29,Clouds
12105,30,1552586400,15,5,20,Clouds
12106,31,1552586400,17,3,20,Clouds
12107,32,1552586400,5,25,30,Clouds
12108,33,1552586400,2,21,23,Clouds
12109,34,1552586400,12,18,30,Clouds
12110,35,1552586400,29,1,30,Clouds
12111,36,1552586400,22,18,40,Clouds
12112,37,1552586400,29,1,30,Clouds
12113,38,1552586400,13,27,40,Clouds
12114,39,1552586400,18,2,20,Clouds
12115,40,1552586400,6,15,21,Clouds
12116,41,1552586400,17,3,20,Clouds
12117,42,1552586400,21,9,30,Clouds
12118,43,1552586400,23,7,30,Clouds
12119,44,1552586400,28,2,30,Clouds
12120,45,1552586400,5,25,30,Clouds
12121,46,1552586400,15,5,20,Clouds
12122,47,1552586400,10,30,40,Clouds
12123,48,1552586400,10,30,40,Clouds
12124,49,1552586400,3,37,40,Clouds
12125,50,1552586400,36,4,40,Clouds
12126,51,1552586400,35,5,40,Clouds
12127,52,1552586400,24,8,32,Clouds
12128,53,1552586400,29,11,40,Clouds
12129,54,1552586400,25,8,33,Clouds
12130,55,1552586400,36,0,36,Clouds
12131,56,1552586400,22,18,40,Clouds
12132,57,1552586400,14,9,23,Clouds
12133,58,1552586400,19,21,40,Clouds
12134,59,1552586400,20,0,20,Clouds
12135,60,1552586400,18,12,30,Clouds
12136,61,1552586400,24,1,25,Clouds
12137,62,1552586400,6,34,40,Clouds
12138,63,1552586400,6,29,35,Clouds
12139,64,1552586400,26,14,40,Clouds
12140,65,1552586400,30,10,40,Clouds
12141,66,1552586400,35,5,40,Clouds
12142,67,1552586400,11,29,40,Clouds
12143,68,1552586400,12,28,40,Clouds
12144,69,1552586400,12,28,40,Clouds
12145,70,1552586400,0,28,28,Clouds
12146,71,1552586400,40,0,40,Clouds
12147,72,1552586400,23,2,25,Clouds
12148,73,1552586400,30,0,30,Clouds
12149,74,1552586400,26,4,30,Clouds
12150,75,1552586400,39,1,40,Clouds
12151,76,1552586400,35,3,38,Clouds
12152,77,1552586400,24,5,29,Clouds
12153,78,1552586400,39,1,40,Clouds
12154,79,1552586400,27,0,27,Clouds
12155,80,1552586400,40,0,40,Clouds
12156,81,1552586400,40,0,40,Clouds
12157,82,1552586400,21,1,22,Clouds
12158,83,1552586400,39,1,40,Clouds
12159,84,1552586400,29,1,30,Clouds
12160,85,1552586400,28,7,35,Clouds
12161,86,1552586400,27,11,38,Clouds
12162,87,1552586400,34,4,38,Clouds
12163,88,1552586400,15,15,30,Clouds
12164,89,1552586400,17,23,40,Clouds
12165,90,1552586400,27,13,40,Clouds
12166,91,1552586400,29,1,30,Clouds
12167,92,1552586400,26,14,40,Clouds
12168,93,1552586400,26,14,40,Clouds
12169,94,1552586400,39,1,40,Clouds
12170,95,1552586400,34,6,40,Clouds
12171,96,1552586400,29,1,30,Clouds
12172,97,1552586400,37,3,40,Clouds
12173,98,1552586400,40,0,40,Clouds
12174,99,1552586400,3,27,30,Clouds
12175,100,1552586400,4,21,25,Clouds
12176,101,1552586400,28,2,30,Clouds
12177,102,1552586400,35,5,40,Clouds
12178,103,1552586400,39,1,40,Clouds
12179,104,1552586400,40,0,40,Clouds
12180,105,1552586400,19,17,36,Clouds
12181,106,1552586400,36,4,40,Clouds
12182,107,1552586400,38,2,40,Clouds
12183,108,1552586400,33,7,40,Clouds
12184,109,1552586400,23,6,29,Clouds
12185,110,1552586400,36,4,40,Clouds
12186,111,1552586400,38,2,40,Clouds
12187,112,1552586400,24,6,30,Clouds
12188,113,1552586400,13,27,40,Clouds
12189,114,1552586400,40,0,40,Clouds
12190,115,1552586400,22,8,30,Clouds
12191,2,1552590000,20,0,20,Rain
12192,3,1552590000,20,0,20,Rain
12193,4,1552590000,20,0,20,Rain
12194,5,1552590000,27,13,40,Rain
12195,6,1552590000,16,4,20,Rain
12196,7,1552590000,25,4,29,Rain
12197,8,1552590000,12,18,30,Rain
12198,9,1552590000,17,7,24,Rain
12199,10,1552590000,10,6,16,Rain
12200,11,1552590000,30,0,30,Rain
12201,12,1552590000,18,2,20,Rain
12202,13,1552590000,30,0,30,Rain
12203,14,1552590000,8,22,30,Rain
12204,15,1552590000,16,0,16,Rain
12205,16,1552590000,3,17,20,Rain
12206,17,1552590000,20,0,20,Rain
12207,18,1552590000,30,0,30,Rain
12208,19,1552590000,29,1,30,Rain
12209,21,1552590000,0,29,29,Rain
12210,22,1552590000,2,18,20,Rain
12211,23,1552590000,1,29,30,Rain
12212,24,1552590000,0,20,20,Rain
12213,25,1552590000,28,1,29,Rain
12214,26,1552590000,1,19,20,Rain
12215,27,1552590000,15,5,20,Rain
12216,28,1552590000,26,4,30,Rain
12217,29,1552590000,17,12,29,Rain
12218,30,1552590000,20,0,20,Rain
12219,31,1552590000,12,8,20,Rain
12220,32,1552590000,1,29,30,Rain
12221,33,1552590000,1,22,23,Rain
12222,34,1552590000,16,14,30,Rain
12223,35,1552590000,30,0,30,Rain
12224,36,1552590000,34,6,40,Rain
12225,37,1552590000,29,1,30,Rain
12226,38,1552590000,9,31,40,Rain
12227,39,1552590000,14,6,20,Rain
12228,40,1552590000,2,19,21,Rain
12229,41,1552590000,20,0,20,Rain
12230,42,1552590000,15,15,30,Rain
12231,43,1552590000,11,19,30,Rain
12232,44,1552590000,23,7,30,Rain
12233,45,1552590000,0,30,30,Rain
12234,46,1552590000,11,9,20,Rain
12235,47,1552590000,39,1,40,Rain
12236,48,1552590000,17,23,40,Rain
12237,49,1552590000,7,33,40,Rain
12238,50,1552590000,37,3,40,Rain
12239,51,1552590000,33,7,40,Rain
12240,52,1552590000,28,4,32,Rain
12241,53,1552590000,39,1,40,Rain
12242,54,1552590000,33,0,33,Rain
12243,55,1552590000,36,0,36,Rain
12244,56,1552590000,40,0,40,Rain
12245,57,1552590000,23,0,23,Rain
12246,58,1552590000,39,1,40,Rain
12247,59,1552590000,17,3,20,Rain
12248,60,1552590000,5,25,30,Rain
12249,61,1552590000,25,0,25,Rain
12250,62,1552590000,26,14,40,Rain
12251,63,1552590000,24,11,35,Rain
12252,64,1552590000,29,11,40,Rain
12253,65,1552590000,37,3,40,Rain
12254,66,1552590000,40,0,40,Rain
12255,67,1552590000,7,33,40,Rain
12256,68,1552590000,40,0,40,Rain
12257,69,1552590000,37,3,40,Rain
12258,70,1552590000,11,17,28,Rain
12259,71,1552590000,37,3,40,Rain
12260,72,1552590000,23,2,25,Rain
12261,73,1552590000,29,1,30,Rain
12262,74,1552590000,30,0,30,Rain
12263,75,1552590000,34,6,40,Rain
12264,76,1552590000,20,18,38,Rain
12265,77,1552590000,29,0,29,Rain
12266,78,1552590000,26,14,40,Rain
12267,79,1552590000,27,0,27,Rain
12268,80,1552590000,36,4,40,Rain
12269,81,1552590000,40,0,40,Rain
12270,82,1552590000,21,1,22,Rain
12271,83,1552590000,33,7,40,Rain
12272,84,1552590000,25,5,30,Rain
12273,85,1552590000,23,12,35,Rain
12274,86,1552590000,14,24,38,Rain
12275,87,1552590000,29,9,38,Rain
12276,88,1552590000,13,17,30,Rain
12277,89,1552590000,40,0,40,Rain
12278,90,1552590000,39,1,40,Rain
12279,91,1552590000,18,12,30,Rain
12280,92,1552590000,2,38,40,Rain
12281,93,1552590000,11,29,40,Rain
12282,94,1552590000,22,18,40,Rain
12283,95,1552590000,33,7,40,Rain
12284,96,1552590000,22,8,30,Rain
12285,97,1552590000,38,2,40,Rain
12286,98,1552590000,32,8,40,Rain
12287,99,1552590000,10,20,30,Rain
12288,100,1552590000,0,25,25,Rain
12289,101,1552590000,23,7,30,Rain
12290,102,1552590000,35,5,40,Rain
12291,103,1552590000,40,0,40,Rain
12292,104,1552590000,40,0,40,Rain
12293,105,1552590000,24,12,36,Rain
12294,106,1552590000,32,8,40,Rain
12295,107,1552590000,37,3,40,Rain
12296,108,1552590000,32,8,40,Rain
12297,109,1552590000,22,7,29,Rain
12298,110,1552590000,33,7,40,Rain
12299,111,1552590000,36,4,40,Rain
12300,112,1552590000,20,10,30,Rain
12301,113,1552590000,20,20,40,Rain
12302,114,1552590000,40,0,40,Rain
12303,115,1552590000,16,14,30,Rain
12304,2,1552593600,16,4,20,Rain
12305,3,1552593600,20,0,20,Rain
12306,4,1552593600,19,1,20,Rain
12307,5,1552593600,25,15,40,Rain
12308,6,1552593600,17,3,20,Rain
12309,7,1552593600,18,11,29,Rain
12310,8,1552593600,8,22,30,Rain
12311,9,1552593600,21,3,24,Rain
12312,10,1552593600,4,12,16,Rain
12313,11,1552593600,30,0,30,Rain
12314,12,1552593600,17,3,20,Rain
12315,13,1552593600,27,3,30,Rain
12316,14,1552593600,12,18,30,Rain
12317,15,1552593600,15,1,16,Rain
12318,16,1552593600,3,17,20,Rain
12319,17,1552593600,13,7,20,Rain
12320,18,1552593600,25,5,30,Rain
12321,19,1552593600,28,2,30,Rain
12322,21,1552593600,0,29,29,Rain
12323,22,1552593600,1,19,20,Rain
12324,23,1552593600,3,27,30,Rain
12325,24,1552593600,2,18,20,Rain
12326,25,1552593600,29,0,29,Rain
12327,26,1552593600,6,14,20,Rain
12328,27,1552593600,18,2,20,Rain
12329,28,1552593600,22,8,30,Rain
12330,29,1552593600,20,9,29,Rain
12331,30,1552593600,20,0,20,Rain
12332,31,1552593600,5,15,20,Rain
12333,32,1552593600,0,30,30,Rain
12334,33,1552593600,1,22,23,Rain
12335,34,1552593600,12,18,30,Rain
12336,35,1552593600,23,7,30,Rain
12337,36,1552593600,36,4,40,Rain
12338,37,1552593600,29,1,30,Rain
12339,38,1552593600,4,36,40,Rain
12340,39,1552593600,20,0,20,Rain
12341,40,1552593600,7,14,21,Rain
12342,41,1552593600,18,2,20,Rain
12343,42,1552593600,17,13,30,Rain
12344,43,1552593600,0,30,30,Rain
12345,44,1552593600,16,14,30,Rain
12346,45,1552593600,1,29,30,Rain
12347,46,1552593600,11,9,20,Rain
12348,47,1552593600,40,0,40,Rain
12349,48,1552593600,28,12,40,Rain
12350,49,1552593600,13,27,40,Rain
12351,50,1552593600,31,9,40,Rain
12352,51,1552593600,38,2,40,Rain
12353,52,1552593600,32,0,32,Rain
12354,53,1552593600,40,0,40,Rain
12355,54,1552593600,33,0,33,Rain
12356,55,1552593600,36,0,36,Rain
12357,56,1552593600,38,2,40,Rain
12358,57,1552593600,23,0,23,Rain
12359,58,1552593600,40,0,40,Rain
12360,59,1552593600,17,3,20,Rain
12361,60,1552593600,12,18,30,Rain
12362,61,1552593600,25,0,25,Rain
12363,62,1552593600,35,5,40,Rain
12364,63,1552593600,30,5,35,Rain
12365,64,1552593600,35,5,40,Rain
12366,65,1552593600,39,1,40,Rain
12367,66,1552593600,37,3,40,Rain
12368,67,1552593600,6,34,40,Rain
12369,68,1552593600,40,0,40,Rain
12370,69,1552593600,40,0,40,Rain
12371,70,1552593600,22,6,28,Rain
12372,71,1552593600,35,5,40,Rain
12373,72,1552593600,20,5,25,Rain
12374,73,1552593600,25,5,30,Rain
12375,74,1552593600,24,6,30,Rain
12376,75,1552593600,27,13,40,Rain
12377,76,1552593600,23,15,38,Rain
12378,77,1552593600,29,0,29,Rain
12379,78,1552593600,28,12,40,Rain
12380,79,1552593600,24,3,27,Rain
12381,80,1552593600,37,3,40,Rain
12382,81,1552593600,40,0,40,Rain
12383,82,1552593600,18,4,22,Rain
12384,83,1552593600,25,15,40,Rain
12385,84,1552593600,16,14,30,Rain
12386,85,1552593600,19,16,35,Rain
12387,86,1552593600,4,34,38,Rain
12388,87,1552593600,30,8,38,Rain
12389,88,1552593600,8,22,30,Rain
12390,89,1552593600,39,1,40,Rain
12391,90,1552593600,40,0,40,Rain
12392,91,1552593600,8,22,30,Rain
12393,92,1552593600,7,33,40,Rain
12394,93,1552593600,0,40,40,Rain
12395,94,1552593600,20,20,40,Rain
12396,95,1552593600,30,10,40,Rain
12397,96,1552593600,20,10,30,Rain
12398,97,1552593600,33,7,40,Rain
12399,98,1552593600,37,3,40,Rain
12400,99,1552593600,12,18,30,Rain
12401,100,1552593600,0,25,25,Rain
12402,101,1552593600,20,10,30,Rain
12403,102,1552593600,12,28,40,Rain
12404,103,1552593600,39,1,40,Rain
12405,104,1552593600,40,0,40,Rain
12406,105,1552593600,26,10,36,Rain
12407,106,1552593600,32,8,40,Rain
12408,107,1552593600,40,0,40,Rain
12409,108,1552593600,33,7,40,Rain
12410,109,1552593600,19,10,29,Rain
12411,110,1552593600,33,7,40,Rain
12412,111,1552593600,31,9,40,Rain
12413,112,1552593600,13,17,30,Rain
12414,113,1552593600,33,7,40,Rain
12415,114,1552593600,40,0,40,Rain
12416,115,1552593600,14,16,30,Rain
12417,2,1552597200,16,4,20,Rain
12418,3,1552597200,20,0,20,Rain
12419,4,1552597200,20,0,20,Rain
12420,5,1552597200,28,12,40,Rain
12421,6,1552597200,14,6,20,Rain
12422,7,1552597200,16,13,29,Rain
12423,8,1552597200,12,18,30,Rain
12424,9,1552597200,23,1,24,Rain
12425,10,1552597200,1,15,16,Rain
12426,11,1552597200,30,0,30,Rain
12427,12,1552597200,10,10,20,Rain
12428,13,1552597200,30,0,30,Rain
12429,14,1552597200,14,16,30,Rain
12430,15,1552597200,15,1,16,Rain
12431,16,1552597200,2,18,20,Rain
12432,17,1552597200,19,1,20,Rain
12433,18,1552597200,27,3,30,Rain
12434,19,1552597200,27,3,30,Rain
12435,21,1552597200,16,13,29,Rain
12436,22,1552597200,0,20,20,Rain
12437,23,1552597200,0,30,30,Rain
12438,24,1552597200,10,10,20,Rain
12439,25,1552597200,29,0,29,Rain
12440,26,1552597200,11,9,20,Rain
12441,27,1552597200,20,0,20,Rain
12442,28,1552597200,23,7,30,Rain
12443,29,1552597200,16,13,29,Rain
12444,30,1552597200,19,1,20,Rain
12445,31,1552597200,13,7,20,Rain
12446,32,1552597200,0,30,30,Rain
12447,33,1552597200,0,23,23,Rain
12448,34,1552597200,1,29,30,Rain
12449,35,1552597200,28,2,30,Rain
12450,36,1552597200,39,1,40,Rain
12451,37,1552597200,30,0,30,Rain
12452,38,1552597200,1,39,40,Rain
12453,39,1552597200,20,0,20,Rain
12454,40,1552597200,4,17,21,Rain
12455,41,1552597200,20,0,20,Rain
12456,42,1552597200,15,15,30,Rain
12457,43,1552597200,1,29,30,Rain
12458,44,1552597200,9,21,30,Rain
12459,45,1552597200,3,27,30,Rain
12460,46,1552597200,0,20,20,Rain
12461,47,1552597200,39,1,40,Rain
12462,48,1552597200,29,11,40,Rain
12463,49,1552597200,16,24,40,Rain
12464,50,1552597200,30,10,40,Rain
12465,51,1552597200,40,0,40,Rain
12466,52,1552597200,31,1,32,Rain
12467,53,1552597200,40,0,40,Rain
12468,54,1552597200,32,1,33,Rain
12469,55,1552597200,36,0,36,Rain
12470,56,1552597200,34,6,40,Rain
12471,57,1552597200,19,4,23,Rain
12472,58,1552597200,40,0,40,Rain
12473,59,1552597200,18,2,20,Rain
12474,60,1552597200,18,12,30,Rain
12475,61,1552597200,25,0,25,Rain
12476,62,1552597200,40,0,40,Rain
12477,63,1552597200,34,1,35,Rain
12478,64,1552597200,35,5,40,Rain
12479,65,1552597200,40,0,40,Rain
12480,66,1552597200,33,7,40,Rain
12481,67,1552597200,6,34,40,Rain
12482,68,1552597200,25,15,40,Rain
12483,69,1552597200,40,0,40,Rain
12484,70,1552597200,17,11,28,Rain
12485,71,1552597200,35,5,40,Rain
12486,72,1552597200,18,7,25,Rain
12487,73,1552597200,23,7,30,Rain
12488,74,1552597200,24,6,30,Rain
12489,75,1552597200,25,15,40,Rain
12490,76,1552597200,19,19,38,Rain
12491,77,1552597200,26,3,29,Rain
12492,78,1552597200,29,11,40,Rain
12493,79,1552597200,23,4,27,Rain
12494,80,1552597200,37,3,40,Rain
12495,81,1552597200,40,0,40,Rain
12496,82,1552597200,17,5,22,Rain
12497,83,1552597200,16,24,40,Rain
12498,84,1552597200,14,16,30,Rain
12499,85,1552597200,20,15,35,Rain
12500,86,1552597200,1,37,38,Rain
12501,87,1552597200,29,9,38,Rain
12502,88,1552597200,2,28,30,Rain
12503,89,1552597200,40,0,40,Rain
12504,90,1552597200,36,4,40,Rain
12505,91,1552597200,4,26,30,Rain
12506,92,1552597200,0,40,40,Rain
12507,93,1552597200,0,40,40,Rain
12508,94,1552597200,15,25,40,Rain
12509,95,1552597200,33,7,40,Rain
12510,96,1552597200,17,13,30,Rain
12511,97,1552597200,26,14,40,Rain
12512,98,1552597200,40,0,40,Rain
12513,99,1552597200,20,10,30,Rain
12514,100,1552597200,1,24,25,Rain
12515,101,1552597200,19,11,30,Rain
12516,102,1552597200,8,32,40,Rain
12517,103,1552597200,40,0,40,Rain
12518,104,1552597200,40,0,40,Rain
12519,105,1552597200,25,11,36,Rain
12520,106,1552597200,33,7,40,Rain
12521,107,1552597200,38,2,40,Rain
12522,108,1552597200,35,5,40,Rain
12523,109,1552597200,18,11,29,Rain
12524,110,1552597200,32,8,40,Rain
12525,111,1552597200,28,12,40,Rain
12526,112,1552597200,14,15,29,Rain
12527,113,1552597200,36,4,40,Rain
12528,114,1552597200,39,1,40,Rain
12529,115,1552597200,2,28,30,Rain
12530,2,1552600800,10,10,20,Rain
12531,3,1552600800,20,0,20,Rain
12532,4,1552600800,20,0,20,Rain
12533,5,1552600800,33,7,40,Rain
12534,6,1552600800,11,9,20,Rain
12535,7,1552600800,17,12,29,Rain
12536,8,1552600800,14,16,30,Rain
12537,9,1552600800,17,6,23,Rain
12538,10,1552600800,2,14,16,Rain
12539,11,1552600800,30,0,30,Rain
12540,12,1552600800,13,7,20,Rain
12541,13,1552600800,30,0,30,Rain
12542,14,1552600800,23,7,30,Rain
12543,15,1552600800,14,2,16,Rain
12544,16,1552600800,15,5,20,Rain
12545,17,1552600800,20,0,20,Rain
12546,18,1552600800,21,9,30,Rain
12547,19,1552600800,30,0,30,Rain
12548,21,1552600800,18,11,29,Rain
12549,22,1552600800,4,16,20,Rain
12550,23,1552600800,3,27,30,Rain
12551,24,1552600800,12,8,20,Rain
12552,25,1552600800,29,0,29,Rain
12553,26,1552600800,11,9,20,Rain
12554,27,1552600800,20,0,20,Rain
12555,28,1552600800,20,10,30,Rain
12556,29,1552600800,18,11,29,Rain
12557,30,1552600800,17,3,20,Rain
12558,31,1552600800,18,2,20,Rain
12559,32,1552600800,1,29,30,Rain
12560,33,1552600800,5,18,23,Rain
12561,34,1552600800,0,30,30,Rain
12562,35,1552600800,22,8,30,Rain
12563,36,1552600800,40,0,40,Rain
12564,37,1552600800,30,0,30,Rain
12565,38,1552600800,7,33,40,Rain
12566,39,1552600800,19,1,20,Rain
12567,40,1552600800,8,13,21,Rain
12568,41,1552600800,20,0,20,Rain
12569,42,1552600800,12,18,30,Rain
12570,43,1552600800,1,29,30,Rain
12571,44,1552600800,9,21,30,Rain
12572,45,1552600800,5,25,30,Rain
12573,46,1552600800,0,20,20,Rain
12574,47,1552600800,39,1,40,Rain
12575,48,1552600800,36,4,40,Rain
12576,49,1552600800,8,32,40,Rain
12577,50,1552600800,16,24,40,Rain
12578,51,1552600800,40,0,40,Rain
12579,52,1552600800,32,0,32,Rain
12580,53,1552600800,40,0,40,Rain
12581,54,1552600800,32,1,33,Rain
12582,55,1552600800,36,0,36,Rain
12583,56,1552600800,35,5,40,Rain
12584,57,1552600800,19,4,23,Rain
12585,58,1552600800,40,0,40,Rain
12586,59,1552600800,19,1,20,Rain
12587,60,1552600800,17,13,30,Rain
12588,61,1552600800,25,0,25,Rain
12589,62,1552600800,40,0,40,Rain
12590,63,1552600800,33,2,35,Rain
12591,64,1552600800,35,5,40,Rain
12592,65,1552600800,39,1,40,Rain
12593,66,1552600800,28,12,40,Rain
12594,67,1552600800,3,37,40,Rain
12595,68,1552600800,34,6,40,Rain
12596,69,1552600800,38,2,40,Rain
12597,70,1552600800,12,16,28,Rain
12598,71,1552600800,37,3,40,Rain
12599,72,1552600800,18,7,25,Rain
12600,73,1552600800,22,8,30,Rain
12601,74,1552600800,25,5,30,Rain
12602,75,1552600800,26,14,40,Rain
12603,76,1552600800,20,18,38,Rain
12604,77,1552600800,26,3,29,Rain
12605,78,1552600800,27,13,40,Rain
12606,79,1552600800,22,5,27,Rain
12607,80,1552600800,36,4,40,Rain
12608,81,1552600800,40,0,40,Rain
12609,82,1552600800,13,9,22,Rain
12610,83,1552600800,17,23,40,Rain
12611,84,1552600800,11,19,30,Rain
12612,85,1552600800,20,15,35,Rain
12613,86,1552600800,0,38,38,Rain
12614,87,1552600800,24,14,38,Rain
12615,88,1552600800,0,30,30,Rain
12616,89,1552600800,40,0,40,Rain
12617,90,1552600800,40,0,40,Rain
12618,91,1552600800,1,29,30,Rain
12619,92,1552600800,0,40,40,Rain
12620,93,1552600800,0,40,40,Rain
12621,94,1552600800,15,25,40,Rain
12622,95,1552600800,29,11,40,Rain
12623,96,1552600800,15,15,30,Rain
12624,97,1552600800,25,15,40,Rain
12625,98,1552600800,40,0,40,Rain
12626,99,1552600800,21,9,30,Rain
12627,100,1552600800,0,25,25,Rain
12628,101,1552600800,16,14,30,Rain
12629,102,1552600800,5,35,40,Rain
12630,103,1552600800,40,0,40,Rain
12631,104,1552600800,40,0,40,Rain
12632,105,1552600800,25,11,36,Rain
12633,106,1552600800,33,7,40,Rain
12634,107,1552600800,34,6,40,Rain
12635,108,1552600800,34,6,40,Rain
12636,109,1552600800,17,12,29,Rain
12637,110,1552600800,27,13,40,Rain
12638,111,1552600800,25,15,40,Rain
12639,112,1552600800,4,25,29,Rain
12640,113,1552600800,37,3,40,Rain
12641,114,1552600800,38,2,40,Rain
12642,115,1552600800,0,30,30,Rain
12643,2,1552604400,6,14,20,Rain
12644,3,1552604400,14,6,20,Rain
12645,4,1552604400,20,0,20,Rain
12646,5,1552604400,34,6,40,Rain
12647,6,1552604400,9,11,20,Rain
12648,7,1552604400,17,12,29,Rain
12649,8,1552604400,13,17,30,Rain
12650,9,1552604400,12,11,23,Rain
12651,10,1552604400,6,10,16,Rain
12652,11,1552604400,30,0,30,Rain
12653,12,1552604400,12,8,20,Rain
12654,13,1552604400,30,0,30,Rain
12655,14,1552604400,20,10,30,Rain
12656,15,1552604400,13,3,16,Rain
12657,16,1552604400,18,2,20,Rain
12658,17,1552604400,19,1,20,Rain
12659,18,1552604400,21,9,30,Rain
12660,19,1552604400,23,7,30,Rain
12661,21,1552604400,18,11,29,Rain
12662,22,1552604400,11,9,20,Rain
12663,23,1552604400,8,22,30,Rain
12664,24,1552604400,11,9,20,Rain
12665,25,1552604400,28,1,29,Rain
12666,26,1552604400,12,8,20,Rain
12667,27,1552604400,18,2,20,Rain
12668,28,1552604400,19,11,30,Rain
12669,29,1552604400,15,14,29,Rain
12670,30,1552604400,17,3,20,Rain
12671,31,1552604400,19,1,20,Rain
12672,32,1552604400,3,27,30,Rain
12673,33,1552604400,6,17,23,Rain
12674,34,1552604400,1,29,30,Rain
12675,35,1552604400,23,7,30,Rain
12676,36,1552604400,39,1,40,Rain
12677,37,1552604400,30,0,30,Rain
12678,38,1552604400,14,26,40,Rain
12679,39,1552604400,18,2,20,Rain
12680,40,1552604400,13,8,21,Rain
12681,41,1552604400,20,0,20,Rain
12682,42,1552604400,8,22,30,Rain
12683,43,1552604400,0,30,30,Rain
12684,44,1552604400,7,23,30,Rain
12685,45,1552604400,3,27,30,Rain
12686,46,1552604400,2,18,20,Rain
12687,47,1552604400,39,1,40,Rain
12688,48,1552604400,37,3,40,Rain
12689,49,1552604400,6,34,40,Rain
12690,50,1552604400,9,31,40,Rain
12691,51,1552604400,40,0,40,Rain
12692,52,1552604400,32,0,32,Rain
12693,53,1552604400,40,0,40,Rain
12694,54,1552604400,33,0,33,Rain
12695,55,1552604400,35,1,36,Rain
12696,56,1552604400,36,4,40,Rain
12697,57,1552604400,18,5,23,Rain
12698,58,1552604400,30,10,40,Rain
12699,59,1552604400,20,0,20,Rain
12700,60,1552604400,16,14,30,Rain
12701,61,1552604400,23,2,25,Rain
12702,62,1552604400,40,0,40,Rain
12703,63,1552604400,35,0,35,Rain
12704,64,1552604400,33,7,40,Rain
12705,65,1552604400,39,1,40,Rain
12706,66,1552604400,25,15,40,Rain
12707,67,1552604400,1,39,40,Rain
12708,68,1552604400,40,0,40,Rain
12709,69,1552604400,38,2,40,Rain
12710,70,1552604400,10,18,28,Rain
12711,71,1552604400,39,1,40,Rain
12712,72,1552604400,16,9,25,Rain
12713,73,1552604400,19,11,30,Rain
12714,74,1552604400,21,9,30,Rain
12715,75,1552604400,27,13,40,Rain
12716,76,1552604400,19,19,38,Rain
12717,77,1552604400,25,4,29,Rain
12718,78,1552604400,25,15,40,Rain
12719,79,1552604400,21,6,27,Rain
12720,80,1552604400,36,4,40,Rain
12721,81,1552604400,40,0,40,Rain
12722,82,1552604400,13,9,22,Rain
12723,83,1552604400,16,24,40,Rain
12724,84,1552604400,10,20,30,Rain
12725,85,1552604400,17,18,35,Rain
12726,86,1552604400,0,38,38,Rain
12727,87,1552604400,21,17,38,Rain
12728,88,1552604400,0,30,30,Rain
12729,89,1552604400,40,0,40,Rain
12730,90,1552604400,40,0,40,Rain
12731,91,1552604400,0,30,30,Rain
12732,92,1552604400,9,31,40,Rain
12733,93,1552604400,0,40,40,Rain
12734,94,1552604400,15,25,40,Rain
12735,95,1552604400,28,12,40,Rain
12736,96,1552604400,17,13,30,Rain
12737,97,1552604400,26,14,40,Rain
12738,98,1552604400,40,0,40,Rain
12739,99,1552604400,24,6,30,Rain
12740,100,1552604400,9,16,25,Rain
12741,101,1552604400,13,17,30,Rain
12742,102,1552604400,5,35,40,Rain
12743,103,1552604400,40,0,40,Rain
12744,104,1552604400,40,0,40,Rain
12745,105,1552604400,25,11,36,Rain
12746,106,1552604400,34,6,40,Rain
12747,107,1552604400,31,9,40,Rain
12748,108,1552604400,34,6,40,Rain
12749,109,1552604400,13,16,29,Rain
12750,110,1552604400,29,11,40,Rain
12751,111,1552604400,20,20,40,Rain
12752,112,1552604400,2,27,29,Rain
12753,113,1552604400,36,4,40,Rain
12754,114,1552604400,38,2,40,Rain
12755,115,1552604400,0,30,30,Rain
12756,2,1552608000,6,14,20,Rain
12757,3,1552608000,15,5,20,Rain
12758,4,1552608000,19,1,20,Rain
12759,5,1552608000,29,11,40,Rain
12760,6,1552608000,10,10,20,Rain
12761,7,1552608000,17,12,29,Rain
12762,8,1552608000,13,17,30,Rain
12763,9,1552608000,16,8,24,Rain
12764,10,1552608000,9,7,16,Rain
12765,11,1552608000,30,0,30,Rain
12766,12,1552608000,12,8,20,Rain
12767,13,1552608000,30,0,30,Rain
12768,14,1552608000,19,11,30,Rain
12769,15,1552608000,11,5,16,Rain
12770,16,1552608000,19,1,20,Rain
12771,17,1552608000,20,0,20,Rain
12772,18,1552608000,22,8,30,Rain
12773,19,1552608000,23,7,30,Rain
12774,21,1552608000,22,7,29,Rain
12775,22,1552608000,11,9,20,Rain
12776,23,1552608000,17,13,30,Rain
12777,24,1552608000,14,6,20,Rain
12778,25,1552608000,29,0,29,Rain
12779,26,1552608000,16,4,20,Rain
12780,27,1552608000,20,0,20,Rain
12781,28,1552608000,17,13,30,Rain
12782,29,1552608000,17,12,29,Rain
12783,30,1552608000,17,3,20,Rain
12784,31,1552608000,20,0,20,Rain
12785,32,1552608000,3,27,30,Rain
12786,33,1552608000,7,16,23,Rain
12787,34,1552608000,2,28,30,Rain
12788,35,1552608000,21,9,30,Rain
12789,36,1552608000,31,9,40,Rain
12790,37,1552608000,30,0,30,Rain
12791,38,1552608000,11,29,40,Rain
12792,39,1552608000,18,2,20,Rain
12793,40,1552608000,17,4,21,Rain
12794,41,1552608000,16,4,20,Rain
12795,42,1552608000,7,23,30,Rain
12796,43,1552608000,0,30,30,Rain
12797,44,1552608000,7,23,30,Rain
12798,45,1552608000,1,29,30,Rain
12799,46,1552608000,3,17,20,Rain
12800,47,1552608000,40,0,40,Rain
12801,48,1552608000,38,2,40,Rain
12802,49,1552608000,12,28,40,Rain
12803,50,1552608000,11,29,40,Rain
12804,51,1552608000,40,0,40,Rain
12805,52,1552608000,32,0,32,Rain
12806,53,1552608000,32,8,40,Rain
12807,54,1552608000,33,0,33,Rain
12808,55,1552608000,36,0,36,Rain
12809,56,1552608000,36,4,40,Rain
12810,57,1552608000,22,1,23,Rain
12811,58,1552608000,34,6,40,Rain
12812,59,1552608000,19,1,20,Rain
12813,60,1552608000,16,14,30,Rain
12814,61,1552608000,24,1,25,Rain
12815,62,1552608000,40,0,40,Rain
12816,63,1552608000,34,1,35,Rain
12817,64,1552608000,30,10,40,Rain
12818,65,1552608000,40,0,40,Rain
12819,66,1552608000,16,24,40,Rain
12820,67,1552608000,1,39,40,Rain
12821,68,1552608000,39,1,40,Rain
12822,69,1552608000,40,0,40,Rain
12823,70,1552608000,11,17,28,Rain
12824,71,1552608000,39,1,40,Rain
12825,72,1552608000,13,12,25,Rain
12826,73,1552608000,20,10,30,Rain
12827,74,1552608000,22,8,30,Rain
12828,75,1552608000,24,16,40,Rain
12829,76,1552608000,18,20,38,Rain
12830,77,1552608000,23,6,29,Rain
12831,78,1552608000,26,14,40,Rain
12832,79,1552608000,11,16,27,Rain
12833,80,1552608000,35,5,40,Rain
12834,81,1552608000,40,0,40,Rain
12835,82,1552608000,13,9,22,Rain
12836,83,1552608000,19,21,40,Rain
12837,84,1552608000,8,22,30,Rain
12838,85,1552608000,14,21,35,Rain
12839,86,1552608000,1,37,38,Rain
12840,87,1552608000,22,16,38,Rain
12841,88,1552608000,0,30,30,Rain
12842,89,1552608000,40,0,40,Rain
12843,90,1552608000,40,0,40,Rain
12844,91,1552608000,4,26,30,Rain
12845,92,1552608000,8,32,40,Rain
12846,93,1552608000,0,40,40,Rain
12847,94,1552608000,15,25,40,Rain
12848,95,1552608000,27,13,40,Rain
12849,96,1552608000,17,13,30,Rain
12850,97,1552608000,24,16,40,Rain
12851,98,1552608000,40,0,40,Rain
12852,99,1552608000,28,2,30,Rain
12853,100,1552608000,7,18,25,Rain
12854,101,1552608000,14,16,30,Rain
12855,102,1552608000,4,36,40,Rain
12856,103,1552608000,40,0,40,Rain
12857,104,1552608000,40,0,40,Rain
12858,105,1552608000,26,10,36,Rain
12859,106,1552608000,34,6,40,Rain
12860,107,1552608000,31,9,40,Rain
12861,108,1552608000,33,7,40,Rain
12862,109,1552608000,7,22,29,Rain
12863,110,1552608000,28,12,40,Rain
12864,111,1552608000,17,23,40,Rain
12865,112,1552608000,2,28,30,Rain
12866,113,1552608000,36,4,40,Rain
12867,114,1552608000,38,2,40,Rain
12868,115,1552608000,0,30,30,Rain
12869,2,1552611600,6,14,20,Rain
12870,3,1552611600,13,7,20,Rain
12871,4,1552611600,20,0,20,Rain
12872,5,1552611600,25,15,40,Rain
12873,6,1552611600,14,6,20,Rain
12874,7,1552611600,18,11,29,Rain
12875,8,1552611600,16,14,30,Rain
12876,9,1552611600,24,0,24,Rain
12877,10,1552611600,11,5,16,Rain
12878,11,1552611600,30,0,30,Rain
12879,12,1552611600,11,9,20,Rain
12880,13,1552611600,30,0,30,Rain
12881,14,1552611600,23,7,30,Rain
12882,15,1552611600,9,7,16,Rain
12883,16,1552611600,19,1,20,Rain
12884,17,1552611600,20,0,20,Rain
12885,18,1552611600,19,11,30,Rain
12886,19,1552611600,22,8,30,Rain
12887,21,1552611600,22,7,29,Rain
12888,22,1552611600,10,10,20,Rain
12889,23,1552611600,22,8,30,Rain
12890,24,1552611600,13,7,20,Rain
12891,25,1552611600,29,0,29,Rain
12892,26,1552611600,17,3,20,Rain
12893,27,1552611600,20,0,20,Rain
12894,28,1552611600,16,14,30,Rain
12895,29,1552611600,17,12,29,Rain
12896,30,1552611600,19,1,20,Rain
12897,31,1552611600,18,2,20,Rain
12898,32,1552611600,7,23,30,Rain
12899,33,1552611600,8,15,23,Rain
12900,34,1552611600,1,29,30,Rain
12901,35,1552611600,26,4,30,Rain
12902,36,1552611600,34,6,40,Rain
12903,37,1552611600,30,0,30,Rain
12904,38,1552611600,12,28,40,Rain
12905,39,1552611600,15,5,20,Rain
12906,40,1552611600,18,3,21,Rain
12907,41,1552611600,16,4,20,Rain
12908,42,1552611600,3,27,30,Rain
12909,43,1552611600,0,30,30,Rain
12910,44,1552611600,6,24,30,Rain
12911,45,1552611600,0,30,30,Rain
12912,46,1552611600,16,4,20,Rain
12913,47,1552611600,40,0,40,Rain
12914,48,1552611600,39,1,40,Rain
12915,49,1552611600,18,22,40,Rain
12916,50,1552611600,3,37,40,Rain
12917,51,1552611600,40,0,40,Rain
12918,52,1552611600,30,2,32,Rain
12919,53,1552611600,34,6,40,Rain
12920,54,1552611600,32,1,33,Rain
12921,55,1552611600,36,0,36,Rain
12922,56,1552611600,35,5,40,Rain
12923,57,1552611600,21,2,23,Rain
12924,58,1552611600,33,7,40,Rain
12925,59,1552611600,18,2,20,Rain
12926,60,1552611600,9,21,30,Rain
12927,61,1552611600,22,3,25,Rain
12928,62,1552611600,40,0,40,Rain
12929,63,1552611600,35,0,35,Rain
12930,64,1552611600,31,9,40,Rain
12931,65,1552611600,39,1,40,Rain
12932,66,1552611600,13,27,40,Rain
12933,67,1552611600,1,39,40,Rain
12934,68,1552611600,37,3,40,Rain
12935,69,1552611600,40,0,40,Rain
12936,70,1552611600,11,17,28,Rain
12937,71,1552611600,39,1,40,Rain
12938,72,1552611600,12,13,25,Rain
12939,73,1552611600,19,11,30,Rain
12940,74,1552611600,20,10,30,Rain
12941,75,1552611600,24,16,40,Rain
12942,76,1552611600,19,19,38,Rain
12943,77,1552611600,20,9,29,Rain
12944,78,1552611600,27,13,40,Rain
12945,79,1552611600,12,15,27,Rain
12946,80,1552611600,34,6,40,Rain
12947,81,1552611600,39,1,40,Rain
12948,82,1552611600,12,10,22,Rain
12949,83,1552611600,20,20,40,Rain
12950,84,1552611600,6,24,30,Rain
12951,85,1552611600,10,25,35,Rain
12952,86,1552611600,1,37,38,Rain
12953,87,1552611600,20,18,38,Rain
12954,88,1552611600,0,30,30,Rain
12955,89,1552611600,40,0,40,Rain
12956,90,1552611600,40,0,40,Rain
12957,91,1552611600,6,24,30,Rain
12958,92,1552611600,8,32,40,Rain
12959,93,1552611600,0,40,40,Rain
12960,94,1552611600,15,25,40,Rain
12961,95,1552611600,25,15,40,Rain
12962,96,1552611600,17,13,30,Rain
12963,97,1552611600,22,18,40,Rain
12964,98,1552611600,40,0,40,Rain
12965,99,1552611600,26,4,30,Rain
12966,100,1552611600,10,15,25,Rain
12967,101,1552611600,12,18,30,Rain
12968,102,1552611600,4,36,40,Rain
12969,103,1552611600,40,0,40,Rain
12970,104,1552611600,40,0,40,Rain
12971,105,1552611600,26,10,36,Rain
12972,106,1552611600,33,7,40,Rain
12973,107,1552611600,30,10,40,Rain
12974,108,1552611600,31,9,40,Rain
12975,109,1552611600,6,23,29,Rain
12976,110,1552611600,30,10,40,Rain
12977,111,1552611600,12,28,40,Rain
12978,112,1552611600,0,30,30,Rain
12979,113,1552611600,38,2,40,Rain
12980,114,1552611600,39,1,40,Rain
12981,115,1552611600,0,30,30,Rain
12982,2,1552615200,5,15,20,Rain
12983,3,1552615200,13,7,20,Rain
12984,4,1552615200,19,1,20,Rain
12985,5,1552615200,24,16,40,Rain
12986,6,1552615200,13,7,20,Rain
12987,7,1552615200,17,12,29,Rain
12988,8,1552615200,17,13,30,Rain
12989,9,1552615200,24,0,24,Rain
12990,10,1552615200,10,6,16,Rain
12991,11,1552615200,30,0,30,Rain
12992,12,1552615200,11,9,20,Rain
12993,13,1552615200,30,0,30,Rain
12994,14,1552615200,28,2,30,Rain
12995,15,1552615200,9,7,16,Rain
12996,16,1552615200,19,1,20,Rain
12997,17,1552615200,20,0,20,Rain
12998,18,1552615200,18,12,30,Rain
12999,19,1552615200,23,7,30,Rain
13000,21,1552615200,24,5,29,Rain
13001,22,1552615200,10,10,20,Rain
13002,23,1552615200,22,8,30,Rain
13003,24,1552615200,12,8,20,Rain
13004,25,1552615200,29,0,29,Rain
13005,26,1552615200,17,3,20,Rain
13006,27,1552615200,20,0,20,Rain
13007,28,1552615200,16,14,30,Rain
13008,29,1552615200,18,11,29,Rain
13009,30,1552615200,19,1,20,Rain
13010,31,1552615200,18,2,20,Rain
13011,32,1552615200,7,23,30,Rain
13012,33,1552615200,9,14,23,Rain
13013,34,1552615200,1,29,30,Rain
13014,35,1552615200,28,2,30,Rain
13015,36,1552615200,36,4,40,Rain
13016,37,1552615200,30,0,30,Rain
13017,38,1552615200,14,26,40,Rain
13018,39,1552615200,14,6,20,Rain
13019,40,1552615200,17,4,21,Rain
13020,41,1552615200,16,4,20,Rain
13021,42,1552615200,2,28,30,Rain
13022,43,1552615200,0,30,30,Rain
13023,44,1552615200,6,24,30,Rain
13024,45,1552615200,1,29,30,Rain
13025,46,1552615200,16,4,20,Rain
13026,47,1552615200,40,0,40,Rain
13027,48,1552615200,38,2,40,Rain
13028,49,1552615200,19,21,40,Rain
13029,50,1552615200,3,37,40,Rain
13030,51,1552615200,40,0,40,Rain
13031,52,1552615200,29,3,32,Rain
13032,53,1552615200,34,6,40,Rain
13033,54,1552615200,33,0,33,Rain
13034,55,1552615200,36,0,36,Rain
13035,56,1552615200,34,6,40,Rain
13036,57,1552615200,21,2,23,Rain
13037,58,1552615200,33,7,40,Rain
13038,59,1552615200,18,2,20,Rain
13039,60,1552615200,4,26,30,Rain
13040,61,1552615200,21,4,25,Rain
13041,62,1552615200,40,0,40,Rain
13042,63,1552615200,35,0,35,Rain
13043,64,1552615200,32,8,40,Rain
13044,65,1552615200,40,0,40,Rain
13045,66,1552615200,13,27,40,Rain
13046,67,1552615200,2,38,40,Rain
13047,68,1552615200,37,3,40,Rain
13048,69,1552615200,39,1,40,Rain
13049,70,1552615200,9,19,28,Rain
13050,71,1552615200,39,1,40,Rain
13051,72,1552615200,13,12,25,Rain
13052,73,1552615200,19,11,30,Rain
13053,74,1552615200,21,9,30,Rain
13054,75,1552615200,23,17,40,Rain
13055,76,1552615200,17,21,38,Rain
13056,77,1552615200,19,10,29,Rain
13057,78,1552615200,26,14,40,Rain
13058,79,1552615200,12,15,27,Rain
13059,80,1552615200,34,6,40,Rain
13060,81,1552615200,39,1,40,Rain
13061,82,1552615200,12,10,22,Rain
13062,83,1552615200,20,20,40,Rain
13063,84,1552615200,5,25,30,Rain
13064,85,1552615200,10,25,35,Rain
13065,86,1552615200,3,35,38,Rain
13066,87,1552615200,20,18,38,Rain
13067,88,1552615200,1,29,30,Rain
13068,89,1552615200,40,0,40,Rain
13069,90,1552615200,40,0,40,Rain
13070,91,1552615200,6,24,30,Rain
13071,92,1552615200,8,32,40,Rain
13072,93,1552615200,0,40,40,Rain
13073,94,1552615200,15,25,40,Rain
13074,95,1552615200,24,16,40,Rain
13075,96,1552615200,17,13,30,Rain
13076,97,1552615200,21,19,40,Rain
13077,98,1552615200,40,0,40,Rain
13078,99,1552615200,26,4,30,Rain
13079,100,1552615200,10,15,25,Rain
13080,101,1552615200,11,19,30,Rain
13081,102,1552615200,4,36,40,Rain
13082,103,1552615200,40,0,40,Rain
13083,104,1552615200,40,0,40,Rain
13084,105,1552615200,25,11,36,Rain
13085,106,1552615200,33,7,40,Rain
13086,107,1552615200,30,10,40,Rain
13087,108,1552615200,30,10,40,Rain
13088,109,1552615200,5,24,29,Rain
13089,110,1552615200,29,11,40,Rain
13090,111,1552615200,11,29,40,Rain
13091,112,1552615200,0,30,30,Rain
13092,113,1552615200,39,1,40,Rain
13093,114,1552615200,39,1,40,Rain
13094,115,1552615200,0,30,30,Rain
13095,2,1552618800,5,15,20,Rain
13096,3,1552618800,13,7,20,Rain
13097,4,1552618800,19,1,20,Rain
13098,5,1552618800,24,16,40,Rain
13099,6,1552618800,13,7,20,Rain
13100,7,1552618800,17,12,29,Rain
13101,8,1552618800,17,13,30,Rain
13102,9,1552618800,24,0,24,Rain
13103,10,1552618800,10,6,16,Rain
13104,11,1552618800,30,0,30,Rain
13105,12,1552618800,11,9,20,Rain
13106,13,1552618800,30,0,30,Rain
13107,14,1552618800,28,2,30,Rain
13108,15,1552618800,9,7,16,Rain
13109,16,1552618800,19,1,20,Rain
13110,17,1552618800,20,0,20,Rain
13111,18,1552618800,18,12,30,Rain
13112,19,1552618800,23,7,30,Rain
13113,21,1552618800,24,5,29,Rain
13114,22,1552618800,10,10,20,Rain
13115,23,1552618800,22,8,30,Rain
13116,24,1552618800,12,8,20,Rain
13117,25,1552618800,29,0,29,Rain
13118,26,1552618800,17,3,20,Rain
13119,27,1552618800,20,0,20,Rain
13120,28,1552618800,13,17,30,Rain
13121,29,1552618800,18,11,29,Rain
13122,30,1552618800,19,1,20,Rain
13123,31,1552618800,18,2,20,Rain
13124,32,1552618800,7,23,30,Rain
13125,33,1552618800,9,14,23,Rain
13126,34,1552618800,1,29,30,Rain
13127,35,1552618800,28,2,30,Rain
13128,36,1552618800,36,4,40,Rain
13129,37,1552618800,30,0,30,Rain
13130,38,1552618800,14,26,40,Rain
13131,39,1552618800,14,6,20,Rain
13132,40,1552618800,17,4,21,Rain
13133,41,1552618800,16,4,20,Rain
13134,42,1552618800,2,28,30,Rain
13135,43,1552618800,0,30,30,Rain
13136,44,1552618800,6,24,30,Rain
13137,45,1552618800,1,29,30,Rain
13138,46,1552618800,16,4,20,Rain
13139,47,1552618800,40,0,40,Rain
13140,48,1552618800,38,2,40,Rain
13141,49,1552618800,19,21,40,Rain
13142,50,1552618800,3,37,40,Rain
13143,51,1552618800,40,0,40,Rain
13144,52,1552618800,29,3,32,Rain
13145,53,1552618800,34,6,40,Rain
13146,54,1552618800,33,0,33,Rain
13147,55,1552618800,36,0,36,Rain
13148,56,1552618800,34,6,40,Rain
13149,57,1552618800,21,2,23,Rain
13150,58,1552618800,33,7,40,Rain
13151,59,1552618800,18,2,20,Rain
13152,60,1552618800,4,26,30,Rain
13153,61,1552618800,21,4,25,Rain
13154,62,1552618800,40,0,40,Rain
13155,63,1552618800,35,0,35,Rain
13156,64,1552618800,32,8,40,Rain
13157,65,1552618800,40,0,40,Rain
13158,66,1552618800,12,28,40,Rain
13159,67,1552618800,2,38,40,Rain
13160,68,1552618800,37,3,40,Rain
13161,69,1552618800,39,1,40,Rain
13162,70,1552618800,9,19,28,Rain
13163,71,1552618800,39,1,40,Rain
13164,72,1552618800,13,12,25,Rain
13165,73,1552618800,19,11,30,Rain
13166,74,1552618800,21,9,30,Rain
13167,75,1552618800,23,17,40,Rain
13168,76,1552618800,17,21,38,Rain
13169,77,1552618800,19,10,29,Rain
13170,78,1552618800,26,14,40,Rain
13171,79,1552618800,12,15,27,Rain
13172,80,1552618800,34,6,40,Rain
13173,81,1552618800,39,1,40,Rain
13174,82,1552618800,12,10,22,Rain
13175,83,1552618800,20,20,40,Rain
13176,84,1552618800,5,25,30,Rain
13177,85,1552618800,10,25,35,Rain
13178,86,1552618800,3,35,38,Rain
13179,87,1552618800,20,18,38,Rain
13180,88,1552618800,1,29,30,Rain
13181,89,1552618800,40,0,40,Rain
13182,90,1552618800,40,0,40,Rain
13183,91,1552618800,6,24,30,Rain
13184,92,1552618800,8,32,40,Rain
13185,93,1552618800,0,40,40,Rain
13186,94,1552618800,15,25,40,Rain
13187,95,1552618800,24,16,40,Rain
13188,96,1552618800,17,13,30,Rain
13189,97,1552618800,21,19,40,Rain
13190,98,1552618800,40,0,40,Rain
13191,99,1552618800,26,4,30,Rain
13192,100,1552618800,10,15,25,Rain
13193,101,1552618800,11,19,30,Rain
13194,102,1552618800,4,36,40,Rain
13195,103,1552618800,40,0,40,Rain
13196,104,1552618800,40,0,40,Rain
13197,105,1552618800,25,11,36,Rain
13198,106,1552618800,33,7,40,Rain
13199,107,1552618800,29,11,40,Rain
13200,108,1552618800,30,10,40,Rain
13201,109,1552618800,5,24,29,Rain
13202,110,1552618800,29,11,40,Rain
13203,111,1552618800,11,29,40,Rain
13204,112,1552618800,0,30,30,Rain
13205,113,1552618800,39,1,40,Rain
13206,114,1552618800,39,1,40,Rain
13207,115,1552618800,0,30,30,Rain
13208,2,1552622400,5,15,20,Drizzle
13209,3,1552622400,13,7,20,Drizzle
13210,4,1552622400,19,1,20,Drizzle
13211,5,1552622400,24,16,40,Drizzle
13212,6,1552622400,13,7,20,Drizzle
13213,7,1552622400,17,12,29,Drizzle
13214,8,1552622400,17,13,30,Drizzle
13215,9,1552622400,24,0,24,Drizzle
13216,10,1552622400,10,6,16,Drizzle
13217,11,1552622400,30,0,30,Drizzle
13218,12,1552622400,11,9,20,Drizzle
13219,13,1552622400,30,0,30,Drizzle
13220,14,1552622400,28,2,30,Drizzle
13221,15,1552622400,9,7,16,Drizzle
13222,16,1552622400,19,1,20,Drizzle
13223,17,1552622400,20,0,20,Drizzle
13224,18,1552622400,18,12,30,Drizzle
13225,19,1552622400,23,7,30,Drizzle
13226,21,1552622400,24,5,29,Drizzle
13227,22,1552622400,10,10,20,Drizzle
13228,23,1552622400,22,8,30,Drizzle
13229,24,1552622400,12,8,20,Drizzle
13230,25,1552622400,29,0,29,Drizzle
13231,26,1552622400,17,3,20,Drizzle
13232,27,1552622400,20,0,20,Drizzle
13233,28,1552622400,13,17,30,Drizzle
13234,29,1552622400,18,11,29,Drizzle
13235,30,1552622400,19,1,20,Drizzle
13236,31,1552622400,18,2,20,Drizzle
13237,32,1552622400,7,23,30,Drizzle
13238,33,1552622400,9,14,23,Drizzle
13239,34,1552622400,1,29,30,Drizzle
13240,35,1552622400,28,2,30,Drizzle
13241,36,1552622400,36,4,40,Drizzle
13242,37,1552622400,30,0,30,Drizzle
13243,38,1552622400,14,26,40,Drizzle
13244,39,1552622400,14,6,20,Drizzle
13245,40,1552622400,17,4,21,Drizzle
13246,41,1552622400,16,4,20,Drizzle
13247,42,1552622400,2,28,30,Drizzle
13248,43,1552622400,0,30,30,Drizzle
13249,44,1552622400,6,24,30,Drizzle
13250,45,1552622400,1,29,30,Drizzle
13251,46,1552622400,16,4,20,Drizzle
13252,47,1552622400,40,0,40,Drizzle
13253,48,1552622400,38,2,40,Drizzle
13254,49,1552622400,19,21,40,Drizzle
13255,50,1552622400,3,37,40,Drizzle
13256,51,1552622400,40,0,40,Drizzle
13257,52,1552622400,29,3,32,Drizzle
13258,53,1552622400,34,6,40,Drizzle
13259,54,1552622400,33,0,33,Drizzle
13260,55,1552622400,36,0,36,Drizzle
13261,56,1552622400,34,6,40,Drizzle
13262,57,1552622400,21,2,23,Drizzle
13263,58,1552622400,33,7,40,Drizzle
13264,59,1552622400,18,2,20,Drizzle
13265,60,1552622400,4,26,30,Drizzle
13266,61,1552622400,21,4,25,Drizzle
13267,62,1552622400,40,0,40,Drizzle
13268,63,1552622400,35,0,35,Drizzle
13269,64,1552622400,32,8,40,Drizzle
13270,65,1552622400,40,0,40,Drizzle
13271,66,1552622400,12,28,40,Drizzle
13272,67,1552622400,2,38,40,Drizzle
13273,68,1552622400,37,3,40,Drizzle
13274,69,1552622400,39,1,40,Drizzle
13275,70,1552622400,9,19,28,Drizzle
13276,71,1552622400,39,1,40,Drizzle
13277,72,1552622400,13,12,25,Drizzle
13278,73,1552622400,19,11,30,Drizzle
13279,74,1552622400,21,9,30,Drizzle
13280,75,1552622400,23,17,40,Drizzle
13281,76,1552622400,17,21,38,Drizzle
13282,77,1552622400,19,10,29,Drizzle
13283,78,1552622400,26,14,40,Drizzle
13284,79,1552622400,12,15,27,Drizzle
13285,80,1552622400,34,6,40,Drizzle
13286,81,1552622400,39,1,40,Drizzle
13287,82,1552622400,12,10,22,Drizzle
13288,83,1552622400,20,20,40,Drizzle
13289,84,1552622400,5,25,30,Drizzle
13290,85,1552622400,10,25,35,Drizzle
13291,86,1552622400,3,35,38,Drizzle
13292,87,1552622400,20,18,38,Drizzle
13293,88,1552622400,1,29,30,Drizzle
13294,89,1552622400,40,0,40,Drizzle
13295,90,1552622400,40,0,40,Drizzle
13296,91,1552622400,6,24,30,Drizzle
13297,92,1552622400,8,32,40,Drizzle
13298,93,1552622400,0,40,40,Drizzle
13299,94,1552622400,15,25,40,Drizzle
13300,95,1552622400,24,16,40,Drizzle
13301,96,1552622400,17,13,30,Drizzle
13302,97,1552622400,21,19,40,Drizzle
13303,98,1552622400,40,0,40,Drizzle
13304,99,1552622400,26,4,30,Drizzle
13305,100,1552622400,10,15,25,Drizzle
13306,101,1552622400,11,19,30,Drizzle
13307,102,1552622400,4,36,40,Drizzle
13308,103,1552622400,40,0,40,Drizzle
13309,104,1552622400,40,0,40,Drizzle
13310,105,1552622400,25,11,36,Drizzle
13311,106,1552622400,33,7,40,Drizzle
13312,107,1552622400,29,11,40,Drizzle
13313,108,1552622400,30,10,40,Drizzle
13314,109,1552622400,5,24,29,Drizzle
13315,110,1552622400,29,11,40,Drizzle
13316,111,1552622400,11,29,40,Drizzle
13317,112,1552622400,0,30,30,Drizzle
13318,113,1552622400,39,1,40,Drizzle
13319,114,1552622400,39,1,40,Drizzle
13320,115,1552622400,0,30,30,Drizzle
13321,2,1552626000,5,15,20,Drizzle
13322,3,1552626000,13,7,20,Drizzle
13323,4,1552626000,19,1,20,Drizzle
13324,5,1552626000,24,16,40,Drizzle
13325,6,1552626000,13,7,20,Drizzle
13326,7,1552626000,17,12,29,Drizzle
13327,8,1552626000,17,13,30,Drizzle
13328,9,1552626000,24,0,24,Drizzle
13329,10,1552626000,10,6,16,Drizzle
13330,11,1552626000,30,0,30,Drizzle
13331,12,1552626000,11,9,20,Drizzle
13332,13,1552626000,30,0,30,Drizzle
13333,14,1552626000,28,2,30,Drizzle
13334,15,1552626000,9,7,16,Drizzle
13335,16,1552626000,19,1,20,Drizzle
13336,17,1552626000,20,0,20,Drizzle
13337,18,1552626000,18,12,30,Drizzle
13338,19,1552626000,23,7,30,Drizzle
13339,21,1552626000,24,5,29,Drizzle
13340,22,1552626000,10,10,20,Drizzle
13341,23,1552626000,22,8,30,Drizzle
13342,24,1552626000,12,8,20,Drizzle
13343,25,1552626000,29,0,29,Drizzle
13344,26,1552626000,17,3,20,Drizzle
13345,27,1552626000,20,0,20,Drizzle
13346,28,1552626000,13,17,30,Drizzle
13347,29,1552626000,17,12,29,Drizzle
13348,30,1552626000,19,1,20,Drizzle
13349,31,1552626000,18,2,20,Drizzle
13350,32,1552626000,7,23,30,Drizzle
13351,33,1552626000,9,14,23,Drizzle
13352,34,1552626000,1,29,30,Drizzle
13353,35,1552626000,28,2,30,Drizzle
13354,36,1552626000,36,4,40,Drizzle
13355,37,1552626000,30,0,30,Drizzle
13356,38,1552626000,14,26,40,Drizzle
13357,39,1552626000,14,6,20,Drizzle
13358,40,1552626000,17,4,21,Drizzle
13359,41,1552626000,16,4,20,Drizzle
13360,42,1552626000,2,28,30,Drizzle
13361,43,1552626000,0,30,30,Drizzle
13362,44,1552626000,6,24,30,Drizzle
13363,45,1552626000,1,29,30,Drizzle
13364,46,1552626000,16,4,20,Drizzle
13365,47,1552626000,40,0,40,Drizzle
13366,48,1552626000,38,2,40,Drizzle
13367,49,1552626000,19,21,40,Drizzle
13368,50,1552626000,3,37,40,Drizzle
13369,51,1552626000,40,0,40,Drizzle
13370,52,1552626000,29,3,32,Drizzle
13371,53,1552626000,34,6,40,Drizzle
13372,54,1552626000,33,0,33,Drizzle
13373,55,1552626000,36,0,36,Drizzle
13374,56,1552626000,34,6,40,Drizzle
13375,57,1552626000,21,2,23,Drizzle
13376,58,1552626000,33,7,40,Drizzle
13377,59,1552626000,18,2,20,Drizzle
13378,60,1552626000,4,26,30,Drizzle
13379,61,1552626000,21,4,25,Drizzle
13380,62,1552626000,40,0,40,Drizzle
13381,63,1552626000,35,0,35,Drizzle
13382,64,1552626000,32,8,40,Drizzle
13383,65,1552626000,40,0,40,Drizzle
13384,66,1552626000,12,28,40,Drizzle
13385,67,1552626000,2,38,40,Drizzle
13386,68,1552626000,37,3,40,Drizzle
13387,69,1552626000,39,1,40,Drizzle
13388,70,1552626000,9,19,28,Drizzle
13389,71,1552626000,39,1,40,Drizzle
13390,72,1552626000,13,12,25,Drizzle
13391,73,1552626000,19,11,30,Drizzle
13392,74,1552626000,21,9,30,Drizzle
13393,75,1552626000,23,17,40,Drizzle
13394,76,1552626000,17,21,38,Drizzle
13395,77,1552626000,19,10,29,Drizzle
13396,78,1552626000,26,14,40,Drizzle
13397,79,1552626000,12,15,27,Drizzle
13398,80,1552626000,34,6,40,Drizzle
13399,81,1552626000,39,1,40,Drizzle
13400,82,1552626000,12,10,22,Drizzle
13401,83,1552626000,20,20,40,Drizzle
13402,84,1552626000,5,25,30,Drizzle
13403,85,1552626000,10,25,35,Drizzle
13404,86,1552626000,3,35,38,Drizzle
13405,87,1552626000,20,18,38,Drizzle
13406,88,1552626000,1,29,30,Drizzle
13407,89,1552626000,40,0,40,Drizzle
13408,90,1552626000,40,0,40,Drizzle
13409,91,1552626000,6,24,30,Drizzle
13410,92,1552626000,8,32,40,Drizzle
13411,93,1552626000,0,40,40,Drizzle
13412,94,1552626000,15,25,40,Drizzle
13413,95,1552626000,24,16,40,Drizzle
13414,96,1552626000,17,13,30,Drizzle
13415,97,1552626000,21,19,40,Drizzle
13416,98,1552626000,40,0,40,Drizzle
13417,99,1552626000,26,4,30,Drizzle
13418,100,1552626000,10,15,25,Drizzle
13419,101,1552626000,11,19,30,Drizzle
13420,102,1552626000,4,36,40,Drizzle
13421,103,1552626000,40,0,40,Drizzle
13422,104,1552626000,40,0,40,Drizzle
13423,105,1552626000,25,11,36,Drizzle
13424,106,1552626000,33,7,40,Drizzle
13425,107,1552626000,29,11,40,Drizzle
13426,108,1552626000,30,10,40,Drizzle
13427,109,1552626000,5,24,29,Drizzle
13428,110,1552626000,29,11,40,Drizzle
13429,111,1552626000,11,29,40,Drizzle
13430,112,1552626000,0,30,30,Drizzle
13431,113,1552626000,39,1,40,Drizzle
13432,114,1552626000,39,1,40,Drizzle
13433,115,1552626000,0,30,30,Drizzle
13434,2,1552629600,5,15,20,Rain
13435,3,1552629600,13,7,20,Rain
13436,4,1552629600,19,1,20,Rain
13437,5,1552629600,24,16,40,Rain
13438,6,1552629600,13,7,20,Rain
13439,7,1552629600,17,12,29,Rain
13440,8,1552629600,17,13,30,Rain
13441,9,1552629600,24,0,24,Rain
13442,10,1552629600,10,6,16,Rain
13443,11,1552629600,30,0,30,Rain
13444,12,1552629600,11,9,20,Rain
13445,13,1552629600,30,0,30,Rain
13446,14,1552629600,28,2,30,Rain
13447,15,1552629600,9,7,16,Rain
13448,16,1552629600,19,1,20,Rain
13449,17,1552629600,20,0,20,Rain
13450,18,1552629600,18,12,30,Rain
13451,19,1552629600,23,7,30,Rain
13452,21,1552629600,24,5,29,Rain
13453,22,1552629600,10,10,20,Rain
13454,23,1552629600,22,8,30,Rain
13455,24,1552629600,12,8,20,Rain
13456,25,1552629600,29,0,29,Rain
13457,26,1552629600,17,3,20,Rain
13458,27,1552629600,20,0,20,Rain
13459,28,1552629600,13,17,30,Rain
13460,29,1552629600,17,12,29,Rain
13461,30,1552629600,19,1,20,Rain
13462,31,1552629600,18,2,20,Rain
13463,32,1552629600,7,23,30,Rain
13464,33,1552629600,9,14,23,Rain
13465,34,1552629600,1,29,30,Rain
13466,35,1552629600,28,2,30,Rain
13467,36,1552629600,36,4,40,Rain
13468,37,1552629600,30,0,30,Rain
13469,38,1552629600,14,26,40,Rain
13470,39,1552629600,14,6,20,Rain
13471,40,1552629600,17,4,21,Rain
13472,41,1552629600,16,4,20,Rain
13473,42,1552629600,2,28,30,Rain
13474,43,1552629600,0,30,30,Rain
13475,44,1552629600,6,24,30,Rain
13476,45,1552629600,1,29,30,Rain
13477,46,1552629600,16,4,20,Rain
13478,47,1552629600,40,0,40,Rain
13479,48,1552629600,38,2,40,Rain
13480,49,1552629600,19,21,40,Rain
13481,50,1552629600,3,37,40,Rain
13482,51,1552629600,40,0,40,Rain
13483,52,1552629600,29,3,32,Rain
13484,53,1552629600,34,6,40,Rain
13485,54,1552629600,33,0,33,Rain
13486,55,1552629600,36,0,36,Rain
13487,56,1552629600,34,6,40,Rain
13488,57,1552629600,21,2,23,Rain
13489,58,1552629600,33,7,40,Rain
13490,59,1552629600,18,2,20,Rain
13491,60,1552629600,4,26,30,Rain
13492,61,1552629600,21,4,25,Rain
13493,62,1552629600,40,0,40,Rain
13494,63,1552629600,35,0,35,Rain
13495,64,1552629600,32,8,40,Rain
13496,65,1552629600,40,0,40,Rain
13497,66,1552629600,12,28,40,Rain
13498,67,1552629600,2,38,40,Rain
13499,68,1552629600,37,3,40,Rain
13500,69,1552629600,39,1,40,Rain
13501,70,1552629600,9,19,28,Rain
13502,71,1552629600,39,1,40,Rain
13503,72,1552629600,13,12,25,Rain
13504,73,1552629600,19,11,30,Rain
13505,74,1552629600,21,9,30,Rain
13506,75,1552629600,23,17,40,Rain
13507,76,1552629600,17,21,38,Rain
13508,77,1552629600,19,10,29,Rain
13509,78,1552629600,26,14,40,Rain
13510,79,1552629600,12,15,27,Rain
13511,80,1552629600,34,6,40,Rain
13512,81,1552629600,39,1,40,Rain
13513,82,1552629600,12,10,22,Rain
13514,83,1552629600,20,20,40,Rain
13515,84,1552629600,5,25,30,Rain
13516,85,1552629600,10,25,35,Rain
13517,86,1552629600,3,35,38,Rain
13518,87,1552629600,20,18,38,Rain
13519,88,1552629600,1,29,30,Rain
13520,89,1552629600,40,0,40,Rain
13521,90,1552629600,40,0,40,Rain
13522,91,1552629600,6,24,30,Rain
13523,92,1552629600,8,32,40,Rain
13524,93,1552629600,0,40,40,Rain
13525,94,1552629600,15,25,40,Rain
13526,95,1552629600,24,16,40,Rain
13527,96,1552629600,17,13,30,Rain
13528,97,1552629600,21,19,40,Rain
13529,98,1552629600,40,0,40,Rain
13530,99,1552629600,26,4,30,Rain
13531,100,1552629600,10,15,25,Rain
13532,101,1552629600,11,19,30,Rain
13533,102,1552629600,4,36,40,Rain
13534,103,1552629600,40,0,40,Rain
13535,104,1552629600,40,0,40,Rain
13536,105,1552629600,25,11,36,Rain
13537,106,1552629600,33,7,40,Rain
13538,107,1552629600,29,11,40,Rain
13539,108,1552629600,30,10,40,Rain
13540,109,1552629600,5,24,29,Rain
13541,110,1552629600,29,11,40,Rain
13542,111,1552629600,11,29,40,Rain
13543,112,1552629600,0,30,30,Rain
13544,113,1552629600,39,1,40,Rain
13545,114,1552629600,39,1,40,Rain
13546,115,1552629600,0,30,30,Rain
13547,2,1552633200,6,14,20,Drizzle
13548,3,1552633200,13,7,20,Drizzle
13549,4,1552633200,20,0,20,Drizzle
13550,5,1552633200,6,34,40,Drizzle
13551,6,1552633200,14,6,20,Drizzle
13552,7,1552633200,18,11,29,Drizzle
13553,8,1552633200,18,12,30,Drizzle
13554,9,1552633200,23,1,24,Drizzle
13555,10,1552633200,9,7,16,Drizzle
13556,11,1552633200,30,0,30,Drizzle
13557,12,1552633200,13,7,20,Drizzle
13558,13,1552633200,30,0,30,Drizzle
13559,14,1552633200,22,8,30,Drizzle
13560,15,1552633200,11,5,16,Drizzle
13561,16,1552633200,19,1,20,Drizzle
13562,17,1552633200,19,1,20,Drizzle
13563,18,1552633200,21,9,30,Drizzle
13564,19,1552633200,20,10,30,Drizzle
13565,21,1552633200,24,6,30,Drizzle
13566,22,1552633200,8,12,20,Drizzle
13567,23,1552633200,22,8,30,Drizzle
13568,24,1552633200,7,13,20,Drizzle
13569,25,1552633200,27,2,29,Drizzle
13570,26,1552633200,15,5,20,Drizzle
13571,27,1552633200,19,1,20,Drizzle
13572,28,1552633200,16,14,30,Drizzle
13573,29,1552633200,17,12,29,Drizzle
13574,30,1552633200,19,1,20,Drizzle
13575,31,1552633200,6,14,20,Drizzle
13576,32,1552633200,28,2,30,Drizzle
13577,33,1552633200,1,22,23,Drizzle
13578,34,1552633200,4,26,30,Drizzle
13579,35,1552633200,28,2,30,Drizzle
13580,36,1552633200,34,6,40,Drizzle
13581,37,1552633200,30,0,30,Drizzle
13582,38,1552633200,15,25,40,Drizzle
13583,39,1552633200,15,5,20,Drizzle
13584,40,1552633200,16,5,21,Drizzle
13585,41,1552633200,17,3,20,Drizzle
13586,42,1552633200,5,25,30,Drizzle
13587,43,1552633200,3,27,30,Drizzle
13588,44,1552633200,11,19,30,Drizzle
13589,45,1552633200,1,29,30,Drizzle
13590,46,1552633200,17,3,20,Drizzle
13591,47,1552633200,39,1,40,Drizzle
13592,48,1552633200,35,5,40,Drizzle
13593,49,1552633200,34,6,40,Drizzle
13594,50,1552633200,7,33,40,Drizzle
13595,51,1552633200,38,2,40,Drizzle
13596,52,1552633200,21,11,32,Drizzle
13597,53,1552633200,33,7,40,Drizzle
13598,54,1552633200,32,1,33,Drizzle
13599,55,1552633200,36,0,36,Drizzle
13600,56,1552633200,37,3,40,Drizzle
13601,57,1552633200,20,3,23,Drizzle
13602,58,1552633200,31,9,40,Drizzle
13603,59,1552633200,18,2,20,Drizzle
13604,60,1552633200,10,20,30,Drizzle
13605,61,1552633200,22,3,25,Drizzle
13606,62,1552633200,39,1,40,Drizzle
13607,63,1552633200,34,1,35,Drizzle
13608,64,1552633200,34,6,40,Drizzle
13609,65,1552633200,40,0,40,Drizzle
13610,66,1552633200,29,11,40,Drizzle
13611,67,1552633200,21,19,40,Drizzle
13612,68,1552633200,33,7,40,Drizzle
13613,69,1552633200,37,3,40,Drizzle
13614,70,1552633200,22,6,28,Drizzle
13615,71,1552633200,38,2,40,Drizzle
13616,72,1552633200,13,12,25,Drizzle
13617,73,1552633200,22,8,30,Drizzle
13618,74,1552633200,21,9,30,Drizzle
13619,75,1552633200,23,17,40,Drizzle
13620,76,1552633200,20,18,38,Drizzle
13621,77,1552633200,20,9,29,Drizzle
13622,78,1552633200,29,11,40,Drizzle
13623,79,1552633200,12,15,27,Drizzle
13624,80,1552633200,37,3,40,Drizzle
13625,81,1552633200,39,1,40,Drizzle
13626,82,1552633200,10,12,22,Drizzle
13627,83,1552633200,3,37,40,Drizzle
13628,84,1552633200,12,18,30,Drizzle
13629,85,1552633200,11,24,35,Drizzle
13630,86,1552633200,3,35,38,Drizzle
13631,87,1552633200,21,17,38,Drizzle
13632,88,1552633200,1,29,30,Drizzle
13633,89,1552633200,40,0,40,Drizzle
13634,90,1552633200,40,0,40,Drizzle
13635,91,1552633200,8,22,30,Drizzle
13636,92,1552633200,12,28,40,Drizzle
13637,93,1552633200,0,40,40,Drizzle
13638,94,1552633200,15,25,40,Drizzle
13639,95,1552633200,23,17,40,Drizzle
13640,96,1552633200,17,13,30,Drizzle
13641,97,1552633200,25,15,40,Drizzle
13642,98,1552633200,40,0,40,Drizzle
13643,99,1552633200,24,6,30,Drizzle
13644,100,1552633200,8,17,25,Drizzle
13645,101,1552633200,12,18,30,Drizzle
13646,102,1552633200,4,36,40,Drizzle
13647,103,1552633200,40,0,40,Drizzle
13648,104,1552633200,40,0,40,Drizzle
13649,105,1552633200,26,10,36,Drizzle
13650,106,1552633200,33,7,40,Drizzle
13651,107,1552633200,33,7,40,Drizzle
13652,108,1552633200,32,8,40,Drizzle
13653,109,1552633200,11,18,29,Drizzle
13654,110,1552633200,29,11,40,Drizzle
13655,111,1552633200,12,28,40,Drizzle
13656,112,1552633200,3,27,30,Drizzle
13657,113,1552633200,39,1,40,Drizzle
13658,114,1552633200,38,2,40,Drizzle
13659,115,1552633200,0,30,30,Drizzle
13660,2,1552636800,7,13,20,Drizzle
13661,3,1552636800,12,8,20,Drizzle
13662,4,1552636800,19,1,20,Drizzle
13663,5,1552636800,18,22,40,Drizzle
13664,6,1552636800,15,5,20,Drizzle
13665,7,1552636800,19,10,29,Drizzle
13666,8,1552636800,11,19,30,Drizzle
13667,9,1552636800,10,14,24,Drizzle
13668,10,1552636800,9,7,16,Drizzle
13669,11,1552636800,28,2,30,Drizzle
13670,12,1552636800,7,13,20,Drizzle
13671,13,1552636800,29,1,30,Drizzle
13672,14,1552636800,22,8,30,Drizzle
13673,15,1552636800,12,4,16,Drizzle
13674,16,1552636800,18,2,20,Drizzle
13675,17,1552636800,19,1,20,Drizzle
13676,18,1552636800,1,29,30,Drizzle
13677,19,1552636800,24,6,30,Drizzle
13678,21,1552636800,22,8,30,Drizzle
13679,22,1552636800,20,0,20,Drizzle
13680,23,1552636800,22,8,30,Drizzle
13681,24,1552636800,6,14,20,Drizzle
13682,25,1552636800,23,6,29,Drizzle
13683,26,1552636800,10,10,20,Drizzle
13684,27,1552636800,17,3,20,Drizzle
13685,28,1552636800,22,8,30,Drizzle
13686,29,1552636800,21,8,29,Drizzle
13687,30,1552636800,14,6,20,Drizzle
13688,31,1552636800,5,15,20,Drizzle
13689,32,1552636800,23,7,30,Drizzle
13690,33,1552636800,1,22,23,Drizzle
13691,34,1552636800,23,7,30,Drizzle
13692,35,1552636800,30,0,30,Drizzle
13693,36,1552636800,32,8,40,Drizzle
13694,37,1552636800,29,1,30,Drizzle
13695,38,1552636800,1,39,40,Drizzle
13696,39,1552636800,12,8,20,Drizzle
13697,40,1552636800,15,6,21,Drizzle
13698,41,1552636800,17,3,20,Drizzle
13699,42,1552636800,12,18,30,Drizzle
13700,43,1552636800,19,11,30,Drizzle
13701,44,1552636800,23,7,30,Drizzle
13702,45,1552636800,6,24,30,Drizzle
13703,46,1552636800,14,6,20,Drizzle
13704,47,1552636800,38,2,40,Drizzle
13705,48,1552636800,34,6,40,Drizzle
13706,49,1552636800,36,4,40,Drizzle
13707,50,1552636800,17,23,40,Drizzle
13708,51,1552636800,33,7,40,Drizzle
13709,52,1552636800,30,2,32,Drizzle
13710,53,1552636800,32,8,40,Drizzle
13711,54,1552636800,29,4,33,Drizzle
13712,55,1552636800,32,4,36,Drizzle
13713,56,1552636800,39,1,40,Drizzle
13714,57,1552636800,21,2,23,Drizzle
13715,58,1552636800,27,13,40,Drizzle
13716,59,1552636800,18,2,20,Drizzle
13717,60,1552636800,21,9,30,Drizzle
13718,61,1552636800,9,16,25,Drizzle
13719,62,1552636800,37,3,40,Drizzle
13720,63,1552636800,33,2,35,Drizzle
13721,64,1552636800,34,6,40,Drizzle
13722,65,1552636800,38,2,40,Drizzle
13723,66,1552636800,20,20,40,Drizzle
13724,67,1552636800,19,21,40,Drizzle
13725,68,1552636800,18,22,40,Drizzle
13726,69,1552636800,24,16,40,Drizzle
13727,70,1552636800,16,12,28,Drizzle
13728,71,1552636800,40,0,40,Drizzle
13729,72,1552636800,18,7,25,Drizzle
13730,73,1552636800,26,4,30,Drizzle
13731,74,1552636800,21,9,30,Drizzle
13732,75,1552636800,21,19,40,Drizzle
13733,76,1552636800,24,14,38,Drizzle
13734,77,1552636800,20,9,29,Drizzle
13735,78,1552636800,29,11,40,Drizzle
13736,79,1552636800,12,15,27,Drizzle
13737,80,1552636800,37,3,40,Drizzle
13738,81,1552636800,38,2,40,Drizzle
13739,82,1552636800,11,11,22,Drizzle
13740,83,1552636800,4,36,40,Drizzle
13741,84,1552636800,16,14,30,Drizzle
13742,85,1552636800,13,22,35,Drizzle
13743,86,1552636800,6,32,38,Drizzle
13744,87,1552636800,22,16,38,Drizzle
13745,88,1552636800,2,28,30,Drizzle
13746,89,1552636800,40,0,40,Drizzle
13747,90,1552636800,28,12,40,Drizzle
13748,91,1552636800,26,4,30,Drizzle
13749,92,1552636800,14,26,40,Drizzle
13750,93,1552636800,2,38,40,Drizzle
13751,94,1552636800,16,24,40,Drizzle
13752,95,1552636800,6,34,40,Drizzle
13753,96,1552636800,18,12,30,Drizzle
13754,97,1552636800,31,9,40,Drizzle
13755,98,1552636800,38,2,40,Drizzle
13756,99,1552636800,20,10,30,Drizzle
13757,100,1552636800,11,14,25,Drizzle
13758,101,1552636800,18,12,30,Drizzle
13759,102,1552636800,7,33,40,Drizzle
13760,103,1552636800,40,0,40,Drizzle
13761,104,1552636800,40,0,40,Drizzle
13762,105,1552636800,27,9,36,Drizzle
13763,106,1552636800,34,6,40,Drizzle
13764,107,1552636800,33,7,40,Drizzle
13765,108,1552636800,37,3,40,Drizzle
13766,109,1552636800,19,10,29,Drizzle
13767,110,1552636800,34,6,40,Drizzle
13768,111,1552636800,15,25,40,Drizzle
13769,112,1552636800,19,11,30,Drizzle
13770,113,1552636800,38,2,40,Drizzle
13771,114,1552636800,33,7,40,Drizzle
13772,115,1552636800,3,27,30,Drizzle
13773,2,1552640400,14,6,20,Clouds
13774,3,1552640400,19,1,20,Clouds
13775,4,1552640400,19,1,20,Clouds
13776,5,1552640400,33,7,40,Clouds
13777,6,1552640400,18,2,20,Clouds
13778,7,1552640400,24,5,29,Clouds
13779,8,1552640400,17,13,30,Clouds
13780,9,1552640400,17,7,24,Clouds
13781,10,1552640400,4,12,16,Clouds
13782,11,1552640400,23,7,30,Clouds
13783,12,1552640400,9,11,20,Clouds
13784,13,1552640400,24,6,30,Clouds
13785,14,1552640400,19,11,30,Clouds
13786,15,1552640400,12,4,16,Clouds
13787,16,1552640400,17,3,20,Clouds
13788,17,1552640400,19,1,20,Clouds
13789,18,1552640400,2,28,30,Clouds
13790,19,1552640400,18,12,30,Clouds
13791,21,1552640400,15,15,30,Clouds
13792,22,1552640400,11,9,20,Clouds
13793,23,1552640400,27,3,30,Clouds
13794,24,1552640400,10,10,20,Clouds
13795,25,1552640400,9,20,29,Clouds
13796,26,1552640400,7,13,20,Clouds
13797,27,1552640400,3,17,20,Clouds
13798,28,1552640400,30,0,30,Clouds
13799,29,1552640400,27,2,29,Clouds
13800,30,1552640400,12,8,20,Clouds
13801,31,1552640400,5,15,20,Clouds
13802,32,1552640400,22,8,30,Clouds
13803,33,1552640400,2,21,23,Clouds
13804,34,1552640400,30,0,30,Clouds
13805,35,1552640400,29,1,30,Clouds
13806,36,1552640400,26,14,40,Clouds
13807,37,1552640400,27,3,30,Clouds
13808,38,1552640400,3,37,40,Clouds
13809,39,1552640400,18,2,20,Clouds
13810,40,1552640400,4,17,21,Clouds
13811,41,1552640400,13,7,20,Clouds
13812,42,1552640400,30,0,30,Clouds
13813,43,1552640400,30,0,30,Clouds
13814,44,1552640400,28,2,30,Clouds
13815,45,1552640400,5,25,30,Clouds
13816,46,1552640400,14,6,20,Clouds
13817,47,1552640400,33,7,40,Clouds
13818,48,1552640400,33,6,39,Clouds
13819,49,1552640400,34,6,40,Clouds
13820,50,1552640400,35,5,40,Clouds
13821,51,1552640400,31,9,40,Clouds
13822,52,1552640400,19,13,32,Clouds
13823,53,1552640400,24,16,40,Clouds
13824,54,1552640400,27,6,33,Clouds
13825,55,1552640400,27,9,36,Clouds
13826,56,1552640400,25,15,40,Clouds
13827,57,1552640400,19,4,23,Clouds
13828,58,1552640400,24,16,40,Clouds
13829,59,1552640400,15,5,20,Clouds
13830,60,1552640400,16,14,30,Clouds
13831,61,1552640400,13,12,25,Clouds
13832,62,1552640400,35,5,40,Clouds
13833,63,1552640400,24,10,34,Clouds
13834,64,1552640400,28,12,40,Clouds
13835,65,1552640400,32,8,40,Clouds
13836,66,1552640400,6,34,40,Clouds
13837,67,1552640400,10,30,40,Clouds
13838,68,1552640400,20,20,40,Clouds
13839,69,1552640400,10,30,40,Clouds
13840,70,1552640400,14,14,28,Clouds
13841,71,1552640400,33,7,40,Clouds
13842,72,1552640400,6,19,25,Clouds
13843,73,1552640400,30,0,30,Clouds
13844,74,1552640400,26,4,30,Clouds
13845,75,1552640400,31,9,40,Clouds
13846,76,1552640400,31,7,38,Clouds
13847,77,1552640400,29,0,29,Clouds
13848,78,1552640400,31,9,40,Clouds
13849,79,1552640400,13,14,27,Clouds
13850,80,1552640400,34,6,40,Clouds
13851,81,1552640400,35,5,40,Clouds
13852,82,1552640400,15,7,22,Clouds
13853,83,1552640400,13,27,40,Clouds
13854,84,1552640400,25,4,29,Clouds
13855,85,1552640400,29,6,35,Clouds
13856,86,1552640400,21,17,38,Clouds
13857,87,1552640400,27,11,38,Clouds
13858,88,1552640400,10,20,30,Clouds
13859,89,1552640400,39,1,40,Clouds
13860,90,1552640400,9,29,38,Clouds
13861,91,1552640400,19,11,30,Clouds
13862,92,1552640400,21,19,40,Clouds
13863,93,1552640400,18,22,40,Clouds
13864,94,1552640400,24,16,40,Clouds
13865,95,1552640400,30,10,40,Clouds
13866,96,1552640400,23,7,30,Clouds
13867,97,1552640400,40,0,40,Clouds
13868,98,1552640400,34,6,40,Clouds
13869,99,1552640400,23,7,30,Clouds
13870,100,1552640400,24,1,25,Clouds
13871,101,1552640400,25,5,30,Clouds
13872,102,1552640400,14,26,40,Clouds
13873,103,1552640400,39,1,40,Clouds
13874,104,1552640400,40,0,40,Clouds
13875,105,1552640400,29,7,36,Clouds
13876,106,1552640400,40,0,40,Clouds
13877,107,1552640400,40,0,40,Clouds
13878,108,1552640400,38,2,40,Clouds
13879,109,1552640400,28,1,29,Clouds
13880,110,1552640400,35,5,40,Clouds
13881,111,1552640400,27,13,40,Clouds
13882,112,1552640400,30,0,30,Clouds
13883,113,1552640400,34,6,40,Clouds
13884,114,1552640400,26,14,40,Clouds
13885,115,1552640400,11,19,30,Clouds
13886,2,1552644000,20,0,20,Clouds
13887,3,1552644000,16,4,20,Clouds
13888,4,1552644000,19,1,20,Clouds
13889,5,1552644000,40,0,40,Clouds
13890,6,1552644000,18,2,20,Clouds
13891,7,1552644000,29,0,29,Clouds
13892,8,1552644000,17,13,30,Clouds
13893,9,1552644000,4,20,24,Clouds
13894,10,1552644000,9,7,16,Clouds
13895,11,1552644000,8,22,30,Clouds
13896,12,1552644000,19,1,20,Clouds
13897,13,1552644000,10,20,30,Clouds
13898,14,1552644000,14,16,30,Clouds
13899,15,1552644000,14,2,16,Clouds
13900,16,1552644000,13,7,20,Clouds
13901,17,1552644000,18,2,20,Clouds
13902,18,1552644000,22,8,30,Clouds
13903,19,1552644000,13,17,30,Clouds
13904,21,1552644000,0,30,30,Clouds
13905,22,1552644000,13,6,19,Clouds
13906,23,1552644000,27,3,30,Clouds
13907,24,1552644000,11,9,20,Clouds
13908,25,1552644000,16,13,29,Clouds
13909,26,1552644000,12,8,20,Clouds
13910,27,1552644000,3,17,20,Clouds
13911,28,1552644000,30,0,30,Clouds
13912,29,1552644000,27,2,29,Clouds
13913,30,1552644000,14,6,20,Clouds
13914,31,1552644000,7,13,20,Clouds
13915,32,1552644000,25,5,30,Clouds
13916,33,1552644000,2,21,23,Clouds
13917,34,1552644000,30,0,30,Clouds
13918,35,1552644000,30,0,30,Clouds
13919,36,1552644000,12,28,40,Clouds
13920,37,1552644000,27,3,30,Clouds
13921,38,1552644000,7,33,40,Clouds
13922,39,1552644000,19,1,20,Clouds
13923,40,1552644000,3,18,21,Clouds
13924,41,1552644000,16,4,20,Clouds
13925,42,1552644000,30,0,30,Clouds
13926,43,1552644000,30,0,30,Clouds
13927,44,1552644000,30,0,30,Clouds
13928,45,1552644000,20,10,30,Clouds
13929,46,1552644000,15,5,20,Clouds
13930,47,1552644000,2,38,40,Clouds
13931,48,1552644000,30,9,39,Clouds
13932,49,1552644000,32,8,40,Clouds
13933,50,1552644000,39,1,40,Clouds
13934,51,1552644000,29,11,40,Clouds
13935,52,1552644000,2,30,32,Clouds
13936,53,1552644000,30,10,40,Clouds
13937,54,1552644000,22,11,33,Clouds
13938,55,1552644000,11,25,36,Clouds
13939,56,1552644000,0,40,40,Clouds
13940,57,1552644000,8,15,23,Clouds
13941,58,1552644000,0,39,39,Clouds
13942,59,1552644000,18,2,20,Clouds
13943,60,1552644000,30,0,30,Clouds
13944,61,1552644000,25,0,25,Clouds
13945,62,1552644000,11,29,40,Clouds
13946,63,1552644000,12,22,34,Clouds
13947,64,1552644000,12,28,40,Clouds
13948,65,1552644000,29,11,40,Clouds
13949,66,1552644000,1,39,40,Clouds
13950,67,1552644000,12,28,40,Clouds
13951,68,1552644000,8,32,40,Clouds
13952,69,1552644000,1,39,40,Clouds
13953,70,1552644000,8,20,28,Clouds
13954,71,1552644000,37,3,40,Clouds
13955,72,1552644000,25,0,25,Clouds
13956,73,1552644000,29,1,30,Clouds
13957,74,1552644000,30,0,30,Clouds
13958,75,1552644000,39,1,40,Clouds
13959,76,1552644000,38,0,38,Clouds
13960,77,1552644000,27,2,29,Clouds
13961,78,1552644000,40,0,40,Clouds
13962,79,1552644000,26,1,27,Clouds
13963,80,1552644000,38,2,40,Clouds
13964,81,1552644000,40,0,40,Clouds
13965,82,1552644000,22,0,22,Clouds
13966,83,1552644000,40,0,40,Clouds
13967,84,1552644000,29,0,29,Clouds
13968,85,1552644000,35,0,35,Clouds
13969,86,1552644000,38,0,38,Clouds
13970,87,1552644000,38,0,38,Clouds
13971,88,1552644000,29,1,30,Clouds
13972,89,1552644000,35,4,39,Clouds
13973,90,1552644000,1,37,38,Clouds
13974,91,1552644000,19,11,30,Clouds
13975,92,1552644000,40,0,40,Clouds
13976,93,1552644000,40,0,40,Clouds
13977,94,1552644000,39,1,40,Clouds
13978,95,1552644000,40,0,40,Clouds
13979,96,1552644000,30,0,30,Clouds
13980,97,1552644000,40,0,40,Clouds
13981,98,1552644000,31,9,40,Clouds
13982,99,1552644000,8,22,30,Clouds
13983,100,1552644000,25,0,25,Clouds
13984,101,1552644000,30,0,30,Clouds
13985,102,1552644000,19,21,40,Clouds
13986,103,1552644000,38,2,40,Clouds
13987,104,1552644000,40,0,40,Clouds
13988,105,1552644000,36,0,36,Clouds
13989,106,1552644000,40,0,40,Clouds
13990,107,1552644000,40,0,40,Clouds
13991,108,1552644000,40,0,40,Clouds
13992,109,1552644000,29,0,29,Clouds
13993,110,1552644000,40,0,40,Clouds
13994,111,1552644000,38,2,40,Clouds
13995,112,1552644000,30,0,30,Clouds
13996,113,1552644000,28,12,40,Clouds
13997,114,1552644000,19,21,40,Clouds
13998,115,1552644000,30,0,30,Clouds
13999,2,1552647600,19,1,20,Rain
14000,3,1552647600,13,7,20,Rain
14001,4,1552647600,18,2,20,Rain
14002,5,1552647600,34,6,40,Rain
14003,6,1552647600,20,0,20,Rain
14004,7,1552647600,29,0,29,Rain
14005,8,1552647600,14,16,30,Rain
14006,9,1552647600,1,23,24,Rain
14007,10,1552647600,13,3,16,Rain
14008,11,1552647600,3,27,30,Rain
14009,12,1552647600,20,0,20,Rain
14010,13,1552647600,7,23,30,Rain
14011,14,1552647600,11,19,30,Rain
14012,15,1552647600,15,1,16,Rain
14013,16,1552647600,13,7,20,Rain
14014,17,1552647600,18,2,20,Rain
14015,18,1552647600,29,1,30,Rain
14016,19,1552647600,8,22,30,Rain
14017,21,1552647600,0,30,30,Rain
14018,22,1552647600,15,5,20,Rain
14019,23,1552647600,26,4,30,Rain
14020,24,1552647600,19,1,20,Rain
14021,25,1552647600,17,13,30,Rain
14022,26,1552647600,4,16,20,Rain
14023,27,1552647600,0,20,20,Rain
14024,28,1552647600,29,1,30,Rain
14025,29,1552647600,29,0,29,Rain
14026,30,1552647600,17,3,20,Rain
14027,31,1552647600,7,13,20,Rain
14028,32,1552647600,12,18,30,Rain
14029,33,1552647600,8,15,23,Rain
14030,34,1552647600,30,0,30,Rain
14031,35,1552647600,28,2,30,Rain
14032,36,1552647600,4,36,40,Rain
14033,37,1552647600,25,5,30,Rain
14034,38,1552647600,13,27,40,Rain
14035,39,1552647600,18,2,20,Rain
14036,40,1552647600,4,17,21,Rain
14037,41,1552647600,17,3,20,Rain
14038,42,1552647600,30,0,30,Rain
14039,43,1552647600,30,0,30,Rain
14040,44,1552647600,30,0,30,Rain
14041,45,1552647600,27,3,30,Rain
14042,46,1552647600,16,4,20,Rain
14043,47,1552647600,0,40,40,Rain
14044,48,1552647600,17,22,39,Rain
14045,49,1552647600,15,25,40,Rain
14046,50,1552647600,39,1,40,Rain
14047,51,1552647600,26,14,40,Rain
14048,52,1552647600,0,32,32,Rain
14049,53,1552647600,24,16,40,Rain
14050,54,1552647600,12,21,33,Rain
14051,55,1552647600,6,30,36,Rain
14052,56,1552647600,9,31,40,Rain
14053,57,1552647600,0,23,23,Rain
14054,58,1552647600,0,40,40,Rain
14055,59,1552647600,20,0,20,Rain
14056,60,1552647600,29,1,30,Rain
14057,61,1552647600,18,7,25,Rain
14058,62,1552647600,2,38,40,Rain
14059,63,1552647600,0,34,34,Rain
14060,64,1552647600,3,37,40,Rain
14061,65,1552647600,9,31,40,Rain
14062,66,1552647600,0,40,40,Rain
14063,67,1552647600,14,26,40,Rain
14064,68,1552647600,11,29,40,Rain
14065,69,1552647600,0,40,40,Rain
14066,70,1552647600,5,23,28,Rain
14067,71,1552647600,39,1,40,Rain
14068,72,1552647600,24,1,25,Rain
14069,73,1552647600,28,2,30,Rain
14070,74,1552647600,29,1,30,Rain
14071,75,1552647600,40,0,40,Rain
14072,76,1552647600,38,0,38,Rain
14073,77,1552647600,27,2,29,Rain
14074,78,1552647600,39,1,40,Rain
14075,79,1552647600,26,1,27,Rain
14076,80,1552647600,40,0,40,Rain
14077,81,1552647600,40,0,40,Rain
14078,82,1552647600,22,0,22,Rain
14079,83,1552647600,40,0,40,Rain
14080,84,1552647600,29,0,29,Rain
14081,85,1552647600,35,0,35,Rain
14082,86,1552647600,38,0,38,Rain
14083,87,1552647600,38,0,38,Rain
14084,88,1552647600,30,0,30,Rain
14085,89,1552647600,26,14,40,Rain
14086,90,1552647600,1,37,38,Rain
14087,91,1552647600,9,21,30,Rain
14088,92,1552647600,40,0,40,Rain
14089,93,1552647600,40,0,40,Rain
14090,94,1552647600,39,1,40,Rain
14091,95,1552647600,40,0,40,Rain
14092,96,1552647600,30,0,30,Rain
14093,97,1552647600,39,1,40,Rain
14094,98,1552647600,14,26,40,Rain
14095,99,1552647600,6,24,30,Rain
14096,100,1552647600,25,0,25,Rain
14097,101,1552647600,30,0,30,Rain
14098,102,1552647600,26,14,40,Rain
14099,103,1552647600,38,2,40,Rain
14100,104,1552647600,40,0,40,Rain
14101,105,1552647600,36,0,36,Rain
14102,106,1552647600,40,0,40,Rain
14103,107,1552647600,40,0,40,Rain
14104,108,1552647600,39,1,40,Rain
14105,109,1552647600,28,1,29,Rain
14106,110,1552647600,39,1,40,Rain
14107,111,1552647600,39,1,40,Rain
14108,112,1552647600,30,0,30,Rain
14109,113,1552647600,20,0,20,Rain
14110,114,1552647600,7,33,40,Rain
14111,115,1552647600,30,0,30,Rain
14112,2,1552651200,20,0,20,Clouds
14113,3,1552651200,19,1,20,Clouds
14114,4,1552651200,19,1,20,Clouds
14115,5,1552651200,40,0,40,Clouds
14116,6,1552651200,18,2,20,Clouds
14117,7,1552651200,29,0,29,Clouds
14118,8,1552651200,13,17,30,Clouds
14119,9,1552651200,0,24,24,Clouds
14120,10,1552651200,11,5,16,Clouds
14121,11,1552651200,0,29,29,Clouds
14122,12,1552651200,17,3,20,Clouds
14123,13,1552651200,9,21,30,Clouds
14124,14,1552651200,13,17,30,Clouds
14125,15,1552651200,15,1,16,Clouds
14126,16,1552651200,10,10,20,Clouds
14127,17,1552651200,17,3,20,Clouds
14128,18,1552651200,30,0,30,Clouds
14129,19,1552651200,1,29,30,Clouds
14130,21,1552651200,0,30,30,Clouds
14131,22,1552651200,18,2,20,Clouds
14132,23,1552651200,24,6,30,Clouds
14133,24,1552651200,19,1,20,Clouds
14134,25,1552651200,15,15,30,Clouds
14135,26,1552651200,2,18,20,Clouds
14136,27,1552651200,2,18,20,Clouds
14137,28,1552651200,30,0,30,Clouds
14138,29,1552651200,26,3,29,Clouds
14139,30,1552651200,19,1,20,Clouds
14140,31,1552651200,9,11,20,Clouds
14141,32,1552651200,7,23,30,Clouds
14142,33,1552651200,10,13,23,Clouds
14143,34,1552651200,29,1,30,Clouds
14144,35,1552651200,27,3,30,Clouds
14145,36,1552651200,5,35,40,Clouds
14146,37,1552651200,24,6,30,Clouds
14147,38,1552651200,10,30,40,Clouds
14148,39,1552651200,20,0,20,Clouds
14149,40,1552651200,6,15,21,Clouds
14150,41,1552651200,18,2,20,Clouds
14151,42,1552651200,29,1,30,Clouds
14152,43,1552651200,30,0,30,Clouds
14153,44,1552651200,29,1,30,Clouds
14154,45,1552651200,29,1,30,Clouds
14155,46,1552651200,19,1,20,Clouds
14156,47,1552651200,0,40,40,Clouds
14157,48,1552651200,7,32,39,Clouds
14158,49,1552651200,11,29,40,Clouds
14159,50,1552651200,39,1,40,Clouds
14160,51,1552651200,23,17,40,Clouds
14161,52,1552651200,0,32,32,Clouds
14162,53,1552651200,22,18,40,Clouds
14163,54,1552651200,14,19,33,Clouds
14164,55,1552651200,4,32,36,Clouds
14165,56,1552651200,14,26,40,Clouds
14166,57,1552651200,0,23,23,Clouds
14167,58,1552651200,5,35,40,Clouds
14168,59,1552651200,18,2,20,Clouds
14169,60,1552651200,25,5,30,Clouds
14170,61,1552651200,23,2,25,Clouds
14171,62,1552651200,0,40,40,Clouds
14172,63,1552651200,0,34,34,Clouds
14173,64,1552651200,0,40,40,Clouds
14174,65,1552651200,3,37,40,Clouds
14175,66,1552651200,5,35,40,Clouds
14176,67,1552651200,16,24,40,Clouds
14177,68,1552651200,1,39,40,Clouds
14178,69,1552651200,1,39,40,Clouds
14179,70,1552651200,10,18,28,Clouds
14180,71,1552651200,40,0,40,Clouds
14181,72,1552651200,29,1,30,Clouds
14182,73,1552651200,30,0,30,Clouds
14183,74,1552651200,30,0,30,Clouds
14184,75,1552651200,40,0,40,Clouds
14185,76,1552651200,38,0,38,Clouds
14186,77,1552651200,26,3,29,Clouds
14187,78,1552651200,23,17,40,Clouds
14188,79,1552651200,27,0,27,Clouds
14189,80,1552651200,38,2,40,Clouds
14190,81,1552651200,40,0,40,Clouds
14191,82,1552651200,22,0,22,Clouds
14192,83,1552651200,40,0,40,Clouds
14193,84,1552651200,27,2,29,Clouds
14194,85,1552651200,35,0,35,Clouds
14195,86,1552651200,38,0,38,Clouds
14196,87,1552651200,38,0,38,Clouds
14197,88,1552651200,29,1,30,Clouds
14198,89,1552651200,25,15,40,Clouds
14199,90,1552651200,1,37,38,Clouds
14200,91,1552651200,11,19,30,Clouds
14201,92,1552651200,40,0,40,Clouds
14202,93,1552651200,40,0,40,Clouds
14203,94,1552651200,40,0,40,Clouds
14204,95,1552651200,40,0,40,Clouds
14205,96,1552651200,30,0,30,Clouds
14206,97,1552651200,40,0,40,Clouds
14207,98,1552651200,14,26,40,Clouds
14208,99,1552651200,1,29,30,Clouds
14209,100,1552651200,25,0,25,Clouds
14210,101,1552651200,30,0,30,Clouds
14211,102,1552651200,31,9,40,Clouds
14212,103,1552651200,40,0,40,Clouds
14213,104,1552651200,40,0,40,Clouds
14214,105,1552651200,36,0,36,Clouds
14215,106,1552651200,40,0,40,Clouds
14216,107,1552651200,40,0,40,Clouds
14217,108,1552651200,40,0,40,Clouds
14218,109,1552651200,29,0,29,Clouds
14219,110,1552651200,39,1,40,Clouds
14220,111,1552651200,40,0,40,Clouds
14221,112,1552651200,24,6,30,Clouds
14222,113,1552651200,0,0,0,Clouds
14223,114,1552651200,3,37,40,Clouds
14224,115,1552651200,23,7,30,Clouds
14225,2,1552654800,20,0,20,Clouds
14226,3,1552654800,17,3,20,Clouds
14227,4,1552654800,17,3,20,Clouds
14228,5,1552654800,39,1,40,Clouds
14229,6,1552654800,20,0,20,Clouds
14230,7,1552654800,29,0,29,Clouds
14231,8,1552654800,16,14,30,Clouds
14232,9,1552654800,2,21,23,Clouds
14233,10,1552654800,16,0,16,Clouds
14234,11,1552654800,1,29,30,Clouds
14235,12,1552654800,20,0,20,Clouds
14236,13,1552654800,13,17,30,Clouds
14237,14,1552654800,3,27,30,Clouds
14238,15,1552654800,15,1,16,Clouds
14239,16,1552654800,11,9,20,Clouds
14240,17,1552654800,15,5,20,Clouds
14241,18,1552654800,28,2,30,Clouds
14242,19,1552654800,1,29,30,Clouds
14243,21,1552654800,2,28,30,Clouds
14244,22,1552654800,16,4,20,Clouds
14245,23,1552654800,22,8,30,Clouds
14246,24,1552654800,18,2,20,Clouds
14247,25,1552654800,14,16,30,Clouds
14248,26,1552654800,4,16,20,Clouds
14249,27,1552654800,2,18,20,Clouds
14250,28,1552654800,29,1,30,Clouds
14251,29,1552654800,27,2,29,Clouds
14252,30,1552654800,19,1,20,Clouds
14253,31,1552654800,13,7,20,Clouds
14254,32,1552654800,0,30,30,Clouds
14255,33,1552654800,4,19,23,Clouds
14256,34,1552654800,30,0,30,Clouds
14257,35,1552654800,28,2,30,Clouds
14258,36,1552654800,7,33,40,Clouds
14259,37,1552654800,23,7,30,Clouds
14260,38,1552654800,14,26,40,Clouds
14261,39,1552654800,19,1,20,Clouds
14262,40,1552654800,11,10,21,Clouds
14263,41,1552654800,17,3,20,Clouds
14264,42,1552654800,27,3,30,Clouds
14265,43,1552654800,29,1,30,Clouds
14266,44,1552654800,30,0,30,Clouds
14267,45,1552654800,28,2,30,Clouds
14268,46,1552654800,20,0,20,Clouds
14269,47,1552654800,1,39,40,Clouds
14270,48,1552654800,4,35,39,Clouds
14271,49,1552654800,17,23,40,Clouds
14272,50,1552654800,40,0,40,Clouds
14273,51,1552654800,22,18,40,Clouds
14274,52,1552654800,1,31,32,Clouds
14275,53,1552654800,18,22,40,Clouds
14276,54,1552654800,14,19,33,Clouds
14277,55,1552654800,4,32,36,Clouds
14278,56,1552654800,14,26,40,Clouds
14279,57,1552654800,0,23,23,Clouds
14280,58,1552654800,1,39,40,Clouds
14281,59,1552654800,19,1,20,Clouds
14282,60,1552654800,29,1,30,Clouds
14283,61,1552654800,25,0,25,Clouds
14284,62,1552654800,1,39,40,Clouds
14285,63,1552654800,9,25,34,Clouds
14286,64,1552654800,11,29,40,Clouds
14287,65,1552654800,5,35,40,Clouds
14288,66,1552654800,12,28,40,Clouds
14289,67,1552654800,22,18,40,Clouds
14290,68,1552654800,0,40,40,Clouds
14291,69,1552654800,1,39,40,Clouds
14292,70,1552654800,7,21,28,Clouds
14293,71,1552654800,38,2,40,Clouds
14294,72,1552654800,26,5,31,Clouds
14295,73,1552654800,30,0,30,Clouds
14296,74,1552654800,29,1,30,Clouds
14297,75,1552654800,39,1,40,Clouds
14298,76,1552654800,38,0,38,Clouds
14299,77,1552654800,25,4,29,Clouds
14300,78,1552654800,28,12,40,Clouds
14301,79,1552654800,26,1,27,Clouds
14302,80,1552654800,40,0,40,Clouds
14303,81,1552654800,40,0,40,Clouds
14304,82,1552654800,22,0,22,Clouds
14305,83,1552654800,39,1,40,Clouds
14306,84,1552654800,30,0,30,Clouds
14307,85,1552654800,35,0,35,Clouds
14308,86,1552654800,38,0,38,Clouds
14309,87,1552654800,38,0,38,Clouds
14310,88,1552654800,30,0,30,Clouds
14311,89,1552654800,29,10,39,Clouds
14312,90,1552654800,8,30,38,Clouds
14313,91,1552654800,14,16,30,Clouds
14314,92,1552654800,39,1,40,Clouds
14315,93,1552654800,40,0,40,Clouds
14316,94,1552654800,40,0,40,Clouds
14317,95,1552654800,40,0,40,Clouds
14318,96,1552654800,30,0,30,Clouds
14319,97,1552654800,40,0,40,Clouds
14320,98,1552654800,9,31,40,Clouds
14321,99,1552654800,0,30,30,Clouds
14322,100,1552654800,23,2,25,Clouds
14323,101,1552654800,30,0,30,Clouds
14324,102,1552654800,39,1,40,Clouds
14325,103,1552654800,39,1,40,Clouds
14326,104,1552654800,40,0,40,Clouds
14327,105,1552654800,36,0,36,Clouds
14328,106,1552654800,40,0,40,Clouds
14329,107,1552654800,40,0,40,Clouds
14330,108,1552654800,40,0,40,Clouds
14331,109,1552654800,29,0,29,Clouds
14332,110,1552654800,40,0,40,Clouds
14333,111,1552654800,38,2,40,Clouds
14334,112,1552654800,23,7,30,Clouds
14335,113,1552654800,0,0,0,Clouds
14336,114,1552654800,4,36,40,Clouds
14337,115,1552654800,24,6,30,Clouds
14338,2,1552658400,19,1,20,Rain
14339,3,1552658400,18,2,20,Rain
14340,4,1552658400,20,0,20,Rain
14341,5,1552658400,39,1,40,Rain
14342,6,1552658400,19,1,20,Rain
14343,7,1552658400,29,0,29,Rain
14344,8,1552658400,16,14,30,Rain
14345,9,1552658400,4,20,24,Rain
14346,10,1552658400,13,3,16,Rain
14347,11,1552658400,7,23,30,Rain
14348,12,1552658400,19,1,20,Rain
14349,13,1552658400,13,17,30,Rain
14350,14,1552658400,14,16,30,Rain
14351,15,1552658400,16,0,16,Rain
14352,16,1552658400,13,7,20,Rain
14353,17,1552658400,15,5,20,Rain
14354,18,1552658400,27,3,30,Rain
14355,19,1552658400,5,25,30,Rain
14356,21,1552658400,0,30,30,Rain
14357,22,1552658400,8,12,20,Rain
14358,23,1552658400,21,9,30,Rain
14359,24,1552658400,18,2,20,Rain
14360,25,1552658400,15,15,30,Rain
14361,26,1552658400,1,19,20,Rain
14362,27,1552658400,1,19,20,Rain
14363,28,1552658400,30,0,30,Rain
14364,29,1552658400,25,4,29,Rain
14365,30,1552658400,19,1,20,Rain
14366,31,1552658400,18,2,20,Rain
14367,32,1552658400,7,23,30,Rain
14368,33,1552658400,1,22,23,Rain
14369,34,1552658400,29,1,30,Rain
14370,35,1552658400,27,3,30,Rain
14371,36,1552658400,8,32,40,Rain
14372,37,1552658400,25,5,30,Rain
14373,38,1552658400,22,18,40,Rain
14374,39,1552658400,18,2,20,Rain
14375,40,1552658400,19,2,21,Rain
14376,41,1552658400,20,0,20,Rain
14377,42,1552658400,25,5,30,Rain
14378,43,1552658400,29,1,30,Rain
14379,44,1552658400,28,2,30,Rain
14380,45,1552658400,27,3,30,Rain
14381,46,1552658400,18,2,20,Rain
14382,47,1552658400,0,40,40,Rain
14383,48,1552658400,13,27,40,Rain
14384,49,1552658400,21,19,40,Rain
14385,50,1552658400,38,2,40,Rain
14386,51,1552658400,18,22,40,Rain
14387,52,1552658400,0,32,32,Rain
14388,53,1552658400,19,21,40,Rain
14389,54,1552658400,18,15,33,Rain
14390,55,1552658400,13,23,36,Rain
14391,56,1552658400,18,22,40,Rain
14392,57,1552658400,3,20,23,Rain
14393,58,1552658400,19,21,40,Rain
14394,59,1552658400,19,1,20,Rain
14395,60,1552658400,30,0,30,Rain
14396,61,1552658400,24,1,25,Rain
14397,62,1552658400,4,36,40,Rain
14398,63,1552658400,13,21,34,Rain
14399,64,1552658400,10,30,40,Rain
14400,65,1552658400,11,29,40,Rain
14401,66,1552658400,22,18,40,Rain
14402,67,1552658400,21,19,40,Rain
14403,68,1552658400,4,36,40,Rain
14404,69,1552658400,6,34,40,Rain
14405,70,1552658400,6,22,28,Rain
14406,71,1552658400,37,3,40,Rain
14407,72,1552658400,31,0,31,Rain
14408,73,1552658400,29,1,30,Rain
14409,74,1552658400,28,2,30,Rain
14410,75,1552658400,40,0,40,Rain
14411,76,1552658400,37,1,38,Rain
14412,77,1552658400,28,1,29,Rain
14413,78,1552658400,37,3,40,Rain
14414,79,1552658400,27,0,27,Rain
14415,80,1552658400,29,11,40,Rain
14416,81,1552658400,40,0,40,Rain
14417,82,1552658400,22,0,22,Rain
14418,83,1552658400,37,3,40,Rain
14419,84,1552658400,30,0,30,Rain
14420,85,1552658400,28,7,35,Rain
14421,86,1552658400,37,1,38,Rain
14422,87,1552658400,38,0,38,Rain
14423,88,1552658400,28,2,30,Rain
14424,89,1552658400,32,8,40,Rain
14425,90,1552658400,22,18,40,Rain
14426,91,1552658400,13,17,30,Rain
14427,92,1552658400,40,0,40,Rain
14428,93,1552658400,40,0,40,Rain
14429,94,1552658400,40,0,40,Rain
14430,95,1552658400,40,0,40,Rain
14431,96,1552658400,29,1,30,Rain
14432,97,1552658400,32,8,40,Rain
14433,98,1552658400,2,38,40,Rain
14434,99,1552658400,3,27,30,Rain
14435,100,1552658400,22,3,25,Rain
14436,101,1552658400,30,0,30,Rain
14437,102,1552658400,40,0,40,Rain
14438,103,1552658400,39,1,40,Rain
14439,104,1552658400,40,0,40,Rain
14440,105,1552658400,36,0,36,Rain
14441,106,1552658400,39,1,40,Rain
14442,107,1552658400,33,7,40,Rain
14443,108,1552658400,40,0,40,Rain
14444,109,1552658400,29,0,29,Rain
14445,110,1552658400,39,1,40,Rain
14446,111,1552658400,39,1,40,Rain
14447,112,1552658400,18,12,30,Rain
14448,113,1552658400,0,0,0,Rain
14449,114,1552658400,5,35,40,Rain
14450,115,1552658400,24,6,30,Rain
14451,2,1552662000,20,0,20,Rain
14452,3,1552662000,14,6,20,Rain
14453,4,1552662000,18,2,20,Rain
14454,5,1552662000,37,3,40,Rain
14455,6,1552662000,19,1,20,Rain
14456,7,1552662000,29,0,29,Rain
14457,8,1552662000,16,14,30,Rain
14458,9,1552662000,5,19,24,Rain
14459,10,1552662000,14,2,16,Rain
14460,11,1552662000,13,17,30,Rain
14461,12,1552662000,19,1,20,Rain
14462,13,1552662000,8,22,30,Rain
14463,14,1552662000,10,20,30,Rain
14464,15,1552662000,5,11,16,Rain
14465,16,1552662000,12,8,20,Rain
14466,17,1552662000,14,6,20,Rain
14467,18,1552662000,30,0,30,Rain
14468,19,1552662000,4,26,30,Rain
14469,21,1552662000,1,29,30,Rain
14470,22,1552662000,0,20,20,Rain
14471,23,1552662000,13,17,30,Rain
14472,24,1552662000,17,3,20,Rain
14473,25,1552662000,15,15,30,Rain
14474,26,1552662000,3,17,20,Rain
14475,27,1552662000,3,17,20,Rain
14476,28,1552662000,30,0,30,Rain
14477,29,1552662000,26,3,29,Rain
14478,30,1552662000,15,5,20,Rain
14479,31,1552662000,16,4,20,Rain
14480,32,1552662000,9,21,30,Rain
14481,33,1552662000,0,23,23,Rain
14482,34,1552662000,25,5,30,Rain
14483,35,1552662000,29,1,30,Rain
14484,36,1552662000,10,30,40,Rain
14485,37,1552662000,27,3,30,Rain
14486,38,1552662000,12,27,39,Rain
14487,39,1552662000,20,0,20,Rain
14488,40,1552662000,17,3,20,Rain
14489,41,1552662000,17,3,20,Rain
14490,42,1552662000,25,5,30,Rain
14491,43,1552662000,29,1,30,Rain
14492,44,1552662000,28,2,30,Rain
14493,45,1552662000,26,4,30,Rain
14494,46,1552662000,13,7,20,Rain
14495,47,1552662000,2,38,40,Rain
14496,48,1552662000,13,27,40,Rain
14497,49,1552662000,12,28,40,Rain
14498,50,1552662000,38,2,40,Rain
14499,51,1552662000,16,23,39,Rain
14500,52,1552662000,1,31,32,Rain
14501,53,1552662000,22,18,40,Rain
14502,54,1552662000,18,15,33,Rain
14503,55,1552662000,13,23,36,Rain
14504,56,1552662000,22,18,40,Rain
14505,57,1552662000,4,19,23,Rain
14506,58,1552662000,12,28,40,Rain
14507,59,1552662000,18,2,20,Rain
14508,60,1552662000,28,2,30,Rain
14509,61,1552662000,25,0,25,Rain
14510,62,1552662000,2,38,40,Rain
14511,63,1552662000,6,28,34,Rain
14512,64,1552662000,5,35,40,Rain
14513,65,1552662000,10,30,40,Rain
14514,66,1552662000,16,24,40,Rain
14515,67,1552662000,17,23,40,Rain
14516,68,1552662000,2,38,40,Rain
14517,69,1552662000,10,30,40,Rain
14518,70,1552662000,5,23,28,Rain
14519,71,1552662000,34,6,40,Rain
14520,72,1552662000,31,0,31,Rain
14521,73,1552662000,27,3,30,Rain
14522,74,1552662000,27,3,30,Rain
14523,75,1552662000,38,2,40,Rain
14524,76,1552662000,36,2,38,Rain
14525,77,1552662000,29,0,29,Rain
14526,78,1552662000,39,1,40,Rain
14527,79,1552662000,21,6,27,Rain
14528,80,1552662000,34,6,40,Rain
14529,81,1552662000,40,0,40,Rain
14530,82,1552662000,22,0,22,Rain
14531,83,1552662000,35,5,40,Rain
14532,84,1552662000,29,1,30,Rain
14533,85,1552662000,30,5,35,Rain
14534,86,1552662000,38,0,38,Rain
14535,87,1552662000,36,2,38,Rain
14536,88,1552662000,29,1,30,Rain
14537,89,1552662000,35,5,40,Rain
14538,90,1552662000,29,11,40,Rain
14539,91,1552662000,13,17,30,Rain
14540,92,1552662000,38,2,40,Rain
14541,93,1552662000,40,0,40,Rain
14542,94,1552662000,39,1,40,Rain
14543,95,1552662000,37,3,40,Rain
14544,96,1552662000,30,0,30,Rain
14545,97,1552662000,31,9,40,Rain
14546,98,1552662000,12,28,40,Rain
14547,99,1552662000,2,28,30,Rain
14548,100,1552662000,20,5,25,Rain
14549,101,1552662000,30,0,30,Rain
14550,102,1552662000,39,1,40,Rain
14551,103,1552662000,40,0,40,Rain
14552,104,1552662000,40,0,40,Rain
14553,105,1552662000,36,0,36,Rain
14554,106,1552662000,39,1,40,Rain
14555,107,1552662000,34,6,40,Rain
14556,108,1552662000,39,1,40,Rain
14557,109,1552662000,26,3,29,Rain
14558,110,1552662000,40,0,40,Rain
14559,111,1552662000,39,1,40,Rain
14560,112,1552662000,19,11,30,Rain
14561,113,1552662000,0,0,0,Rain
14562,114,1552662000,10,30,40,Rain
14563,115,1552662000,26,4,30,Rain
14564,2,1552665600,18,2,20,Rain
14565,3,1552665600,19,1,20,Rain
14566,4,1552665600,19,1,20,Rain
14567,5,1552665600,34,6,40,Rain
14568,6,1552665600,19,1,20,Rain
14569,7,1552665600,12,17,29,Rain
14570,8,1552665600,19,11,30,Rain
14571,9,1552665600,11,13,24,Rain
14572,10,1552665600,14,2,16,Rain
14573,11,1552665600,14,16,30,Rain
14574,12,1552665600,20,0,20,Rain
14575,13,1552665600,10,20,30,Rain
14576,14,1552665600,2,28,30,Rain
14577,15,1552665600,7,9,16,Rain
14578,16,1552665600,14,6,20,Rain
14579,17,1552665600,17,3,20,Rain
14580,18,1552665600,27,3,30,Rain
14581,19,1552665600,10,20,30,Rain
14582,21,1552665600,9,21,30,Rain
14583,22,1552665600,8,12,20,Rain
14584,23,1552665600,12,18,30,Rain
14585,24,1552665600,10,10,20,Rain
14586,25,1552665600,17,13,30,Rain
14587,26,1552665600,4,16,20,Rain
14588,27,1552665600,3,17,20,Rain
14589,28,1552665600,30,0,30,Rain
14590,29,1552665600,18,11,29,Rain
14591,30,1552665600,16,4,20,Rain
14592,31,1552665600,17,3,20,Rain
14593,32,1552665600,25,5,30,Rain
14594,33,1552665600,0,23,23,Rain
14595,34,1552665600,30,0,30,Rain
14596,35,1552665600,23,7,30,Rain
14597,36,1552665600,10,30,40,Rain
14598,37,1552665600,28,2,30,Rain
14599,38,1552665600,16,24,40,Rain
14600,39,1552665600,16,4,20,Rain
14601,40,1552665600,15,5,20,Rain
14602,41,1552665600,12,8,20,Rain
14603,42,1552665600,28,2,30,Rain
14604,43,1552665600,30,0,30,Rain
14605,44,1552665600,30,0,30,Rain
14606,45,1552665600,27,3,30,Rain
14607,46,1552665600,12,8,20,Rain
14608,47,1552665600,5,35,40,Rain
14609,48,1552665600,15,25,40,Rain
14610,49,1552665600,11,29,40,Rain
14611,50,1552665600,38,2,40,Rain
14612,51,1552665600,10,30,40,Rain
14613,52,1552665600,1,31,32,Rain
14614,53,1552665600,20,20,40,Rain
14615,54,1552665600,21,12,33,Rain
14616,55,1552665600,14,22,36,Rain
14617,56,1552665600,22,18,40,Rain
14618,57,1552665600,2,21,23,Rain
14619,58,1552665600,11,29,40,Rain
14620,59,1552665600,20,0,20,Rain
14621,60,1552665600,21,9,30,Rain
14622,61,1552665600,25,0,25,Rain
14623,62,1552665600,6,34,40,Rain
14624,63,1552665600,5,29,34,Rain
14625,64,1552665600,1,39,40,Rain
14626,65,1552665600,13,27,40,Rain
14627,66,1552665600,18,22,40,Rain
14628,67,1552665600,10,30,40,Rain
14629,68,1552665600,10,30,40,Rain
14630,69,1552665600,0,40,40,Rain
14631,70,1552665600,7,21,28,Rain
14632,71,1552665600,35,5,40,Rain
14633,72,1552665600,31,0,31,Rain
14634,73,1552665600,29,1,30,Rain
14635,74,1552665600,25,5,30,Rain
14636,75,1552665600,38,2,40,Rain
14637,76,1552665600,38,0,38,Rain
14638,77,1552665600,26,3,29,Rain
14639,78,1552665600,39,1,40,Rain
14640,79,1552665600,23,4,27,Rain
14641,80,1552665600,40,0,40,Rain
14642,81,1552665600,30,10,40,Rain
14643,82,1552665600,22,0,22,Rain
14644,83,1552665600,34,6,40,Rain
14645,84,1552665600,30,0,30,Rain
14646,85,1552665600,31,4,35,Rain
14647,86,1552665600,31,7,38,Rain
14648,87,1552665600,36,2,38,Rain
14649,88,1552665600,30,0,30,Rain
14650,89,1552665600,33,7,40,Rain
14651,90,1552665600,11,29,40,Rain
14652,91,1552665600,9,21,30,Rain
14653,92,1552665600,37,3,40,Rain
14654,93,1552665600,40,0,40,Rain
14655,94,1552665600,38,2,40,Rain
14656,95,1552665600,35,5,40,Rain
14657,96,1552665600,30,0,30,Rain
14658,97,1552665600,33,7,40,Rain
14659,98,1552665600,15,25,40,Rain
14660,99,1552665600,2,28,30,Rain
14661,100,1552665600,10,15,25,Rain
14662,101,1552665600,29,1,30,Rain
14663,102,1552665600,37,3,40,Rain
14664,103,1552665600,40,0,40,Rain
14665,104,1552665600,40,0,40,Rain
14666,105,1552665600,36,0,36,Rain
14667,106,1552665600,39,1,40,Rain
14668,107,1552665600,37,3,40,Rain
14669,108,1552665600,39,1,40,Rain
14670,109,1552665600,27,2,29,Rain
14671,110,1552665600,39,1,40,Rain
14672,111,1552665600,38,2,40,Rain
14673,112,1552665600,19,11,30,Rain
14674,113,1552665600,0,0,0,Rain
14675,114,1552665600,9,31,40,Rain
14676,115,1552665600,23,7,30,Rain
14677,2,1552669200,18,2,20,Clouds
14678,3,1552669200,20,0,20,Clouds
14679,4,1552669200,17,3,20,Clouds
14680,5,1552669200,27,13,40,Clouds
14681,6,1552669200,20,0,20,Clouds
14682,7,1552669200,19,10,29,Clouds
14683,8,1552669200,17,13,30,Clouds
14684,9,1552669200,4,20,24,Clouds
14685,10,1552669200,12,4,16,Clouds
14686,11,1552669200,21,9,30,Clouds
14687,12,1552669200,19,1,20,Clouds
14688,13,1552669200,6,24,30,Clouds
14689,14,1552669200,3,27,30,Clouds
14690,15,1552669200,14,2,16,Clouds
14691,16,1552669200,11,9,20,Clouds
14692,17,1552669200,18,2,20,Clouds
14693,18,1552669200,30,0,30,Clouds
14694,19,1552669200,12,18,30,Clouds
14695,21,1552669200,3,27,30,Clouds
14696,22,1552669200,13,7,20,Clouds
14697,23,1552669200,0,15,15,Clouds
14698,24,1552669200,0,20,20,Clouds
14699,25,1552669200,18,12,30,Clouds
14700,26,1552669200,1,19,20,Clouds
14701,27,1552669200,4,16,20,Clouds
14702,28,1552669200,30,0,30,Clouds
14703,29,1552669200,14,15,29,Clouds
14704,30,1552669200,19,1,20,Clouds
14705,31,1552669200,20,0,20,Clouds
14706,32,1552669200,17,13,30,Clouds
14707,33,1552669200,1,22,23,Clouds
14708,34,1552669200,25,5,30,Clouds
14709,35,1552669200,18,12,30,Clouds
14710,36,1552669200,15,25,40,Clouds
14711,37,1552669200,28,2,30,Clouds
14712,38,1552669200,13,27,40,Clouds
14713,39,1552669200,16,4,20,Clouds
14714,40,1552669200,12,8,20,Clouds
14715,41,1552669200,20,0,20,Clouds
14716,42,1552669200,23,7,30,Clouds
14717,43,1552669200,27,3,30,Clouds
14718,44,1552669200,28,2,30,Clouds
14719,45,1552669200,24,6,30,Clouds
14720,46,1552669200,11,9,20,Clouds
14721,47,1552669200,4,36,40,Clouds
14722,48,1552669200,7,33,40,Clouds
14723,49,1552669200,13,27,40,Clouds
14724,50,1552669200,39,1,40,Clouds
14725,51,1552669200,37,3,40,Clouds
14726,52,1552669200,5,27,32,Clouds
14727,53,1552669200,22,18,40,Clouds
14728,54,1552669200,20,13,33,Clouds
14729,55,1552669200,16,20,36,Clouds
14730,56,1552669200,6,34,40,Clouds
14731,57,1552669200,5,18,23,Clouds
14732,58,1552669200,20,20,40,Clouds
14733,59,1552669200,20,0,20,Clouds
14734,60,1552669200,19,11,30,Clouds
14735,61,1552669200,25,0,25,Clouds
14736,62,1552669200,8,32,40,Clouds
14737,63,1552669200,5,29,34,Clouds
14738,64,1552669200,5,35,40,Clouds
14739,65,1552669200,32,8,40,Clouds
14740,66,1552669200,37,3,40,Clouds
14741,67,1552669200,7,33,40,Clouds
14742,68,1552669200,8,32,40,Clouds
14743,69,1552669200,2,38,40,Clouds
14744,70,1552669200,15,13,28,Clouds
14745,71,1552669200,39,1,40,Clouds
14746,72,1552669200,29,2,31,Clouds
14747,73,1552669200,30,0,30,Clouds
14748,74,1552669200,4,26,30,Clouds
14749,75,1552669200,40,0,40,Clouds
14750,76,1552669200,38,0,38,Clouds
14751,77,1552669200,27,2,29,Clouds
14752,78,1552669200,38,2,40,Clouds
14753,79,1552669200,27,0,27,Clouds
14754,80,1552669200,36,4,40,Clouds
14755,81,1552669200,24,16,40,Clouds
14756,82,1552669200,22,0,22,Clouds
14757,83,1552669200,33,7,40,Clouds
14758,84,1552669200,30,0,30,Clouds
14759,85,1552669200,30,5,35,Clouds
14760,86,1552669200,36,2,38,Clouds
14761,87,1552669200,34,4,38,Clouds
14762,88,1552669200,30,0,30,Clouds
14763,89,1552669200,34,6,40,Clouds
14764,90,1552669200,4,36,40,Clouds
14765,91,1552669200,18,12,30,Clouds
14766,92,1552669200,36,4,40,Clouds
14767,93,1552669200,38,2,40,Clouds
14768,94,1552669200,38,2,40,Clouds
14769,95,1552669200,40,0,40,Clouds
14770,96,1552669200,30,0,30,Clouds
14771,97,1552669200,35,5,40,Clouds
14772,98,1552669200,17,23,40,Clouds
14773,99,1552669200,1,29,30,Clouds
14774,100,1552669200,11,14,25,Clouds
14775,101,1552669200,28,2,30,Clouds
14776,102,1552669200,40,0,40,Clouds
14777,103,1552669200,40,0,40,Clouds
14778,104,1552669200,40,0,40,Clouds
14779,105,1552669200,36,0,36,Clouds
14780,106,1552669200,40,0,40,Clouds
14781,107,1552669200,37,3,40,Clouds
14782,108,1552669200,38,2,40,Clouds
14783,109,1552669200,26,3,29,Clouds
14784,110,1552669200,40,0,40,Clouds
14785,111,1552669200,39,1,40,Clouds
14786,112,1552669200,16,14,30,Clouds
14787,113,1552669200,0,0,0,Clouds
14788,114,1552669200,16,24,40,Clouds
14789,115,1552669200,16,14,30,Clouds
14790,2,1552672800,20,0,20,Rain
14791,3,1552672800,20,0,20,Rain
14792,4,1552672800,20,0,20,Rain
14793,5,1552672800,23,17,40,Rain
14794,6,1552672800,16,4,20,Rain
14795,7,1552672800,22,7,29,Rain
14796,8,1552672800,4,26,30,Rain
14797,9,1552672800,11,13,24,Rain
14798,10,1552672800,9,7,16,Rain
14799,11,1552672800,30,0,30,Rain
14800,12,1552672800,19,1,20,Rain
14801,13,1552672800,14,16,30,Rain
14802,14,1552672800,0,30,30,Rain
14803,15,1552672800,16,0,16,Rain
14804,16,1552672800,0,20,20,Rain
14805,17,1552672800,20,0,20,Rain
14806,18,1552672800,30,0,30,Rain
14807,19,1552672800,24,6,30,Rain
14808,21,1552672800,1,29,30,Rain
14809,22,1552672800,6,14,20,Rain
14810,23,1552672800,0,0,0,Rain
14811,24,1552672800,4,16,20,Rain
14812,25,1552672800,25,5,30,Rain
14813,26,1552672800,1,19,20,Rain
14814,27,1552672800,0,20,20,Rain
14815,28,1552672800,30,0,30,Rain
14816,29,1552672800,21,8,29,Rain
14817,30,1552672800,19,1,20,Rain
14818,31,1552672800,20,0,20,Rain
14819,32,1552672800,0,30,30,Rain
14820,33,1552672800,0,23,23,Rain
14821,34,1552672800,14,16,30,Rain
14822,35,1552672800,25,5,30,Rain
14823,36,1552672800,29,11,40,Rain
14824,37,1552672800,30,0,30,Rain
14825,38,1552672800,2,38,40,Rain
14826,39,1552672800,19,1,20,Rain
14827,40,1552672800,19,1,20,Rain
14828,41,1552672800,20,0,20,Rain
14829,42,1552672800,19,11,30,Rain
14830,43,1552672800,19,11,30,Rain
14831,44,1552672800,26,4,30,Rain
14832,45,1552672800,21,9,30,Rain
14833,46,1552672800,7,13,20,Rain
14834,47,1552672800,14,26,40,Rain
14835,48,1552672800,8,32,40,Rain
14836,49,1552672800,9,31,40,Rain
14837,50,1552672800,38,2,40,Rain
14838,51,1552672800,37,3,40,Rain
14839,52,1552672800,5,27,32,Rain
14840,53,1552672800,38,2,40,Rain
14841,54,1552672800,29,4,33,Rain
14842,55,1552672800,35,1,36,Rain
14843,56,1552672800,27,13,40,Rain
14844,57,1552672800,9,14,23,Rain
14845,58,1552672800,40,0,40,Rain
14846,59,1552672800,19,1,20,Rain
14847,60,1552672800,15,15,30,Rain
14848,61,1552672800,24,1,25,Rain
14849,62,1552672800,18,22,40,Rain
14850,63,1552672800,5,29,34,Rain
14851,64,1552672800,29,11,40,Rain
14852,65,1552672800,38,2,40,Rain
14853,66,1552672800,26,14,40,Rain
14854,67,1552672800,7,33,40,Rain
14855,68,1552672800,22,18,40,Rain
14856,69,1552672800,5,35,40,Rain
14857,70,1552672800,18,10,28,Rain
14858,71,1552672800,40,0,40,Rain
14859,72,1552672800,31,0,31,Rain
14860,73,1552672800,26,4,30,Rain
14861,74,1552672800,6,24,30,Rain
14862,75,1552672800,32,8,40,Rain
14863,76,1552672800,16,22,38,Rain
14864,77,1552672800,29,0,29,Rain
14865,78,1552672800,38,2,40,Rain
14866,79,1552672800,26,1,27,Rain
14867,80,1552672800,35,5,40,Rain
14868,81,1552672800,25,15,40,Rain
14869,82,1552672800,21,1,22,Rain
14870,83,1552672800,31,9,40,Rain
14871,84,1552672800,29,1,30,Rain
14872,85,1552672800,26,9,35,Rain
14873,86,1552672800,21,17,38,Rain
14874,87,1552672800,33,5,38,Rain
14875,88,1552672800,30,0,30,Rain
14876,89,1552672800,40,0,40,Rain
14877,90,1552672800,18,22,40,Rain
14878,91,1552672800,17,13,30,Rain
14879,92,1552672800,29,11,40,Rain
14880,93,1552672800,24,16,40,Rain
14881,94,1552672800,38,2,40,Rain
14882,95,1552672800,34,6,40,Rain
14883,96,1552672800,25,5,30,Rain
14884,97,1552672800,38,2,40,Rain
14885,98,1552672800,19,21,40,Rain
14886,99,1552672800,1,29,30,Rain
14887,100,1552672800,1,24,25,Rain
14888,101,1552672800,27,3,30,Rain
14889,102,1552672800,39,1,40,Rain
14890,103,1552672800,30,10,40,Rain
14891,104,1552672800,40,0,40,Rain
14892,105,1552672800,36,0,36,Rain
14893,106,1552672800,39,1,40,Rain
14894,107,1552672800,38,2,40,Rain
14895,108,1552672800,39,1,40,Rain
14896,109,1552672800,26,3,29,Rain
14897,110,1552672800,39,1,40,Rain
14898,111,1552672800,38,2,40,Rain
14899,112,1552672800,13,17,30,Rain
14900,113,1552672800,0,0,0,Rain
14901,114,1552672800,40,0,40,Rain
14902,115,1552672800,12,18,30,Rain
14903,2,1552676400,16,4,20,Rain
14904,3,1552676400,17,3,20,Rain
14905,4,1552676400,18,2,20,Rain
14906,5,1552676400,34,6,40,Rain
14907,6,1552676400,16,4,20,Rain
14908,7,1552676400,24,5,29,Rain
14909,8,1552676400,19,11,30,Rain
14910,9,1552676400,3,21,24,Rain
14911,10,1552676400,8,8,16,Rain
14912,11,1552676400,30,0,30,Rain
14913,12,1552676400,15,5,20,Rain
14914,13,1552676400,29,0,29,Rain
14915,14,1552676400,1,29,30,Rain
14916,15,1552676400,13,3,16,Rain
14917,16,1552676400,1,19,20,Rain
14918,17,1552676400,18,2,20,Rain
14919,18,1552676400,28,2,30,Rain
14920,19,1552676400,30,0,30,Rain
14921,21,1552676400,0,30,30,Rain
14922,22,1552676400,0,20,20,Rain
14923,23,1552676400,0,0,0,Rain
14924,24,1552676400,1,19,20,Rain
14925,25,1552676400,29,1,30,Rain
14926,26,1552676400,7,13,20,Rain
14927,27,1552676400,4,16,20,Rain
14928,28,1552676400,27,3,30,Rain
14929,29,1552676400,20,9,29,Rain
14930,30,1552676400,17,3,20,Rain
14931,31,1552676400,16,4,20,Rain
14932,32,1552676400,9,21,30,Rain
14933,33,1552676400,0,23,23,Rain
14934,34,1552676400,9,21,30,Rain
14935,35,1552676400,29,1,30,Rain
14936,36,1552676400,38,2,40,Rain
14937,37,1552676400,30,0,30,Rain
14938,38,1552676400,3,37,40,Rain
14939,39,1552676400,20,0,20,Rain
14940,40,1552676400,18,3,21,Rain
14941,41,1552676400,19,1,20,Rain
14942,42,1552676400,20,10,30,Rain
14943,43,1552676400,11,19,30,Rain
14944,44,1552676400,25,5,30,Rain
14945,45,1552676400,19,11,30,Rain
14946,46,1552676400,6,14,20,Rain
14947,47,1552676400,39,1,40,Rain
14948,48,1552676400,0,40,40,Rain
14949,49,1552676400,8,32,40,Rain
14950,50,1552676400,27,13,40,Rain
14951,51,1552676400,33,7,40,Rain
14952,52,1552676400,30,2,32,Rain
14953,53,1552676400,40,0,40,Rain
14954,54,1552676400,33,0,33,Rain
14955,55,1552676400,35,1,36,Rain
14956,56,1552676400,38,2,40,Rain
14957,57,1552676400,21,2,23,Rain
14958,58,1552676400,25,15,40,Rain
14959,59,1552676400,18,2,20,Rain
14960,60,1552676400,5,25,30,Rain
14961,61,1552676400,23,2,25,Rain
14962,62,1552676400,30,10,40,Rain
14963,63,1552676400,13,21,34,Rain
14964,64,1552676400,21,19,40,Rain
14965,65,1552676400,38,2,40,Rain
14966,66,1552676400,40,0,40,Rain
14967,67,1552676400,13,27,40,Rain
14968,68,1552676400,31,9,40,Rain
14969,69,1552676400,10,30,40,Rain
14970,70,1552676400,17,11,28,Rain
14971,71,1552676400,38,2,40,Rain
14972,72,1552676400,31,0,31,Rain
14973,73,1552676400,13,17,30,Rain
14974,74,1552676400,15,15,30,Rain
14975,75,1552676400,33,7,40,Rain
14976,76,1552676400,11,27,38,Rain
14977,77,1552676400,26,3,29,Rain
14978,78,1552676400,36,4,40,Rain
14979,79,1552676400,27,0,27,Rain
14980,80,1552676400,37,3,40,Rain
14981,81,1552676400,26,14,40,Rain
14982,82,1552676400,20,2,22,Rain
14983,83,1552676400,27,13,40,Rain
14984,84,1552676400,22,8,30,Rain
14985,85,1552676400,18,17,35,Rain
14986,86,1552676400,12,26,38,Rain
14987,87,1552676400,32,6,38,Rain
14988,88,1552676400,23,7,30,Rain
14989,89,1552676400,40,0,40,Rain
14990,90,1552676400,40,0,40,Rain
14991,91,1552676400,21,9,30,Rain
14992,92,1552676400,15,25,40,Rain
14993,93,1552676400,1,39,40,Rain
14994,94,1552676400,34,6,40,Rain
14995,95,1552676400,21,19,40,Rain
14996,96,1552676400,26,4,30,Rain
14997,97,1552676400,35,5,40,Rain
14998,98,1552676400,15,25,40,Rain
14999,99,1552676400,6,24,30,Rain
15000,100,1552676400,11,14,25,Rain
15001,101,1552676400,24,6,30,Rain
15002,102,1552676400,38,2,40,Rain
15003,103,1552676400,23,17,40,Rain
15004,104,1552676400,40,0,40,Rain
15005,105,1552676400,35,1,36,Rain
15006,106,1552676400,38,2,40,Rain
15007,107,1552676400,38,2,40,Rain
15008,108,1552676400,38,2,40,Rain
15009,109,1552676400,22,7,29,Rain
15010,110,1552676400,39,1,40,Rain
15011,111,1552676400,38,2,40,Rain
15012,112,1552676400,15,15,30,Rain
15013,113,1552676400,0,0,0,Rain
15014,114,1552676400,39,1,40,Rain
15015,115,1552676400,1,29,30,Rain
15016,2,1552680000,8,12,20,Rain
15017,3,1552680000,18,2,20,Rain
15018,4,1552680000,20,0,20,Rain
15019,5,1552680000,24,16,40,Rain
15020,6,1552680000,17,3,20,Rain
15021,7,1552680000,6,23,29,Rain
15022,8,1552680000,21,9,30,Rain
15023,9,1552680000,2,22,24,Rain
15024,10,1552680000,3,13,16,Rain
15025,11,1552680000,29,1,30,Rain
15026,12,1552680000,13,7,20,Rain
15027,13,1552680000,30,0,30,Rain
15028,14,1552680000,0,30,30,Rain
15029,15,1552680000,14,2,16,Rain
15030,16,1552680000,14,6,20,Rain
15031,17,1552680000,17,3,20,Rain
15032,18,1552680000,19,11,30,Rain
15033,19,1552680000,18,12,30,Rain
15034,21,1552680000,11,19,30,Rain
15035,22,1552680000,15,5,20,Rain
15036,23,1552680000,0,0,0,Rain
15037,24,1552680000,3,17,20,Rain
15038,25,1552680000,29,1,30,Rain
15039,26,1552680000,11,9,20,Rain
15040,27,1552680000,3,17,20,Rain
15041,28,1552680000,27,3,30,Rain
15042,29,1552680000,12,17,29,Rain
15043,30,1552680000,15,5,20,Rain
15044,31,1552680000,13,7,20,Rain
15045,32,1552680000,6,24,30,Rain
15046,33,1552680000,4,19,23,Rain
15047,34,1552680000,17,13,30,Rain
15048,35,1552680000,29,1,30,Rain
15049,36,1552680000,37,3,40,Rain
15050,37,1552680000,30,0,30,Rain
15051,38,1552680000,6,34,40,Rain
15052,39,1552680000,18,2,20,Rain
15053,40,1552680000,16,5,21,Rain
15054,41,1552680000,17,3,20,Rain
15055,42,1552680000,11,19,30,Rain
15056,43,1552680000,10,20,30,Rain
15057,44,1552680000,21,9,30,Rain
15058,45,1552680000,13,17,30,Rain
15059,46,1552680000,3,17,20,Rain
15060,47,1552680000,39,1,40,Rain
15061,48,1552680000,14,26,40,Rain
15062,49,1552680000,11,29,40,Rain
15063,50,1552680000,26,14,40,Rain
15064,51,1552680000,30,10,40,Rain
15065,52,1552680000,32,0,32,Rain
15066,53,1552680000,40,0,40,Rain
15067,54,1552680000,32,0,32,Rain
15068,55,1552680000,36,0,36,Rain
15069,56,1552680000,38,2,40,Rain
15070,57,1552680000,20,3,23,Rain
15071,58,1552680000,30,10,40,Rain
15072,59,1552680000,17,3,20,Rain
15073,60,1552680000,0,30,30,Rain
15074,61,1552680000,25,0,25,Rain
15075,62,1552680000,33,7,40,Rain
15076,63,1552680000,20,14,34,Rain
15077,64,1552680000,20,20,40,Rain
15078,65,1552680000,40,0,40,Rain
15079,66,1552680000,34,6,40,Rain
15080,67,1552680000,19,21,40,Rain
15081,68,1552680000,25,15,40,Rain
15082,69,1552680000,9,31,40,Rain
15083,70,1552680000,19,9,28,Rain
15084,71,1552680000,40,0,40,Rain
15085,72,1552680000,28,3,31,Rain
15086,73,1552680000,15,15,30,Rain
15087,74,1552680000,14,16,30,Rain
15088,75,1552680000,33,7,40,Rain
15089,76,1552680000,13,25,38,Rain
15090,77,1552680000,28,1,29,Rain
15091,78,1552680000,35,5,40,Rain
15092,79,1552680000,27,0,27,Rain
15093,80,1552680000,34,6,40,Rain
15094,81,1552680000,24,16,40,Rain
15095,82,1552680000,16,6,22,Rain
15096,83,1552680000,23,17,40,Rain
15097,84,1552680000,18,12,30,Rain
15098,85,1552680000,19,16,35,Rain
15099,86,1552680000,9,29,38,Rain
15100,87,1552680000,25,13,38,Rain
15101,88,1552680000,23,7,30,Rain
15102,89,1552680000,40,0,40,Rain
15103,90,1552680000,39,1,40,Rain
15104,91,1552680000,6,23,29,Rain
15105,92,1552680000,12,28,40,Rain
15106,93,1552680000,1,39,40,Rain
15107,94,1552680000,34,6,40,Rain
15108,95,1552680000,16,24,40,Rain
15109,96,1552680000,25,5,30,Rain
15110,97,1552680000,33,7,40,Rain
15111,98,1552680000,20,20,40,Rain
15112,99,1552680000,10,20,30,Rain
15113,100,1552680000,18,7,25,Rain
15114,101,1552680000,23,7,30,Rain
15115,102,1552680000,28,12,40,Rain
15116,103,1552680000,24,16,40,Rain
15117,104,1552680000,40,0,40,Rain
15118,105,1552680000,33,3,36,Rain
15119,106,1552680000,37,3,40,Rain
15120,107,1552680000,35,5,40,Rain
15121,108,1552680000,30,10,40,Rain
15122,109,1552680000,17,12,29,Rain
15123,110,1552680000,38,2,40,Rain
15124,111,1552680000,39,1,40,Rain
15125,112,1552680000,14,16,30,Rain
15126,113,1552680000,0,0,0,Rain
15127,114,1552680000,37,3,40,Rain
15128,115,1552680000,1,29,30,Rain
15129,2,1552683600,8,12,20,Rain
15130,3,1552683600,18,2,20,Rain
15131,4,1552683600,20,0,20,Rain
15132,5,1552683600,21,19,40,Rain
15133,6,1552683600,7,13,20,Rain
15134,7,1552683600,6,23,29,Rain
15135,8,1552683600,20,10,30,Rain
15136,9,1552683600,1,23,24,Rain
15137,10,1552683600,0,16,16,Rain
15138,11,1552683600,29,1,30,Rain
15139,12,1552683600,16,4,20,Rain
15140,13,1552683600,28,2,30,Rain
15141,14,1552683600,1,29,30,Rain
15142,15,1552683600,12,4,16,Rain
15143,16,1552683600,16,4,20,Rain
15144,17,1552683600,16,4,20,Rain
15145,18,1552683600,19,11,30,Rain
15146,19,1552683600,23,7,30,Rain
15147,21,1552683600,16,14,30,Rain
15148,22,1552683600,15,5,20,Rain
15149,23,1552683600,0,0,0,Rain
15150,24,1552683600,5,15,20,Rain
15151,25,1552683600,27,3,30,Rain
15152,26,1552683600,10,10,20,Rain
15153,27,1552683600,7,13,20,Rain
15154,28,1552683600,26,4,30,Rain
15155,29,1552683600,7,22,29,Rain
15156,30,1552683600,20,0,20,Rain
15157,31,1552683600,19,1,20,Rain
15158,32,1552683600,13,17,30,Rain
15159,33,1552683600,6,17,23,Rain
15160,34,1552683600,10,20,30,Rain
15161,35,1552683600,21,9,30,Rain
15162,36,1552683600,38,2,40,Rain
15163,37,1552683600,30,0,30,Rain
15164,38,1552683600,6,34,40,Rain
15165,39,1552683600,17,3,20,Rain
15166,40,1552683600,21,0,21,Rain
15167,41,1552683600,20,0,20,Rain
15168,42,1552683600,7,23,30,Rain
15169,43,1552683600,21,9,30,Rain
15170,44,1552683600,12,18,30,Rain
15171,45,1552683600,11,19,30,Rain
15172,46,1552683600,0,20,20,Rain
15173,47,1552683600,40,0,40,Rain
15174,48,1552683600,16,24,40,Rain
15175,49,1552683600,10,30,40,Rain
15176,50,1552683600,31,9,40,Rain
15177,51,1552683600,30,10,40,Rain
15178,52,1552683600,32,0,32,Rain
15179,53,1552683600,40,0,40,Rain
15180,54,1552683600,33,0,33,Rain
15181,55,1552683600,35,1,36,Rain
15182,56,1552683600,40,0,40,Rain
15183,57,1552683600,23,0,23,Rain
15184,58,1552683600,33,7,40,Rain
15185,59,1552683600,18,2,20,Rain
15186,60,1552683600,0,30,30,Rain
15187,61,1552683600,24,1,25,Rain
15188,62,1552683600,38,2,40,Rain
15189,63,1552683600,20,14,34,Rain
15190,64,1552683600,22,18,40,Rain
15191,65,1552683600,35,5,40,Rain
15192,66,1552683600,37,3,40,Rain
15193,67,1552683600,18,22,40,Rain
15194,68,1552683600,25,15,40,Rain
15195,69,1552683600,20,20,40,Rain
15196,70,1552683600,17,11,28,Rain
15197,71,1552683600,38,2,40,Rain
15198,72,1552683600,25,6,31,Rain
15199,73,1552683600,9,21,30,Rain
15200,74,1552683600,16,14,30,Rain
15201,75,1552683600,35,5,40,Rain
15202,76,1552683600,10,28,38,Rain
15203,77,1552683600,28,1,29,Rain
15204,78,1552683600,35,5,40,Rain
15205,79,1552683600,8,19,27,Rain
15206,80,1552683600,36,4,40,Rain
15207,81,1552683600,26,14,40,Rain
15208,82,1552683600,13,9,22,Rain
15209,83,1552683600,23,17,40,Rain
15210,84,1552683600,15,15,30,Rain
15211,85,1552683600,19,16,35,Rain
15212,86,1552683600,8,30,38,Rain
15213,87,1552683600,21,17,38,Rain
15214,88,1552683600,17,13,30,Rain
15215,89,1552683600,40,0,40,Rain
15216,90,1552683600,39,1,40,Rain
15217,91,1552683600,11,18,29,Rain
15218,92,1552683600,11,29,40,Rain
15219,93,1552683600,1,39,40,Rain
15220,94,1552683600,34,6,40,Rain
15221,95,1552683600,16,24,40,Rain
15222,96,1552683600,23,7,30,Rain
15223,97,1552683600,28,12,40,Rain
15224,98,1552683600,22,18,40,Rain
15225,99,1552683600,12,18,30,Rain
15226,100,1552683600,13,12,25,Rain
15227,101,1552683600,23,7,30,Rain
15228,102,1552683600,26,14,40,Rain
15229,103,1552683600,24,16,40,Rain
15230,104,1552683600,40,0,40,Rain
15231,105,1552683600,32,4,36,Rain
15232,106,1552683600,36,4,40,Rain
15233,107,1552683600,32,8,40,Rain
15234,108,1552683600,31,9,40,Rain
15235,109,1552683600,12,17,29,Rain
15236,110,1552683600,37,3,40,Rain
15237,111,1552683600,36,4,40,Rain
15238,112,1552683600,9,21,30,Rain
15239,113,1552683600,0,0,0,Rain
15240,114,1552683600,39,1,40,Rain
15241,115,1552683600,16,14,30,Rain
15242,2,1552687200,14,6,20,Rain
15243,3,1552687200,18,2,20,Rain
15244,4,1552687200,18,2,20,Rain
15245,5,1552687200,23,17,40,Rain
15246,6,1552687200,10,10,20,Rain
15247,7,1552687200,6,23,29,Rain
15248,8,1552687200,21,9,30,Rain
15249,9,1552687200,4,20,24,Rain
15250,10,1552687200,2,14,16,Rain
15251,11,1552687200,30,0,30,Rain
15252,12,1552687200,15,5,20,Rain
15253,13,1552687200,28,2,30,Rain
15254,14,1552687200,0,30,30,Rain
15255,15,1552687200,16,0,16,Rain
15256,16,1552687200,15,5,20,Rain
15257,17,1552687200,20,0,20,Rain
15258,18,1552687200,22,8,30,Rain
15259,19,1552687200,24,6,30,Rain
15260,21,1552687200,19,11,30,Rain
15261,22,1552687200,18,2,20,Rain
15262,23,1552687200,0,0,0,Rain
15263,24,1552687200,2,18,20,Rain
15264,25,1552687200,28,2,30,Rain
15265,26,1552687200,9,11,20,Rain
15266,27,1552687200,8,12,20,Rain
15267,28,1552687200,27,3,30,Rain
15268,29,1552687200,2,27,29,Rain
15269,30,1552687200,19,1,20,Rain
15270,31,1552687200,20,0,20,Rain
15271,32,1552687200,17,13,30,Rain
15272,33,1552687200,5,18,23,Rain
15273,34,1552687200,6,24,30,Rain
15274,35,1552687200,20,10,30,Rain
15275,36,1552687200,25,15,40,Rain
15276,37,1552687200,30,0,30,Rain
15277,38,1552687200,1,39,40,Rain
15278,39,1552687200,20,0,20,Rain
15279,40,1552687200,19,2,21,Rain
15280,41,1552687200,20,0,20,Rain
15281,42,1552687200,5,25,30,Rain
15282,43,1552687200,20,10,30,Rain
15283,44,1552687200,10,20,30,Rain
15284,45,1552687200,12,18,30,Rain
15285,46,1552687200,4,16,20,Rain
15286,47,1552687200,39,1,40,Rain
15287,48,1552687200,16,24,40,Rain
15288,49,1552687200,9,31,40,Rain
15289,50,1552687200,27,13,40,Rain
15290,51,1552687200,30,10,40,Rain
15291,52,1552687200,31,1,32,Rain
15292,53,1552687200,40,0,40,Rain
15293,54,1552687200,32,1,33,Rain
15294,55,1552687200,36,0,36,Rain
15295,56,1552687200,37,3,40,Rain
15296,57,1552687200,23,0,23,Rain
15297,58,1552687200,33,7,40,Rain
15298,59,1552687200,15,5,20,Rain
15299,60,1552687200,2,28,30,Rain
15300,61,1552687200,22,3,25,Rain
15301,62,1552687200,38,2,40,Rain
15302,63,1552687200,20,14,34,Rain
15303,64,1552687200,21,19,40,Rain
15304,65,1552687200,40,0,40,Rain
15305,66,1552687200,31,9,40,Rain
15306,67,1552687200,17,23,40,Rain
15307,68,1552687200,31,9,40,Rain
15308,69,1552687200,17,23,40,Rain
15309,70,1552687200,18,10,28,Rain
15310,71,1552687200,35,5,40,Rain
15311,72,1552687200,26,5,31,Rain
15312,73,1552687200,9,21,30,Rain
15313,74,1552687200,14,16,30,Rain
15314,75,1552687200,39,1,40,Rain
15315,76,1552687200,9,29,38,Rain
15316,77,1552687200,28,1,29,Rain
15317,78,1552687200,35,5,40,Rain
15318,79,1552687200,8,19,27,Rain
15319,80,1552687200,35,5,40,Rain
15320,81,1552687200,26,14,40,Rain
15321,82,1552687200,12,10,22,Rain
15322,83,1552687200,20,20,40,Rain
15323,84,1552687200,14,16,30,Rain
15324,85,1552687200,16,19,35,Rain
15325,86,1552687200,6,32,38,Rain
15326,87,1552687200,19,19,38,Rain
15327,88,1552687200,18,12,30,Rain
15328,89,1552687200,39,1,40,Rain
15329,90,1552687200,40,0,40,Rain
15330,91,1552687200,6,23,29,Rain
15331,92,1552687200,10,30,40,Rain
15332,93,1552687200,1,39,40,Rain
15333,94,1552687200,34,6,40,Rain
15334,95,1552687200,19,21,40,Rain
15335,96,1552687200,20,10,30,Rain
15336,97,1552687200,28,12,40,Rain
15337,98,1552687200,25,15,40,Rain
15338,99,1552687200,12,18,30,Rain
15339,100,1552687200,10,15,25,Rain
15340,101,1552687200,18,12,30,Rain
15341,102,1552687200,25,15,40,Rain
15342,103,1552687200,25,15,40,Rain
15343,104,1552687200,40,0,40,Rain
15344,105,1552687200,34,2,36,Rain
15345,106,1552687200,36,4,40,Rain
15346,107,1552687200,31,9,40,Rain
15347,108,1552687200,32,8,40,Rain
15348,109,1552687200,14,15,29,Rain
15349,110,1552687200,32,8,40,Rain
15350,111,1552687200,32,8,40,Rain
15351,112,1552687200,0,30,30,Rain
15352,113,1552687200,0,0,0,Rain
15353,114,1552687200,40,0,40,Rain
15354,115,1552687200,12,18,30,Rain
15355,2,1552690800,13,7,20,Rain
15356,3,1552690800,16,4,20,Rain
15357,4,1552690800,20,0,20,Rain
15358,5,1552690800,24,16,40,Rain
15359,6,1552690800,10,10,20,Rain
15360,7,1552690800,8,21,29,Rain
15361,8,1552690800,19,11,30,Rain
15362,9,1552690800,0,24,24,Rain
15363,10,1552690800,0,16,16,Rain
15364,11,1552690800,30,0,30,Rain
15365,12,1552690800,13,7,20,Rain
15366,13,1552690800,20,10,30,Rain
15367,14,1552690800,1,29,30,Rain
15368,15,1552690800,14,2,16,Rain
15369,16,1552690800,14,6,20,Rain
15370,17,1552690800,20,0,20,Rain
15371,18,1552690800,21,9,30,Rain
15372,19,1552690800,29,1,30,Rain
15373,21,1552690800,23,7,30,Rain
15374,22,1552690800,19,1,20,Rain
15375,23,1552690800,0,0,0,Rain
15376,24,1552690800,1,19,20,Rain
15377,25,1552690800,30,0,30,Rain
15378,26,1552690800,13,7,20,Rain
15379,27,1552690800,10,10,20,Rain
15380,28,1552690800,26,4,30,Rain
15381,29,1552690800,1,28,29,Rain
15382,30,1552690800,19,1,20,Rain
15383,31,1552690800,17,3,20,Rain
15384,32,1552690800,18,12,30,Rain
15385,33,1552690800,10,13,23,Rain
15386,34,1552690800,19,11,30,Rain
15387,35,1552690800,22,8,30,Rain
15388,36,1552690800,24,16,40,Rain
15389,37,1552690800,30,0,30,Rain
15390,38,1552690800,0,40,40,Rain
15391,39,1552690800,20,0,20,Rain
15392,40,1552690800,20,1,21,Rain
15393,41,1552690800,20,0,20,Rain
15394,42,1552690800,4,26,30,Rain
15395,43,1552690800,18,12,30,Rain
15396,44,1552690800,4,26,30,Rain
15397,45,1552690800,10,20,30,Rain
15398,46,1552690800,0,20,20,Rain
15399,47,1552690800,40,0,40,Rain
15400,48,1552690800,16,24,40,Rain
15401,49,1552690800,11,29,40,Rain
15402,50,1552690800,26,14,40,Rain
15403,51,1552690800,30,10,40,Rain
15404,52,1552690800,32,0,32,Rain
15405,53,1552690800,40,0,40,Rain
15406,54,1552690800,30,3,33,Rain
15407,55,1552690800,36,0,36,Rain
15408,56,1552690800,34,6,40,Rain
15409,57,1552690800,23,0,23,Rain
15410,58,1552690800,40,0,40,Rain
15411,59,1552690800,15,5,20,Rain
15412,60,1552690800,0,30,30,Rain
15413,61,1552690800,20,5,25,Rain
15414,62,1552690800,40,0,40,Rain
15415,63,1552690800,23,12,35,Rain
15416,64,1552690800,20,20,40,Rain
15417,65,1552690800,40,0,40,Rain
15418,66,1552690800,31,9,40,Rain
15419,67,1552690800,17,23,40,Rain
15420,68,1552690800,33,7,40,Rain
15421,69,1552690800,18,22,40,Rain
15422,70,1552690800,26,2,28,Rain
15423,71,1552690800,34,6,40,Rain
15424,72,1552690800,29,2,31,Rain
15425,73,1552690800,7,23,30,Rain
15426,74,1552690800,14,16,30,Rain
15427,75,1552690800,39,1,40,Rain
15428,76,1552690800,9,29,38,Rain
15429,77,1552690800,25,4,29,Rain
15430,78,1552690800,32,8,40,Rain
15431,79,1552690800,8,19,27,Rain
15432,80,1552690800,34,6,40,Rain
15433,81,1552690800,27,13,40,Rain
15434,82,1552690800,12,10,22,Rain
15435,83,1552690800,18,22,40,Rain
15436,84,1552690800,11,19,30,Rain
15437,85,1552690800,14,21,35,Rain
15438,86,1552690800,12,26,38,Rain
15439,87,1552690800,18,20,38,Rain
15440,88,1552690800,18,12,30,Rain
15441,89,1552690800,31,9,40,Rain
15442,90,1552690800,39,1,40,Rain
15443,91,1552690800,20,10,30,Rain
15444,92,1552690800,17,23,40,Rain
15445,93,1552690800,1,39,40,Rain
15446,94,1552690800,34,6,40,Rain
15447,95,1552690800,20,20,40,Rain
15448,96,1552690800,18,12,30,Rain
15449,97,1552690800,27,13,40,Rain
15450,98,1552690800,25,15,40,Rain
15451,99,1552690800,16,14,30,Rain
15452,100,1552690800,10,15,25,Rain
15453,101,1552690800,15,15,30,Rain
15454,102,1552690800,25,15,40,Rain
15455,103,1552690800,26,14,40,Rain
15456,104,1552690800,40,0,40,Rain
15457,105,1552690800,33,3,36,Rain
15458,106,1552690800,35,5,40,Rain
15459,107,1552690800,30,10,40,Rain
15460,108,1552690800,30,10,40,Rain
15461,109,1552690800,15,14,29,Rain
15462,110,1552690800,33,7,40,Rain
15463,111,1552690800,28,12,40,Rain
15464,112,1552690800,0,30,30,Rain
15465,113,1552690800,0,0,0,Rain
15466,114,1552690800,39,1,40,Rain
15467,115,1552690800,9,21,30,Rain
15468,2,1552694400,14,6,20,Rain
15469,3,1552694400,18,2,20,Rain
15470,4,1552694400,20,0,20,Rain
15471,5,1552694400,25,15,40,Rain
15472,6,1552694400,11,9,20,Rain
15473,7,1552694400,6,23,29,Rain
15474,8,1552694400,20,10,30,Rain
15475,9,1552694400,0,24,24,Rain
15476,10,1552694400,1,15,16,Rain
15477,11,1552694400,30,0,30,Rain
15478,12,1552694400,13,7,20,Rain
15479,13,1552694400,20,10,30,Rain
15480,14,1552694400,0,30,30,Rain
15481,15,1552694400,12,4,16,Rain
15482,16,1552694400,19,1,20,Rain
15483,17,1552694400,19,1,20,Rain
15484,18,1552694400,22,8,30,Rain
15485,19,1552694400,28,2,30,Rain
15486,21,1552694400,26,4,30,Rain
15487,22,1552694400,16,4,20,Rain
15488,23,1552694400,0,0,0,Rain
15489,24,1552694400,3,17,20,Rain
15490,25,1552694400,30,0,30,Rain
15491,26,1552694400,14,6,20,Rain
15492,27,1552694400,10,10,20,Rain
15493,28,1552694400,24,6,30,Rain
15494,29,1552694400,4,25,29,Rain
15495,30,1552694400,18,2,20,Rain
15496,31,1552694400,17,3,20,Rain
15497,32,1552694400,22,8,30,Rain
15498,33,1552694400,9,14,23,Rain
15499,34,1552694400,25,5,30,Rain
15500,35,1552694400,24,6,30,Rain
15501,36,1552694400,23,17,40,Rain
15502,37,1552694400,30,0,30,Rain
15503,38,1552694400,2,38,40,Rain
15504,39,1552694400,17,3,20,Rain
15505,40,1552694400,19,2,21,Rain
15506,41,1552694400,20,0,20,Rain
15507,42,1552694400,3,27,30,Rain
15508,43,1552694400,15,15,30,Rain
15509,44,1552694400,2,28,30,Rain
15510,45,1552694400,9,21,30,Rain
15511,46,1552694400,0,20,20,Rain
15512,47,1552694400,40,0,40,Rain
15513,48,1552694400,18,22,40,Rain
15514,49,1552694400,13,27,40,Rain
15515,50,1552694400,27,13,40,Rain
15516,51,1552694400,28,12,40,Rain
15517,52,1552694400,31,1,32,Rain
15518,53,1552694400,40,0,40,Rain
15519,54,1552694400,30,3,33,Rain
15520,55,1552694400,36,0,36,Rain
15521,56,1552694400,29,11,40,Rain
15522,57,1552694400,20,3,23,Rain
15523,58,1552694400,30,10,40,Rain
15524,59,1552694400,14,6,20,Rain
15525,60,1552694400,0,30,30,Rain
15526,61,1552694400,22,3,25,Rain
15527,62,1552694400,39,1,40,Rain
15528,63,1552694400,24,11,35,Rain
15529,64,1552694400,23,17,40,Rain
15530,65,1552694400,40,0,40,Rain
15531,66,1552694400,29,11,40,Rain
15532,67,1552694400,17,23,40,Rain
15533,68,1552694400,32,8,40,Rain
15534,69,1552694400,21,19,40,Rain
15535,70,1552694400,25,3,28,Rain
15536,71,1552694400,32,7,39,Rain
15537,72,1552694400,27,4,31,Rain
15538,73,1552694400,10,20,30,Rain
15539,74,1552694400,14,16,30,Rain
15540,75,1552694400,39,1,40,Rain
15541,76,1552694400,9,29,38,Rain
15542,77,1552694400,23,6,29,Rain
15543,78,1552694400,29,11,40,Rain
15544,79,1552694400,8,19,27,Rain
15545,80,1552694400,16,24,40,Rain
15546,81,1552694400,27,13,40,Rain
15547,82,1552694400,11,11,22,Rain
15548,83,1552694400,18,22,40,Rain
15549,84,1552694400,11,19,30,Rain
15550,85,1552694400,13,22,35,Rain
15551,86,1552694400,14,24,38,Rain
15552,87,1552694400,17,21,38,Rain
15553,88,1552694400,16,14,30,Rain
15554,89,1552694400,29,11,40,Rain
15555,90,1552694400,33,7,40,Rain
15556,91,1552694400,22,8,30,Rain
15557,92,1552694400,17,23,40,Rain
15558,93,1552694400,1,39,40,Rain
15559,94,1552694400,34,6,40,Rain
15560,95,1552694400,19,21,40,Rain
15561,96,1552694400,18,12,30,Rain
15562,97,1552694400,27,13,40,Rain
15563,98,1552694400,26,14,40,Rain
15564,99,1552694400,16,14,30,Rain
15565,100,1552694400,10,15,25,Rain
15566,101,1552694400,15,15,30,Rain
15567,102,1552694400,24,16,40,Rain
15568,103,1552694400,26,14,40,Rain
15569,104,1552694400,40,0,40,Rain
15570,105,1552694400,33,3,36,Rain
15571,106,1552694400,34,6,40,Rain
15572,107,1552694400,32,8,40,Rain
15573,108,1552694400,29,11,40,Rain
15574,109,1552694400,14,15,29,Rain
15575,110,1552694400,31,9,40,Rain
15576,111,1552694400,25,15,40,Rain
15577,112,1552694400,0,30,30,Rain
15578,113,1552694400,0,0,0,Rain
15579,114,1552694400,36,4,40,Rain
15580,115,1552694400,8,22,30,Rain
15581,2,1552698000,14,6,20,Rain
15582,3,1552698000,16,4,20,Rain
15583,4,1552698000,20,0,20,Rain
15584,5,1552698000,25,15,40,Rain
15585,6,1552698000,16,4,20,Rain
15586,7,1552698000,6,23,29,Rain
15587,8,1552698000,22,8,30,Rain
15588,9,1552698000,9,15,24,Rain
15589,10,1552698000,2,14,16,Rain
15590,11,1552698000,30,0,30,Rain
15591,12,1552698000,13,7,20,Rain
15592,13,1552698000,20,10,30,Rain
15593,14,1552698000,1,29,30,Rain
15594,15,1552698000,11,5,16,Rain
15595,16,1552698000,19,1,20,Rain
15596,17,1552698000,19,1,20,Rain
15597,18,1552698000,23,7,30,Rain
15598,19,1552698000,30,0,30,Rain
15599,21,1552698000,30,0,30,Rain
15600,22,1552698000,15,5,20,Rain
15601,23,1552698000,0,0,0,Rain
15602,24,1552698000,1,19,20,Rain
15603,25,1552698000,30,0,30,Rain
15604,26,1552698000,16,4,20,Rain
15605,27,1552698000,11,9,20,Rain
15606,28,1552698000,22,8,30,Rain
15607,29,1552698000,2,27,29,Rain
15608,30,1552698000,19,1,20,Rain
15609,31,1552698000,17,3,20,Rain
15610,32,1552698000,21,9,30,Rain
15611,33,1552698000,5,18,23,Rain
15612,34,1552698000,29,1,30,Rain
15613,35,1552698000,27,3,30,Rain
15614,36,1552698000,25,15,40,Rain
15615,37,1552698000,29,1,30,Rain
15616,38,1552698000,2,38,40,Rain
15617,39,1552698000,17,3,20,Rain
15618,40,1552698000,20,1,21,Rain
15619,41,1552698000,20,0,20,Rain
15620,42,1552698000,3,27,30,Rain
15621,43,1552698000,13,17,30,Rain
15622,44,1552698000,1,29,30,Rain
15623,45,1552698000,9,21,30,Rain
15624,46,1552698000,4,16,20,Rain
15625,47,1552698000,40,0,40,Rain
15626,48,1552698000,21,19,40,Rain
15627,49,1552698000,12,28,40,Rain
15628,50,1552698000,22,18,40,Rain
15629,51,1552698000,30,10,40,Rain
15630,52,1552698000,28,4,32,Rain
15631,53,1552698000,39,1,40,Rain
15632,54,1552698000,31,2,33,Rain
15633,55,1552698000,36,0,36,Rain
15634,56,1552698000,31,9,40,Rain
15635,57,1552698000,19,4,23,Rain
15636,58,1552698000,30,10,40,Rain
15637,59,1552698000,12,8,20,Rain
15638,60,1552698000,0,30,30,Rain
15639,61,1552698000,22,3,25,Rain
15640,62,1552698000,40,0,40,Rain
15641,63,1552698000,25,10,35,Rain
15642,64,1552698000,24,16,40,Rain
15643,65,1552698000,39,1,40,Rain
15644,66,1552698000,28,12,40,Rain
15645,67,1552698000,18,22,40,Rain
15646,68,1552698000,31,9,40,Rain
15647,69,1552698000,22,18,40,Rain
15648,70,1552698000,21,7,28,Rain
15649,71,1552698000,34,5,39,Rain
15650,72,1552698000,24,7,31,Rain
15651,73,1552698000,7,23,30,Rain
15652,74,1552698000,14,16,30,Rain
15653,75,1552698000,39,1,40,Rain
15654,76,1552698000,9,29,38,Rain
15655,77,1552698000,22,7,29,Rain
15656,78,1552698000,28,12,40,Rain
15657,79,1552698000,8,19,27,Rain
15658,80,1552698000,13,27,40,Rain
15659,81,1552698000,27,13,40,Rain
15660,82,1552698000,11,11,22,Rain
15661,83,1552698000,19,21,40,Rain
15662,84,1552698000,11,19,30,Rain
15663,85,1552698000,10,25,35,Rain
15664,86,1552698000,15,23,38,Rain
15665,87,1552698000,15,23,38,Rain
15666,88,1552698000,14,16,30,Rain
15667,89,1552698000,30,10,40,Rain
15668,90,1552698000,33,7,40,Rain
15669,91,1552698000,22,8,30,Rain
15670,92,1552698000,16,24,40,Rain
15671,93,1552698000,1,39,40,Rain
15672,94,1552698000,34,6,40,Rain
15673,95,1552698000,19,21,40,Rain
15674,96,1552698000,17,13,30,Rain
15675,97,1552698000,26,14,40,Rain
15676,98,1552698000,25,15,40,Rain
15677,99,1552698000,17,13,30,Rain
15678,100,1552698000,10,15,25,Rain
15679,101,1552698000,16,14,30,Rain
15680,102,1552698000,25,15,40,Rain
15681,103,1552698000,26,14,40,Rain
15682,104,1552698000,40,0,40,Rain
15683,105,1552698000,33,3,36,Rain
15684,106,1552698000,34,6,40,Rain
15685,107,1552698000,31,9,40,Rain
15686,108,1552698000,29,11,40,Rain
15687,109,1552698000,14,15,29,Rain
15688,110,1552698000,30,10,40,Rain
15689,111,1552698000,21,19,40,Rain
15690,112,1552698000,0,30,30,Rain
15691,113,1552698000,0,0,0,Rain
15692,114,1552698000,39,1,40,Rain
15693,115,1552698000,8,22,30,Rain
15694,2,1552701600,15,5,20,Rain
15695,3,1552701600,16,4,20,Rain
15696,4,1552701600,20,0,20,Rain
15697,5,1552701600,26,14,40,Rain
15698,6,1552701600,18,2,20,Rain
15699,7,1552701600,7,22,29,Rain
15700,8,1552701600,21,9,30,Rain
15701,9,1552701600,12,12,24,Rain
15702,10,1552701600,1,15,16,Rain
15703,11,1552701600,30,0,30,Rain
15704,12,1552701600,14,6,20,Rain
15705,13,1552701600,20,10,30,Rain
15706,14,1552701600,4,26,30,Rain
15707,15,1552701600,9,7,16,Rain
15708,16,1552701600,19,1,20,Rain
15709,17,1552701600,19,1,20,Rain
15710,18,1552701600,21,9,30,Rain
15711,19,1552701600,29,1,30,Rain
15712,21,1552701600,30,0,30,Rain
15713,22,1552701600,18,2,20,Rain
15714,23,1552701600,0,0,0,Rain
15715,24,1552701600,0,20,20,Rain
15716,25,1552701600,30,0,30,Rain
15717,26,1552701600,17,3,20,Rain
15718,27,1552701600,12,8,20,Rain
15719,28,1552701600,22,8,30,Rain
15720,29,1552701600,2,27,29,Rain
15721,30,1552701600,19,1,20,Rain
15722,31,1552701600,18,2,20,Rain
15723,32,1552701600,22,8,30,Rain
15724,33,1552701600,6,17,23,Rain
15725,34,1552701600,27,3,30,Rain
15726,35,1552701600,27,3,30,Rain
15727,36,1552701600,26,14,40,Rain
15728,37,1552701600,29,1,30,Rain
15729,38,1552701600,3,37,40,Rain
15730,39,1552701600,18,2,20,Rain
15731,40,1552701600,19,2,21,Rain
15732,41,1552701600,20,0,20,Rain
15733,42,1552701600,1,29,30,Rain
15734,43,1552701600,13,17,30,Rain
15735,44,1552701600,0,30,30,Rain
15736,45,1552701600,8,22,30,Rain
15737,46,1552701600,4,16,20,Rain
15738,47,1552701600,40,0,40,Rain
15739,48,1552701600,20,20,40,Rain
15740,49,1552701600,12,28,40,Rain
15741,50,1552701600,21,19,40,Rain
15742,51,1552701600,30,10,40,Rain
15743,52,1552701600,27,5,32,Rain
15744,53,1552701600,39,1,40,Rain
15745,54,1552701600,32,1,33,Rain
15746,55,1552701600,36,0,36,Rain
15747,56,1552701600,32,8,40,Rain
15748,57,1552701600,19,4,23,Rain
15749,58,1552701600,31,9,40,Rain
15750,59,1552701600,12,8,20,Rain
15751,60,1552701600,0,30,30,Rain
15752,61,1552701600,22,3,25,Rain
15753,62,1552701600,40,0,40,Rain
15754,63,1552701600,25,10,35,Rain
15755,64,1552701600,24,16,40,Rain
15756,65,1552701600,39,1,40,Rain
15757,66,1552701600,27,13,40,Rain
15758,67,1552701600,18,22,40,Rain
15759,68,1552701600,33,7,40,Rain
15760,69,1552701600,22,18,40,Rain
15761,70,1552701600,20,8,28,Rain
15762,71,1552701600,35,4,39,Rain
15763,72,1552701600,24,7,31,Rain
15764,73,1552701600,7,23,30,Rain
15765,74,1552701600,14,16,30,Rain
15766,75,1552701600,37,3,40,Rain
15767,76,1552701600,8,30,38,Rain
15768,77,1552701600,23,6,29,Rain
15769,78,1552701600,26,14,40,Rain
15770,79,1552701600,8,19,27,Rain
15771,80,1552701600,13,27,40,Rain
15772,81,1552701600,27,13,40,Rain
15773,82,1552701600,11,11,22,Rain
15774,83,1552701600,20,20,40,Rain
15775,84,1552701600,11,19,30,Rain
15776,85,1552701600,9,26,35,Rain
15777,86,1552701600,15,23,38,Rain
15778,87,1552701600,14,24,38,Rain
15779,88,1552701600,14,16,30,Rain
15780,89,1552701600,30,10,40,Rain
15781,90,1552701600,33,7,40,Rain
15782,91,1552701600,17,13,30,Rain
15783,92,1552701600,16,24,40,Rain
15784,93,1552701600,1,39,40,Rain
15785,94,1552701600,34,6,40,Rain
15786,95,1552701600,20,20,40,Rain
15787,96,1552701600,17,13,30,Rain
15788,97,1552701600,26,14,40,Rain
15789,98,1552701600,25,15,40,Rain
15790,99,1552701600,17,13,30,Rain
15791,100,1552701600,10,15,25,Rain
15792,101,1552701600,16,14,30,Rain
15793,102,1552701600,25,15,40,Rain
15794,103,1552701600,26,14,40,Rain
15795,104,1552701600,40,0,40,Rain
15796,105,1552701600,32,4,36,Rain
15797,106,1552701600,34,6,40,Rain
15798,107,1552701600,29,11,40,Rain
15799,108,1552701600,29,11,40,Rain
15800,109,1552701600,13,16,29,Rain
15801,110,1552701600,31,9,40,Rain
15802,111,1552701600,14,26,40,Rain
15803,112,1552701600,0,30,30,Rain
15804,113,1552701600,0,0,0,Rain
15805,114,1552701600,39,1,40,Rain
15806,115,1552701600,8,22,30,Rain
15807,2,1552705200,15,5,20,Rain
15808,3,1552705200,16,4,20,Rain
15809,4,1552705200,20,0,20,Rain
15810,5,1552705200,26,14,40,Rain
15811,6,1552705200,18,2,20,Rain
15812,7,1552705200,7,22,29,Rain
15813,8,1552705200,21,9,30,Rain
15814,9,1552705200,12,12,24,Rain
15815,10,1552705200,1,15,16,Rain
15816,11,1552705200,30,0,30,Rain
15817,12,1552705200,14,6,20,Rain
15818,13,1552705200,20,10,30,Rain
15819,14,1552705200,4,26,30,Rain
15820,15,1552705200,9,7,16,Rain
15821,16,1552705200,19,1,20,Rain
15822,17,1552705200,19,1,20,Rain
15823,18,1552705200,21,9,30,Rain
15824,19,1552705200,29,1,30,Rain
15825,21,1552705200,30,0,30,Rain
15826,22,1552705200,18,2,20,Rain
15827,23,1552705200,0,0,0,Rain
15828,24,1552705200,0,20,20,Rain
15829,25,1552705200,30,0,30,Rain
15830,26,1552705200,17,3,20,Rain
15831,27,1552705200,12,8,20,Rain
15832,28,1552705200,22,8,30,Rain
15833,29,1552705200,2,27,29,Rain
15834,30,1552705200,19,1,20,Rain
15835,31,1552705200,18,2,20,Rain
15836,32,1552705200,22,8,30,Rain
15837,33,1552705200,6,17,23,Rain
15838,34,1552705200,27,3,30,Rain
15839,35,1552705200,27,3,30,Rain
15840,36,1552705200,26,14,40,Rain
15841,37,1552705200,29,1,30,Rain
15842,38,1552705200,3,37,40,Rain
15843,39,1552705200,18,2,20,Rain
15844,40,1552705200,19,2,21,Rain
15845,41,1552705200,20,0,20,Rain
15846,42,1552705200,1,29,30,Rain
15847,43,1552705200,13,17,30,Rain
15848,44,1552705200,0,30,30,Rain
15849,45,1552705200,8,22,30,Rain
15850,46,1552705200,4,16,20,Rain
15851,47,1552705200,40,0,40,Rain
15852,48,1552705200,20,20,40,Rain
15853,49,1552705200,12,28,40,Rain
15854,50,1552705200,21,19,40,Rain
15855,51,1552705200,30,10,40,Rain
15856,52,1552705200,27,5,32,Rain
15857,53,1552705200,39,1,40,Rain
15858,54,1552705200,32,1,33,Rain
15859,55,1552705200,36,0,36,Rain
15860,56,1552705200,32,8,40,Rain
15861,57,1552705200,19,4,23,Rain
15862,58,1552705200,31,9,40,Rain
15863,59,1552705200,12,8,20,Rain
15864,60,1552705200,0,30,30,Rain
15865,61,1552705200,22,3,25,Rain
15866,62,1552705200,40,0,40,Rain
15867,63,1552705200,25,10,35,Rain
15868,64,1552705200,24,16,40,Rain
15869,65,1552705200,39,1,40,Rain
15870,66,1552705200,27,13,40,Rain
15871,67,1552705200,18,22,40,Rain
15872,68,1552705200,33,7,40,Rain
15873,69,1552705200,22,18,40,Rain
15874,70,1552705200,20,8,28,Rain
15875,71,1552705200,35,4,39,Rain
15876,72,1552705200,24,7,31,Rain
15877,73,1552705200,7,23,30,Rain
15878,74,1552705200,14,16,30,Rain
15879,75,1552705200,37,3,40,Rain
15880,76,1552705200,8,30,38,Rain
15881,77,1552705200,23,6,29,Rain
15882,78,1552705200,26,14,40,Rain
15883,79,1552705200,8,19,27,Rain
15884,80,1552705200,13,27,40,Rain
15885,81,1552705200,27,13,40,Rain
15886,82,1552705200,11,11,22,Rain
15887,83,1552705200,20,20,40,Rain
15888,84,1552705200,11,19,30,Rain
15889,85,1552705200,9,26,35,Rain
15890,86,1552705200,15,23,38,Rain
15891,87,1552705200,14,24,38,Rain
15892,88,1552705200,14,16,30,Rain
15893,89,1552705200,30,10,40,Rain
15894,90,1552705200,33,7,40,Rain
15895,91,1552705200,17,13,30,Rain
15896,92,1552705200,16,24,40,Rain
15897,93,1552705200,1,39,40,Rain
15898,94,1552705200,34,6,40,Rain
15899,95,1552705200,20,20,40,Rain
15900,96,1552705200,17,13,30,Rain
15901,97,1552705200,26,14,40,Rain
15902,98,1552705200,25,15,40,Rain
15903,99,1552705200,17,13,30,Rain
15904,100,1552705200,10,15,25,Rain
15905,101,1552705200,16,14,30,Rain
15906,102,1552705200,25,15,40,Rain
15907,103,1552705200,26,14,40,Rain
15908,104,1552705200,40,0,40,Rain
15909,105,1552705200,32,4,36,Rain
15910,106,1552705200,34,6,40,Rain
15911,107,1552705200,29,11,40,Rain
15912,108,1552705200,29,11,40,Rain
15913,109,1552705200,13,16,29,Rain
15914,110,1552705200,31,9,40,Rain
15915,111,1552705200,14,26,40,Rain
15916,112,1552705200,0,30,30,Rain
15917,113,1552705200,0,0,0,Rain
15918,114,1552705200,39,1,40,Rain
15919,115,1552705200,8,22,30,Rain
15920,2,1552708800,15,5,20,Rain
15921,3,1552708800,16,4,20,Rain
15922,4,1552708800,20,0,20,Rain
15923,5,1552708800,26,14,40,Rain
15924,6,1552708800,18,2,20,Rain
15925,7,1552708800,7,22,29,Rain
15926,8,1552708800,21,9,30,Rain
15927,9,1552708800,12,12,24,Rain
15928,10,1552708800,1,15,16,Rain
15929,11,1552708800,30,0,30,Rain
15930,12,1552708800,14,6,20,Rain
15931,13,1552708800,20,10,30,Rain
15932,14,1552708800,4,26,30,Rain
15933,15,1552708800,9,7,16,Rain
15934,16,1552708800,19,1,20,Rain
15935,17,1552708800,19,1,20,Rain
15936,18,1552708800,21,9,30,Rain
15937,19,1552708800,29,1,30,Rain
15938,21,1552708800,30,0,30,Rain
15939,22,1552708800,18,2,20,Rain
15940,23,1552708800,0,0,0,Rain
15941,24,1552708800,0,20,20,Rain
15942,25,1552708800,30,0,30,Rain
15943,26,1552708800,17,3,20,Rain
15944,27,1552708800,12,8,20,Rain
15945,28,1552708800,22,8,30,Rain
15946,29,1552708800,2,27,29,Rain
15947,30,1552708800,19,1,20,Rain
15948,31,1552708800,18,2,20,Rain
15949,32,1552708800,22,8,30,Rain
15950,33,1552708800,6,17,23,Rain
15951,34,1552708800,27,3,30,Rain
15952,35,1552708800,27,3,30,Rain
15953,36,1552708800,26,14,40,Rain
15954,37,1552708800,29,1,30,Rain
15955,38,1552708800,3,37,40,Rain
15956,39,1552708800,18,2,20,Rain
15957,40,1552708800,19,2,21,Rain
15958,41,1552708800,20,0,20,Rain
15959,42,1552708800,1,29,30,Rain
15960,43,1552708800,13,17,30,Rain
15961,44,1552708800,0,30,30,Rain
15962,45,1552708800,8,22,30,Rain
15963,46,1552708800,4,16,20,Rain
15964,47,1552708800,40,0,40,Rain
15965,48,1552708800,19,21,40,Rain
15966,49,1552708800,12,28,40,Rain
15967,50,1552708800,21,19,40,Rain
15968,51,1552708800,30,10,40,Rain
15969,52,1552708800,27,5,32,Rain
15970,53,1552708800,39,1,40,Rain
15971,54,1552708800,32,1,33,Rain
15972,55,1552708800,36,0,36,Rain
15973,56,1552708800,32,8,40,Rain
15974,57,1552708800,19,4,23,Rain
15975,58,1552708800,31,9,40,Rain
15976,59,1552708800,12,8,20,Rain
15977,60,1552708800,0,30,30,Rain
15978,61,1552708800,22,3,25,Rain
15979,62,1552708800,40,0,40,Rain
15980,63,1552708800,25,10,35,Rain
15981,64,1552708800,24,16,40,Rain
15982,65,1552708800,39,1,40,Rain
15983,66,1552708800,27,13,40,Rain
15984,67,1552708800,18,22,40,Rain
15985,68,1552708800,33,7,40,Rain
15986,69,1552708800,22,18,40,Rain
15987,70,1552708800,20,8,28,Rain
15988,71,1552708800,35,4,39,Rain
15989,72,1552708800,24,7,31,Rain
15990,73,1552708800,7,23,30,Rain
15991,74,1552708800,14,16,30,Rain
15992,75,1552708800,37,3,40,Rain
15993,76,1552708800,8,30,38,Rain
15994,77,1552708800,23,6,29,Rain
15995,78,1552708800,26,14,40,Rain
15996,79,1552708800,8,19,27,Rain
15997,80,1552708800,13,27,40,Rain
15998,81,1552708800,27,13,40,Rain
15999,82,1552708800,11,11,22,Rain
16000,83,1552708800,20,20,40,Rain
16001,84,1552708800,11,19,30,Rain
16002,85,1552708800,9,26,35,Rain
16003,86,1552708800,15,23,38,Rain
16004,87,1552708800,14,24,38,Rain
16005,88,1552708800,14,16,30,Rain
16006,89,1552708800,30,10,40,Rain
16007,90,1552708800,33,7,40,Rain
16008,91,1552708800,17,13,30,Rain
16009,92,1552708800,16,24,40,Rain
16010,93,1552708800,1,39,40,Rain
16011,94,1552708800,34,6,40,Rain
16012,95,1552708800,20,20,40,Rain
16013,96,1552708800,17,13,30,Rain
16014,97,1552708800,26,14,40,Rain
16015,98,1552708800,25,15,40,Rain
16016,99,1552708800,17,13,30,Rain
16017,100,1552708800,10,15,25,Rain
16018,101,1552708800,16,14,30,Rain
16019,102,1552708800,25,15,40,Rain
16020,103,1552708800,26,14,40,Rain
16021,104,1552708800,40,0,40,Rain
16022,105,1552708800,32,4,36,Rain
16023,106,1552708800,34,6,40,Rain
16024,107,1552708800,29,11,40,Rain
16025,108,1552708800,29,11,40,Rain
16026,109,1552708800,13,16,29,Rain
16027,110,1552708800,31,9,40,Rain
16028,111,1552708800,13,27,40,Rain
16029,112,1552708800,0,30,30,Rain
16030,113,1552708800,0,0,0,Rain
16031,114,1552708800,39,1,40,Rain
16032,115,1552708800,8,22,30,Rain
16033,2,1552712400,15,5,20,Rain
16034,3,1552712400,16,4,20,Rain
16035,4,1552712400,20,0,20,Rain
16036,5,1552712400,26,14,40,Rain
16037,6,1552712400,18,2,20,Rain
16038,7,1552712400,7,22,29,Rain
16039,8,1552712400,21,9,30,Rain
16040,9,1552712400,12,12,24,Rain
16041,10,1552712400,1,15,16,Rain
16042,11,1552712400,30,0,30,Rain
16043,12,1552712400,14,6,20,Rain
16044,13,1552712400,20,10,30,Rain
16045,14,1552712400,4,26,30,Rain
16046,15,1552712400,9,7,16,Rain
16047,16,1552712400,19,1,20,Rain
16048,17,1552712400,19,1,20,Rain
16049,18,1552712400,21,9,30,Rain
16050,19,1552712400,29,1,30,Rain
16051,21,1552712400,30,0,30,Rain
16052,22,1552712400,18,2,20,Rain
16053,23,1552712400,0,0,0,Rain
16054,24,1552712400,0,20,20,Rain
16055,25,1552712400,0,0,0,Rain
16056,26,1552712400,17,3,20,Rain
16057,27,1552712400,12,8,20,Rain
16058,28,1552712400,21,9,30,Rain
16059,29,1552712400,2,27,29,Rain
16060,30,1552712400,19,1,20,Rain
16061,31,1552712400,18,2,20,Rain
16062,32,1552712400,22,8,30,Rain
16063,33,1552712400,6,17,23,Rain
16064,34,1552712400,27,3,30,Rain
16065,35,1552712400,27,3,30,Rain
16066,36,1552712400,26,14,40,Rain
16067,37,1552712400,29,1,30,Rain
16068,38,1552712400,3,37,40,Rain
16069,39,1552712400,18,2,20,Rain
16070,40,1552712400,19,2,21,Rain
16071,41,1552712400,20,0,20,Rain
16072,42,1552712400,1,29,30,Rain
16073,43,1552712400,13,17,30,Rain
16074,44,1552712400,0,30,30,Rain
16075,45,1552712400,8,22,30,Rain
16076,46,1552712400,4,16,20,Rain
16077,47,1552712400,40,0,40,Rain
16078,48,1552712400,19,21,40,Rain
16079,49,1552712400,12,28,40,Rain
16080,50,1552712400,21,19,40,Rain
16081,51,1552712400,30,10,40,Rain
16082,52,1552712400,27,5,32,Rain
16083,53,1552712400,39,1,40,Rain
16084,54,1552712400,32,1,33,Rain
16085,55,1552712400,36,0,36,Rain
16086,56,1552712400,32,8,40,Rain
16087,57,1552712400,19,4,23,Rain
16088,58,1552712400,31,9,40,Rain
16089,59,1552712400,12,8,20,Rain
16090,60,1552712400,0,30,30,Rain
16091,61,1552712400,22,3,25,Rain
16092,62,1552712400,40,0,40,Rain
16093,63,1552712400,25,10,35,Rain
16094,64,1552712400,24,16,40,Rain
16095,65,1552712400,39,1,40,Rain
16096,66,1552712400,27,13,40,Rain
16097,67,1552712400,18,22,40,Rain
16098,68,1552712400,33,7,40,Rain
16099,69,1552712400,22,18,40,Rain
16100,70,1552712400,20,8,28,Rain
16101,71,1552712400,35,4,39,Rain
16102,72,1552712400,24,7,31,Rain
16103,73,1552712400,7,23,30,Rain
16104,74,1552712400,14,16,30,Rain
16105,75,1552712400,37,3,40,Rain
16106,76,1552712400,8,30,38,Rain
16107,77,1552712400,23,6,29,Rain
16108,78,1552712400,26,14,40,Rain
16109,79,1552712400,8,19,27,Rain
16110,80,1552712400,13,27,40,Rain
16111,81,1552712400,27,13,40,Rain
16112,82,1552712400,11,11,22,Rain
16113,83,1552712400,20,20,40,Rain
16114,84,1552712400,11,19,30,Rain
16115,85,1552712400,9,26,35,Rain
16116,86,1552712400,15,23,38,Rain
16117,87,1552712400,14,24,38,Rain
16118,88,1552712400,14,16,30,Rain
16119,89,1552712400,30,10,40,Rain
16120,90,1552712400,33,7,40,Rain
16121,91,1552712400,17,13,30,Rain
16122,92,1552712400,16,24,40,Rain
16123,93,1552712400,1,39,40,Rain
16124,94,1552712400,34,6,40,Rain
16125,95,1552712400,20,20,40,Rain
16126,96,1552712400,17,13,30,Rain
16127,97,1552712400,26,14,40,Rain
16128,98,1552712400,25,15,40,Rain
16129,99,1552712400,17,13,30,Rain
16130,100,1552712400,10,15,25,Rain
16131,101,1552712400,16,14,30,Rain
16132,102,1552712400,25,15,40,Rain
16133,103,1552712400,26,14,40,Rain
16134,104,1552712400,40,0,40,Rain
16135,105,1552712400,32,4,36,Rain
16136,106,1552712400,34,6,40,Rain
16137,107,1552712400,29,11,40,Rain
16138,108,1552712400,29,11,40,Rain
16139,109,1552712400,13,16,29,Rain
16140,110,1552712400,31,9,40,Rain
16141,111,1552712400,13,27,40,Rain
16142,112,1552712400,0,30,30,Rain
16143,113,1552712400,0,0,0,Rain
16144,114,1552712400,39,1,40,Rain
16145,115,1552712400,8,22,30,Rain
16146,2,1552716000,15,5,20,Rain
16147,3,1552716000,16,4,20,Rain
16148,4,1552716000,20,0,20,Rain
16149,5,1552716000,26,14,40,Rain
16150,6,1552716000,18,2,20,Rain
16151,7,1552716000,7,22,29,Rain
16152,8,1552716000,21,9,30,Rain
16153,9,1552716000,12,12,24,Rain
16154,10,1552716000,1,15,16,Rain
16155,11,1552716000,30,0,30,Rain
16156,12,1552716000,14,6,20,Rain
16157,13,1552716000,20,10,30,Rain
16158,14,1552716000,4,26,30,Rain
16159,15,1552716000,9,7,16,Rain
16160,16,1552716000,19,1,20,Rain
16161,17,1552716000,19,1,20,Rain
16162,18,1552716000,21,9,30,Rain
16163,19,1552716000,29,1,30,Rain
16164,21,1552716000,30,0,30,Rain
16165,22,1552716000,18,2,20,Rain
16166,23,1552716000,0,0,0,Rain
16167,24,1552716000,0,20,20,Rain
16168,25,1552716000,0,0,0,Rain
16169,26,1552716000,17,3,20,Rain
16170,27,1552716000,12,8,20,Rain
16171,28,1552716000,21,9,30,Rain
16172,29,1552716000,2,27,29,Rain
16173,30,1552716000,19,1,20,Rain
16174,31,1552716000,18,2,20,Rain
16175,32,1552716000,22,8,30,Rain
16176,33,1552716000,6,17,23,Rain
16177,34,1552716000,27,3,30,Rain
16178,35,1552716000,27,3,30,Rain
16179,36,1552716000,26,14,40,Rain
16180,37,1552716000,29,1,30,Rain
16181,38,1552716000,3,37,40,Rain
16182,39,1552716000,18,2,20,Rain
16183,40,1552716000,19,2,21,Rain
16184,41,1552716000,20,0,20,Rain
16185,42,1552716000,1,29,30,Rain
16186,43,1552716000,13,17,30,Rain
16187,44,1552716000,0,30,30,Rain
16188,45,1552716000,8,22,30,Rain
16189,46,1552716000,4,16,20,Rain
16190,47,1552716000,40,0,40,Rain
16191,48,1552716000,19,21,40,Rain
16192,49,1552716000,12,28,40,Rain
16193,50,1552716000,21,19,40,Rain
16194,51,1552716000,30,10,40,Rain
16195,52,1552716000,27,5,32,Rain
16196,53,1552716000,39,1,40,Rain
16197,54,1552716000,32,1,33,Rain
16198,55,1552716000,36,0,36,Rain
16199,56,1552716000,32,8,40,Rain
16200,57,1552716000,19,4,23,Rain
16201,58,1552716000,31,9,40,Rain
16202,59,1552716000,12,8,20,Rain
16203,60,1552716000,0,30,30,Rain
16204,61,1552716000,22,3,25,Rain
16205,62,1552716000,40,0,40,Rain
16206,63,1552716000,25,10,35,Rain
16207,64,1552716000,24,16,40,Rain
16208,65,1552716000,39,1,40,Rain
16209,66,1552716000,27,13,40,Rain
16210,67,1552716000,18,22,40,Rain
16211,68,1552716000,33,7,40,Rain
16212,69,1552716000,22,18,40,Rain
16213,70,1552716000,20,8,28,Rain
16214,71,1552716000,35,4,39,Rain
16215,72,1552716000,24,7,31,Rain
16216,73,1552716000,7,23,30,Rain
16217,74,1552716000,14,16,30,Rain
16218,75,1552716000,37,3,40,Rain
16219,76,1552716000,8,30,38,Rain
16220,77,1552716000,23,6,29,Rain
16221,78,1552716000,26,14,40,Rain
16222,79,1552716000,8,19,27,Rain
16223,80,1552716000,13,27,40,Rain
16224,81,1552716000,27,13,40,Rain
16225,82,1552716000,11,11,22,Rain
16226,83,1552716000,20,20,40,Rain
16227,84,1552716000,11,19,30,Rain
16228,85,1552716000,9,26,35,Rain
16229,86,1552716000,15,23,38,Rain
16230,87,1552716000,14,24,38,Rain
16231,88,1552716000,14,16,30,Rain
16232,89,1552716000,30,10,40,Rain
16233,90,1552716000,33,7,40,Rain
16234,91,1552716000,17,13,30,Rain
16235,92,1552716000,16,24,40,Rain
16236,93,1552716000,1,39,40,Rain
16237,94,1552716000,34,6,40,Rain
16238,95,1552716000,20,20,40,Rain
16239,96,1552716000,17,13,30,Rain
16240,97,1552716000,26,14,40,Rain
16241,98,1552716000,25,15,40,Rain
16242,99,1552716000,17,13,30,Rain
16243,100,1552716000,10,15,25,Rain
16244,101,1552716000,16,14,30,Rain
16245,102,1552716000,25,15,40,Rain
16246,103,1552716000,26,14,40,Rain
16247,104,1552716000,40,0,40,Rain
16248,105,1552716000,32,4,36,Rain
16249,106,1552716000,34,6,40,Rain
16250,107,1552716000,29,11,40,Rain
16251,108,1552716000,29,11,40,Rain
16252,109,1552716000,13,16,29,Rain
16253,110,1552716000,31,9,40,Rain
16254,111,1552716000,13,27,40,Rain
16255,112,1552716000,0,30,30,Rain
16256,113,1552716000,0,0,0,Rain
16257,114,1552716000,39,1,40,Rain
16258,115,1552716000,8,22,30,Rain
16259,2,1552719600,15,5,20,Rain
16260,3,1552719600,16,4,20,Rain
16261,4,1552719600,20,0,20,Rain
16262,5,1552719600,25,15,40,Rain
16263,6,1552719600,19,1,20,Rain
16264,7,1552719600,7,22,29,Rain
16265,8,1552719600,21,9,30,Rain
16266,9,1552719600,12,12,24,Rain
16267,10,1552719600,1,15,16,Rain
16268,11,1552719600,30,0,30,Rain
16269,12,1552719600,16,4,20,Rain
16270,13,1552719600,20,10,30,Rain
16271,14,1552719600,2,28,30,Rain
16272,15,1552719600,8,8,16,Rain
16273,16,1552719600,19,1,20,Rain
16274,17,1552719600,19,1,20,Rain
16275,18,1552719600,19,11,30,Rain
16276,19,1552719600,30,0,30,Rain
16277,21,1552719600,30,0,30,Rain
16278,22,1552719600,18,2,20,Rain
16279,23,1552719600,0,0,0,Rain
16280,24,1552719600,0,20,20,Rain
16281,25,1552719600,0,0,0,Rain
16282,26,1552719600,16,4,20,Rain
16283,27,1552719600,12,8,20,Rain
16284,28,1552719600,20,10,30,Rain
16285,29,1552719600,3,26,29,Rain
16286,30,1552719600,19,1,20,Rain
16287,31,1552719600,16,4,20,Rain
16288,32,1552719600,21,9,30,Rain
16289,33,1552719600,4,19,23,Rain
16290,34,1552719600,27,3,30,Rain
16291,35,1552719600,28,2,30,Rain
16292,36,1552719600,27,13,40,Rain
16293,37,1552719600,30,0,30,Rain
16294,38,1552719600,3,37,40,Rain
16295,39,1552719600,19,1,20,Rain
16296,40,1552719600,19,2,21,Rain
16297,41,1552719600,20,0,20,Rain
16298,42,1552719600,3,27,30,Rain
16299,43,1552719600,13,17,30,Rain
16300,44,1552719600,1,29,30,Rain
16301,45,1552719600,9,21,30,Rain
16302,46,1552719600,4,16,20,Rain
16303,47,1552719600,40,0,40,Rain
16304,48,1552719600,18,22,40,Rain
16305,49,1552719600,11,29,40,Rain
16306,50,1552719600,22,18,40,Rain
16307,51,1552719600,30,10,40,Rain
16308,52,1552719600,25,7,32,Rain
16309,53,1552719600,40,0,40,Rain
16310,54,1552719600,33,0,33,Rain
16311,55,1552719600,36,0,36,Rain
16312,56,1552719600,34,6,40,Rain
16313,57,1552719600,18,5,23,Rain
16314,58,1552719600,31,9,40,Rain
16315,59,1552719600,12,8,20,Rain
16316,60,1552719600,2,28,30,Rain
16317,61,1552719600,23,2,25,Rain
16318,62,1552719600,40,0,40,Rain
16319,63,1552719600,25,10,35,Rain
16320,64,1552719600,24,16,40,Rain
16321,65,1552719600,39,1,40,Rain
16322,66,1552719600,28,12,40,Rain
16323,67,1552719600,17,23,40,Rain
16324,68,1552719600,33,7,40,Rain
16325,69,1552719600,21,19,40,Rain
16326,70,1552719600,18,10,28,Rain
16327,71,1552719600,36,3,39,Rain
16328,72,1552719600,23,8,31,Rain
16329,73,1552719600,7,23,30,Rain
16330,74,1552719600,13,17,30,Rain
16331,75,1552719600,39,1,40,Rain
16332,76,1552719600,10,28,38,Rain
16333,77,1552719600,21,8,29,Rain
16334,78,1552719600,27,13,40,Rain
16335,79,1552719600,8,19,27,Rain
16336,80,1552719600,14,26,40,Rain
16337,81,1552719600,27,13,40,Rain
16338,82,1552719600,10,12,22,Rain
16339,83,1552719600,20,20,40,Rain
16340,84,1552719600,12,18,30,Rain
16341,85,1552719600,9,26,35,Rain
16342,86,1552719600,14,24,38,Rain
16343,87,1552719600,14,24,38,Rain
16344,88,1552719600,13,17,30,Rain
16345,89,1552719600,31,9,40,Rain
16346,90,1552719600,33,7,40,Rain
16347,91,1552719600,17,13,30,Rain
16348,92,1552719600,18,22,40,Rain
16349,93,1552719600,1,39,40,Rain
16350,94,1552719600,34,6,40,Rain
16351,95,1552719600,20,20,40,Rain
16352,96,1552719600,17,13,30,Rain
16353,97,1552719600,28,12,40,Rain
16354,98,1552719600,25,15,40,Rain
16355,99,1552719600,17,13,30,Rain
16356,100,1552719600,8,17,25,Rain
16357,101,1552719600,17,13,30,Rain
16358,102,1552719600,25,15,40,Rain
16359,103,1552719600,26,14,40,Rain
16360,104,1552719600,40,0,40,Rain
16361,105,1552719600,32,4,36,Rain
16362,106,1552719600,34,6,40,Rain
16363,107,1552719600,30,10,40,Rain
16364,108,1552719600,30,10,40,Rain
16365,109,1552719600,15,14,29,Rain
16366,110,1552719600,31,9,40,Rain
16367,111,1552719600,13,27,40,Rain
16368,112,1552719600,1,29,30,Rain
16369,113,1552719600,0,0,0,Rain
16370,114,1552719600,39,1,40,Rain
16371,115,1552719600,8,22,30,Rain
16372,2,1552723200,18,2,20,Rain
16373,3,1552723200,16,4,20,Rain
16374,4,1552723200,18,2,20,Rain
16375,5,1552723200,25,15,40,Rain
16376,6,1552723200,19,1,20,Rain
16377,7,1552723200,7,22,29,Rain
16378,8,1552723200,20,10,30,Rain
16379,9,1552723200,1,23,24,Rain
16380,10,1552723200,1,15,16,Rain
16381,11,1552723200,28,2,30,Rain
16382,12,1552723200,20,0,20,Rain
16383,13,1552723200,20,10,30,Rain
16384,14,1552723200,0,30,30,Rain
16385,15,1552723200,7,9,16,Rain
16386,16,1552723200,19,1,20,Rain
16387,17,1552723200,19,1,20,Rain
16388,18,1552723200,22,8,30,Rain
16389,19,1552723200,26,4,30,Rain
16390,21,1552723200,28,2,30,Rain
16391,22,1552723200,17,3,20,Rain
16392,23,1552723200,0,0,0,Rain
16393,24,1552723200,0,20,20,Rain
16394,25,1552723200,0,0,0,Rain
16395,26,1552723200,15,5,20,Rain
16396,27,1552723200,11,9,20,Rain
16397,28,1552723200,21,9,30,Rain
16398,29,1552723200,2,27,29,Rain
16399,30,1552723200,17,3,20,Rain
16400,31,1552723200,15,5,20,Rain
16401,32,1552723200,21,9,30,Rain
16402,33,1552723200,19,4,23,Rain
16403,34,1552723200,25,5,30,Rain
16404,35,1552723200,30,0,30,Rain
16405,36,1552723200,26,14,40,Rain
16406,37,1552723200,30,0,30,Rain
16407,38,1552723200,3,37,40,Rain
16408,39,1552723200,18,2,20,Rain
16409,40,1552723200,19,2,21,Rain
16410,41,1552723200,20,0,20,Rain
16411,42,1552723200,5,25,30,Rain
16412,43,1552723200,14,16,30,Rain
16413,44,1552723200,4,26,30,Rain
16414,45,1552723200,9,21,30,Rain
16415,46,1552723200,4,16,20,Rain
16416,47,1552723200,40,0,40,Rain
16417,48,1552723200,16,24,40,Rain
16418,49,1552723200,10,30,40,Rain
16419,50,1552723200,22,18,40,Rain
16420,51,1552723200,30,10,40,Rain
16421,52,1552723200,25,7,32,Rain
16422,53,1552723200,40,0,40,Rain
16423,54,1552723200,33,0,33,Rain
16424,55,1552723200,36,0,36,Rain
16425,56,1552723200,33,7,40,Rain
16426,57,1552723200,17,6,23,Rain
16427,58,1552723200,30,10,40,Rain
16428,59,1552723200,12,8,20,Rain
16429,60,1552723200,5,25,30,Rain
16430,61,1552723200,24,1,25,Rain
16431,62,1552723200,40,0,40,Rain
16432,63,1552723200,25,10,35,Rain
16433,64,1552723200,24,16,40,Rain
16434,65,1552723200,39,1,40,Rain
16435,66,1552723200,29,11,40,Rain
16436,67,1552723200,17,23,40,Rain
16437,68,1552723200,30,10,40,Rain
16438,69,1552723200,19,21,40,Rain
16439,70,1552723200,16,12,28,Rain
16440,71,1552723200,40,0,40,Rain
16441,72,1552723200,23,8,31,Rain
16442,73,1552723200,9,21,30,Rain
16443,74,1552723200,13,17,30,Rain
16444,75,1552723200,39,1,40,Rain
16445,76,1552723200,10,28,38,Rain
16446,77,1552723200,22,7,29,Rain
16447,78,1552723200,28,12,40,Rain
16448,79,1552723200,8,19,27,Rain
16449,80,1552723200,15,25,40,Rain
16450,81,1552723200,27,13,40,Rain
16451,82,1552723200,11,11,22,Rain
16452,83,1552723200,22,18,40,Rain
16453,84,1552723200,14,16,30,Rain
16454,85,1552723200,9,26,35,Rain
16455,86,1552723200,14,24,38,Rain
16456,87,1552723200,14,24,38,Rain
16457,88,1552723200,11,19,30,Rain
16458,89,1552723200,31,9,40,Rain
16459,90,1552723200,32,8,40,Rain
16460,91,1552723200,17,13,30,Rain
16461,92,1552723200,18,22,40,Rain
16462,93,1552723200,1,39,40,Rain
16463,94,1552723200,34,6,40,Rain
16464,95,1552723200,20,20,40,Rain
16465,96,1552723200,17,13,30,Rain
16466,97,1552723200,28,12,40,Rain
16467,98,1552723200,26,14,40,Rain
16468,99,1552723200,17,13,30,Rain
16469,100,1552723200,6,19,25,Rain
16470,101,1552723200,20,10,30,Rain
16471,102,1552723200,25,15,40,Rain
16472,103,1552723200,26,14,40,Rain
16473,104,1552723200,40,0,40,Rain
16474,105,1552723200,32,4,36,Rain
16475,106,1552723200,34,6,40,Rain
16476,107,1552723200,31,9,40,Rain
16477,108,1552723200,31,9,40,Rain
16478,109,1552723200,18,11,29,Rain
16479,110,1552723200,31,9,40,Rain
16480,111,1552723200,16,24,40,Rain
16481,112,1552723200,6,24,30,Rain
16482,113,1552723200,0,0,0,Rain
16483,114,1552723200,39,1,40,Rain
16484,115,1552723200,8,22,30,Rain
16485,2,1552726800,20,0,20,Rain
16486,3,1552726800,17,3,20,Rain
16487,4,1552726800,18,2,20,Rain
16488,5,1552726800,25,15,40,Rain
16489,6,1552726800,20,0,20,Rain
16490,7,1552726800,7,22,29,Rain
16491,8,1552726800,21,9,30,Rain
16492,9,1552726800,16,8,24,Rain
16493,10,1552726800,0,16,16,Rain
16494,11,1552726800,28,2,30,Rain
16495,12,1552726800,19,1,20,Rain
16496,13,1552726800,20,10,30,Rain
16497,14,1552726800,13,17,30,Rain
16498,15,1552726800,8,8,16,Rain
16499,16,1552726800,20,0,20,Rain
16500,17,1552726800,20,0,20,Rain
16501,18,1552726800,3,27,30,Rain
16502,19,1552726800,23,7,30,Rain
16503,21,1552726800,27,3,30,Rain
16504,22,1552726800,15,5,20,Rain
16505,23,1552726800,0,0,0,Rain
16506,24,1552726800,0,20,20,Rain
16507,25,1552726800,0,0,0,Rain
16508,26,1552726800,13,7,20,Rain
16509,27,1552726800,5,15,20,Rain
16510,28,1552726800,22,8,30,Rain
16511,29,1552726800,1,28,29,Rain
16512,30,1552726800,17,3,20,Rain
16513,31,1552726800,11,9,20,Rain
16514,32,1552726800,20,10,30,Rain
16515,33,1552726800,17,6,23,Rain
16516,34,1552726800,18,12,30,Rain
16517,35,1552726800,28,2,30,Rain
16518,36,1552726800,25,15,40,Rain
16519,37,1552726800,30,0,30,Rain
16520,38,1552726800,3,37,40,Rain
16521,39,1552726800,19,1,20,Rain
16522,40,1552726800,18,3,21,Rain
16523,41,1552726800,20,0,20,Rain
16524,42,1552726800,7,23,30,Rain
16525,43,1552726800,14,16,30,Rain
16526,44,1552726800,5,25,30,Rain
16527,45,1552726800,9,21,30,Rain
16528,46,1552726800,6,14,20,Rain
16529,47,1552726800,40,0,40,Rain
16530,48,1552726800,17,23,40,Rain
16531,49,1552726800,10,30,40,Rain
16532,50,1552726800,28,12,40,Rain
16533,51,1552726800,29,11,40,Rain
16534,52,1552726800,27,5,32,Rain
16535,53,1552726800,40,0,40,Rain
16536,54,1552726800,32,1,33,Rain
16537,55,1552726800,36,0,36,Rain
16538,56,1552726800,34,6,40,Rain
16539,57,1552726800,16,7,23,Rain
16540,58,1552726800,23,17,40,Rain
16541,59,1552726800,14,6,20,Rain
16542,60,1552726800,5,25,30,Rain
16543,61,1552726800,25,0,25,Rain
16544,62,1552726800,39,1,40,Rain
16545,63,1552726800,26,9,35,Rain
16546,64,1552726800,23,17,40,Rain
16547,65,1552726800,40,0,40,Rain
16548,66,1552726800,25,15,40,Rain
16549,67,1552726800,17,23,40,Rain
16550,68,1552726800,29,11,40,Rain
16551,69,1552726800,17,23,40,Rain
16552,70,1552726800,16,12,28,Rain
16553,71,1552726800,40,0,40,Rain
16554,72,1552726800,17,14,31,Rain
16555,73,1552726800,9,21,30,Rain
16556,74,1552726800,14,16,30,Rain
16557,75,1552726800,39,1,40,Rain
16558,76,1552726800,10,28,38,Rain
16559,77,1552726800,20,9,29,Rain
16560,78,1552726800,27,13,40,Rain
16561,79,1552726800,9,18,27,Rain
16562,80,1552726800,15,25,40,Rain
16563,81,1552726800,27,13,40,Rain
16564,82,1552726800,11,11,22,Rain
16565,83,1552726800,23,17,40,Rain
16566,84,1552726800,14,16,30,Rain
16567,85,1552726800,12,23,35,Rain
16568,86,1552726800,14,24,38,Rain
16569,87,1552726800,15,23,38,Rain
16570,88,1552726800,13,17,30,Rain
16571,89,1552726800,31,9,40,Rain
16572,90,1552726800,31,9,40,Rain
16573,91,1552726800,17,13,30,Rain
16574,92,1552726800,19,21,40,Rain
16575,93,1552726800,1,39,40,Rain
16576,94,1552726800,34,6,40,Rain
16577,95,1552726800,20,20,40,Rain
16578,96,1552726800,17,13,30,Rain
16579,97,1552726800,29,11,40,Rain
16580,98,1552726800,25,15,40,Rain
16581,99,1552726800,15,15,30,Rain
16582,100,1552726800,6,19,25,Rain
16583,101,1552726800,24,6,30,Rain
16584,102,1552726800,40,0,40,Rain
16585,103,1552726800,27,13,40,Rain
16586,104,1552726800,40,0,40,Rain
16587,105,1552726800,33,3,36,Rain
16588,106,1552726800,34,6,40,Rain
16589,107,1552726800,32,8,40,Rain
16590,108,1552726800,32,8,40,Rain
16591,109,1552726800,18,11,29,Rain
16592,110,1552726800,31,9,40,Rain
16593,111,1552726800,18,22,40,Rain
16594,112,1552726800,9,21,30,Rain
16595,113,1552726800,0,0,0,Rain
16596,114,1552726800,38,2,40,Rain
16597,115,1552726800,9,21,30,Rain
16598,2,1552730400,20,0,20,Rain
16599,3,1552730400,18,2,20,Rain
16600,4,1552730400,18,2,20,Rain
16601,5,1552730400,7,33,40,Rain
16602,6,1552730400,20,0,20,Rain
16603,7,1552730400,9,20,29,Rain
16604,8,1552730400,20,10,30,Rain
16605,9,1552730400,15,9,24,Rain
16606,10,1552730400,0,16,16,Rain
16607,11,1552730400,29,1,30,Rain
16608,12,1552730400,20,0,20,Rain
16609,13,1552730400,18,12,30,Rain
16610,14,1552730400,28,2,30,Rain
16611,15,1552730400,10,6,16,Rain
16612,16,1552730400,20,0,20,Rain
16613,17,1552730400,20,0,20,Rain
16614,18,1552730400,2,28,30,Rain
16615,19,1552730400,22,8,30,Rain
16616,21,1552730400,26,4,30,Rain
16617,22,1552730400,11,9,20,Rain
16618,23,1552730400,0,0,0,Rain
16619,24,1552730400,0,20,20,Rain
16620,25,1552730400,0,0,0,Rain
16621,26,1552730400,10,10,20,Rain
16622,27,1552730400,2,18,20,Rain
16623,28,1552730400,27,3,30,Rain
16624,29,1552730400,0,29,29,Rain
16625,30,1552730400,17,3,20,Rain
16626,31,1552730400,15,5,20,Rain
16627,32,1552730400,19,11,30,Rain
16628,33,1552730400,16,7,23,Rain
16629,34,1552730400,18,11,29,Rain
16630,35,1552730400,26,4,30,Rain
16631,36,1552730400,40,0,40,Rain
16632,37,1552730400,28,2,30,Rain
16633,38,1552730400,2,38,40,Rain
16634,39,1552730400,17,3,20,Rain
16635,40,1552730400,18,3,21,Rain
16636,41,1552730400,20,0,20,Rain
16637,42,1552730400,8,22,30,Rain
16638,43,1552730400,15,15,30,Rain
16639,44,1552730400,10,20,30,Rain
16640,45,1552730400,9,21,30,Rain
16641,46,1552730400,6,14,20,Rain
16642,47,1552730400,40,0,40,Rain
16643,48,1552730400,16,24,40,Rain
16644,49,1552730400,9,31,40,Rain
16645,50,1552730400,28,12,40,Rain
16646,51,1552730400,30,10,40,Rain
16647,52,1552730400,26,6,32,Rain
16648,53,1552730400,40,0,40,Rain
16649,54,1552730400,32,1,33,Rain
16650,55,1552730400,36,0,36,Rain
16651,56,1552730400,36,4,40,Rain
16652,57,1552730400,16,7,23,Rain
16653,58,1552730400,20,20,40,Rain
16654,59,1552730400,13,7,20,Rain
16655,60,1552730400,7,23,30,Rain
16656,61,1552730400,25,0,25,Rain
16657,62,1552730400,38,2,40,Rain
16658,63,1552730400,23,12,35,Rain
16659,64,1552730400,23,17,40,Rain
16660,65,1552730400,38,2,40,Rain
16661,66,1552730400,23,17,40,Rain
16662,67,1552730400,19,21,40,Rain
16663,68,1552730400,26,14,40,Rain
16664,69,1552730400,18,22,40,Rain
16665,70,1552730400,17,11,28,Rain
16666,71,1552730400,40,0,40,Rain
16667,72,1552730400,5,26,31,Rain
16668,73,1552730400,8,22,30,Rain
16669,74,1552730400,17,13,30,Rain
16670,75,1552730400,40,0,40,Rain
16671,76,1552730400,12,26,38,Rain
16672,77,1552730400,19,10,29,Rain
16673,78,1552730400,29,11,40,Rain
16674,79,1552730400,9,18,27,Rain
16675,80,1552730400,17,23,40,Rain
16676,81,1552730400,27,13,40,Rain
16677,82,1552730400,11,11,22,Rain
16678,83,1552730400,27,13,40,Rain
16679,84,1552730400,15,15,30,Rain
16680,85,1552730400,14,21,35,Rain
16681,86,1552730400,13,25,38,Rain
16682,87,1552730400,15,23,38,Rain
16683,88,1552730400,14,16,30,Rain
16684,89,1552730400,31,9,40,Rain
16685,90,1552730400,28,12,40,Rain
16686,91,1552730400,20,10,30,Rain
16687,92,1552730400,19,21,40,Rain
16688,93,1552730400,1,39,40,Rain
16689,94,1552730400,16,24,40,Rain
16690,95,1552730400,19,21,40,Rain
16691,96,1552730400,16,14,30,Rain
16692,97,1552730400,30,10,40,Rain
16693,98,1552730400,25,15,40,Rain
16694,99,1552730400,16,14,30,Rain
16695,100,1552730400,2,23,25,Rain
16696,101,1552730400,26,4,30,Rain
16697,102,1552730400,0,0,0,Rain
16698,103,1552730400,27,13,40,Rain
16699,104,1552730400,40,0,40,Rain
16700,105,1552730400,33,3,36,Rain
16701,106,1552730400,34,6,40,Rain
16702,107,1552730400,32,8,40,Rain
16703,108,1552730400,34,6,40,Rain
16704,109,1552730400,19,10,29,Rain
16705,110,1552730400,32,8,40,Rain
16706,111,1552730400,19,21,40,Rain
16707,112,1552730400,10,20,30,Rain
16708,113,1552730400,0,0,0,Rain
16709,114,1552730400,38,2,40,Rain
16710,115,1552730400,11,19,30,Rain
16711,2,1552734000,20,0,20,Rain
16712,3,1552734000,16,4,20,Rain
16713,4,1552734000,19,1,20,Rain
16714,5,1552734000,10,30,40,Rain
16715,6,1552734000,20,0,20,Rain
16716,7,1552734000,11,18,29,Rain
16717,8,1552734000,21,9,30,Rain
16718,9,1552734000,6,18,24,Rain
16719,10,1552734000,0,16,16,Rain
16720,11,1552734000,30,0,30,Rain
16721,12,1552734000,19,1,20,Rain
16722,13,1552734000,18,12,30,Rain
16723,14,1552734000,22,8,30,Rain
16724,15,1552734000,11,5,16,Rain
16725,16,1552734000,16,4,20,Rain
16726,17,1552734000,19,1,20,Rain
16727,18,1552734000,0,30,30,Rain
16728,19,1552734000,19,11,30,Rain
16729,21,1552734000,26,4,30,Rain
16730,22,1552734000,9,11,20,Rain
16731,23,1552734000,0,0,0,Rain
16732,24,1552734000,0,20,20,Rain
16733,25,1552734000,0,0,0,Rain
16734,26,1552734000,8,12,20,Rain
16735,27,1552734000,0,20,20,Rain
16736,28,1552734000,10,20,30,Rain
16737,29,1552734000,12,17,29,Rain
16738,30,1552734000,17,3,20,Rain
16739,31,1552734000,16,4,20,Rain
16740,32,1552734000,17,13,30,Rain
16741,33,1552734000,12,11,23,Rain
16742,34,1552734000,22,8,30,Rain
16743,35,1552734000,28,2,30,Rain
16744,36,1552734000,40,0,40,Rain
16745,37,1552734000,30,0,30,Rain
16746,38,1552734000,1,39,40,Rain
16747,39,1552734000,20,0,20,Rain
16748,40,1552734000,19,2,21,Rain
16749,41,1552734000,20,0,20,Rain
16750,42,1552734000,6,24,30,Rain
16751,43,1552734000,18,12,30,Rain
16752,44,1552734000,13,17,30,Rain
16753,45,1552734000,8,22,30,Rain
16754,46,1552734000,4,16,20,Rain
16755,47,1552734000,39,1,40,Rain
16756,48,1552734000,14,26,40,Rain
16757,49,1552734000,11,29,40,Rain
16758,50,1552734000,31,9,40,Rain
16759,51,1552734000,26,14,40,Rain
16760,52,1552734000,25,7,32,Rain
16761,53,1552734000,40,0,40,Rain
16762,54,1552734000,31,2,33,Rain
16763,55,1552734000,36,0,36,Rain
16764,56,1552734000,31,9,40,Rain
16765,57,1552734000,15,8,23,Rain
16766,58,1552734000,22,18,40,Rain
16767,59,1552734000,14,6,20,Rain
16768,60,1552734000,16,14,30,Rain
16769,61,1552734000,25,0,25,Rain
16770,62,1552734000,36,4,40,Rain
16771,63,1552734000,23,12,35,Rain
16772,64,1552734000,24,16,40,Rain
16773,65,1552734000,38,2,40,Rain
16774,66,1552734000,25,15,40,Rain
16775,67,1552734000,17,23,40,Rain
16776,68,1552734000,25,15,40,Rain
16777,69,1552734000,12,28,40,Rain
16778,70,1552734000,19,9,28,Rain
16779,71,1552734000,40,0,40,Rain
16780,72,1552734000,10,21,31,Rain
16781,73,1552734000,7,23,30,Rain
16782,74,1552734000,16,14,30,Rain
16783,75,1552734000,40,0,40,Rain
16784,76,1552734000,13,25,38,Rain
16785,77,1552734000,19,9,28,Rain
16786,78,1552734000,31,9,40,Rain
16787,79,1552734000,9,18,27,Rain
16788,80,1552734000,15,25,40,Rain
16789,81,1552734000,27,13,40,Rain
16790,82,1552734000,11,11,22,Rain
16791,83,1552734000,30,10,40,Rain
16792,84,1552734000,19,11,30,Rain
16793,85,1552734000,21,14,35,Rain
16794,86,1552734000,15,23,38,Rain
16795,87,1552734000,16,22,38,Rain
16796,88,1552734000,17,13,30,Rain
16797,89,1552734000,30,10,40,Rain
16798,90,1552734000,27,13,40,Rain
16799,91,1552734000,18,12,30,Rain
16800,92,1552734000,17,23,40,Rain
16801,93,1552734000,1,39,40,Rain
16802,94,1552734000,16,24,40,Rain
16803,95,1552734000,18,22,40,Rain
16804,96,1552734000,15,15,30,Rain
16805,97,1552734000,31,9,40,Rain
16806,98,1552734000,23,17,40,Rain
16807,99,1552734000,13,17,30,Rain
16808,100,1552734000,0,25,25,Rain
16809,101,1552734000,26,4,30,Rain
16810,102,1552734000,0,0,0,Rain
16811,103,1552734000,27,13,40,Rain
16812,104,1552734000,40,0,40,Rain
16813,105,1552734000,33,3,36,Rain
16814,106,1552734000,34,6,40,Rain
16815,107,1552734000,31,9,40,Rain
16816,108,1552734000,35,5,40,Rain
16817,109,1552734000,22,7,29,Rain
16818,110,1552734000,32,8,40,Rain
16819,111,1552734000,22,18,40,Rain
16820,112,1552734000,13,17,30,Rain
16821,113,1552734000,0,0,0,Rain
16822,114,1552734000,31,9,40,Rain
16823,115,1552734000,14,16,30,Rain
16824,2,1552737600,20,0,20,Rain
16825,3,1552737600,18,2,20,Rain
16826,4,1552737600,19,1,20,Rain
16827,5,1552737600,7,33,40,Rain
16828,6,1552737600,20,0,20,Rain
16829,7,1552737600,13,16,29,Rain
16830,8,1552737600,15,15,30,Rain
16831,9,1552737600,0,24,24,Rain
16832,10,1552737600,0,16,16,Rain
16833,11,1552737600,30,0,30,Rain
16834,12,1552737600,19,1,20,Rain
16835,13,1552737600,18,12,30,Rain
16836,14,1552737600,16,14,30,Rain
16837,15,1552737600,12,4,16,Rain
16838,16,1552737600,17,3,20,Rain
16839,17,1552737600,17,3,20,Rain
16840,18,1552737600,3,27,30,Rain
16841,19,1552737600,20,10,30,Rain
16842,21,1552737600,22,8,30,Rain
16843,22,1552737600,6,14,20,Rain
16844,23,1552737600,0,0,0,Rain
16845,24,1552737600,0,20,20,Rain
16846,25,1552737600,0,0,0,Rain
16847,26,1552737600,2,18,20,Rain
16848,27,1552737600,0,20,20,Rain
16849,28,1552737600,11,19,30,Rain
16850,29,1552737600,5,24,29,Rain
16851,30,1552737600,18,2,20,Rain
16852,31,1552737600,18,2,20,Rain
16853,32,1552737600,15,15,30,Rain
16854,33,1552737600,6,17,23,Rain
16855,34,1552737600,22,8,30,Rain
16856,35,1552737600,28,2,30,Rain
16857,36,1552737600,39,1,40,Rain
16858,37,1552737600,30,0,30,Rain
16859,38,1552737600,0,40,40,Rain
16860,39,1552737600,19,1,20,Rain
16861,40,1552737600,15,6,21,Rain
16862,41,1552737600,19,1,20,Rain
16863,42,1552737600,7,23,30,Rain
16864,43,1552737600,21,9,30,Rain
16865,44,1552737600,17,13,30,Rain
16866,45,1552737600,3,27,30,Rain
16867,46,1552737600,1,19,20,Rain
16868,47,1552737600,39,1,40,Rain
16869,48,1552737600,17,23,40,Rain
16870,49,1552737600,13,27,40,Rain
16871,50,1552737600,30,10,40,Rain
16872,51,1552737600,26,14,40,Rain
16873,52,1552737600,22,10,32,Rain
16874,53,1552737600,40,0,40,Rain
16875,54,1552737600,29,4,33,Rain
16876,55,1552737600,36,0,36,Rain
16877,56,1552737600,31,9,40,Rain
16878,57,1552737600,14,9,23,Rain
16879,58,1552737600,22,18,40,Rain
16880,59,1552737600,15,5,20,Rain
16881,60,1552737600,18,12,30,Rain
16882,61,1552737600,25,0,25,Rain
16883,62,1552737600,35,5,40,Rain
16884,63,1552737600,24,11,35,Rain
16885,64,1552737600,27,13,40,Rain
16886,65,1552737600,36,4,40,Rain
16887,66,1552737600,24,16,40,Rain
16888,67,1552737600,22,18,40,Rain
16889,68,1552737600,25,15,40,Rain
16890,69,1552737600,19,21,40,Rain
16891,70,1552737600,20,8,28,Rain
16892,71,1552737600,40,0,40,Rain
16893,72,1552737600,13,18,31,Rain
16894,73,1552737600,12,18,30,Rain
16895,74,1552737600,19,11,30,Rain
16896,75,1552737600,40,0,40,Rain
16897,76,1552737600,13,25,38,Rain
16898,77,1552737600,16,12,28,Rain
16899,78,1552737600,34,6,40,Rain
16900,79,1552737600,8,19,27,Rain
16901,80,1552737600,15,25,40,Rain
16902,81,1552737600,28,12,40,Rain
16903,82,1552737600,13,9,22,Rain
16904,83,1552737600,35,5,40,Rain
16905,84,1552737600,19,11,30,Rain
16906,85,1552737600,22,13,35,Rain
16907,86,1552737600,13,25,38,Rain
16908,87,1552737600,18,20,38,Rain
16909,88,1552737600,17,13,30,Rain
16910,89,1552737600,30,10,40,Rain
16911,90,1552737600,28,12,40,Rain
16912,91,1552737600,19,11,30,Rain
16913,92,1552737600,17,23,40,Rain
16914,93,1552737600,1,39,40,Rain
16915,94,1552737600,16,24,40,Rain
16916,95,1552737600,21,19,40,Rain
16917,96,1552737600,16,14,30,Rain
16918,97,1552737600,35,5,40,Rain
16919,98,1552737600,18,22,40,Rain
16920,99,1552737600,11,19,30,Rain
16921,100,1552737600,2,23,25,Rain
16922,101,1552737600,26,4,30,Rain
16923,102,1552737600,0,0,0,Rain
16924,103,1552737600,27,13,40,Rain
16925,104,1552737600,40,0,40,Rain
16926,105,1552737600,34,2,36,Rain
16927,106,1552737600,36,4,40,Rain
16928,107,1552737600,33,7,40,Rain
16929,108,1552737600,38,2,40,Rain
16930,109,1552737600,23,6,29,Rain
16931,110,1552737600,32,8,40,Rain
16932,111,1552737600,31,9,40,Rain
16933,112,1552737600,19,11,30,Rain
16934,113,1552737600,0,0,0,Rain
16935,114,1552737600,34,6,40,Rain
16936,115,1552737600,12,18,30,Rain
16937,2,1552741200,1,19,20,Rain
16938,3,1552741200,17,3,20,Rain
16939,4,1552741200,18,2,20,Rain
16940,5,1552741200,10,30,40,Rain
16941,6,1552741200,20,0,20,Rain
16942,7,1552741200,15,14,29,Rain
16943,8,1552741200,18,12,30,Rain
16944,9,1552741200,9,15,24,Rain
16945,10,1552741200,0,16,16,Rain
16946,11,1552741200,30,0,30,Rain
16947,12,1552741200,20,0,20,Rain
16948,13,1552741200,20,10,30,Rain
16949,14,1552741200,13,17,30,Rain
16950,15,1552741200,13,3,16,Rain
16951,16,1552741200,14,6,20,Rain
16952,17,1552741200,15,5,20,Rain
16953,18,1552741200,2,28,30,Rain
16954,19,1552741200,17,13,30,Rain
16955,21,1552741200,21,9,30,Rain
16956,22,1552741200,2,18,20,Rain
16957,23,1552741200,0,0,0,Rain
16958,24,1552741200,0,20,20,Rain
16959,25,1552741200,0,0,0,Rain
16960,26,1552741200,1,19,20,Rain
16961,27,1552741200,0,20,20,Rain
16962,28,1552741200,13,17,30,Rain
16963,29,1552741200,17,12,29,Rain
16964,30,1552741200,19,1,20,Rain
16965,31,1552741200,18,2,20,Rain
16966,32,1552741200,14,16,30,Rain
16967,33,1552741200,3,20,23,Rain
16968,34,1552741200,23,7,30,Rain
16969,35,1552741200,30,0,30,Rain
16970,36,1552741200,36,4,40,Rain
16971,37,1552741200,30,0,30,Rain
16972,38,1552741200,0,40,40,Rain
16973,39,1552741200,20,0,20,Rain
16974,40,1552741200,15,6,21,Rain
16975,41,1552741200,19,1,20,Rain
16976,42,1552741200,11,19,30,Rain
16977,43,1552741200,25,5,30,Rain
16978,44,1552741200,20,10,30,Rain
16979,45,1552741200,2,28,30,Rain
16980,46,1552741200,0,20,20,Rain
16981,47,1552741200,39,1,40,Rain
16982,48,1552741200,18,22,40,Rain
16983,49,1552741200,11,29,40,Rain
16984,50,1552741200,31,9,40,Rain
16985,51,1552741200,26,14,40,Rain
16986,52,1552741200,22,10,32,Rain
16987,53,1552741200,40,0,40,Rain
16988,54,1552741200,27,6,33,Rain
16989,55,1552741200,36,0,36,Rain
16990,56,1552741200,31,9,40,Rain
16991,57,1552741200,15,8,23,Rain
16992,58,1552741200,23,17,40,Rain
16993,59,1552741200,15,5,20,Rain
16994,60,1552741200,19,11,30,Rain
16995,61,1552741200,24,1,25,Rain
16996,62,1552741200,35,5,40,Rain
16997,63,1552741200,23,12,35,Rain
16998,64,1552741200,26,14,40,Rain
16999,65,1552741200,36,4,40,Rain
17000,66,1552741200,23,17,40,Rain
17001,67,1552741200,24,16,40,Rain
17002,68,1552741200,22,18,40,Rain
17003,69,1552741200,14,26,40,Rain
17004,70,1552741200,22,6,28,Rain
17005,71,1552741200,40,0,40,Rain
17006,72,1552741200,10,21,31,Rain
17007,73,1552741200,13,17,30,Rain
17008,74,1552741200,21,9,30,Rain
17009,75,1552741200,39,1,40,Rain
17010,76,1552741200,14,24,38,Rain
17011,77,1552741200,20,8,28,Rain
17012,78,1552741200,34,6,40,Rain
17013,79,1552741200,8,19,27,Rain
17014,80,1552741200,16,24,40,Rain
17015,81,1552741200,27,13,40,Rain
17016,82,1552741200,18,4,22,Rain
17017,83,1552741200,35,5,40,Rain
17018,84,1552741200,21,9,30,Rain
17019,85,1552741200,21,14,35,Rain
17020,86,1552741200,11,27,38,Rain
17021,87,1552741200,18,20,38,Rain
17022,88,1552741200,16,14,30,Rain
17023,89,1552741200,30,10,40,Rain
17024,90,1552741200,28,12,40,Rain
17025,91,1552741200,19,11,30,Rain
17026,92,1552741200,19,21,40,Rain
17027,93,1552741200,1,39,40,Rain
17028,94,1552741200,16,24,40,Rain
17029,95,1552741200,20,20,40,Rain
17030,96,1552741200,19,11,30,Rain
17031,97,1552741200,40,0,40,Rain
17032,98,1552741200,13,27,40,Rain
17033,99,1552741200,10,20,30,Rain
17034,100,1552741200,4,21,25,Rain
17035,101,1552741200,30,0,30,Rain
17036,102,1552741200,0,0,0,Rain
17037,103,1552741200,26,14,40,Rain
17038,104,1552741200,40,0,40,Rain
17039,105,1552741200,34,2,36,Rain
17040,106,1552741200,37,3,40,Rain
17041,107,1552741200,34,6,40,Rain
17042,108,1552741200,38,2,40,Rain
17043,109,1552741200,25,4,29,Rain
17044,110,1552741200,33,7,40,Rain
17045,111,1552741200,34,6,40,Rain
17046,112,1552741200,21,9,30,Rain
17047,113,1552741200,0,0,0,Rain
17048,114,1552741200,32,8,40,Rain
17049,115,1552741200,13,17,30,Rain
17050,2,1552744800,4,16,20,Rain
17051,3,1552744800,13,7,20,Rain
17052,4,1552744800,20,0,20,Rain
17053,5,1552744800,7,33,40,Rain
17054,6,1552744800,20,0,20,Rain
17055,7,1552744800,15,14,29,Rain
17056,8,1552744800,16,14,30,Rain
17057,9,1552744800,6,18,24,Rain
17058,10,1552744800,0,16,16,Rain
17059,11,1552744800,30,0,30,Rain
17060,12,1552744800,19,1,20,Rain
17061,13,1552744800,21,9,30,Rain
17062,14,1552744800,4,26,30,Rain
17063,15,1552744800,13,3,16,Rain
17064,16,1552744800,11,8,19,Rain
17065,17,1552744800,17,3,20,Rain
17066,18,1552744800,3,27,30,Rain
17067,19,1552744800,21,9,30,Rain
17068,21,1552744800,19,11,30,Rain
17069,22,1552744800,0,20,20,Rain
17070,23,1552744800,0,0,0,Rain
17071,24,1552744800,0,20,20,Rain
17072,25,1552744800,0,0,0,Rain
17073,26,1552744800,0,20,20,Rain
17074,27,1552744800,0,20,20,Rain
17075,28,1552744800,13,17,30,Rain
17076,29,1552744800,15,14,29,Rain
17077,30,1552744800,20,0,20,Rain
17078,31,1552744800,12,8,20,Rain
17079,32,1552744800,12,18,30,Rain
17080,33,1552744800,0,23,23,Rain
17081,34,1552744800,10,20,30,Rain
17082,35,1552744800,29,1,30,Rain
17083,36,1552744800,35,5,40,Rain
17084,37,1552744800,30,0,30,Rain
17085,38,1552744800,2,38,40,Rain
17086,39,1552744800,20,0,20,Rain
17087,40,1552744800,13,8,21,Rain
17088,41,1552744800,19,1,20,Rain
17089,42,1552744800,11,19,30,Rain
17090,43,1552744800,27,3,30,Rain
17091,44,1552744800,25,5,30,Rain
17092,45,1552744800,2,28,30,Rain
17093,46,1552744800,1,19,20,Rain
17094,47,1552744800,39,1,40,Rain
17095,48,1552744800,20,20,40,Rain
17096,49,1552744800,10,30,40,Rain
17097,50,1552744800,33,7,40,Rain
17098,51,1552744800,20,20,40,Rain
17099,52,1552744800,18,14,32,Rain
17100,53,1552744800,40,0,40,Rain
17101,54,1552744800,28,5,33,Rain
17102,55,1552744800,36,0,36,Rain
17103,56,1552744800,31,9,40,Rain
17104,57,1552744800,14,9,23,Rain
17105,58,1552744800,28,12,40,Rain
17106,59,1552744800,16,4,20,Rain
17107,60,1552744800,19,11,30,Rain
17108,61,1552744800,25,0,25,Rain
17109,62,1552744800,34,6,40,Rain
17110,63,1552744800,21,14,35,Rain
17111,64,1552744800,26,14,40,Rain
17112,65,1552744800,34,6,40,Rain
17113,66,1552744800,26,14,40,Rain
17114,67,1552744800,34,6,40,Rain
17115,68,1552744800,23,17,40,Rain
17116,69,1552744800,25,15,40,Rain
17117,70,1552744800,25,3,28,Rain
17118,71,1552744800,39,1,40,Rain
17119,72,1552744800,13,18,31,Rain
17120,73,1552744800,11,19,30,Rain
17121,74,1552744800,21,9,30,Rain
17122,75,1552744800,39,1,40,Rain
17123,76,1552744800,15,23,38,Rain
17124,77,1552744800,21,7,28,Rain
17125,78,1552744800,35,5,40,Rain
17126,79,1552744800,8,19,27,Rain
17127,80,1552744800,17,23,40,Rain
17128,81,1552744800,27,13,40,Rain
17129,82,1552744800,18,4,22,Rain
17130,83,1552744800,35,5,40,Rain
17131,84,1552744800,19,11,30,Rain
17132,85,1552744800,23,12,35,Rain
17133,86,1552744800,9,29,38,Rain
17134,87,1552744800,18,20,38,Rain
17135,88,1552744800,21,9,30,Rain
17136,89,1552744800,30,10,40,Rain
17137,90,1552744800,29,11,40,Rain
17138,91,1552744800,20,10,30,Rain
17139,92,1552744800,20,20,40,Rain
17140,93,1552744800,1,39,40,Rain
17141,94,1552744800,16,24,40,Rain
17142,95,1552744800,21,19,40,Rain
17143,96,1552744800,21,9,30,Rain
17144,97,1552744800,39,1,40,Rain
17145,98,1552744800,11,29,40,Rain
17146,99,1552744800,11,19,30,Rain
17147,100,1552744800,5,20,25,Rain
17148,101,1552744800,29,1,30,Rain
17149,102,1552744800,0,0,0,Rain
17150,103,1552744800,26,14,40,Rain
17151,104,1552744800,40,0,40,Rain
17152,105,1552744800,34,2,36,Rain
17153,106,1552744800,37,3,40,Rain
17154,107,1552744800,37,3,40,Rain
17155,108,1552744800,40,0,40,Rain
17156,109,1552744800,23,6,29,Rain
17157,110,1552744800,34,6,40,Rain
17158,111,1552744800,38,2,40,Rain
17159,112,1552744800,21,9,30,Rain
17160,113,1552744800,0,0,0,Rain
17161,114,1552744800,32,8,40,Rain
17162,115,1552744800,15,15,30,Rain
17163,2,1552748400,7,13,20,Rain
17164,3,1552748400,12,8,20,Rain
17165,4,1552748400,20,0,20,Rain
17166,5,1552748400,10,30,40,Rain
17167,6,1552748400,20,0,20,Rain
17168,7,1552748400,14,15,29,Rain
17169,8,1552748400,16,14,30,Rain
17170,9,1552748400,0,24,24,Rain
17171,10,1552748400,0,16,16,Rain
17172,11,1552748400,30,0,30,Rain
17173,12,1552748400,20,0,20,Rain
17174,13,1552748400,20,10,30,Rain
17175,14,1552748400,8,22,30,Rain
17176,15,1552748400,14,2,16,Rain
17177,16,1552748400,11,8,19,Rain
17178,17,1552748400,14,6,20,Rain
17179,18,1552748400,2,28,30,Rain
17180,19,1552748400,21,9,30,Rain
17181,21,1552748400,15,15,30,Rain
17182,22,1552748400,0,20,20,Rain
17183,23,1552748400,0,0,0,Rain
17184,24,1552748400,1,19,20,Rain
17185,25,1552748400,0,0,0,Rain
17186,26,1552748400,1,19,20,Rain
17187,27,1552748400,0,20,20,Rain
17188,28,1552748400,16,14,30,Rain
17189,29,1552748400,9,20,29,Rain
17190,30,1552748400,20,0,20,Rain
17191,31,1552748400,8,12,20,Rain
17192,32,1552748400,30,0,30,Rain
17193,33,1552748400,1,22,23,Rain
17194,34,1552748400,20,10,30,Rain
17195,35,1552748400,27,3,30,Rain
17196,36,1552748400,32,8,40,Rain
17197,37,1552748400,30,0,30,Rain
17198,38,1552748400,2,38,40,Rain
17199,39,1552748400,16,4,20,Rain
17200,40,1552748400,5,16,21,Rain
17201,41,1552748400,20,0,20,Rain
17202,42,1552748400,10,20,30,Rain
17203,43,1552748400,29,1,30,Rain
17204,44,1552748400,30,0,30,Rain
17205,45,1552748400,0,30,30,Rain
17206,46,1552748400,1,19,20,Rain
17207,47,1552748400,39,1,40,Rain
17208,48,1552748400,22,18,40,Rain
17209,49,1552748400,15,25,40,Rain
17210,50,1552748400,32,8,40,Rain
17211,51,1552748400,19,21,40,Rain
17212,52,1552748400,17,15,32,Rain
17213,53,1552748400,40,0,40,Rain
17214,54,1552748400,28,5,33,Rain
17215,55,1552748400,36,0,36,Rain
17216,56,1552748400,28,12,40,Rain
17217,57,1552748400,13,10,23,Rain
17218,58,1552748400,24,16,40,Rain
17219,59,1552748400,16,4,20,Rain
17220,60,1552748400,24,6,30,Rain
17221,61,1552748400,23,2,25,Rain
17222,62,1552748400,33,7,40,Rain
17223,63,1552748400,18,17,35,Rain
17224,64,1552748400,28,12,40,Rain
17225,65,1552748400,35,5,40,Rain
17226,66,1552748400,24,16,40,Rain
17227,67,1552748400,30,10,40,Rain
17228,68,1552748400,23,17,40,Rain
17229,69,1552748400,28,12,40,Rain
17230,70,1552748400,27,1,28,Rain
17231,71,1552748400,38,2,40,Rain
17232,72,1552748400,13,18,31,Rain
17233,73,1552748400,12,18,30,Rain
17234,74,1552748400,15,15,30,Rain
17235,75,1552748400,40,0,40,Rain
17236,76,1552748400,16,22,38,Rain
17237,77,1552748400,21,7,28,Rain
17238,78,1552748400,33,7,40,Rain
17239,79,1552748400,9,18,27,Rain
17240,80,1552748400,19,21,40,Rain
17241,81,1552748400,27,13,40,Rain
17242,82,1552748400,19,3,22,Rain
17243,83,1552748400,21,19,40,Rain
17244,84,1552748400,23,7,30,Rain
17245,85,1552748400,23,12,35,Rain
17246,86,1552748400,12,26,38,Rain
17247,87,1552748400,21,17,38,Rain
17248,88,1552748400,24,6,30,Rain
17249,89,1552748400,29,11,40,Rain
17250,90,1552748400,29,11,40,Rain
17251,91,1552748400,22,8,30,Rain
17252,92,1552748400,22,18,40,Rain
17253,93,1552748400,1,39,40,Rain
17254,94,1552748400,16,24,40,Rain
17255,95,1552748400,23,17,40,Rain
17256,96,1552748400,22,8,30,Rain
17257,97,1552748400,40,0,40,Rain
17258,98,1552748400,10,30,40,Rain
17259,99,1552748400,10,20,30,Rain
17260,100,1552748400,10,15,25,Rain
17261,101,1552748400,27,3,30,Rain
17262,102,1552748400,0,0,0,Rain
17263,103,1552748400,26,14,40,Rain
17264,104,1552748400,40,0,40,Rain
17265,105,1552748400,34,2,36,Rain
17266,106,1552748400,40,0,40,Rain
17267,107,1552748400,39,1,40,Rain
17268,108,1552748400,40,0,40,Rain
17269,109,1552748400,23,6,29,Rain
17270,110,1552748400,36,4,40,Rain
17271,111,1552748400,38,2,40,Rain
17272,112,1552748400,24,6,30,Rain
17273,113,1552748400,0,0,0,Rain
17274,114,1552748400,29,11,40,Rain
17275,115,1552748400,10,20,30,Rain
17276,2,1552752000,14,6,20,Clouds
17277,3,1552752000,13,7,20,Clouds
17278,4,1552752000,19,1,20,Clouds
17279,5,1552752000,10,30,40,Clouds
17280,6,1552752000,20,0,20,Clouds
17281,7,1552752000,12,17,29,Clouds
17282,8,1552752000,15,15,30,Clouds
17283,9,1552752000,14,10,24,Clouds
17284,10,1552752000,1,15,16,Clouds
17285,11,1552752000,30,0,30,Clouds
17286,12,1552752000,11,9,20,Clouds
17287,13,1552752000,16,14,30,Clouds
17288,14,1552752000,6,24,30,Clouds
17289,15,1552752000,16,0,16,Clouds
17290,16,1552752000,9,11,20,Clouds
17291,17,1552752000,12,8,20,Clouds
17292,18,1552752000,0,30,30,Clouds
17293,19,1552752000,23,7,30,Clouds
17294,21,1552752000,9,21,30,Clouds
17295,22,1552752000,3,17,20,Clouds
17296,23,1552752000,0,0,0,Clouds
17297,24,1552752000,0,20,20,Clouds
17298,25,1552752000,0,0,0,Clouds
17299,26,1552752000,0,20,20,Clouds
17300,27,1552752000,1,19,20,Clouds
17301,28,1552752000,21,9,30,Clouds
17302,29,1552752000,8,21,29,Clouds
17303,30,1552752000,20,0,20,Clouds
17304,31,1552752000,3,17,20,Clouds
17305,32,1552752000,24,6,30,Clouds
17306,33,1552752000,0,23,23,Clouds
17307,34,1552752000,23,7,30,Clouds
17308,35,1552752000,27,3,30,Clouds
17309,36,1552752000,34,6,40,Clouds
17310,37,1552752000,30,0,30,Clouds
17311,38,1552752000,1,39,40,Clouds
17312,39,1552752000,12,8,20,Clouds
17313,40,1552752000,6,15,21,Clouds
17314,41,1552752000,20,0,20,Clouds
17315,42,1552752000,12,18,30,Clouds
17316,43,1552752000,15,15,30,Clouds
17317,44,1552752000,29,1,30,Clouds
17318,45,1552752000,0,30,30,Clouds
17319,46,1552752000,0,20,20,Clouds
17320,47,1552752000,39,1,40,Clouds
17321,48,1552752000,24,16,40,Clouds
17322,49,1552752000,14,26,40,Clouds
17323,50,1552752000,32,8,40,Clouds
17324,51,1552752000,16,24,40,Clouds
17325,52,1552752000,17,15,32,Clouds
17326,53,1552752000,40,0,40,Clouds
17327,54,1552752000,28,5,33,Clouds
17328,55,1552752000,34,2,36,Clouds
17329,56,1552752000,28,12,40,Clouds
17330,57,1552752000,14,9,23,Clouds
17331,58,1552752000,31,9,40,Clouds
17332,59,1552752000,18,2,20,Clouds
17333,60,1552752000,20,10,30,Clouds
17334,61,1552752000,23,2,25,Clouds
17335,62,1552752000,34,6,40,Clouds
17336,63,1552752000,16,19,35,Clouds
17337,64,1552752000,27,13,40,Clouds
17338,65,1552752000,36,4,40,Clouds
17339,66,1552752000,20,20,40,Clouds
17340,67,1552752000,32,8,40,Clouds
17341,68,1552752000,33,7,40,Clouds
17342,69,1552752000,27,13,40,Clouds
17343,70,1552752000,27,1,28,Clouds
17344,71,1552752000,39,1,40,Clouds
17345,72,1552752000,17,14,31,Clouds
17346,73,1552752000,16,14,30,Clouds
17347,74,1552752000,10,20,30,Clouds
17348,75,1552752000,35,5,40,Clouds
17349,76,1552752000,20,18,38,Clouds
17350,77,1552752000,25,3,28,Clouds
17351,78,1552752000,35,5,40,Clouds
17352,79,1552752000,11,16,27,Clouds
17353,80,1552752000,19,21,40,Clouds
17354,81,1552752000,27,13,40,Clouds
17355,82,1552752000,19,3,22,Clouds
17356,83,1552752000,15,25,40,Clouds
17357,84,1552752000,21,9,30,Clouds
17358,85,1552752000,25,10,35,Clouds
17359,86,1552752000,14,24,38,Clouds
17360,87,1552752000,18,20,38,Clouds
17361,88,1552752000,26,4,30,Clouds
17362,89,1552752000,28,12,40,Clouds
17363,90,1552752000,35,5,40,Clouds
17364,91,1552752000,21,9,30,Clouds
17365,92,1552752000,20,20,40,Clouds
17366,93,1552752000,1,39,40,Clouds
17367,94,1552752000,16,24,40,Clouds
17368,95,1552752000,27,13,40,Clouds
17369,96,1552752000,23,7,30,Clouds
17370,97,1552752000,22,18,40,Clouds
17371,98,1552752000,8,32,40,Clouds
17372,99,1552752000,4,26,30,Clouds
17373,100,1552752000,9,16,25,Clouds
17374,101,1552752000,30,0,30,Clouds
17375,102,1552752000,0,0,0,Clouds
17376,103,1552752000,27,13,40,Clouds
17377,104,1552752000,40,0,40,Clouds
17378,105,1552752000,35,1,36,Clouds
17379,106,1552752000,39,1,40,Clouds
17380,107,1552752000,39,1,40,Clouds
17381,108,1552752000,40,0,40,Clouds
17382,109,1552752000,22,7,29,Clouds
17383,110,1552752000,36,4,40,Clouds
17384,111,1552752000,38,2,40,Clouds
17385,112,1552752000,28,2,30,Clouds
17386,113,1552752000,0,0,0,Clouds
17387,114,1552752000,32,8,40,Clouds
17388,115,1552752000,9,21,30,Clouds
17389,2,1552755600,17,3,20,Rain
17390,3,1552755600,15,5,20,Rain
17391,4,1552755600,20,0,20,Rain
17392,5,1552755600,8,32,40,Rain
17393,6,1552755600,20,0,20,Rain
17394,7,1552755600,8,21,29,Rain
17395,8,1552755600,17,13,30,Rain
17396,9,1552755600,8,16,24,Rain
17397,10,1552755600,1,15,16,Rain
17398,11,1552755600,30,0,30,Rain
17399,12,1552755600,14,6,20,Rain
17400,13,1552755600,15,15,30,Rain
17401,14,1552755600,16,14,30,Rain
17402,15,1552755600,16,0,16,Rain
17403,16,1552755600,7,13,20,Rain
17404,17,1552755600,13,7,20,Rain
17405,18,1552755600,3,27,30,Rain
17406,19,1552755600,22,8,30,Rain
17407,21,1552755600,8,22,30,Rain
17408,22,1552755600,14,6,20,Rain
17409,23,1552755600,0,0,0,Rain
17410,24,1552755600,0,20,20,Rain
17411,25,1552755600,0,0,0,Rain
17412,26,1552755600,0,20,20,Rain
17413,27,1552755600,0,20,20,Rain
17414,28,1552755600,19,11,30,Rain
17415,29,1552755600,3,26,29,Rain
17416,30,1552755600,20,0,20,Rain
17417,31,1552755600,4,16,20,Rain
17418,32,1552755600,23,7,30,Rain
17419,33,1552755600,1,22,23,Rain
17420,34,1552755600,21,9,30,Rain
17421,35,1552755600,22,8,30,Rain
17422,36,1552755600,30,10,40,Rain
17423,37,1552755600,30,0,30,Rain
17424,38,1552755600,5,35,40,Rain
17425,39,1552755600,11,9,20,Rain
17426,40,1552755600,13,8,21,Rain
17427,41,1552755600,19,1,20,Rain
17428,42,1552755600,9,21,30,Rain
17429,43,1552755600,18,12,30,Rain
17430,44,1552755600,30,0,30,Rain
17431,45,1552755600,1,29,30,Rain
17432,46,1552755600,4,16,20,Rain
17433,47,1552755600,39,1,40,Rain
17434,48,1552755600,25,15,40,Rain
17435,49,1552755600,11,29,40,Rain
17436,50,1552755600,33,7,40,Rain
17437,51,1552755600,16,24,40,Rain
17438,52,1552755600,10,22,32,Rain
17439,53,1552755600,40,0,40,Rain
17440,54,1552755600,29,4,33,Rain
17441,55,1552755600,34,2,36,Rain
17442,56,1552755600,28,12,40,Rain
17443,57,1552755600,16,7,23,Rain
17444,58,1552755600,30,10,40,Rain
17445,59,1552755600,19,1,20,Rain
17446,60,1552755600,23,7,30,Rain
17447,61,1552755600,24,1,25,Rain
17448,62,1552755600,33,7,40,Rain
17449,63,1552755600,15,20,35,Rain
17450,64,1552755600,30,10,40,Rain
17451,65,1552755600,37,3,40,Rain
17452,66,1552755600,19,21,40,Rain
17453,67,1552755600,36,4,40,Rain
17454,68,1552755600,32,8,40,Rain
17455,69,1552755600,25,15,40,Rain
17456,70,1552755600,24,4,28,Rain
17457,71,1552755600,39,1,40,Rain
17458,72,1552755600,22,9,31,Rain
17459,73,1552755600,21,9,30,Rain
17460,74,1552755600,11,19,30,Rain
17461,75,1552755600,30,10,40,Rain
17462,76,1552755600,18,20,38,Rain
17463,77,1552755600,26,3,29,Rain
17464,78,1552755600,36,4,40,Rain
17465,79,1552755600,12,15,27,Rain
17466,80,1552755600,18,22,40,Rain
17467,81,1552755600,10,30,40,Rain
17468,82,1552755600,19,3,22,Rain
17469,83,1552755600,18,22,40,Rain
17470,84,1552755600,21,9,30,Rain
17471,85,1552755600,26,9,35,Rain
17472,86,1552755600,12,26,38,Rain
17473,87,1552755600,18,20,38,Rain
17474,88,1552755600,25,5,30,Rain
17475,89,1552755600,28,12,40,Rain
17476,90,1552755600,35,5,40,Rain
17477,91,1552755600,20,10,30,Rain
17478,92,1552755600,20,20,40,Rain
17479,93,1552755600,1,39,40,Rain
17480,94,1552755600,16,24,40,Rain
17481,95,1552755600,24,16,40,Rain
17482,96,1552755600,25,5,30,Rain
17483,97,1552755600,21,19,40,Rain
17484,98,1552755600,9,31,40,Rain
17485,99,1552755600,4,26,30,Rain
17486,100,1552755600,15,10,25,Rain
17487,101,1552755600,28,2,30,Rain
17488,102,1552755600,0,0,0,Rain
17489,103,1552755600,27,13,40,Rain
17490,104,1552755600,40,0,40,Rain
17491,105,1552755600,36,0,36,Rain
17492,106,1552755600,39,1,40,Rain
17493,107,1552755600,39,1,40,Rain
17494,108,1552755600,38,2,40,Rain
17495,109,1552755600,23,6,29,Rain
17496,110,1552755600,36,4,40,Rain
17497,111,1552755600,38,2,40,Rain
17498,112,1552755600,26,4,30,Rain
17499,113,1552755600,0,0,0,Rain
17500,114,1552755600,31,9,40,Rain
17501,115,1552755600,9,21,30,Rain
17502,2,1552759200,17,3,20,Rain
17503,3,1552759200,16,4,20,Rain
17504,4,1552759200,20,0,20,Rain
17505,5,1552759200,6,34,40,Rain
17506,6,1552759200,20,0,20,Rain
17507,7,1552759200,9,20,29,Rain
17508,8,1552759200,17,13,30,Rain
17509,9,1552759200,7,17,24,Rain
17510,10,1552759200,6,10,16,Rain
17511,11,1552759200,30,0,30,Rain
17512,12,1552759200,14,6,20,Rain
17513,13,1552759200,14,16,30,Rain
17514,14,1552759200,8,22,30,Rain
17515,15,1552759200,14,2,16,Rain
17516,16,1552759200,1,19,20,Rain
17517,17,1552759200,12,8,20,Rain
17518,18,1552759200,5,25,30,Rain
17519,19,1552759200,26,4,30,Rain
17520,21,1552759200,8,22,30,Rain
17521,22,1552759200,10,10,20,Rain
17522,23,1552759200,0,0,0,Rain
17523,24,1552759200,3,17,20,Rain
17524,25,1552759200,0,0,0,Rain
17525,26,1552759200,0,20,20,Rain
17526,27,1552759200,0,20,20,Rain
17527,28,1552759200,17,13,30,Rain
17528,29,1552759200,5,24,29,Rain
17529,30,1552759200,20,0,20,Rain
17530,31,1552759200,3,17,20,Rain
17531,32,1552759200,25,5,30,Rain
17532,33,1552759200,0,23,23,Rain
17533,34,1552759200,25,5,30,Rain
17534,35,1552759200,22,8,30,Rain
17535,36,1552759200,24,16,40,Rain
17536,37,1552759200,30,0,30,Rain
17537,38,1552759200,2,38,40,Rain
17538,39,1552759200,16,4,20,Rain
17539,40,1552759200,11,10,21,Rain
17540,41,1552759200,1,19,20,Rain
17541,42,1552759200,9,21,30,Rain
17542,43,1552759200,19,11,30,Rain
17543,44,1552759200,29,1,30,Rain
17544,45,1552759200,2,28,30,Rain
17545,46,1552759200,4,16,20,Rain
17546,47,1552759200,38,2,40,Rain
17547,48,1552759200,28,12,40,Rain
17548,49,1552759200,11,29,40,Rain
17549,50,1552759200,33,7,40,Rain
17550,51,1552759200,15,25,40,Rain
17551,52,1552759200,10,22,32,Rain
17552,53,1552759200,40,0,40,Rain
17553,54,1552759200,32,1,33,Rain
17554,55,1552759200,35,1,36,Rain
17555,56,1552759200,28,12,40,Rain
17556,57,1552759200,15,8,23,Rain
17557,58,1552759200,27,13,40,Rain
17558,59,1552759200,19,1,20,Rain
17559,60,1552759200,22,8,30,Rain
17560,61,1552759200,25,0,25,Rain
17561,62,1552759200,31,9,40,Rain
17562,63,1552759200,15,20,35,Rain
17563,64,1552759200,33,7,40,Rain
17564,65,1552759200,38,2,40,Rain
17565,66,1552759200,22,18,40,Rain
17566,67,1552759200,35,5,40,Rain
17567,68,1552759200,27,13,40,Rain
17568,69,1552759200,20,20,40,Rain
17569,70,1552759200,20,8,28,Rain
17570,71,1552759200,37,3,40,Rain
17571,72,1552759200,25,6,31,Rain
17572,73,1552759200,24,6,30,Rain
17573,74,1552759200,10,20,30,Rain
17574,75,1552759200,29,11,40,Rain
17575,76,1552759200,13,25,38,Rain
17576,77,1552759200,29,0,29,Rain
17577,78,1552759200,38,2,40,Rain
17578,79,1552759200,12,15,27,Rain
17579,80,1552759200,18,22,40,Rain
17580,81,1552759200,9,31,40,Rain
17581,82,1552759200,21,1,22,Rain
17582,83,1552759200,19,21,40,Rain
17583,84,1552759200,21,9,30,Rain
17584,85,1552759200,25,10,35,Rain
17585,86,1552759200,11,27,38,Rain
17586,87,1552759200,17,21,38,Rain
17587,88,1552759200,24,6,30,Rain
17588,89,1552759200,27,13,40,Rain
17589,90,1552759200,37,3,40,Rain
17590,91,1552759200,20,10,30,Rain
17591,92,1552759200,20,20,40,Rain
17592,93,1552759200,1,39,40,Rain
17593,94,1552759200,16,24,40,Rain
17594,95,1552759200,27,13,40,Rain
17595,96,1552759200,25,5,30,Rain
17596,97,1552759200,20,20,40,Rain
17597,98,1552759200,30,10,40,Rain
17598,99,1552759200,6,24,30,Rain
17599,100,1552759200,13,12,25,Rain
17600,101,1552759200,29,1,30,Rain
17601,102,1552759200,0,0,0,Rain
17602,103,1552759200,32,8,40,Rain
17603,104,1552759200,40,0,40,Rain
17604,105,1552759200,36,0,36,Rain
17605,106,1552759200,40,0,40,Rain
17606,107,1552759200,39,1,40,Rain
17607,108,1552759200,39,1,40,Rain
17608,109,1552759200,22,7,29,Rain
17609,110,1552759200,36,4,40,Rain
17610,111,1552759200,36,4,40,Rain
17611,112,1552759200,24,6,30,Rain
17612,113,1552759200,0,0,0,Rain
17613,114,1552759200,29,11,40,Rain
17614,115,1552759200,10,20,30,Rain
17615,2,1552762800,14,6,20,Clouds
17616,3,1552762800,13,7,20,Clouds
17617,4,1552762800,18,2,20,Clouds
17618,5,1552762800,7,33,40,Clouds
17619,6,1552762800,20,0,20,Clouds
17620,7,1552762800,10,19,29,Clouds
17621,8,1552762800,10,20,30,Clouds
17622,9,1552762800,10,14,24,Clouds
17623,10,1552762800,9,7,16,Clouds
17624,11,1552762800,30,0,30,Clouds
17625,12,1552762800,16,4,20,Clouds
17626,13,1552762800,14,16,30,Clouds
17627,14,1552762800,9,21,30,Clouds
17628,15,1552762800,12,4,16,Clouds
17629,16,1552762800,0,19,19,Clouds
17630,17,1552762800,14,6,20,Clouds
17631,18,1552762800,7,23,30,Clouds
17632,19,1552762800,26,4,30,Clouds
17633,21,1552762800,8,22,30,Clouds
17634,22,1552762800,13,7,20,Clouds
17635,23,1552762800,0,0,0,Clouds
17636,24,1552762800,0,20,20,Clouds
17637,25,1552762800,0,0,0,Clouds
17638,26,1552762800,0,20,20,Clouds
17639,27,1552762800,1,19,20,Clouds
17640,28,1552762800,15,15,30,Clouds
17641,29,1552762800,2,27,29,Clouds
17642,30,1552762800,20,0,20,Clouds
17643,31,1552762800,2,18,20,Clouds
17644,32,1552762800,26,4,30,Clouds
17645,33,1552762800,1,22,23,Clouds
17646,34,1552762800,25,5,30,Clouds
17647,35,1552762800,20,10,30,Clouds
17648,36,1552762800,23,17,40,Clouds
17649,37,1552762800,30,0,30,Clouds
17650,38,1552762800,5,35,40,Clouds
17651,39,1552762800,13,7,20,Clouds
17652,40,1552762800,12,9,21,Clouds
17653,41,1552762800,0,20,20,Clouds
17654,42,1552762800,6,24,30,Clouds
17655,43,1552762800,18,12,30,Clouds
17656,44,1552762800,30,0,30,Clouds
17657,45,1552762800,5,25,30,Clouds
17658,46,1552762800,5,15,20,Clouds
17659,47,1552762800,37,3,40,Clouds
17660,48,1552762800,29,11,40,Clouds
17661,49,1552762800,14,26,40,Clouds
17662,50,1552762800,34,6,40,Clouds
17663,51,1552762800,18,22,40,Clouds
17664,52,1552762800,10,22,32,Clouds
17665,53,1552762800,40,0,40,Clouds
17666,54,1552762800,33,0,33,Clouds
17667,55,1552762800,32,4,36,Clouds
17668,56,1552762800,26,14,40,Clouds
17669,57,1552762800,16,7,23,Clouds
17670,58,1552762800,25,15,40,Clouds
17671,59,1552762800,19,1,20,Clouds
17672,60,1552762800,23,7,30,Clouds
17673,61,1552762800,25,0,25,Clouds
17674,62,1552762800,30,10,40,Clouds
17675,63,1552762800,16,19,35,Clouds
17676,64,1552762800,34,6,40,Clouds
17677,65,1552762800,37,3,40,Clouds
17678,66,1552762800,22,18,40,Clouds
17679,67,1552762800,33,7,40,Clouds
17680,68,1552762800,28,12,40,Clouds
17681,69,1552762800,26,14,40,Clouds
17682,70,1552762800,20,8,28,Clouds
17683,71,1552762800,35,5,40,Clouds
17684,72,1552762800,26,5,31,Clouds
17685,73,1552762800,26,4,30,Clouds
17686,74,1552762800,9,21,30,Clouds
17687,75,1552762800,28,12,40,Clouds
17688,76,1552762800,11,27,38,Clouds
17689,77,1552762800,26,3,29,Clouds
17690,78,1552762800,37,3,40,Clouds
17691,79,1552762800,13,14,27,Clouds
17692,80,1552762800,18,22,40,Clouds
17693,81,1552762800,9,31,40,Clouds
17694,82,1552762800,20,2,22,Clouds
17695,83,1552762800,18,22,40,Clouds
17696,84,1552762800,18,12,30,Clouds
17697,85,1552762800,23,12,35,Clouds
17698,86,1552762800,11,27,38,Clouds
17699,87,1552762800,17,21,38,Clouds
17700,88,1552762800,24,6,30,Clouds
17701,89,1552762800,29,11,40,Clouds
17702,90,1552762800,39,1,40,Clouds
17703,91,1552762800,21,9,30,Clouds
17704,92,1552762800,21,19,40,Clouds
17705,93,1552762800,1,39,40,Clouds
17706,94,1552762800,16,24,40,Clouds
17707,95,1552762800,25,15,40,Clouds
17708,96,1552762800,24,6,30,Clouds
17709,97,1552762800,21,19,40,Clouds
17710,98,1552762800,28,12,40,Clouds
17711,99,1552762800,11,19,30,Clouds
17712,100,1552762800,11,14,25,Clouds
17713,101,1552762800,28,2,30,Clouds
17714,102,1552762800,0,0,0,Clouds
17715,103,1552762800,31,9,40,Clouds
17716,104,1552762800,40,0,40,Clouds
17717,105,1552762800,36,0,36,Clouds
17718,106,1552762800,40,0,40,Clouds
17719,107,1552762800,40,0,40,Clouds
17720,108,1552762800,39,1,40,Clouds
17721,109,1552762800,22,7,29,Clouds
17722,110,1552762800,35,5,40,Clouds
17723,111,1552762800,36,4,40,Clouds
17724,112,1552762800,24,6,30,Clouds
17725,113,1552762800,0,0,0,Clouds
17726,114,1552762800,32,8,40,Clouds
17727,115,1552762800,11,19,30,Clouds
17728,2,1552766400,19,1,20,Rain
17729,3,1552766400,14,6,20,Rain
17730,4,1552766400,14,6,20,Rain
17731,5,1552766400,9,31,40,Rain
17732,6,1552766400,20,0,20,Rain
17733,7,1552766400,11,18,29,Rain
17734,8,1552766400,12,18,30,Rain
17735,9,1552766400,15,9,24,Rain
17736,10,1552766400,7,9,16,Rain
17737,11,1552766400,30,0,30,Rain
17738,12,1552766400,16,4,20,Rain
17739,13,1552766400,14,16,30,Rain
17740,14,1552766400,8,22,30,Rain
17741,15,1552766400,16,0,16,Rain
17742,16,1552766400,1,18,19,Rain
17743,17,1552766400,17,3,20,Rain
17744,18,1552766400,4,26,30,Rain
17745,19,1552766400,24,6,30,Rain
17746,21,1552766400,9,21,30,Rain
17747,22,1552766400,10,10,20,Rain
17748,23,1552766400,0,0,0,Rain
17749,24,1552766400,4,16,20,Rain
17750,25,1552766400,0,0,0,Rain
17751,26,1552766400,1,19,20,Rain
17752,27,1552766400,2,18,20,Rain
17753,28,1552766400,16,14,30,Rain
17754,29,1552766400,0,29,29,Rain
17755,30,1552766400,20,0,20,Rain
17756,31,1552766400,2,18,20,Rain
17757,32,1552766400,28,2,30,Rain
17758,33,1552766400,2,21,23,Rain
17759,34,1552766400,27,3,30,Rain
17760,35,1552766400,18,12,30,Rain
17761,36,1552766400,24,16,40,Rain
17762,37,1552766400,30,0,30,Rain
17763,38,1552766400,4,36,40,Rain
17764,39,1552766400,16,4,20,Rain
17765,40,1552766400,14,7,21,Rain
17766,41,1552766400,0,20,20,Rain
17767,42,1552766400,1,29,30,Rain
17768,43,1552766400,16,14,30,Rain
17769,44,1552766400,24,6,30,Rain
17770,45,1552766400,7,23,30,Rain
17771,46,1552766400,4,16,20,Rain
17772,47,1552766400,36,4,40,Rain
17773,48,1552766400,27,13,40,Rain
17774,49,1552766400,15,25,40,Rain
17775,50,1552766400,36,4,40,Rain
17776,51,1552766400,19,21,40,Rain
17777,52,1552766400,12,20,32,Rain
17778,53,1552766400,38,2,40,Rain
17779,54,1552766400,31,2,33,Rain
17780,55,1552766400,31,5,36,Rain
17781,56,1552766400,21,19,40,Rain
17782,57,1552766400,16,7,23,Rain
17783,58,1552766400,25,15,40,Rain
17784,59,1552766400,19,1,20,Rain
17785,60,1552766400,24,6,30,Rain
17786,61,1552766400,25,0,25,Rain
17787,62,1552766400,31,9,40,Rain
17788,63,1552766400,16,19,35,Rain
17789,64,1552766400,36,4,40,Rain
17790,65,1552766400,37,3,40,Rain
17791,66,1552766400,22,18,40,Rain
17792,67,1552766400,34,6,40,Rain
17793,68,1552766400,31,9,40,Rain
17794,69,1552766400,28,12,40,Rain
17795,70,1552766400,24,4,28,Rain
17796,71,1552766400,35,5,40,Rain
17797,72,1552766400,27,4,31,Rain
17798,73,1552766400,26,4,30,Rain
17799,74,1552766400,8,22,30,Rain
17800,75,1552766400,27,13,40,Rain
17801,76,1552766400,14,24,38,Rain
17802,77,1552766400,27,2,29,Rain
17803,78,1552766400,39,1,40,Rain
17804,79,1552766400,13,14,27,Rain
17805,80,1552766400,19,21,40,Rain
17806,81,1552766400,9,31,40,Rain
17807,82,1552766400,19,3,22,Rain
17808,83,1552766400,18,22,40,Rain
17809,84,1552766400,19,11,30,Rain
17810,85,1552766400,25,10,35,Rain
17811,86,1552766400,8,30,38,Rain
17812,87,1552766400,16,22,38,Rain
17813,88,1552766400,24,6,30,Rain
17814,89,1552766400,29,11,40,Rain
17815,90,1552766400,40,0,40,Rain
17816,91,1552766400,14,16,30,Rain
17817,92,1552766400,21,19,40,Rain
17818,93,1552766400,1,39,40,Rain
17819,94,1552766400,16,24,40,Rain
17820,95,1552766400,29,11,40,Rain
17821,96,1552766400,24,6,30,Rain
17822,97,1552766400,21,19,40,Rain
17823,98,1552766400,28,12,40,Rain
17824,99,1552766400,14,16,30,Rain
17825,100,1552766400,7,18,25,Rain
17826,101,1552766400,25,5,30,Rain
17827,102,1552766400,0,0,0,Rain
17828,103,1552766400,33,7,40,Rain
17829,104,1552766400,40,0,40,Rain
17830,105,1552766400,36,0,36,Rain
17831,106,1552766400,40,0,40,Rain
17832,107,1552766400,39,1,40,Rain
17833,108,1552766400,40,0,40,Rain
17834,109,1552766400,25,4,29,Rain
17835,110,1552766400,34,6,40,Rain
17836,111,1552766400,35,5,40,Rain
17837,112,1552766400,19,11,30,Rain
17838,113,1552766400,0,0,0,Rain
17839,114,1552766400,30,10,40,Rain
17840,115,1552766400,9,21,30,Rain
17841,2,1552770000,20,0,20,Rain
17842,3,1552770000,12,8,20,Rain
17843,4,1552770000,13,7,20,Rain
17844,5,1552770000,4,36,40,Rain
17845,6,1552770000,20,0,20,Rain
17846,7,1552770000,10,19,29,Rain
17847,8,1552770000,10,20,30,Rain
17848,9,1552770000,17,7,24,Rain
17849,10,1552770000,2,14,16,Rain
17850,11,1552770000,30,0,30,Rain
17851,12,1552770000,14,6,20,Rain
17852,13,1552770000,15,15,30,Rain
17853,14,1552770000,8,22,30,Rain
17854,15,1552770000,16,0,16,Rain
17855,16,1552770000,0,20,20,Rain
17856,17,1552770000,14,6,20,Rain
17857,18,1552770000,2,28,30,Rain
17858,19,1552770000,24,6,30,Rain
17859,21,1552770000,9,21,30,Rain
17860,22,1552770000,9,11,20,Rain
17861,23,1552770000,0,0,0,Rain
17862,24,1552770000,2,18,20,Rain
17863,25,1552770000,0,0,0,Rain
17864,26,1552770000,1,19,20,Rain
17865,27,1552770000,1,19,20,Rain
17866,28,1552770000,14,16,30,Rain
17867,29,1552770000,12,17,29,Rain
17868,30,1552770000,20,0,20,Rain
17869,31,1552770000,7,13,20,Rain
17870,32,1552770000,30,0,30,Rain
17871,33,1552770000,0,23,23,Rain
17872,34,1552770000,20,10,30,Rain
17873,35,1552770000,19,11,30,Rain
17874,36,1552770000,27,13,40,Rain
17875,37,1552770000,30,0,30,Rain
17876,38,1552770000,1,39,40,Rain
17877,39,1552770000,15,5,20,Rain
17878,40,1552770000,16,5,21,Rain
17879,41,1552770000,1,19,20,Rain
17880,42,1552770000,1,29,30,Rain
17881,43,1552770000,14,16,30,Rain
17882,44,1552770000,23,7,30,Rain
17883,45,1552770000,8,22,30,Rain
17884,46,1552770000,7,13,20,Rain
17885,47,1552770000,38,2,40,Rain
17886,48,1552770000,27,13,40,Rain
17887,49,1552770000,17,23,40,Rain
17888,50,1552770000,38,2,40,Rain
17889,51,1552770000,20,20,40,Rain
17890,52,1552770000,13,19,32,Rain
17891,53,1552770000,37,3,40,Rain
17892,54,1552770000,29,4,33,Rain
17893,55,1552770000,30,6,36,Rain
17894,56,1552770000,24,16,40,Rain
17895,57,1552770000,15,8,23,Rain
17896,58,1552770000,28,12,40,Rain
17897,59,1552770000,17,3,20,Rain
17898,60,1552770000,24,6,30,Rain
17899,61,1552770000,25,0,25,Rain
17900,62,1552770000,32,8,40,Rain
17901,63,1552770000,16,19,35,Rain
17902,64,1552770000,31,9,40,Rain
17903,65,1552770000,40,0,40,Rain
17904,66,1552770000,21,19,40,Rain
17905,67,1552770000,30,10,40,Rain
17906,68,1552770000,34,6,40,Rain
17907,69,1552770000,28,12,40,Rain
17908,70,1552770000,18,10,28,Rain
17909,71,1552770000,32,8,40,Rain
17910,72,1552770000,26,5,31,Rain
17911,73,1552770000,25,5,30,Rain
17912,74,1552770000,8,22,30,Rain
17913,75,1552770000,26,14,40,Rain
17914,76,1552770000,15,23,38,Rain
17915,77,1552770000,28,1,29,Rain
17916,78,1552770000,34,6,40,Rain
17917,79,1552770000,13,14,27,Rain
17918,80,1552770000,18,22,40,Rain
17919,81,1552770000,9,31,40,Rain
17920,82,1552770000,18,4,22,Rain
17921,83,1552770000,18,22,40,Rain
17922,84,1552770000,18,12,30,Rain
17923,85,1552770000,26,9,35,Rain
17924,86,1552770000,8,30,38,Rain
17925,87,1552770000,16,22,38,Rain
17926,88,1552770000,28,2,30,Rain
17927,89,1552770000,30,10,40,Rain
17928,90,1552770000,39,1,40,Rain
17929,91,1552770000,19,11,30,Rain
17930,92,1552770000,21,19,40,Rain
17931,93,1552770000,1,39,40,Rain
17932,94,1552770000,16,24,40,Rain
17933,95,1552770000,28,12,40,Rain
17934,96,1552770000,25,5,30,Rain
17935,97,1552770000,22,18,40,Rain
17936,98,1552770000,26,14,40,Rain
17937,99,1552770000,13,17,30,Rain
17938,100,1552770000,7,18,25,Rain
17939,101,1552770000,23,7,30,Rain
17940,102,1552770000,0,0,0,Rain
17941,103,1552770000,33,7,40,Rain
17942,104,1552770000,40,0,40,Rain
17943,105,1552770000,36,0,36,Rain
17944,106,1552770000,39,1,40,Rain
17945,107,1552770000,39,1,40,Rain
17946,108,1552770000,40,0,40,Rain
17947,109,1552770000,25,4,29,Rain
17948,110,1552770000,36,4,40,Rain
17949,111,1552770000,33,7,40,Rain
17950,112,1552770000,22,8,30,Rain
17951,113,1552770000,0,0,0,Rain
17952,114,1552770000,28,12,40,Rain
17953,115,1552770000,10,20,30,Rain
17954,2,1552773600,20,0,20,Clouds
17955,3,1552773600,15,5,20,Clouds
17956,4,1552773600,14,6,20,Clouds
17957,5,1552773600,8,32,40,Clouds
17958,6,1552773600,20,0,20,Clouds
17959,7,1552773600,11,18,29,Clouds
17960,8,1552773600,7,23,30,Clouds
17961,9,1552773600,16,8,24,Clouds
17962,10,1552773600,3,13,16,Clouds
17963,11,1552773600,30,0,30,Clouds
17964,12,1552773600,15,5,20,Clouds
17965,13,1552773600,14,16,30,Clouds
17966,14,1552773600,1,29,30,Clouds
17967,15,1552773600,14,2,16,Clouds
17968,16,1552773600,1,19,20,Clouds
17969,17,1552773600,16,4,20,Clouds
17970,18,1552773600,3,27,30,Clouds
17971,19,1552773600,21,9,30,Clouds
17972,21,1552773600,9,21,30,Clouds
17973,22,1552773600,12,8,20,Clouds
17974,23,1552773600,0,0,0,Clouds
17975,24,1552773600,1,19,20,Clouds
17976,25,1552773600,0,0,0,Clouds
17977,26,1552773600,6,14,20,Clouds
17978,27,1552773600,2,18,20,Clouds
17979,28,1552773600,15,15,30,Clouds
17980,29,1552773600,6,23,29,Clouds
17981,30,1552773600,20,0,20,Clouds
17982,31,1552773600,1,19,20,Clouds
17983,32,1552773600,30,0,30,Clouds
17984,33,1552773600,3,20,23,Clouds
17985,34,1552773600,17,13,30,Clouds
17986,35,1552773600,23,7,30,Clouds
17987,36,1552773600,27,13,40,Clouds
17988,37,1552773600,30,0,30,Clouds
17989,38,1552773600,2,38,40,Clouds
17990,39,1552773600,14,6,20,Clouds
17991,40,1552773600,13,8,21,Clouds
17992,41,1552773600,1,19,20,Clouds
17993,42,1552773600,1,29,30,Clouds
17994,43,1552773600,11,19,30,Clouds
17995,44,1552773600,22,8,30,Clouds
17996,45,1552773600,8,22,30,Clouds
17997,46,1552773600,6,14,20,Clouds
17998,47,1552773600,38,2,40,Clouds
17999,48,1552773600,28,12,40,Clouds
18000,49,1552773600,20,20,40,Clouds
18001,50,1552773600,38,2,40,Clouds
18002,51,1552773600,26,14,40,Clouds
18003,52,1552773600,12,20,32,Clouds
18004,53,1552773600,36,4,40,Clouds
18005,54,1552773600,29,4,33,Clouds
18006,55,1552773600,29,7,36,Clouds
18007,56,1552773600,24,16,40,Clouds
18008,57,1552773600,14,9,23,Clouds
18009,58,1552773600,27,13,40,Clouds
18010,59,1552773600,17,3,20,Clouds
18011,60,1552773600,28,2,30,Clouds
18012,61,1552773600,24,1,25,Clouds
18013,62,1552773600,31,9,40,Clouds
18014,63,1552773600,16,19,35,Clouds
18015,64,1552773600,33,7,40,Clouds
18016,65,1552773600,40,0,40,Clouds
18017,66,1552773600,21,19,40,Clouds
18018,67,1552773600,30,10,40,Clouds
18019,68,1552773600,32,8,40,Clouds
18020,69,1552773600,28,12,40,Clouds
18021,70,1552773600,21,7,28,Clouds
18022,71,1552773600,32,8,40,Clouds
18023,72,1552773600,20,11,31,Clouds
18024,73,1552773600,23,7,30,Clouds
18025,74,1552773600,10,20,30,Clouds
18026,75,1552773600,27,13,40,Clouds
18027,76,1552773600,16,22,38,Clouds
18028,77,1552773600,28,1,29,Clouds
18029,78,1552773600,32,8,40,Clouds
18030,79,1552773600,14,13,27,Clouds
18031,80,1552773600,18,22,40,Clouds
18032,81,1552773600,9,31,40,Clouds
18033,82,1552773600,18,4,22,Clouds
18034,83,1552773600,23,17,40,Clouds
18035,84,1552773600,15,15,30,Clouds
18036,85,1552773600,25,10,35,Clouds
18037,86,1552773600,9,28,37,Clouds
18038,87,1552773600,16,22,38,Clouds
18039,88,1552773600,29,1,30,Clouds
18040,89,1552773600,30,10,40,Clouds
18041,90,1552773600,34,6,40,Clouds
18042,91,1552773600,18,12,30,Clouds
18043,92,1552773600,20,20,40,Clouds
18044,93,1552773600,1,39,40,Clouds
18045,94,1552773600,16,24,40,Clouds
18046,95,1552773600,28,12,40,Clouds
18047,96,1552773600,25,5,30,Clouds
18048,97,1552773600,23,17,40,Clouds
18049,98,1552773600,28,12,40,Clouds
18050,99,1552773600,13,17,30,Clouds
18051,100,1552773600,11,14,25,Clouds
18052,101,1552773600,24,6,30,Clouds
18053,102,1552773600,0,0,0,Clouds
18054,103,1552773600,35,5,40,Clouds
18055,104,1552773600,40,0,40,Clouds
18056,105,1552773600,36,0,36,Clouds
18057,106,1552773600,40,0,40,Clouds
18058,107,1552773600,39,1,40,Clouds
18059,108,1552773600,39,1,40,Clouds
18060,109,1552773600,24,5,29,Clouds
18061,110,1552773600,37,3,40,Clouds
18062,111,1552773600,32,8,40,Clouds
18063,112,1552773600,20,10,30,Clouds
18064,113,1552773600,0,0,0,Clouds
18065,114,1552773600,27,13,40,Clouds
18066,115,1552773600,14,16,30,Clouds
18067,2,1552777200,18,2,20,Clouds
18068,3,1552777200,15,5,20,Clouds
18069,4,1552777200,15,5,20,Clouds
18070,5,1552777200,7,33,40,Clouds
18071,6,1552777200,20,0,20,Clouds
18072,7,1552777200,11,18,29,Clouds
18073,8,1552777200,6,24,30,Clouds
18074,9,1552777200,6,18,24,Clouds
18075,10,1552777200,1,15,16,Clouds
18076,11,1552777200,30,0,30,Clouds
18077,12,1552777200,15,5,20,Clouds
18078,13,1552777200,14,16,30,Clouds
18079,14,1552777200,0,30,30,Clouds
18080,15,1552777200,15,1,16,Clouds
18081,16,1552777200,2,18,20,Clouds
18082,17,1552777200,17,3,20,Clouds
18083,18,1552777200,1,29,30,Clouds
18084,19,1552777200,24,6,30,Clouds
18085,21,1552777200,10,20,30,Clouds
18086,22,1552777200,8,12,20,Clouds
18087,23,1552777200,0,0,0,Clouds
18088,24,1552777200,2,18,20,Clouds
18089,25,1552777200,0,0,0,Clouds
18090,26,1552777200,8,12,20,Clouds
18091,27,1552777200,4,16,20,Clouds
18092,28,1552777200,13,17,30,Clouds
18093,29,1552777200,1,28,29,Clouds
18094,30,1552777200,20,0,20,Clouds
18095,31,1552777200,4,16,20,Clouds
18096,32,1552777200,29,1,30,Clouds
18097,33,1552777200,2,21,23,Clouds
18098,34,1552777200,17,13,30,Clouds
18099,35,1552777200,22,8,30,Clouds
18100,36,1552777200,30,10,40,Clouds
18101,37,1552777200,30,0,30,Clouds
18102,38,1552777200,1,39,40,Clouds
18103,39,1552777200,12,8,20,Clouds
18104,40,1552777200,13,8,21,Clouds
18105,41,1552777200,2,18,20,Clouds
18106,42,1552777200,3,27,30,Clouds
18107,43,1552777200,13,17,30,Clouds
18108,44,1552777200,17,12,29,Clouds
18109,45,1552777200,6,24,30,Clouds
18110,46,1552777200,5,15,20,Clouds
18111,47,1552777200,37,3,40,Clouds
18112,48,1552777200,26,14,40,Clouds
18113,49,1552777200,22,18,40,Clouds
18114,50,1552777200,38,2,40,Clouds
18115,51,1552777200,26,14,40,Clouds
18116,52,1552777200,11,21,32,Clouds
18117,53,1552777200,35,5,40,Clouds
18118,54,1552777200,29,4,33,Clouds
18119,55,1552777200,29,7,36,Clouds
18120,56,1552777200,24,16,40,Clouds
18121,57,1552777200,14,9,23,Clouds
18122,58,1552777200,27,13,40,Clouds
18123,59,1552777200,17,3,20,Clouds
18124,60,1552777200,25,5,30,Clouds
18125,61,1552777200,25,0,25,Clouds
18126,62,1552777200,31,9,40,Clouds
18127,63,1552777200,16,19,35,Clouds
18128,64,1552777200,35,5,40,Clouds
18129,65,1552777200,40,0,40,Clouds
18130,66,1552777200,20,20,40,Clouds
18131,67,1552777200,32,8,40,Clouds
18132,68,1552777200,33,7,40,Clouds
18133,69,1552777200,28,12,40,Clouds
18134,70,1552777200,22,6,28,Clouds
18135,71,1552777200,35,5,40,Clouds
18136,72,1552777200,21,10,31,Clouds
18137,73,1552777200,21,9,30,Clouds
18138,74,1552777200,11,19,30,Clouds
18139,75,1552777200,30,10,40,Clouds
18140,76,1552777200,16,22,38,Clouds
18141,77,1552777200,28,1,29,Clouds
18142,78,1552777200,31,9,40,Clouds
18143,79,1552777200,13,14,27,Clouds
18144,80,1552777200,20,20,40,Clouds
18145,81,1552777200,9,31,40,Clouds
18146,82,1552777200,16,6,22,Clouds
18147,83,1552777200,21,19,40,Clouds
18148,84,1552777200,16,14,30,Clouds
18149,85,1552777200,26,9,35,Clouds
18150,86,1552777200,9,29,38,Clouds
18151,87,1552777200,17,21,38,Clouds
18152,88,1552777200,28,2,30,Clouds
18153,89,1552777200,31,9,40,Clouds
18154,90,1552777200,33,7,40,Clouds
18155,91,1552777200,15,15,30,Clouds
18156,92,1552777200,21,19,40,Clouds
18157,93,1552777200,1,39,40,Clouds
18158,94,1552777200,16,24,40,Clouds
18159,95,1552777200,30,10,40,Clouds
18160,96,1552777200,25,5,30,Clouds
18161,97,1552777200,25,15,40,Clouds
18162,98,1552777200,28,12,40,Clouds
18163,99,1552777200,13,17,30,Clouds
18164,100,1552777200,13,12,25,Clouds
18165,101,1552777200,23,7,30,Clouds
18166,102,1552777200,0,0,0,Clouds
18167,103,1552777200,35,5,40,Clouds
18168,104,1552777200,40,0,40,Clouds
18169,105,1552777200,36,0,36,Clouds
18170,106,1552777200,39,1,40,Clouds
18171,107,1552777200,40,0,40,Clouds
18172,108,1552777200,34,6,40,Clouds
18173,109,1552777200,21,8,29,Clouds
18174,110,1552777200,38,2,40,Clouds
18175,111,1552777200,31,9,40,Clouds
18176,112,1552777200,24,6,30,Clouds
18177,113,1552777200,0,0,0,Clouds
18178,114,1552777200,27,13,40,Clouds
18179,115,1552777200,16,14,30,Clouds
18180,2,1552780800,15,5,20,Clouds
18181,3,1552780800,16,4,20,Clouds
18182,4,1552780800,15,5,20,Clouds
18183,5,1552780800,9,31,40,Clouds
18184,6,1552780800,20,0,20,Clouds
18185,7,1552780800,11,18,29,Clouds
18186,8,1552780800,8,22,30,Clouds
18187,9,1552780800,7,17,24,Clouds
18188,10,1552780800,2,14,16,Clouds
18189,11,1552780800,30,0,30,Clouds
18190,12,1552780800,16,4,20,Clouds
18191,13,1552780800,14,16,30,Clouds
18192,14,1552780800,1,29,30,Clouds
18193,15,1552780800,14,2,16,Clouds
18194,16,1552780800,4,16,20,Clouds
18195,17,1552780800,16,4,20,Clouds
18196,18,1552780800,1,29,30,Clouds
18197,19,1552780800,27,3,30,Clouds
18198,21,1552780800,12,18,30,Clouds
18199,22,1552780800,8,12,20,Clouds
18200,23,1552780800,0,0,0,Clouds
18201,24,1552780800,1,18,19,Clouds
18202,25,1552780800,0,0,0,Clouds
18203,26,1552780800,7,13,20,Clouds
18204,27,1552780800,2,18,20,Clouds
18205,28,1552780800,15,15,30,Clouds
18206,29,1552780800,5,24,29,Clouds
18207,30,1552780800,20,0,20,Clouds
18208,31,1552780800,12,8,20,Clouds
18209,32,1552780800,30,0,30,Clouds
18210,33,1552780800,1,22,23,Clouds
18211,34,1552780800,19,11,30,Clouds
18212,35,1552780800,26,4,30,Clouds
18213,36,1552780800,32,8,40,Clouds
18214,37,1552780800,30,0,30,Clouds
18215,38,1552780800,1,39,40,Clouds
18216,39,1552780800,10,10,20,Clouds
18217,40,1552780800,13,8,21,Clouds
18218,41,1552780800,2,18,20,Clouds
18219,42,1552780800,3,27,30,Clouds
18220,43,1552780800,12,18,30,Clouds
18221,44,1552780800,18,11,29,Clouds
18222,45,1552780800,6,24,30,Clouds
18223,46,1552780800,5,15,20,Clouds
18224,47,1552780800,37,3,40,Clouds
18225,48,1552780800,24,16,40,Clouds
18226,49,1552780800,24,16,40,Clouds
18227,50,1552780800,40,0,40,Clouds
18228,51,1552780800,26,14,40,Clouds
18229,52,1552780800,9,23,32,Clouds
18230,53,1552780800,36,4,40,Clouds
18231,54,1552780800,28,5,33,Clouds
18232,55,1552780800,29,7,36,Clouds
18233,56,1552780800,20,20,40,Clouds
18234,57,1552780800,14,9,23,Clouds
18235,58,1552780800,28,12,40,Clouds
18236,59,1552780800,17,3,20,Clouds
18237,60,1552780800,22,8,30,Clouds
18238,61,1552780800,25,0,25,Clouds
18239,62,1552780800,31,9,40,Clouds
18240,63,1552780800,17,18,35,Clouds
18241,64,1552780800,34,6,40,Clouds
18242,65,1552780800,40,0,40,Clouds
18243,66,1552780800,20,20,40,Clouds
18244,67,1552780800,32,8,40,Clouds
18245,68,1552780800,34,6,40,Clouds
18246,69,1552780800,27,13,40,Clouds
18247,70,1552780800,22,6,28,Clouds
18248,71,1552780800,34,6,40,Clouds
18249,72,1552780800,24,7,31,Clouds
18250,73,1552780800,19,11,30,Clouds
18251,74,1552780800,10,20,30,Clouds
18252,75,1552780800,31,9,40,Clouds
18253,76,1552780800,17,21,38,Clouds
18254,77,1552780800,27,2,29,Clouds
18255,78,1552780800,31,9,40,Clouds
18256,79,1552780800,13,14,27,Clouds
18257,80,1552780800,17,23,40,Clouds
18258,81,1552780800,9,31,40,Clouds
18259,82,1552780800,16,6,22,Clouds
18260,83,1552780800,20,20,40,Clouds
18261,84,1552780800,15,15,30,Clouds
18262,85,1552780800,26,9,35,Clouds
18263,86,1552780800,9,29,38,Clouds
18264,87,1552780800,17,21,38,Clouds
18265,88,1552780800,29,1,30,Clouds
18266,89,1552780800,31,9,40,Clouds
18267,90,1552780800,32,8,40,Clouds
18268,91,1552780800,12,18,30,Clouds
18269,92,1552780800,21,19,40,Clouds
18270,93,1552780800,1,39,40,Clouds
18271,94,1552780800,16,24,40,Clouds
18272,95,1552780800,30,10,40,Clouds
18273,96,1552780800,26,4,30,Clouds
18274,97,1552780800,24,16,40,Clouds
18275,98,1552780800,28,12,40,Clouds
18276,99,1552780800,13,17,30,Clouds
18277,100,1552780800,14,11,25,Clouds
18278,101,1552780800,20,10,30,Clouds
18279,102,1552780800,0,0,0,Clouds
18280,103,1552780800,36,4,40,Clouds
18281,104,1552780800,40,0,40,Clouds
18282,105,1552780800,35,1,36,Clouds
18283,106,1552780800,40,0,40,Clouds
18284,107,1552780800,38,2,40,Clouds
18285,108,1552780800,33,7,40,Clouds
18286,109,1552780800,16,12,28,Clouds
18287,110,1552780800,38,2,40,Clouds
18288,111,1552780800,29,11,40,Clouds
18289,112,1552780800,23,7,30,Clouds
18290,113,1552780800,0,0,0,Clouds
18291,114,1552780800,27,13,40,Clouds
18292,115,1552780800,14,16,30,Clouds
18293,2,1552784400,14,6,20,Clouds
18294,3,1552784400,17,3,20,Clouds
18295,4,1552784400,16,4,20,Clouds
18296,5,1552784400,14,26,40,Clouds
18297,6,1552784400,20,0,20,Clouds
18298,7,1552784400,11,18,29,Clouds
18299,8,1552784400,9,21,30,Clouds
18300,9,1552784400,13,11,24,Clouds
18301,10,1552784400,2,14,16,Clouds
18302,11,1552784400,30,0,30,Clouds
18303,12,1552784400,15,5,20,Clouds
18304,13,1552784400,14,16,30,Clouds
18305,14,1552784400,6,24,30,Clouds
18306,15,1552784400,13,3,16,Clouds
18307,16,1552784400,0,20,20,Clouds
18308,17,1552784400,16,4,20,Clouds
18309,18,1552784400,2,28,30,Clouds
18310,19,1552784400,28,2,30,Clouds
18311,21,1552784400,17,13,30,Clouds
18312,22,1552784400,7,13,20,Clouds
18313,23,1552784400,0,0,0,Clouds
18314,24,1552784400,6,14,20,Clouds
18315,25,1552784400,0,0,0,Clouds
18316,26,1552784400,8,12,20,Clouds
18317,27,1552784400,3,17,20,Clouds
18318,28,1552784400,18,12,30,Clouds
18319,29,1552784400,7,22,29,Clouds
18320,30,1552784400,20,0,20,Clouds
18321,31,1552784400,11,9,20,Clouds
18322,32,1552784400,30,0,30,Clouds
18323,33,1552784400,10,13,23,Clouds
18324,34,1552784400,21,9,30,Clouds
18325,35,1552784400,30,0,30,Clouds
18326,36,1552784400,33,7,40,Clouds
18327,37,1552784400,30,0,30,Clouds
18328,38,1552784400,1,39,40,Clouds
18329,39,1552784400,9,11,20,Clouds
18330,40,1552784400,15,6,21,Clouds
18331,41,1552784400,4,16,20,Clouds
18332,42,1552784400,6,24,30,Clouds
18333,43,1552784400,10,20,30,Clouds
18334,44,1552784400,14,15,29,Clouds
18335,45,1552784400,5,25,30,Clouds
18336,46,1552784400,6,14,20,Clouds
18337,47,1552784400,37,3,40,Clouds
18338,48,1552784400,25,15,40,Clouds
18339,49,1552784400,21,19,40,Clouds
18340,50,1552784400,40,0,40,Clouds
18341,51,1552784400,28,12,40,Clouds
18342,52,1552784400,9,23,32,Clouds
18343,53,1552784400,35,5,40,Clouds
18344,54,1552784400,26,7,33,Clouds
18345,55,1552784400,29,7,36,Clouds
18346,56,1552784400,19,21,40,Clouds
18347,57,1552784400,13,10,23,Clouds
18348,58,1552784400,28,12,40,Clouds
18349,59,1552784400,17,3,20,Clouds
18350,60,1552784400,19,11,30,Clouds
18351,61,1552784400,24,1,25,Clouds
18352,62,1552784400,29,11,40,Clouds
18353,63,1552784400,17,18,35,Clouds
18354,64,1552784400,34,6,40,Clouds
18355,65,1552784400,40,0,40,Clouds
18356,66,1552784400,19,21,40,Clouds
18357,67,1552784400,36,4,40,Clouds
18358,68,1552784400,30,10,40,Clouds
18359,69,1552784400,28,12,40,Clouds
18360,70,1552784400,20,8,28,Clouds
18361,71,1552784400,33,7,40,Clouds
18362,72,1552784400,22,9,31,Clouds
18363,73,1552784400,18,12,30,Clouds
18364,74,1552784400,9,21,30,Clouds
18365,75,1552784400,31,9,40,Clouds
18366,76,1552784400,19,19,38,Clouds
18367,77,1552784400,25,4,29,Clouds
18368,78,1552784400,31,9,40,Clouds
18369,79,1552784400,13,14,27,Clouds
18370,80,1552784400,16,24,40,Clouds
18371,81,1552784400,9,31,40,Clouds
18372,82,1552784400,14,8,22,Clouds
18373,83,1552784400,19,21,40,Clouds
18374,84,1552784400,16,14,30,Clouds
18375,85,1552784400,24,11,35,Clouds
18376,86,1552784400,10,28,38,Clouds
18377,87,1552784400,16,22,38,Clouds
18378,88,1552784400,29,1,30,Clouds
18379,89,1552784400,31,9,40,Clouds
18380,90,1552784400,33,7,40,Clouds
18381,91,1552784400,12,18,30,Clouds
18382,92,1552784400,19,21,40,Clouds
18383,93,1552784400,1,39,40,Clouds
18384,94,1552784400,16,24,40,Clouds
18385,95,1552784400,28,12,40,Clouds
18386,96,1552784400,27,3,30,Clouds
18387,97,1552784400,22,18,40,Clouds
18388,98,1552784400,29,11,40,Clouds
18389,99,1552784400,14,16,30,Clouds
18390,100,1552784400,13,12,25,Clouds
18391,101,1552784400,16,14,30,Clouds
18392,102,1552784400,0,0,0,Clouds
18393,103,1552784400,36,4,40,Clouds
18394,104,1552784400,40,0,40,Clouds
18395,105,1552784400,35,1,36,Clouds
18396,106,1552784400,38,2,40,Clouds
18397,107,1552784400,36,4,40,Clouds
18398,108,1552784400,33,7,40,Clouds
18399,109,1552784400,17,11,28,Clouds
18400,110,1552784400,38,2,40,Clouds
18401,111,1552784400,31,9,40,Clouds
18402,112,1552784400,20,10,30,Clouds
18403,113,1552784400,0,0,0,Clouds
18404,114,1552784400,27,13,40,Clouds
18405,115,1552784400,13,17,30,Clouds
18406,2,1552788000,14,6,20,Rain
18407,3,1552788000,15,5,20,Rain
18408,4,1552788000,15,5,20,Rain
18409,5,1552788000,16,24,40,Rain
18410,6,1552788000,20,0,20,Rain
18411,7,1552788000,11,18,29,Rain
18412,8,1552788000,10,20,30,Rain
18413,9,1552788000,14,10,24,Rain
18414,10,1552788000,4,12,16,Rain
18415,11,1552788000,30,0,30,Rain
18416,12,1552788000,14,6,20,Rain
18417,13,1552788000,13,17,30,Rain
18418,14,1552788000,10,20,30,Rain
18419,15,1552788000,13,3,16,Rain
18420,16,1552788000,0,20,20,Rain
18421,17,1552788000,16,4,20,Rain
18422,18,1552788000,2,28,30,Rain
18423,19,1552788000,28,2,30,Rain
18424,21,1552788000,16,14,30,Rain
18425,22,1552788000,7,13,20,Rain
18426,23,1552788000,0,0,0,Rain
18427,24,1552788000,2,18,20,Rain
18428,25,1552788000,0,0,0,Rain
18429,26,1552788000,10,10,20,Rain
18430,27,1552788000,3,17,20,Rain
18431,28,1552788000,17,13,30,Rain
18432,29,1552788000,6,23,29,Rain
18433,30,1552788000,20,0,20,Rain
18434,31,1552788000,13,7,20,Rain
18435,32,1552788000,30,0,30,Rain
18436,33,1552788000,9,14,23,Rain
18437,34,1552788000,21,8,29,Rain
18438,35,1552788000,29,1,30,Rain
18439,36,1552788000,39,1,40,Rain
18440,37,1552788000,30,0,30,Rain
18441,38,1552788000,2,38,40,Rain
18442,39,1552788000,11,9,20,Rain
18443,40,1552788000,15,6,21,Rain
18444,41,1552788000,4,16,20,Rain
18445,42,1552788000,3,27,30,Rain
18446,43,1552788000,10,20,30,Rain
18447,44,1552788000,11,19,30,Rain
18448,45,1552788000,6,24,30,Rain
18449,46,1552788000,6,14,20,Rain
18450,47,1552788000,37,3,40,Rain
18451,48,1552788000,25,15,40,Rain
18452,49,1552788000,22,18,40,Rain
18453,50,1552788000,39,1,40,Rain
18454,51,1552788000,27,13,40,Rain
18455,52,1552788000,11,21,32,Rain
18456,53,1552788000,35,5,40,Rain
18457,54,1552788000,26,7,33,Rain
18458,55,1552788000,29,7,36,Rain
18459,56,1552788000,17,23,40,Rain
18460,57,1552788000,13,10,23,Rain
18461,58,1552788000,26,14,40,Rain
18462,59,1552788000,17,3,20,Rain
18463,60,1552788000,18,12,30,Rain
18464,61,1552788000,23,2,25,Rain
18465,62,1552788000,29,11,40,Rain
18466,63,1552788000,17,18,35,Rain
18467,64,1552788000,33,7,40,Rain
18468,65,1552788000,40,0,40,Rain
18469,66,1552788000,20,20,40,Rain
18470,67,1552788000,36,4,40,Rain
18471,68,1552788000,33,7,40,Rain
18472,69,1552788000,28,12,40,Rain
18473,70,1552788000,16,12,28,Rain
18474,71,1552788000,34,6,40,Rain
18475,72,1552788000,22,9,31,Rain
18476,73,1552788000,18,12,30,Rain
18477,74,1552788000,9,21,30,Rain
18478,75,1552788000,30,10,40,Rain
18479,76,1552788000,15,23,38,Rain
18480,77,1552788000,24,5,29,Rain
18481,78,1552788000,31,9,40,Rain
18482,79,1552788000,13,14,27,Rain
18483,80,1552788000,16,24,40,Rain
18484,81,1552788000,9,31,40,Rain
18485,82,1552788000,14,8,22,Rain
18486,83,1552788000,19,21,40,Rain
18487,84,1552788000,15,15,30,Rain
18488,85,1552788000,24,11,35,Rain
18489,86,1552788000,10,28,38,Rain
18490,87,1552788000,14,24,38,Rain
18491,88,1552788000,29,1,30,Rain
18492,89,1552788000,31,9,40,Rain
18493,90,1552788000,33,7,40,Rain
18494,91,1552788000,9,21,30,Rain
18495,92,1552788000,19,21,40,Rain
18496,93,1552788000,1,39,40,Rain
18497,94,1552788000,16,24,40,Rain
18498,95,1552788000,28,12,40,Rain
18499,96,1552788000,27,3,30,Rain
18500,97,1552788000,22,18,40,Rain
18501,98,1552788000,27,13,40,Rain
18502,99,1552788000,14,16,30,Rain
18503,100,1552788000,13,12,25,Rain
18504,101,1552788000,15,15,30,Rain
18505,102,1552788000,0,0,0,Rain
18506,103,1552788000,36,4,40,Rain
18507,104,1552788000,40,0,40,Rain
18508,105,1552788000,35,1,36,Rain
18509,106,1552788000,37,3,40,Rain
18510,107,1552788000,36,4,40,Rain
18511,108,1552788000,33,7,40,Rain
18512,109,1552788000,18,10,28,Rain
18513,110,1552788000,37,3,40,Rain
18514,111,1552788000,30,10,40,Rain
18515,112,1552788000,19,11,30,Rain
18516,113,1552788000,0,0,0,Rain
18517,114,1552788000,27,13,40,Rain
18518,115,1552788000,12,18,30,Rain
18519,2,1552791600,14,6,20,Rain
18520,3,1552791600,15,5,20,Rain
18521,4,1552791600,15,5,20,Rain
18522,5,1552791600,16,24,40,Rain
18523,6,1552791600,20,0,20,Rain
18524,7,1552791600,11,18,29,Rain
18525,8,1552791600,10,20,30,Rain
18526,9,1552791600,14,10,24,Rain
18527,10,1552791600,4,12,16,Rain
18528,11,1552791600,30,0,30,Rain
18529,12,1552791600,14,6,20,Rain
18530,13,1552791600,13,17,30,Rain
18531,14,1552791600,10,20,30,Rain
18532,15,1552791600,13,3,16,Rain
18533,16,1552791600,0,20,20,Rain
18534,17,1552791600,16,4,20,Rain
18535,18,1552791600,2,28,30,Rain
18536,19,1552791600,28,2,30,Rain
18537,21,1552791600,16,14,30,Rain
18538,22,1552791600,7,13,20,Rain
18539,23,1552791600,0,0,0,Rain
18540,24,1552791600,2,18,20,Rain
18541,25,1552791600,0,0,0,Rain
18542,26,1552791600,10,10,20,Rain
18543,27,1552791600,3,17,20,Rain
18544,28,1552791600,16,14,30,Rain
18545,29,1552791600,6,23,29,Rain
18546,30,1552791600,20,0,20,Rain
18547,31,1552791600,13,7,20,Rain
18548,32,1552791600,30,0,30,Rain
18549,33,1552791600,9,14,23,Rain
18550,34,1552791600,22,8,30,Rain
18551,35,1552791600,29,1,30,Rain
18552,36,1552791600,39,1,40,Rain
18553,37,1552791600,30,0,30,Rain
18554,38,1552791600,2,38,40,Rain
18555,39,1552791600,11,9,20,Rain
18556,40,1552791600,15,6,21,Rain
18557,41,1552791600,4,16,20,Rain
18558,42,1552791600,3,27,30,Rain
18559,43,1552791600,10,20,30,Rain
18560,44,1552791600,11,19,30,Rain
18561,45,1552791600,6,24,30,Rain
18562,46,1552791600,6,14,20,Rain
18563,47,1552791600,37,3,40,Rain
18564,48,1552791600,25,15,40,Rain
18565,49,1552791600,22,18,40,Rain
18566,50,1552791600,39,1,40,Rain
18567,51,1552791600,27,13,40,Rain
18568,52,1552791600,11,21,32,Rain
18569,53,1552791600,35,5,40,Rain
18570,54,1552791600,26,7,33,Rain
18571,55,1552791600,29,7,36,Rain
18572,56,1552791600,17,23,40,Rain
18573,57,1552791600,13,10,23,Rain
18574,58,1552791600,26,14,40,Rain
18575,59,1552791600,17,3,20,Rain
18576,60,1552791600,18,12,30,Rain
18577,61,1552791600,23,2,25,Rain
18578,62,1552791600,29,11,40,Rain
18579,63,1552791600,17,18,35,Rain
18580,64,1552791600,33,7,40,Rain
18581,65,1552791600,40,0,40,Rain
18582,66,1552791600,20,20,40,Rain
18583,67,1552791600,36,4,40,Rain
18584,68,1552791600,33,7,40,Rain
18585,69,1552791600,28,12,40,Rain
18586,70,1552791600,16,12,28,Rain
18587,71,1552791600,34,6,40,Rain
18588,72,1552791600,22,9,31,Rain
18589,73,1552791600,18,12,30,Rain
18590,74,1552791600,9,21,30,Rain
18591,75,1552791600,30,10,40,Rain
18592,76,1552791600,15,23,38,Rain
18593,77,1552791600,24,5,29,Rain
18594,78,1552791600,31,9,40,Rain
18595,79,1552791600,13,14,27,Rain
18596,80,1552791600,16,24,40,Rain
18597,81,1552791600,9,31,40,Rain
18598,82,1552791600,14,8,22,Rain
18599,83,1552791600,19,21,40,Rain
18600,84,1552791600,15,15,30,Rain
18601,85,1552791600,24,11,35,Rain
18602,86,1552791600,10,28,38,Rain
18603,87,1552791600,14,24,38,Rain
18604,88,1552791600,29,1,30,Rain
18605,89,1552791600,31,9,40,Rain
18606,90,1552791600,33,7,40,Rain
18607,91,1552791600,9,21,30,Rain
18608,92,1552791600,18,22,40,Rain
18609,93,1552791600,1,39,40,Rain
18610,94,1552791600,16,24,40,Rain
18611,95,1552791600,28,12,40,Rain
18612,96,1552791600,27,3,30,Rain
18613,97,1552791600,22,18,40,Rain
18614,98,1552791600,27,13,40,Rain
18615,99,1552791600,14,16,30,Rain
18616,100,1552791600,13,12,25,Rain
18617,101,1552791600,15,15,30,Rain
18618,102,1552791600,0,0,0,Rain
18619,103,1552791600,36,4,40,Rain
18620,104,1552791600,40,0,40,Rain
18621,105,1552791600,35,1,36,Rain
18622,106,1552791600,37,3,40,Rain
18623,107,1552791600,36,4,40,Rain
18624,108,1552791600,33,7,40,Rain
18625,109,1552791600,18,10,28,Rain
18626,110,1552791600,37,3,40,Rain
18627,111,1552791600,30,10,40,Rain
18628,112,1552791600,18,12,30,Rain
18629,113,1552791600,0,0,0,Rain
18630,114,1552791600,27,13,40,Rain
18631,115,1552791600,12,18,30,Rain
18632,2,1552795200,14,6,20,Clouds
18633,3,1552795200,15,5,20,Clouds
18634,4,1552795200,15,5,20,Clouds
18635,5,1552795200,16,24,40,Clouds
18636,6,1552795200,20,0,20,Clouds
18637,7,1552795200,11,18,29,Clouds
18638,8,1552795200,11,19,30,Clouds
18639,9,1552795200,14,10,24,Clouds
18640,10,1552795200,4,12,16,Clouds
18641,11,1552795200,30,0,30,Clouds
18642,12,1552795200,14,6,20,Clouds
18643,13,1552795200,13,17,30,Clouds
18644,14,1552795200,10,20,30,Clouds
18645,15,1552795200,13,3,16,Clouds
18646,16,1552795200,0,20,20,Clouds
18647,17,1552795200,16,4,20,Clouds
18648,18,1552795200,2,28,30,Clouds
18649,19,1552795200,28,2,30,Clouds
18650,21,1552795200,16,14,30,Clouds
18651,22,1552795200,7,13,20,Clouds
18652,23,1552795200,0,0,0,Clouds
18653,24,1552795200,2,18,20,Clouds
18654,25,1552795200,0,0,0,Clouds
18655,26,1552795200,10,10,20,Clouds
18656,27,1552795200,3,17,20,Clouds
18657,28,1552795200,16,14,30,Clouds
18658,29,1552795200,6,23,29,Clouds
18659,30,1552795200,20,0,20,Clouds
18660,31,1552795200,13,7,20,Clouds
18661,32,1552795200,30,0,30,Clouds
18662,33,1552795200,9,14,23,Clouds
18663,34,1552795200,22,8,30,Clouds
18664,35,1552795200,29,1,30,Clouds
18665,36,1552795200,39,1,40,Clouds
18666,37,1552795200,30,0,30,Clouds
18667,38,1552795200,2,38,40,Clouds
18668,39,1552795200,11,9,20,Clouds
18669,40,1552795200,15,6,21,Clouds
18670,41,1552795200,4,16,20,Clouds
18671,42,1552795200,3,27,30,Clouds
18672,43,1552795200,10,20,30,Clouds
18673,44,1552795200,11,19,30,Clouds
18674,45,1552795200,5,25,30,Clouds
18675,46,1552795200,6,14,20,Clouds
18676,47,1552795200,37,3,40,Clouds
18677,48,1552795200,24,16,40,Clouds
18678,49,1552795200,21,19,40,Clouds
18679,50,1552795200,39,1,40,Clouds
18680,51,1552795200,27,13,40,Clouds
18681,52,1552795200,11,21,32,Clouds
18682,53,1552795200,35,5,40,Clouds
18683,54,1552795200,26,7,33,Clouds
18684,55,1552795200,29,7,36,Clouds
18685,56,1552795200,17,23,40,Clouds
18686,57,1552795200,13,10,23,Clouds
18687,58,1552795200,26,14,40,Clouds
18688,59,1552795200,17,3,20,Clouds
18689,60,1552795200,18,12,30,Clouds
18690,61,1552795200,23,2,25,Clouds
18691,62,1552795200,29,11,40,Clouds
18692,63,1552795200,17,18,35,Clouds
18693,64,1552795200,33,7,40,Clouds
18694,65,1552795200,40,0,40,Clouds
18695,66,1552795200,19,21,40,Clouds
18696,67,1552795200,36,4,40,Clouds
18697,68,1552795200,33,7,40,Clouds
18698,69,1552795200,28,12,40,Clouds
18699,70,1552795200,16,12,28,Clouds
18700,71,1552795200,34,6,40,Clouds
18701,72,1552795200,22,9,31,Clouds
18702,73,1552795200,18,12,30,Clouds
18703,74,1552795200,9,21,30,Clouds
18704,75,1552795200,30,10,40,Clouds
18705,76,1552795200,15,23,38,Clouds
18706,77,1552795200,24,5,29,Clouds
18707,78,1552795200,31,9,40,Clouds
18708,79,1552795200,13,14,27,Clouds
18709,80,1552795200,16,24,40,Clouds
18710,81,1552795200,9,31,40,Clouds
18711,82,1552795200,14,8,22,Clouds
18712,83,1552795200,19,21,40,Clouds
18713,84,1552795200,15,15,30,Clouds
18714,85,1552795200,24,11,35,Clouds
18715,86,1552795200,10,28,38,Clouds
18716,87,1552795200,14,24,38,Clouds
18717,88,1552795200,29,1,30,Clouds
18718,89,1552795200,31,9,40,Clouds
18719,90,1552795200,33,7,40,Clouds
18720,91,1552795200,9,21,30,Clouds
18721,92,1552795200,18,22,40,Clouds
18722,93,1552795200,1,39,40,Clouds
18723,94,1552795200,16,24,40,Clouds
18724,95,1552795200,28,12,40,Clouds
18725,96,1552795200,27,3,30,Clouds
18726,97,1552795200,22,18,40,Clouds
18727,98,1552795200,27,13,40,Clouds
18728,99,1552795200,14,16,30,Clouds
18729,100,1552795200,13,12,25,Clouds
18730,101,1552795200,15,15,30,Clouds
18731,102,1552795200,0,0,0,Clouds
18732,103,1552795200,36,4,40,Clouds
18733,104,1552795200,40,0,40,Clouds
18734,105,1552795200,35,1,36,Clouds
18735,106,1552795200,37,3,40,Clouds
18736,107,1552795200,36,4,40,Clouds
18737,108,1552795200,33,7,40,Clouds
18738,109,1552795200,18,10,28,Clouds
18739,110,1552795200,37,3,40,Clouds
18740,111,1552795200,30,10,40,Clouds
18741,112,1552795200,18,12,30,Clouds
18742,113,1552795200,0,0,0,Clouds
18743,114,1552795200,27,13,40,Clouds
18744,115,1552795200,12,18,30,Clouds
18745,2,1552798800,14,6,20,Clouds
18746,3,1552798800,15,5,20,Clouds
18747,4,1552798800,15,5,20,Clouds
18748,5,1552798800,16,24,40,Clouds
18749,6,1552798800,20,0,20,Clouds
18750,7,1552798800,11,18,29,Clouds
18751,8,1552798800,11,19,30,Clouds
18752,9,1552798800,14,10,24,Clouds
18753,10,1552798800,4,12,16,Clouds
18754,11,1552798800,30,0,30,Clouds
18755,12,1552798800,14,6,20,Clouds
18756,13,1552798800,13,17,30,Clouds
18757,14,1552798800,10,20,30,Clouds
18758,15,1552798800,13,3,16,Clouds
18759,16,1552798800,0,20,20,Clouds
18760,17,1552798800,16,4,20,Clouds
18761,18,1552798800,2,28,30,Clouds
18762,19,1552798800,28,2,30,Clouds
18763,21,1552798800,16,14,30,Clouds
18764,22,1552798800,7,13,20,Clouds
18765,23,1552798800,0,0,0,Clouds
18766,24,1552798800,2,18,20,Clouds
18767,25,1552798800,0,0,0,Clouds
18768,26,1552798800,10,10,20,Clouds
18769,27,1552798800,3,17,20,Clouds
18770,28,1552798800,16,14,30,Clouds
18771,29,1552798800,6,23,29,Clouds
18772,30,1552798800,20,0,20,Clouds
18773,31,1552798800,13,7,20,Clouds
18774,32,1552798800,30,0,30,Clouds
18775,33,1552798800,9,14,23,Clouds
18776,34,1552798800,22,8,30,Clouds
18777,35,1552798800,29,1,30,Clouds
18778,36,1552798800,39,1,40,Clouds
18779,37,1552798800,30,0,30,Clouds
18780,38,1552798800,2,38,40,Clouds
18781,39,1552798800,11,9,20,Clouds
18782,40,1552798800,15,6,21,Clouds
18783,41,1552798800,4,16,20,Clouds
18784,42,1552798800,3,27,30,Clouds
18785,43,1552798800,10,20,30,Clouds
18786,44,1552798800,11,19,30,Clouds
18787,45,1552798800,5,25,30,Clouds
18788,46,1552798800,6,14,20,Clouds
18789,47,1552798800,37,3,40,Clouds
18790,48,1552798800,24,16,40,Clouds
18791,49,1552798800,21,19,40,Clouds
18792,50,1552798800,39,1,40,Clouds
18793,51,1552798800,27,13,40,Clouds
18794,52,1552798800,11,21,32,Clouds
18795,53,1552798800,35,5,40,Clouds
18796,54,1552798800,26,7,33,Clouds
18797,55,1552798800,29,7,36,Clouds
18798,56,1552798800,17,23,40,Clouds
18799,57,1552798800,13,10,23,Clouds
18800,58,1552798800,26,14,40,Clouds
18801,59,1552798800,17,3,20,Clouds
18802,60,1552798800,18,12,30,Clouds
18803,61,1552798800,23,2,25,Clouds
18804,62,1552798800,29,11,40,Clouds
18805,63,1552798800,17,18,35,Clouds
18806,64,1552798800,33,7,40,Clouds
18807,65,1552798800,40,0,40,Clouds
18808,66,1552798800,19,21,40,Clouds
18809,67,1552798800,36,4,40,Clouds
18810,68,1552798800,33,7,40,Clouds
18811,69,1552798800,28,12,40,Clouds
18812,70,1552798800,16,12,28,Clouds
18813,71,1552798800,34,6,40,Clouds
18814,72,1552798800,22,9,31,Clouds
18815,73,1552798800,18,12,30,Clouds
18816,74,1552798800,9,21,30,Clouds
18817,75,1552798800,30,10,40,Clouds
18818,76,1552798800,15,23,38,Clouds
18819,77,1552798800,24,5,29,Clouds
18820,78,1552798800,31,9,40,Clouds
18821,79,1552798800,13,14,27,Clouds
18822,80,1552798800,16,24,40,Clouds
18823,81,1552798800,9,31,40,Clouds
18824,82,1552798800,14,8,22,Clouds
18825,83,1552798800,19,21,40,Clouds
18826,84,1552798800,15,15,30,Clouds
18827,85,1552798800,24,11,35,Clouds
18828,86,1552798800,10,28,38,Clouds
18829,87,1552798800,14,24,38,Clouds
18830,88,1552798800,29,1,30,Clouds
18831,89,1552798800,31,9,40,Clouds
18832,90,1552798800,33,7,40,Clouds
18833,91,1552798800,9,21,30,Clouds
18834,92,1552798800,18,22,40,Clouds
18835,93,1552798800,1,39,40,Clouds
18836,94,1552798800,16,24,40,Clouds
18837,95,1552798800,28,12,40,Clouds
18838,96,1552798800,27,3,30,Clouds
18839,97,1552798800,22,18,40,Clouds
18840,98,1552798800,27,13,40,Clouds
18841,99,1552798800,14,16,30,Clouds
18842,100,1552798800,13,12,25,Clouds
18843,101,1552798800,15,15,30,Clouds
18844,102,1552798800,0,0,0,Clouds
18845,103,1552798800,36,4,40,Clouds
18846,104,1552798800,40,0,40,Clouds
18847,105,1552798800,35,1,36,Clouds
18848,106,1552798800,37,3,40,Clouds
18849,107,1552798800,36,4,40,Clouds
18850,108,1552798800,33,7,40,Clouds
18851,109,1552798800,18,10,28,Clouds
18852,110,1552798800,37,3,40,Clouds
18853,111,1552798800,30,10,40,Clouds
18854,112,1552798800,18,12,30,Clouds
18855,113,1552798800,0,0,0,Clouds
18856,114,1552798800,27,13,40,Clouds
18857,115,1552798800,12,18,30,Clouds
18858,2,1552802400,14,6,20,Rain
18859,3,1552802400,15,5,20,Rain
18860,4,1552802400,15,5,20,Rain
18861,5,1552802400,16,24,40,Rain
18862,6,1552802400,20,0,20,Rain
18863,7,1552802400,11,18,29,Rain
18864,8,1552802400,11,19,30,Rain
18865,9,1552802400,14,10,24,Rain
18866,10,1552802400,4,12,16,Rain
18867,11,1552802400,30,0,30,Rain
18868,12,1552802400,14,6,20,Rain
18869,13,1552802400,13,17,30,Rain
18870,14,1552802400,10,20,30,Rain
18871,15,1552802400,13,3,16,Rain
18872,16,1552802400,1,19,20,Rain
18873,17,1552802400,16,4,20,Rain
18874,18,1552802400,2,28,30,Rain
18875,19,1552802400,28,2,30,Rain
18876,21,1552802400,16,14,30,Rain
18877,22,1552802400,7,13,20,Rain
18878,23,1552802400,0,0,0,Rain
18879,24,1552802400,2,18,20,Rain
18880,25,1552802400,0,0,0,Rain
18881,26,1552802400,10,10,20,Rain
18882,27,1552802400,3,17,20,Rain
18883,28,1552802400,16,14,30,Rain
18884,29,1552802400,7,22,29,Rain
18885,30,1552802400,20,0,20,Rain
18886,31,1552802400,13,7,20,Rain
18887,32,1552802400,30,0,30,Rain
18888,33,1552802400,9,14,23,Rain
18889,34,1552802400,22,8,30,Rain
18890,35,1552802400,29,1,30,Rain
18891,36,1552802400,39,1,40,Rain
18892,37,1552802400,30,0,30,Rain
18893,38,1552802400,2,38,40,Rain
18894,39,1552802400,11,9,20,Rain
18895,40,1552802400,15,6,21,Rain
18896,41,1552802400,4,16,20,Rain
18897,42,1552802400,3,27,30,Rain
18898,43,1552802400,10,20,30,Rain
18899,44,1552802400,11,19,30,Rain
18900,45,1552802400,5,25,30,Rain
18901,46,1552802400,6,14,20,Rain
18902,47,1552802400,37,3,40,Rain
18903,48,1552802400,24,16,40,Rain
18904,49,1552802400,21,19,40,Rain
18905,50,1552802400,39,1,40,Rain
18906,51,1552802400,27,13,40,Rain
18907,52,1552802400,11,21,32,Rain
18908,53,1552802400,35,5,40,Rain
18909,54,1552802400,26,7,33,Rain
18910,55,1552802400,29,7,36,Rain
18911,56,1552802400,17,23,40,Rain
18912,57,1552802400,13,10,23,Rain
18913,58,1552802400,26,14,40,Rain
18914,59,1552802400,17,3,20,Rain
18915,60,1552802400,18,12,30,Rain
18916,61,1552802400,23,2,25,Rain
18917,62,1552802400,29,11,40,Rain
18918,63,1552802400,17,18,35,Rain
18919,64,1552802400,33,7,40,Rain
18920,65,1552802400,40,0,40,Rain
18921,66,1552802400,19,21,40,Rain
18922,67,1552802400,36,4,40,Rain
18923,68,1552802400,33,7,40,Rain
18924,69,1552802400,28,12,40,Rain
18925,70,1552802400,16,12,28,Rain
18926,71,1552802400,34,6,40,Rain
18927,72,1552802400,22,9,31,Rain
18928,73,1552802400,18,12,30,Rain
18929,74,1552802400,9,21,30,Rain
18930,75,1552802400,30,10,40,Rain
18931,76,1552802400,15,23,38,Rain
18932,77,1552802400,24,5,29,Rain
18933,78,1552802400,31,9,40,Rain
18934,79,1552802400,13,14,27,Rain
18935,80,1552802400,16,24,40,Rain
18936,81,1552802400,9,31,40,Rain
18937,82,1552802400,14,8,22,Rain
18938,83,1552802400,19,21,40,Rain
18939,84,1552802400,15,15,30,Rain
18940,85,1552802400,24,11,35,Rain
18941,86,1552802400,10,28,38,Rain
18942,87,1552802400,14,24,38,Rain
18943,88,1552802400,29,1,30,Rain
18944,89,1552802400,31,9,40,Rain
18945,90,1552802400,33,7,40,Rain
18946,91,1552802400,9,21,30,Rain
18947,92,1552802400,18,22,40,Rain
18948,93,1552802400,1,39,40,Rain
18949,94,1552802400,16,24,40,Rain
18950,95,1552802400,28,12,40,Rain
18951,96,1552802400,27,3,30,Rain
18952,97,1552802400,22,18,40,Rain
18953,98,1552802400,27,13,40,Rain
18954,99,1552802400,14,16,30,Rain
18955,100,1552802400,13,12,25,Rain
18956,101,1552802400,15,15,30,Rain
18957,102,1552802400,0,0,0,Rain
18958,103,1552802400,36,4,40,Rain
18959,104,1552802400,40,0,40,Rain
18960,105,1552802400,35,1,36,Rain
18961,106,1552802400,37,3,40,Rain
18962,107,1552802400,36,4,40,Rain
18963,108,1552802400,33,7,40,Rain
18964,109,1552802400,18,10,28,Rain
18965,110,1552802400,37,3,40,Rain
18966,111,1552802400,30,10,40,Rain
18967,112,1552802400,18,12,30,Rain
18968,113,1552802400,0,0,0,Rain
18969,114,1552802400,27,13,40,Rain
18970,115,1552802400,12,18,30,Rain
18971,2,1552806000,14,6,20,Rain
18972,3,1552806000,16,4,20,Rain
18973,4,1552806000,15,5,20,Rain
18974,5,1552806000,15,25,40,Rain
18975,6,1552806000,20,0,20,Rain
18976,7,1552806000,12,17,29,Rain
18977,8,1552806000,11,19,30,Rain
18978,9,1552806000,14,10,24,Rain
18979,10,1552806000,3,13,16,Rain
18980,11,1552806000,30,0,30,Rain
18981,12,1552806000,15,5,20,Rain
18982,13,1552806000,13,17,30,Rain
18983,14,1552806000,8,22,30,Rain
18984,15,1552806000,11,5,16,Rain
18985,16,1552806000,1,19,20,Rain
18986,17,1552806000,16,4,20,Rain
18987,18,1552806000,0,30,30,Rain
18988,19,1552806000,28,2,30,Rain
18989,21,1552806000,16,14,30,Rain
18990,22,1552806000,7,13,20,Rain
18991,23,1552806000,0,0,0,Rain
18992,24,1552806000,0,20,20,Rain
18993,25,1552806000,0,0,0,Rain
18994,26,1552806000,10,10,20,Rain
18995,27,1552806000,4,16,20,Rain
18996,28,1552806000,17,13,30,Rain
18997,29,1552806000,8,21,29,Rain
18998,30,1552806000,20,0,20,Rain
18999,31,1552806000,13,7,20,Rain
19000,32,1552806000,30,0,30,Rain
19001,33,1552806000,6,17,23,Rain
19002,34,1552806000,25,5,30,Rain
19003,35,1552806000,29,1,30,Rain
19004,36,1552806000,39,1,40,Rain
19005,37,1552806000,30,0,30,Rain
19006,38,1552806000,2,38,40,Rain
19007,39,1552806000,11,9,20,Rain
19008,40,1552806000,16,5,21,Rain
19009,41,1552806000,4,16,20,Rain
19010,42,1552806000,4,26,30,Rain
19011,43,1552806000,11,19,30,Rain
19012,44,1552806000,12,18,30,Rain
19013,45,1552806000,4,26,30,Rain
19014,46,1552806000,6,14,20,Rain
19015,47,1552806000,38,2,40,Rain
19016,48,1552806000,24,16,40,Rain
19017,49,1552806000,20,20,40,Rain
19018,50,1552806000,37,3,40,Rain
19019,51,1552806000,27,13,40,Rain
19020,52,1552806000,10,22,32,Rain
19021,53,1552806000,36,4,40,Rain
19022,54,1552806000,29,4,33,Rain
19023,55,1552806000,29,7,36,Rain
19024,56,1552806000,16,24,40,Rain
19025,57,1552806000,14,9,23,Rain
19026,58,1552806000,26,14,40,Rain
19027,59,1552806000,17,3,20,Rain
19028,60,1552806000,19,11,30,Rain
19029,61,1552806000,24,1,25,Rain
19030,62,1552806000,29,11,40,Rain
19031,63,1552806000,17,18,35,Rain
19032,64,1552806000,33,7,40,Rain
19033,65,1552806000,40,0,40,Rain
19034,66,1552806000,20,20,40,Rain
19035,67,1552806000,36,4,40,Rain
19036,68,1552806000,33,7,40,Rain
19037,69,1552806000,28,12,40,Rain
19038,70,1552806000,16,12,28,Rain
19039,71,1552806000,34,6,40,Rain
19040,72,1552806000,22,9,31,Rain
19041,73,1552806000,17,13,30,Rain
19042,74,1552806000,9,21,30,Rain
19043,75,1552806000,30,10,40,Rain
19044,76,1552806000,17,21,38,Rain
19045,77,1552806000,24,5,29,Rain
19046,78,1552806000,33,7,40,Rain
19047,79,1552806000,13,14,27,Rain
19048,80,1552806000,16,24,40,Rain
19049,81,1552806000,9,31,40,Rain
19050,82,1552806000,14,8,22,Rain
19051,83,1552806000,20,20,40,Rain
19052,84,1552806000,14,16,30,Rain
19053,85,1552806000,24,11,35,Rain
19054,86,1552806000,8,30,38,Rain
19055,87,1552806000,14,24,38,Rain
19056,88,1552806000,30,0,30,Rain
19057,89,1552806000,31,9,40,Rain
19058,90,1552806000,33,7,40,Rain
19059,91,1552806000,9,21,30,Rain
19060,92,1552806000,19,21,40,Rain
19061,93,1552806000,1,39,40,Rain
19062,94,1552806000,16,24,40,Rain
19063,95,1552806000,27,13,40,Rain
19064,96,1552806000,27,3,30,Rain
19065,97,1552806000,21,19,40,Rain
19066,98,1552806000,27,13,40,Rain
19067,99,1552806000,14,16,30,Rain
19068,100,1552806000,13,12,25,Rain
19069,101,1552806000,15,15,30,Rain
19070,102,1552806000,0,0,0,Rain
19071,103,1552806000,36,4,40,Rain
19072,104,1552806000,40,0,40,Rain
19073,105,1552806000,35,1,36,Rain
19074,106,1552806000,37,3,40,Rain
19075,107,1552806000,36,4,40,Rain
19076,108,1552806000,35,5,40,Rain
19077,109,1552806000,18,10,28,Rain
19078,110,1552806000,37,3,40,Rain
19079,111,1552806000,31,9,40,Rain
19080,112,1552806000,18,12,30,Rain
19081,113,1552806000,0,0,0,Rain
19082,114,1552806000,27,13,40,Rain
19083,115,1552806000,11,19,30,Rain
19084,2,1552809600,15,5,20,Clouds
19085,3,1552809600,17,3,20,Clouds
19086,4,1552809600,16,4,20,Clouds
19087,5,1552809600,15,25,40,Clouds
19088,6,1552809600,20,0,20,Clouds
19089,7,1552809600,13,16,29,Clouds
19090,8,1552809600,9,21,30,Clouds
19091,9,1552809600,12,12,24,Clouds
19092,10,1552809600,2,14,16,Clouds
19093,11,1552809600,30,0,30,Clouds
19094,12,1552809600,16,4,20,Clouds
19095,13,1552809600,13,17,30,Clouds
19096,14,1552809600,1,29,30,Clouds
19097,15,1552809600,10,6,16,Clouds
19098,16,1552809600,2,18,20,Clouds
19099,17,1552809600,16,4,20,Clouds
19100,18,1552809600,0,30,30,Clouds
19101,19,1552809600,24,6,30,Clouds
19102,21,1552809600,14,16,30,Clouds
19103,22,1552809600,6,14,20,Clouds
19104,23,1552809600,0,0,0,Clouds
19105,24,1552809600,1,19,20,Clouds
19106,25,1552809600,0,0,0,Clouds
19107,26,1552809600,9,11,20,Clouds
19108,27,1552809600,3,17,20,Clouds
19109,28,1552809600,20,10,30,Clouds
19110,29,1552809600,9,20,29,Clouds
19111,30,1552809600,20,0,20,Clouds
19112,31,1552809600,14,6,20,Clouds
19113,32,1552809600,30,0,30,Clouds
19114,33,1552809600,3,20,23,Clouds
19115,34,1552809600,28,2,30,Clouds
19116,35,1552809600,26,4,30,Clouds
19117,36,1552809600,37,3,40,Clouds
19118,37,1552809600,30,0,30,Clouds
19119,38,1552809600,0,40,40,Clouds
19120,39,1552809600,9,11,20,Clouds
19121,40,1552809600,16,5,21,Clouds
19122,41,1552809600,6,14,20,Clouds
19123,42,1552809600,6,24,30,Clouds
19124,43,1552809600,12,18,30,Clouds
19125,44,1552809600,14,16,30,Clouds
19126,45,1552809600,3,27,30,Clouds
19127,46,1552809600,6,14,20,Clouds
19128,47,1552809600,38,2,40,Clouds
19129,48,1552809600,23,17,40,Clouds
19130,49,1552809600,20,20,40,Clouds
19131,50,1552809600,40,0,40,Clouds
19132,51,1552809600,27,13,40,Clouds
19133,52,1552809600,7,25,32,Clouds
19134,53,1552809600,37,3,40,Clouds
19135,54,1552809600,29,4,33,Clouds
19136,55,1552809600,27,9,36,Clouds
19137,56,1552809600,14,26,40,Clouds
19138,57,1552809600,15,8,23,Clouds
19139,58,1552809600,24,16,40,Clouds
19140,59,1552809600,16,4,20,Clouds
19141,60,1552809600,20,10,30,Clouds
19142,61,1552809600,25,0,25,Clouds
19143,62,1552809600,27,13,40,Clouds
19144,63,1552809600,16,19,35,Clouds
19145,64,1552809600,33,7,40,Clouds
19146,65,1552809600,40,0,40,Clouds
19147,66,1552809600,15,25,40,Clouds
19148,67,1552809600,35,5,40,Clouds
19149,68,1552809600,30,10,40,Clouds
19150,69,1552809600,26,14,40,Clouds
19151,70,1552809600,16,12,28,Clouds
19152,71,1552809600,36,4,40,Clouds
19153,72,1552809600,21,10,31,Clouds
19154,73,1552809600,16,14,30,Clouds
19155,74,1552809600,11,19,30,Clouds
19156,75,1552809600,32,8,40,Clouds
19157,76,1552809600,15,23,38,Clouds
19158,77,1552809600,24,5,29,Clouds
19159,78,1552809600,33,7,40,Clouds
19160,79,1552809600,12,15,27,Clouds
19161,80,1552809600,20,20,40,Clouds
19162,81,1552809600,9,31,40,Clouds
19163,82,1552809600,15,7,22,Clouds
19164,83,1552809600,21,19,40,Clouds
19165,84,1552809600,17,13,30,Clouds
19166,85,1552809600,26,9,35,Clouds
19167,86,1552809600,11,27,38,Clouds
19168,87,1552809600,14,24,38,Clouds
19169,88,1552809600,30,0,30,Clouds
19170,89,1552809600,31,9,40,Clouds
19171,90,1552809600,33,7,40,Clouds
19172,91,1552809600,9,21,30,Clouds
19173,92,1552809600,21,19,40,Clouds
19174,93,1552809600,1,39,40,Clouds
19175,94,1552809600,16,24,40,Clouds
19176,95,1552809600,27,13,40,Clouds
19177,96,1552809600,27,3,30,Clouds
19178,97,1552809600,23,17,40,Clouds
19179,98,1552809600,27,13,40,Clouds
19180,99,1552809600,14,16,30,Clouds
19181,100,1552809600,13,12,25,Clouds
19182,101,1552809600,19,11,30,Clouds
19183,102,1552809600,0,0,0,Clouds
19184,103,1552809600,36,4,40,Clouds
19185,104,1552809600,40,0,40,Clouds
19186,105,1552809600,35,1,36,Clouds
19187,106,1552809600,37,3,40,Clouds
19188,107,1552809600,37,3,40,Clouds
19189,108,1552809600,38,2,40,Clouds
19190,109,1552809600,19,9,28,Clouds
19191,110,1552809600,38,2,40,Clouds
19192,111,1552809600,33,7,40,Clouds
19193,112,1552809600,22,8,30,Clouds
19194,113,1552809600,0,0,0,Clouds
19195,114,1552809600,27,13,40,Clouds
19196,115,1552809600,11,19,30,Clouds
19197,2,1552813200,16,4,20,Clouds
19198,3,1552813200,17,3,20,Clouds
19199,4,1552813200,17,3,20,Clouds
19200,5,1552813200,17,23,40,Clouds
19201,6,1552813200,20,0,20,Clouds
19202,7,1552813200,11,18,29,Clouds
19203,8,1552813200,9,21,30,Clouds
19204,9,1552813200,5,19,24,Clouds
19205,10,1552813200,0,16,16,Clouds
19206,11,1552813200,30,0,30,Clouds
19207,12,1552813200,19,1,20,Clouds
19208,13,1552813200,13,17,30,Clouds
19209,14,1552813200,0,30,30,Clouds
19210,15,1552813200,11,5,16,Clouds
19211,16,1552813200,6,14,20,Clouds
19212,17,1552813200,16,4,20,Clouds
19213,18,1552813200,0,30,30,Clouds
19214,19,1552813200,20,10,30,Clouds
19215,21,1552813200,14,16,30,Clouds
19216,22,1552813200,5,15,20,Clouds
19217,23,1552813200,0,0,0,Clouds
19218,24,1552813200,2,18,20,Clouds
19219,25,1552813200,0,0,0,Clouds
19220,26,1552813200,6,14,20,Clouds
19221,27,1552813200,0,20,20,Clouds
19222,28,1552813200,21,9,30,Clouds
19223,29,1552813200,9,20,29,Clouds
19224,30,1552813200,0,0,0,Clouds
19225,31,1552813200,17,3,20,Clouds
19226,32,1552813200,30,0,30,Clouds
19227,33,1552813200,0,23,23,Clouds
19228,34,1552813200,29,1,30,Clouds
19229,35,1552813200,25,5,30,Clouds
19230,36,1552813200,35,5,40,Clouds
19231,37,1552813200,30,0,30,Clouds
19232,38,1552813200,0,40,40,Clouds
19233,39,1552813200,7,13,20,Clouds
19234,40,1552813200,14,7,21,Clouds
19235,41,1552813200,6,14,20,Clouds
19236,42,1552813200,13,17,30,Clouds
19237,43,1552813200,12,18,30,Clouds
19238,44,1552813200,17,13,30,Clouds
19239,45,1552813200,3,27,30,Clouds
19240,46,1552813200,4,16,20,Clouds
19241,47,1552813200,38,2,40,Clouds
19242,48,1552813200,25,15,40,Clouds
19243,49,1552813200,18,22,40,Clouds
19244,50,1552813200,40,0,40,Clouds
19245,51,1552813200,27,13,40,Clouds
19246,52,1552813200,8,24,32,Clouds
19247,53,1552813200,37,3,40,Clouds
19248,54,1552813200,27,6,33,Clouds
19249,55,1552813200,26,10,36,Clouds
19250,56,1552813200,11,29,40,Clouds
19251,57,1552813200,15,8,23,Clouds
19252,58,1552813200,21,19,40,Clouds
19253,59,1552813200,15,5,20,Clouds
19254,60,1552813200,24,6,30,Clouds
19255,61,1552813200,24,1,25,Clouds
19256,62,1552813200,28,12,40,Clouds
19257,63,1552813200,16,19,35,Clouds
19258,64,1552813200,34,6,40,Clouds
19259,65,1552813200,40,0,40,Clouds
19260,66,1552813200,15,25,40,Clouds
19261,67,1552813200,36,4,40,Clouds
19262,68,1552813200,28,12,40,Clouds
19263,69,1552813200,26,14,40,Clouds
19264,70,1552813200,14,14,28,Clouds
19265,71,1552813200,37,3,40,Clouds
19266,72,1552813200,21,10,31,Clouds
19267,73,1552813200,14,16,30,Clouds
19268,74,1552813200,12,18,30,Clouds
19269,75,1552813200,31,9,40,Clouds
19270,76,1552813200,17,21,38,Clouds
19271,77,1552813200,25,4,29,Clouds
19272,78,1552813200,33,7,40,Clouds
19273,79,1552813200,11,16,27,Clouds
19274,80,1552813200,21,19,40,Clouds
19275,81,1552813200,8,32,40,Clouds
19276,82,1552813200,17,5,22,Clouds
19277,83,1552813200,26,14,40,Clouds
19278,84,1552813200,18,12,30,Clouds
19279,85,1552813200,26,9,35,Clouds
19280,86,1552813200,11,27,38,Clouds
19281,87,1552813200,14,24,38,Clouds
19282,88,1552813200,29,1,30,Clouds
19283,89,1552813200,31,9,40,Clouds
19284,90,1552813200,29,11,40,Clouds
19285,91,1552813200,6,24,30,Clouds
19286,92,1552813200,22,18,40,Clouds
19287,93,1552813200,1,39,40,Clouds
19288,94,1552813200,16,24,40,Clouds
19289,95,1552813200,27,13,40,Clouds
19290,96,1552813200,27,3,30,Clouds
19291,97,1552813200,24,16,40,Clouds
19292,98,1552813200,27,13,40,Clouds
19293,99,1552813200,14,16,30,Clouds
19294,100,1552813200,9,16,25,Clouds
19295,101,1552813200,23,7,30,Clouds
19296,102,1552813200,0,0,0,Clouds
19297,103,1552813200,36,4,40,Clouds
19298,104,1552813200,40,0,40,Clouds
19299,105,1552813200,35,1,36,Clouds
19300,106,1552813200,37,3,40,Clouds
19301,107,1552813200,40,0,40,Clouds
19302,108,1552813200,40,0,40,Clouds
19303,109,1552813200,22,6,28,Clouds
19304,110,1552813200,37,3,40,Clouds
19305,111,1552813200,37,3,40,Clouds
19306,112,1552813200,27,3,30,Clouds
19307,113,1552813200,0,0,0,Clouds
19308,114,1552813200,27,13,40,Clouds
19309,115,1552813200,11,19,30,Clouds
19310,2,1552816800,18,2,20,Clouds
19311,3,1552816800,19,1,20,Clouds
19312,4,1552816800,15,4,19,Clouds
19313,5,1552816800,20,20,40,Clouds
19314,6,1552816800,20,0,20,Clouds
19315,7,1552816800,12,17,29,Clouds
19316,8,1552816800,6,24,30,Clouds
19317,9,1552816800,0,24,24,Clouds
19318,10,1552816800,0,16,16,Clouds
19319,11,1552816800,30,0,30,Clouds
19320,12,1552816800,20,0,20,Clouds
19321,13,1552816800,10,20,30,Clouds
19322,14,1552816800,0,30,30,Clouds
19323,15,1552816800,12,4,16,Clouds
19324,16,1552816800,5,15,20,Clouds
19325,17,1552816800,15,5,20,Clouds
19326,18,1552816800,0,30,30,Clouds
19327,19,1552816800,16,14,30,Clouds
19328,21,1552816800,13,17,30,Clouds
19329,22,1552816800,4,16,20,Clouds
19330,23,1552816800,0,0,0,Clouds
19331,24,1552816800,2,18,20,Clouds
19332,25,1552816800,0,0,0,Clouds
19333,26,1552816800,6,14,20,Clouds
19334,27,1552816800,0,20,20,Clouds
19335,28,1552816800,24,6,30,Clouds
19336,29,1552816800,6,23,29,Clouds
19337,30,1552816800,0,0,0,Clouds
19338,31,1552816800,18,2,20,Clouds
19339,32,1552816800,29,1,30,Clouds
19340,33,1552816800,0,23,23,Clouds
19341,34,1552816800,29,1,30,Clouds
19342,35,1552816800,24,6,30,Clouds
19343,36,1552816800,31,9,40,Clouds
19344,37,1552816800,30,0,30,Clouds
19345,38,1552816800,0,40,40,Clouds
19346,39,1552816800,8,12,20,Clouds
19347,40,1552816800,12,9,21,Clouds
19348,41,1552816800,6,14,20,Clouds
19349,42,1552816800,12,18,30,Clouds
19350,43,1552816800,15,15,30,Clouds
19351,44,1552816800,20,10,30,Clouds
19352,45,1552816800,3,27,30,Clouds
19353,46,1552816800,1,19,20,Clouds
19354,47,1552816800,38,2,40,Clouds
19355,48,1552816800,24,16,40,Clouds
19356,49,1552816800,19,21,40,Clouds
19357,50,1552816800,40,0,40,Clouds
19358,51,1552816800,26,14,40,Clouds
19359,52,1552816800,5,27,32,Clouds
19360,53,1552816800,37,3,40,Clouds
19361,54,1552816800,27,6,33,Clouds
19362,55,1552816800,26,10,36,Clouds
19363,56,1552816800,12,28,40,Clouds
19364,57,1552816800,15,8,23,Clouds
19365,58,1552816800,20,20,40,Clouds
19366,59,1552816800,15,5,20,Clouds
19367,60,1552816800,25,5,30,Clouds
19368,61,1552816800,25,0,25,Clouds
19369,62,1552816800,28,12,40,Clouds
19370,63,1552816800,16,19,35,Clouds
19371,64,1552816800,34,6,40,Clouds
19372,65,1552816800,40,0,40,Clouds
19373,66,1552816800,15,25,40,Clouds
19374,67,1552816800,39,1,40,Clouds
19375,68,1552816800,25,15,40,Clouds
19376,69,1552816800,28,12,40,Clouds
19377,70,1552816800,15,13,28,Clouds
19378,71,1552816800,38,2,40,Clouds
19379,72,1552816800,20,11,31,Clouds
19380,73,1552816800,16,14,30,Clouds
19381,74,1552816800,11,19,30,Clouds
19382,75,1552816800,30,10,40,Clouds
19383,76,1552816800,18,20,38,Clouds
19384,77,1552816800,24,5,29,Clouds
19385,78,1552816800,35,5,40,Clouds
19386,79,1552816800,11,16,27,Clouds
19387,80,1552816800,24,16,40,Clouds
19388,81,1552816800,7,33,40,Clouds
19389,82,1552816800,17,5,22,Clouds
19390,83,1552816800,27,13,40,Clouds
19391,84,1552816800,21,9,30,Clouds
19392,85,1552816800,30,5,35,Clouds
19393,86,1552816800,13,25,38,Clouds
19394,87,1552816800,16,22,38,Clouds
19395,88,1552816800,29,1,30,Clouds
19396,89,1552816800,31,9,40,Clouds
19397,90,1552816800,26,14,40,Clouds
19398,91,1552816800,6,24,30,Clouds
19399,92,1552816800,23,17,40,Clouds
19400,93,1552816800,1,39,40,Clouds
19401,94,1552816800,16,24,40,Clouds
19402,95,1552816800,28,12,40,Clouds
19403,96,1552816800,28,2,30,Clouds
19404,97,1552816800,25,15,40,Clouds
19405,98,1552816800,23,17,40,Clouds
19406,99,1552816800,14,16,30,Clouds
19407,100,1552816800,9,16,25,Clouds
19408,101,1552816800,25,5,30,Clouds
19409,102,1552816800,0,0,0,Clouds
19410,103,1552816800,36,4,40,Clouds
19411,104,1552816800,40,0,40,Clouds
19412,105,1552816800,36,0,36,Clouds
19413,106,1552816800,40,0,40,Clouds
19414,107,1552816800,40,0,40,Clouds
19415,108,1552816800,40,0,40,Clouds
19416,109,1552816800,21,8,29,Clouds
19417,110,1552816800,40,0,40,Clouds
19418,111,1552816800,38,2,40,Clouds
19419,112,1552816800,29,1,30,Clouds
19420,113,1552816800,0,0,0,Clouds
19421,114,1552816800,25,15,40,Clouds
19422,115,1552816800,13,17,30,Clouds
19423,2,1552820400,18,2,20,Rain
19424,3,1552820400,20,0,20,Rain
19425,4,1552820400,13,6,19,Rain
19426,5,1552820400,25,15,40,Rain
19427,6,1552820400,20,0,20,Rain
19428,7,1552820400,12,17,29,Rain
19429,8,1552820400,6,24,30,Rain
19430,9,1552820400,0,24,24,Rain
19431,10,1552820400,0,16,16,Rain
19432,11,1552820400,30,0,30,Rain
19433,12,1552820400,20,0,20,Rain
19434,13,1552820400,10,20,30,Rain
19435,14,1552820400,0,30,30,Rain
19436,15,1552820400,11,5,16,Rain
19437,16,1552820400,4,16,20,Rain
19438,17,1552820400,9,11,20,Rain
19439,18,1552820400,2,28,30,Rain
19440,19,1552820400,14,16,30,Rain
19441,21,1552820400,12,18,30,Rain
19442,22,1552820400,0,20,20,Rain
19443,23,1552820400,0,0,0,Rain
19444,24,1552820400,0,20,20,Rain
19445,25,1552820400,0,0,0,Rain
19446,26,1552820400,4,16,20,Rain
19447,27,1552820400,0,20,20,Rain
19448,28,1552820400,24,6,30,Rain
19449,29,1552820400,4,25,29,Rain
19450,30,1552820400,0,0,0,Rain
19451,31,1552820400,15,5,20,Rain
19452,32,1552820400,27,3,30,Rain
19453,33,1552820400,0,23,23,Rain
19454,34,1552820400,28,2,30,Rain
19455,35,1552820400,25,5,30,Rain
19456,36,1552820400,31,9,40,Rain
19457,37,1552820400,30,0,30,Rain
19458,38,1552820400,3,37,40,Rain
19459,39,1552820400,11,9,20,Rain
19460,40,1552820400,11,10,21,Rain
19461,41,1552820400,5,15,20,Rain
19462,42,1552820400,17,13,30,Rain
19463,43,1552820400,15,15,30,Rain
19464,44,1552820400,26,4,30,Rain
19465,45,1552820400,1,29,30,Rain
19466,46,1552820400,1,19,20,Rain
19467,47,1552820400,37,3,40,Rain
19468,48,1552820400,19,21,40,Rain
19469,49,1552820400,18,22,40,Rain
19470,50,1552820400,40,0,40,Rain
19471,51,1552820400,20,20,40,Rain
19472,52,1552820400,5,27,32,Rain
19473,53,1552820400,34,6,40,Rain
19474,54,1552820400,27,6,33,Rain
19475,55,1552820400,24,12,36,Rain
19476,56,1552820400,13,27,40,Rain
19477,57,1552820400,15,8,23,Rain
19478,58,1552820400,15,25,40,Rain
19479,59,1552820400,18,2,20,Rain
19480,60,1552820400,29,1,30,Rain
19481,61,1552820400,25,0,25,Rain
19482,62,1552820400,28,12,40,Rain
19483,63,1552820400,16,19,35,Rain
19484,64,1552820400,31,9,40,Rain
19485,65,1552820400,39,1,40,Rain
19486,66,1552820400,19,21,40,Rain
19487,67,1552820400,40,0,40,Rain
19488,68,1552820400,24,16,40,Rain
19489,69,1552820400,26,14,40,Rain
19490,70,1552820400,15,13,28,Rain
19491,71,1552820400,36,4,40,Rain
19492,72,1552820400,22,9,31,Rain
19493,73,1552820400,15,15,30,Rain
19494,74,1552820400,14,16,30,Rain
19495,75,1552820400,31,9,40,Rain
19496,76,1552820400,18,20,38,Rain
19497,77,1552820400,23,6,29,Rain
19498,78,1552820400,36,4,40,Rain
19499,79,1552820400,13,14,27,Rain
19500,80,1552820400,27,13,40,Rain
19501,81,1552820400,7,33,40,Rain
19502,82,1552820400,18,4,22,Rain
19503,83,1552820400,32,8,40,Rain
19504,84,1552820400,23,7,30,Rain
19505,85,1552820400,35,0,35,Rain
19506,86,1552820400,13,25,38,Rain
19507,87,1552820400,16,22,38,Rain
19508,88,1552820400,28,2,30,Rain
19509,89,1552820400,31,9,40,Rain
19510,90,1552820400,25,15,40,Rain
19511,91,1552820400,8,22,30,Rain
19512,92,1552820400,23,17,40,Rain
19513,93,1552820400,1,39,40,Rain
19514,94,1552820400,16,24,40,Rain
19515,95,1552820400,28,12,40,Rain
19516,96,1552820400,28,2,30,Rain
19517,97,1552820400,29,11,40,Rain
19518,98,1552820400,18,22,40,Rain
19519,99,1552820400,15,15,30,Rain
19520,100,1552820400,8,17,25,Rain
19521,101,1552820400,26,4,30,Rain
19522,102,1552820400,0,0,0,Rain
19523,103,1552820400,38,2,40,Rain
19524,104,1552820400,40,0,40,Rain
19525,105,1552820400,36,0,36,Rain
19526,106,1552820400,40,0,40,Rain
19527,107,1552820400,40,0,40,Rain
19528,108,1552820400,40,0,40,Rain
19529,109,1552820400,23,6,29,Rain
19530,110,1552820400,40,0,40,Rain
19531,111,1552820400,37,3,40,Rain
19532,112,1552820400,29,1,30,Rain
19533,113,1552820400,0,0,0,Rain
19534,114,1552820400,21,19,40,Rain
19535,115,1552820400,21,9,30,Rain
19536,2,1552824000,18,2,20,Rain
19537,3,1552824000,19,1,20,Rain
19538,4,1552824000,13,6,19,Rain
19539,5,1552824000,31,9,40,Rain
19540,6,1552824000,20,0,20,Rain
19541,7,1552824000,7,22,29,Rain
19542,8,1552824000,4,26,30,Rain
19543,9,1552824000,0,24,24,Rain
19544,10,1552824000,0,16,16,Rain
19545,11,1552824000,0,0,0,Rain
19546,12,1552824000,20,0,20,Rain
19547,13,1552824000,11,19,30,Rain
19548,14,1552824000,1,29,30,Rain
19549,15,1552824000,12,4,16,Rain
19550,16,1552824000,4,16,20,Rain
19551,17,1552824000,8,12,20,Rain
19552,18,1552824000,1,29,30,Rain
19553,19,1552824000,16,14,30,Rain
19554,21,1552824000,7,23,30,Rain
19555,22,1552824000,1,19,20,Rain
19556,23,1552824000,0,0,0,Rain
19557,24,1552824000,0,20,20,Rain
19558,25,1552824000,0,0,0,Rain
19559,26,1552824000,0,20,20,Rain
19560,27,1552824000,0,20,20,Rain
19561,28,1552824000,28,2,30,Rain
19562,29,1552824000,0,29,29,Rain
19563,30,1552824000,0,0,0,Rain
19564,31,1552824000,16,4,20,Rain
19565,32,1552824000,27,3,30,Rain
19566,33,1552824000,0,23,23,Rain
19567,34,1552824000,30,0,30,Rain
19568,35,1552824000,25,5,30,Rain
19569,36,1552824000,25,15,40,Rain
19570,37,1552824000,30,0,30,Rain
19571,38,1552824000,0,40,40,Rain
19572,39,1552824000,8,12,20,Rain
19573,40,1552824000,0,21,21,Rain
19574,41,1552824000,6,14,20,Rain
19575,42,1552824000,17,13,30,Rain
19576,43,1552824000,18,12,30,Rain
19577,44,1552824000,30,0,30,Rain
19578,45,1552824000,0,30,30,Rain
19579,46,1552824000,0,20,20,Rain
19580,47,1552824000,37,3,40,Rain
19581,48,1552824000,21,19,40,Rain
19582,49,1552824000,16,24,40,Rain
19583,50,1552824000,40,0,40,Rain
19584,51,1552824000,15,25,40,Rain
19585,52,1552824000,0,32,32,Rain
19586,53,1552824000,34,6,40,Rain
19587,54,1552824000,27,6,33,Rain
19588,55,1552824000,26,10,36,Rain
19589,56,1552824000,37,3,40,Rain
19590,57,1552824000,16,7,23,Rain
19591,58,1552824000,15,25,40,Rain
19592,59,1552824000,17,3,20,Rain
19593,60,1552824000,13,17,30,Rain
19594,61,1552824000,25,0,25,Rain
19595,62,1552824000,28,12,40,Rain
19596,63,1552824000,17,18,35,Rain
19597,64,1552824000,29,11,40,Rain
19598,65,1552824000,38,2,40,Rain
19599,66,1552824000,26,14,40,Rain
19600,67,1552824000,38,2,40,Rain
19601,68,1552824000,27,13,40,Rain
19602,69,1552824000,18,22,40,Rain
19603,70,1552824000,19,9,28,Rain
19604,71,1552824000,35,5,40,Rain
19605,72,1552824000,21,10,31,Rain
19606,73,1552824000,14,16,30,Rain
19607,74,1552824000,13,17,30,Rain
19608,75,1552824000,33,7,40,Rain
19609,76,1552824000,20,18,38,Rain
19610,77,1552824000,23,6,29,Rain
19611,78,1552824000,40,0,40,Rain
19612,79,1552824000,14,13,27,Rain
19613,80,1552824000,27,13,40,Rain
19614,81,1552824000,7,33,40,Rain
19615,82,1552824000,17,5,22,Rain
19616,83,1552824000,34,6,40,Rain
19617,84,1552824000,27,3,30,Rain
19618,85,1552824000,35,0,35,Rain
19619,86,1552824000,14,24,38,Rain
19620,87,1552824000,19,19,38,Rain
19621,88,1552824000,29,1,30,Rain
19622,89,1552824000,31,9,40,Rain
19623,90,1552824000,25,15,40,Rain
19624,91,1552824000,9,21,30,Rain
19625,92,1552824000,24,16,40,Rain
19626,93,1552824000,1,39,40,Rain
19627,94,1552824000,16,24,40,Rain
19628,95,1552824000,30,10,40,Rain
19629,96,1552824000,28,2,30,Rain
19630,97,1552824000,38,2,40,Rain
19631,98,1552824000,16,24,40,Rain
19632,99,1552824000,15,15,30,Rain
19633,100,1552824000,6,19,25,Rain
19634,101,1552824000,25,5,30,Rain
19635,102,1552824000,0,0,0,Rain
19636,103,1552824000,40,0,40,Rain
19637,104,1552824000,40,0,40,Rain
19638,105,1552824000,36,0,36,Rain
19639,106,1552824000,40,0,40,Rain
19640,107,1552824000,40,0,40,Rain
19641,108,1552824000,40,0,40,Rain
19642,109,1552824000,24,5,29,Rain
19643,110,1552824000,40,0,40,Rain
19644,111,1552824000,40,0,40,Rain
19645,112,1552824000,30,0,30,Rain
19646,113,1552824000,0,0,0,Rain
19647,114,1552824000,22,18,40,Rain
19648,115,1552824000,24,6,30,Rain
19649,2,1552827600,18,2,20,Clouds
19650,3,1552827600,19,1,20,Clouds
19651,4,1552827600,11,8,19,Clouds
19652,5,1552827600,31,9,40,Clouds
19653,6,1552827600,20,0,20,Clouds
19654,7,1552827600,4,25,29,Clouds
19655,8,1552827600,0,30,30,Clouds
19656,9,1552827600,0,24,24,Clouds
19657,10,1552827600,0,16,16,Clouds
19658,11,1552827600,0,0,0,Clouds
19659,12,1552827600,20,0,20,Clouds
19660,13,1552827600,12,18,30,Clouds
19661,14,1552827600,0,30,30,Clouds
19662,15,1552827600,12,4,16,Clouds
19663,16,1552827600,0,20,20,Clouds
19664,17,1552827600,9,11,20,Clouds
19665,18,1552827600,3,27,30,Clouds
19666,19,1552827600,17,13,30,Clouds
19667,21,1552827600,4,25,29,Clouds
19668,22,1552827600,0,20,20,Clouds
19669,23,1552827600,0,0,0,Clouds
19670,24,1552827600,1,19,20,Clouds
19671,25,1552827600,0,0,0,Clouds
19672,26,1552827600,0,20,20,Clouds
19673,27,1552827600,0,20,20,Clouds
19674,28,1552827600,26,4,30,Clouds
19675,29,1552827600,1,28,29,Clouds
19676,30,1552827600,0,0,0,Clouds
19677,31,1552827600,15,5,20,Clouds
19678,32,1552827600,15,15,30,Clouds
19679,33,1552827600,0,23,23,Clouds
19680,34,1552827600,12,18,30,Clouds
19681,35,1552827600,26,4,30,Clouds
19682,36,1552827600,22,18,40,Clouds
19683,37,1552827600,30,0,30,Clouds
19684,38,1552827600,1,39,40,Clouds
19685,39,1552827600,7,13,20,Clouds
19686,40,1552827600,0,21,21,Clouds
19687,41,1552827600,5,15,20,Clouds
19688,42,1552827600,23,7,30,Clouds
19689,43,1552827600,20,10,30,Clouds
19690,44,1552827600,29,1,30,Clouds
19691,45,1552827600,0,30,30,Clouds
19692,46,1552827600,0,20,20,Clouds
19693,47,1552827600,38,2,40,Clouds
19694,48,1552827600,19,21,40,Clouds
19695,49,1552827600,20,20,40,Clouds
19696,50,1552827600,39,1,40,Clouds
19697,51,1552827600,13,27,40,Clouds
19698,52,1552827600,0,32,32,Clouds
19699,53,1552827600,34,6,40,Clouds
19700,54,1552827600,26,7,33,Clouds
19701,55,1552827600,26,10,36,Clouds
19702,56,1552827600,35,5,40,Clouds
19703,57,1552827600,17,6,23,Clouds
19704,58,1552827600,37,3,40,Clouds
19705,59,1552827600,17,3,20,Clouds
19706,60,1552827600,23,7,30,Clouds
19707,61,1552827600,25,0,25,Clouds
19708,62,1552827600,26,14,40,Clouds
19709,63,1552827600,16,19,35,Clouds
19710,64,1552827600,30,10,40,Clouds
19711,65,1552827600,40,0,40,Clouds
19712,66,1552827600,32,8,40,Clouds
19713,67,1552827600,40,0,40,Clouds
19714,68,1552827600,34,6,40,Clouds
19715,69,1552827600,22,18,40,Clouds
19716,70,1552827600,25,3,28,Clouds
19717,71,1552827600,32,8,40,Clouds
19718,72,1552827600,21,10,31,Clouds
19719,73,1552827600,13,17,30,Clouds
19720,74,1552827600,14,16,30,Clouds
19721,75,1552827600,34,6,40,Clouds
19722,76,1552827600,22,16,38,Clouds
19723,77,1552827600,13,16,29,Clouds
19724,78,1552827600,40,0,40,Clouds
19725,79,1552827600,15,12,27,Clouds
19726,80,1552827600,28,12,40,Clouds
19727,81,1552827600,16,24,40,Clouds
19728,82,1552827600,19,3,22,Clouds
19729,83,1552827600,38,2,40,Clouds
19730,84,1552827600,29,1,30,Clouds
19731,85,1552827600,34,1,35,Clouds
19732,86,1552827600,16,22,38,Clouds
19733,87,1552827600,18,20,38,Clouds
19734,88,1552827600,28,2,30,Clouds
19735,89,1552827600,30,10,40,Clouds
19736,90,1552827600,23,17,40,Clouds
19737,91,1552827600,9,21,30,Clouds
19738,92,1552827600,27,13,40,Clouds
19739,93,1552827600,1,39,40,Clouds
19740,94,1552827600,16,24,40,Clouds
19741,95,1552827600,26,14,40,Clouds
19742,96,1552827600,30,0,30,Clouds
19743,97,1552827600,40,0,40,Clouds
19744,98,1552827600,10,30,40,Clouds
19745,99,1552827600,14,16,30,Clouds
19746,100,1552827600,9,16,25,Clouds
19747,101,1552827600,27,3,30,Clouds
19748,102,1552827600,0,0,0,Clouds
19749,103,1552827600,40,0,40,Clouds
19750,104,1552827600,40,0,40,Clouds
19751,105,1552827600,36,0,36,Clouds
19752,106,1552827600,40,0,40,Clouds
19753,107,1552827600,40,0,40,Clouds
19754,108,1552827600,40,0,40,Clouds
19755,109,1552827600,24,5,29,Clouds
19756,110,1552827600,40,0,40,Clouds
19757,111,1552827600,40,0,40,Clouds
19758,112,1552827600,28,2,30,Clouds
19759,113,1552827600,0,0,0,Clouds
19760,114,1552827600,21,19,40,Clouds
19761,115,1552827600,28,2,30,Clouds
19762,2,1552831200,18,2,20,Clouds
19763,3,1552831200,20,0,20,Clouds
19764,4,1552831200,11,8,19,Clouds
19765,5,1552831200,34,6,40,Clouds
19766,6,1552831200,20,0,20,Clouds
19767,7,1552831200,0,29,29,Clouds
19768,8,1552831200,0,30,30,Clouds
19769,9,1552831200,0,24,24,Clouds
19770,10,1552831200,0,16,16,Clouds
19771,11,1552831200,0,0,0,Clouds
19772,12,1552831200,20,0,20,Clouds
19773,13,1552831200,24,6,30,Clouds
19774,14,1552831200,0,30,30,Clouds
19775,15,1552831200,14,2,16,Clouds
19776,16,1552831200,0,20,20,Clouds
19777,17,1552831200,8,12,20,Clouds
19778,18,1552831200,1,29,30,Clouds
19779,19,1552831200,10,20,30,Clouds
19780,21,1552831200,0,28,28,Clouds
19781,22,1552831200,1,19,20,Clouds
19782,23,1552831200,0,0,0,Clouds
19783,24,1552831200,0,20,20,Clouds
19784,25,1552831200,0,0,0,Clouds
19785,26,1552831200,0,20,20,Clouds
19786,27,1552831200,0,20,20,Clouds
19787,28,1552831200,30,0,30,Clouds
19788,29,1552831200,0,29,29,Clouds
19789,30,1552831200,0,0,0,Clouds
19790,31,1552831200,5,15,20,Clouds
19791,32,1552831200,2,28,30,Clouds
19792,33,1552831200,1,22,23,Clouds
19793,34,1552831200,14,16,30,Clouds
19794,35,1552831200,28,2,30,Clouds
19795,36,1552831200,12,28,40,Clouds
19796,37,1552831200,30,0,30,Clouds
19797,38,1552831200,0,40,40,Clouds
19798,39,1552831200,9,11,20,Clouds
19799,40,1552831200,0,21,21,Clouds
19800,41,1552831200,3,17,20,Clouds
19801,42,1552831200,28,2,30,Clouds
19802,43,1552831200,25,5,30,Clouds
19803,44,1552831200,30,0,30,Clouds
19804,45,1552831200,1,29,30,Clouds
19805,46,1552831200,1,19,20,Clouds
19806,47,1552831200,39,1,40,Clouds
19807,48,1552831200,13,27,40,Clouds
19808,49,1552831200,26,14,40,Clouds
19809,50,1552831200,40,0,40,Clouds
19810,51,1552831200,10,30,40,Clouds
19811,52,1552831200,1,31,32,Clouds
19812,53,1552831200,32,8,40,Clouds
19813,54,1552831200,26,7,33,Clouds
19814,55,1552831200,23,13,36,Clouds
19815,56,1552831200,38,2,40,Clouds
19816,57,1552831200,17,6,23,Clouds
19817,58,1552831200,37,3,40,Clouds
19818,59,1552831200,15,5,20,Clouds
19819,60,1552831200,28,2,30,Clouds
19820,61,1552831200,25,0,25,Clouds
19821,62,1552831200,28,12,40,Clouds
19822,63,1552831200,16,19,35,Clouds
19823,64,1552831200,30,10,40,Clouds
19824,65,1552831200,39,1,40,Clouds
19825,66,1552831200,40,0,40,Clouds
19826,67,1552831200,40,0,40,Clouds
19827,68,1552831200,40,0,40,Clouds
19828,69,1552831200,31,9,40,Clouds
19829,70,1552831200,26,2,28,Clouds
19830,71,1552831200,32,8,40,Clouds
19831,72,1552831200,13,18,31,Clouds
19832,73,1552831200,12,18,30,Clouds
19833,74,1552831200,15,15,30,Clouds
19834,75,1552831200,34,6,40,Clouds
19835,76,1552831200,24,14,38,Clouds
19836,77,1552831200,0,29,29,Clouds
19837,78,1552831200,22,18,40,Clouds
19838,79,1552831200,20,7,27,Clouds
19839,80,1552831200,30,10,40,Clouds
19840,81,1552831200,17,23,40,Clouds
19841,82,1552831200,22,0,22,Clouds
19842,83,1552831200,40,0,40,Clouds
19843,84,1552831200,29,1,30,Clouds
19844,85,1552831200,35,0,35,Clouds
19845,86,1552831200,16,22,38,Clouds
19846,87,1552831200,21,17,38,Clouds
19847,88,1552831200,30,0,30,Clouds
19848,89,1552831200,30,10,40,Clouds
19849,90,1552831200,24,16,40,Clouds
19850,91,1552831200,21,9,30,Clouds
19851,92,1552831200,26,14,40,Clouds
19852,93,1552831200,2,38,40,Clouds
19853,94,1552831200,16,24,40,Clouds
19854,95,1552831200,26,14,40,Clouds
19855,96,1552831200,30,0,30,Clouds
19856,97,1552831200,40,0,40,Clouds
19857,98,1552831200,3,37,40,Clouds
19858,99,1552831200,6,24,30,Clouds
19859,100,1552831200,10,15,25,Clouds
19860,101,1552831200,29,1,30,Clouds
19861,102,1552831200,0,0,0,Clouds
19862,103,1552831200,40,0,40,Clouds
19863,104,1552831200,40,0,40,Clouds
19864,105,1552831200,36,0,36,Clouds
19865,106,1552831200,40,0,40,Clouds
19866,107,1552831200,39,1,40,Clouds
19867,108,1552831200,40,0,40,Clouds
19868,109,1552831200,24,5,29,Clouds
19869,110,1552831200,40,0,40,Clouds
19870,111,1552831200,40,0,40,Clouds
19871,112,1552831200,28,2,30,Clouds
19872,113,1552831200,0,0,0,Clouds
19873,114,1552831200,21,19,40,Clouds
19874,115,1552831200,29,1,30,Clouds
19875,2,1552834800,19,1,20,Clouds
19876,3,1552834800,15,5,20,Clouds
19877,4,1552834800,5,14,19,Clouds
19878,5,1552834800,21,19,40,Clouds
19879,6,1552834800,20,0,20,Clouds
19880,7,1552834800,1,28,29,Clouds
19881,8,1552834800,2,28,30,Clouds
19882,9,1552834800,0,24,24,Clouds
19883,10,1552834800,0,16,16,Clouds
19884,11,1552834800,0,0,0,Clouds
19885,12,1552834800,20,0,20,Clouds
19886,13,1552834800,21,9,30,Clouds
19887,14,1552834800,0,30,30,Clouds
19888,15,1552834800,14,2,16,Clouds
19889,16,1552834800,1,19,20,Clouds
19890,17,1552834800,9,11,20,Clouds
19891,18,1552834800,2,28,30,Clouds
19892,19,1552834800,18,12,30,Clouds
19893,21,1552834800,2,27,29,Clouds
19894,22,1552834800,4,16,20,Clouds
19895,23,1552834800,0,0,0,Clouds
19896,24,1552834800,7,13,20,Clouds
19897,25,1552834800,0,0,0,Clouds
19898,26,1552834800,0,20,20,Clouds
19899,27,1552834800,0,20,20,Clouds
19900,28,1552834800,30,0,30,Clouds
19901,29,1552834800,0,29,29,Clouds
19902,30,1552834800,19,0,19,Clouds
19903,31,1552834800,2,18,20,Clouds
19904,32,1552834800,7,23,30,Clouds
19905,33,1552834800,0,23,23,Clouds
19906,34,1552834800,22,8,30,Clouds
19907,35,1552834800,30,0,30,Clouds
19908,36,1552834800,8,32,40,Clouds
19909,37,1552834800,30,0,30,Clouds
19910,38,1552834800,2,38,40,Clouds
19911,39,1552834800,8,12,20,Clouds
19912,40,1552834800,0,21,21,Clouds
19913,41,1552834800,3,17,20,Clouds
19914,42,1552834800,30,0,30,Clouds
19915,43,1552834800,30,0,30,Clouds
19916,44,1552834800,26,4,30,Clouds
19917,45,1552834800,3,27,30,Clouds
19918,46,1552834800,1,19,20,Clouds
19919,47,1552834800,39,1,40,Clouds
19920,48,1552834800,31,9,40,Clouds
19921,49,1552834800,27,13,40,Clouds
19922,50,1552834800,39,1,40,Clouds
19923,51,1552834800,5,35,40,Clouds
19924,52,1552834800,1,31,32,Clouds
19925,53,1552834800,31,9,40,Clouds
19926,54,1552834800,23,10,33,Clouds
19927,55,1552834800,23,13,36,Clouds
19928,56,1552834800,40,0,40,Clouds
19929,57,1552834800,15,8,23,Clouds
19930,58,1552834800,40,0,40,Clouds
19931,59,1552834800,13,7,20,Clouds
19932,60,1552834800,25,5,30,Clouds
19933,61,1552834800,25,0,25,Clouds
19934,62,1552834800,30,10,40,Clouds
19935,63,1552834800,15,20,35,Clouds
19936,64,1552834800,29,11,40,Clouds
19937,65,1552834800,40,0,40,Clouds
19938,66,1552834800,40,0,40,Clouds
19939,67,1552834800,33,7,40,Clouds
19940,68,1552834800,38,2,40,Clouds
19941,69,1552834800,39,1,40,Clouds
19942,70,1552834800,24,4,28,Clouds
19943,71,1552834800,32,8,40,Clouds
19944,72,1552834800,11,20,31,Clouds
19945,74,1552834800,16,14,30,Clouds
19946,77,1552834800,0,29,29,Clouds
19947,78,1552834800,24,16,40,Clouds
19948,79,1552834800,23,4,27,Clouds
19949,80,1552834800,34,6,40,Clouds
19950,81,1552834800,18,22,40,Clouds
19951,82,1552834800,22,0,22,Clouds
19952,83,1552834800,39,1,40,Clouds
19953,84,1552834800,30,0,30,Clouds
19954,85,1552834800,35,0,35,Clouds
19955,86,1552834800,16,22,38,Clouds
19956,87,1552834800,19,19,38,Clouds
19957,88,1552834800,30,0,30,Clouds
19958,89,1552834800,30,10,40,Clouds
19959,90,1552834800,24,16,40,Clouds
19960,91,1552834800,20,10,30,Clouds
19961,92,1552834800,28,12,40,Clouds
19962,93,1552834800,4,36,40,Clouds
19963,94,1552834800,16,24,40,Clouds
19964,95,1552834800,33,7,40,Clouds
19965,96,1552834800,29,1,30,Clouds
19966,97,1552834800,38,2,40,Clouds
19967,98,1552834800,0,40,40,Clouds
19968,99,1552834800,2,28,30,Clouds
19969,100,1552834800,9,16,25,Clouds
19970,101,1552834800,26,4,30,Clouds
19971,102,1552834800,40,0,40,Clouds
19972,103,1552834800,40,0,40,Clouds
19973,104,1552834800,40,0,40,Clouds
19974,105,1552834800,36,0,36,Clouds
19975,106,1552834800,40,0,40,Clouds
19976,107,1552834800,40,0,40,Clouds
19977,108,1552834800,40,0,40,Clouds
19978,109,1552834800,27,2,29,Clouds
19979,110,1552834800,40,0,40,Clouds
19980,111,1552834800,39,1,40,Clouds
19981,112,1552834800,22,8,30,Clouds
19982,113,1552834800,0,0,0,Clouds
19983,114,1552834800,20,20,40,Clouds
19984,115,1552834800,22,7,29,Clouds
19985,2,1552838400,18,2,20,Rain
19986,3,1552838400,17,3,20,Rain
19987,4,1552838400,3,16,19,Rain
19988,5,1552838400,25,15,40,Rain
19989,6,1552838400,20,0,20,Rain
19990,7,1552838400,5,24,29,Rain
19991,8,1552838400,0,30,30,Rain
19992,9,1552838400,0,24,24,Rain
19993,10,1552838400,1,15,16,Rain
19994,11,1552838400,0,0,0,Rain
19995,12,1552838400,20,0,20,Rain
19996,13,1552838400,20,10,30,Rain
19997,14,1552838400,1,29,30,Rain
19998,15,1552838400,16,0,16,Rain
19999,16,1552838400,0,20,20,Rain
20000,18,1552838400,2,28,30,Rain
20001,19,1552838400,17,13,30,Rain
20002,21,1552838400,6,24,30,Rain
20003,22,1552838400,3,17,20,Rain
20004,23,1552838400,0,0,0,Rain
20005,24,1552838400,7,13,20,Rain
20006,25,1552838400,0,0,0,Rain
20007,26,1552838400,0,20,20,Rain
20008,27,1552838400,1,19,20,Rain
20009,28,1552838400,27,3,30,Rain
20010,29,1552838400,1,28,29,Rain
20011,30,1552838400,19,0,19,Rain
20012,32,1552838400,7,23,30,Rain
20013,33,1552838400,6,17,23,Rain
20014,34,1552838400,26,4,30,Rain
20015,35,1552838400,30,0,30,Rain
20016,36,1552838400,5,35,40,Rain
20017,38,1552838400,1,39,40,Rain
20018,39,1552838400,4,16,20,Rain
20019,40,1552838400,0,21,21,Rain
20020,41,1552838400,4,16,20,Rain
20021,43,1552838400,28,2,30,Rain
20022,44,1552838400,30,0,30,Rain
20023,45,1552838400,0,30,30,Rain
20024,46,1552838400,0,20,20,Rain
20025,47,1552838400,39,1,40,Rain
20026,48,1552838400,31,9,40,Rain
20027,49,1552838400,32,8,40,Rain
20028,50,1552838400,38,2,40,Rain
20029,51,1552838400,3,37,40,Rain
20030,52,1552838400,2,30,32,Rain
20031,53,1552838400,34,6,40,Rain
20032,54,1552838400,19,14,33,Rain
20033,55,1552838400,23,13,36,Rain
20034,56,1552838400,35,5,40,Rain
20035,57,1552838400,17,6,23,Rain
20036,58,1552838400,39,1,40,Rain
20037,59,1552838400,14,6,20,Rain
20038,60,1552838400,27,3,30,Rain
20039,61,1552838400,25,0,25,Rain
20040,62,1552838400,31,9,40,Rain
20041,63,1552838400,15,20,35,Rain
20042,64,1552838400,29,11,40,Rain
20043,66,1552838400,40,0,40,Rain
20044,67,1552838400,35,5,40,Rain
20045,68,1552838400,37,3,40,Rain
20046,69,1552838400,38,2,40,Rain
20047,70,1552838400,26,2,28,Rain
20048,71,1552838400,33,6,39,Rain
20049,72,1552838400,15,16,31,Rain
20050,74,1552838400,16,14,30,Rain
20051,77,1552838400,3,26,29,Rain
20052,78,1552838400,24,16,40,Rain
20053,79,1552838400,24,3,27,Rain
20054,80,1552838400,34,6,40,Rain
20055,81,1552838400,19,21,40,Rain
20056,82,1552838400,22,0,22,Rain
20057,83,1552838400,35,5,40,Rain
20058,84,1552838400,30,0,30,Rain
20059,85,1552838400,35,0,35,Rain
20060,86,1552838400,20,18,38,Rain
20061,87,1552838400,18,20,38,Rain
20062,88,1552838400,27,3,30,Rain
20063,89,1552838400,28,12,40,Rain
20064,90,1552838400,25,15,40,Rain
20065,91,1552838400,16,14,30,Rain
20066,92,1552838400,31,9,40,Rain
20067,93,1552838400,4,36,40,Rain
20068,94,1552838400,16,24,40,Rain
20069,95,1552838400,36,4,40,Rain
20070,96,1552838400,30,0,30,Rain
20071,97,1552838400,37,3,40,Rain
20072,98,1552838400,0,40,40,Rain
20073,99,1552838400,1,29,30,Rain
20074,100,1552838400,9,16,25,Rain
20075,102,1552838400,40,0,40,Rain
20076,103,1552838400,40,0,40,Rain
20077,104,1552838400,40,0,40,Rain
20078,105,1552838400,36,0,36,Rain
20079,106,1552838400,40,0,40,Rain
20080,107,1552838400,40,0,40,Rain
20081,108,1552838400,34,6,40,Rain
20082,109,1552838400,26,3,29,Rain
20083,110,1552838400,40,0,40,Rain
20084,111,1552838400,38,2,40,Rain
20085,112,1552838400,19,11,30,Rain
20086,113,1552838400,0,0,0,Rain
20087,114,1552838400,20,20,40,Rain
20088,115,1552838400,21,8,29,Rain
20089,2,1552842000,19,1,20,Rain
20090,3,1552842000,17,3,20,Rain
20091,4,1552842000,4,15,19,Rain
20092,5,1552842000,27,13,40,Rain
20093,6,1552842000,17,3,20,Rain
20094,7,1552842000,9,20,29,Rain
20095,8,1552842000,3,27,30,Rain
20096,9,1552842000,0,24,24,Rain
20097,10,1552842000,2,14,16,Rain
20098,11,1552842000,30,0,30,Rain
20099,12,1552842000,20,0,20,Rain
20100,13,1552842000,20,10,30,Rain
20101,14,1552842000,2,28,30,Rain
20102,15,1552842000,15,1,16,Rain
20103,16,1552842000,0,20,20,Rain
20104,18,1552842000,3,27,30,Rain
20105,19,1552842000,20,10,30,Rain
20106,21,1552842000,9,21,30,Rain
20107,22,1552842000,0,20,20,Rain
20108,23,1552842000,0,0,0,Rain
20109,24,1552842000,6,14,20,Rain
20110,25,1552842000,0,0,0,Rain
20111,26,1552842000,3,17,20,Rain
20112,27,1552842000,2,18,20,Rain
20113,28,1552842000,26,4,30,Rain
20114,29,1552842000,4,25,29,Rain
20115,30,1552842000,18,1,19,Rain
20116,32,1552842000,8,22,30,Rain
20117,33,1552842000,10,13,23,Rain
20118,34,1552842000,28,2,30,Rain
20119,35,1552842000,30,0,30,Rain
20120,36,1552842000,5,35,40,Rain
20121,38,1552842000,3,37,40,Rain
20122,39,1552842000,3,17,20,Rain
20123,40,1552842000,1,20,21,Rain
20124,41,1552842000,3,17,20,Rain
20125,43,1552842000,28,2,30,Rain
20126,44,1552842000,28,2,30,Rain
20127,45,1552842000,0,30,30,Rain
20128,46,1552842000,1,19,20,Rain
20129,47,1552842000,39,1,40,Rain
20130,48,1552842000,26,14,40,Rain
20131,49,1552842000,29,11,40,Rain
20132,50,1552842000,39,1,40,Rain
20133,51,1552842000,7,33,40,Rain
20134,52,1552842000,4,28,32,Rain
20135,53,1552842000,38,2,40,Rain
20136,54,1552842000,20,13,33,Rain
20137,55,1552842000,23,13,36,Rain
20138,57,1552842000,18,5,23,Rain
20139,58,1552842000,36,4,40,Rain
20140,59,1552842000,13,7,20,Rain
20141,60,1552842000,26,4,30,Rain
20142,61,1552842000,25,0,25,Rain
20143,62,1552842000,30,10,40,Rain
20144,63,1552842000,19,16,35,Rain
20145,64,1552842000,29,11,40,Rain
20146,66,1552842000,40,0,40,Rain
20147,67,1552842000,31,9,40,Rain
20148,68,1552842000,34,6,40,Rain
20149,69,1552842000,33,7,40,Rain
20150,70,1552842000,26,2,28,Rain
20151,72,1552842000,17,14,31,Rain
20152,74,1552842000,17,13,30,Rain
20153,77,1552842000,0,29,29,Rain
20154,78,1552842000,25,15,40,Rain
20155,79,1552842000,24,3,27,Rain
20156,80,1552842000,34,6,40,Rain
20157,81,1552842000,20,20,40,Rain
20158,82,1552842000,21,1,22,Rain
20159,83,1552842000,33,7,40,Rain
20160,84,1552842000,30,0,30,Rain
20161,85,1552842000,34,1,35,Rain
20162,86,1552842000,24,14,38,Rain
20163,87,1552842000,24,14,38,Rain
20164,88,1552842000,24,6,30,Rain
20165,89,1552842000,28,12,40,Rain
20166,90,1552842000,26,14,40,Rain
20167,91,1552842000,16,14,30,Rain
20168,92,1552842000,33,7,40,Rain
20169,93,1552842000,4,36,40,Rain
20170,94,1552842000,16,24,40,Rain
20171,95,1552842000,35,5,40,Rain
20172,96,1552842000,26,4,30,Rain
20173,97,1552842000,38,2,40,Rain
20174,98,1552842000,2,38,40,Rain
20175,99,1552842000,0,30,30,Rain
20176,100,1552842000,11,14,25,Rain
20177,103,1552842000,39,1,40,Rain
20178,104,1552842000,39,1,40,Rain
20179,105,1552842000,36,0,36,Rain
20180,106,1552842000,40,0,40,Rain
20181,107,1552842000,40,0,40,Rain
20182,108,1552842000,34,6,40,Rain
20183,109,1552842000,26,3,29,Rain
20184,110,1552842000,39,1,40,Rain
20185,111,1552842000,40,0,40,Rain
20186,112,1552842000,21,9,30,Rain
20187,113,1552842000,0,0,0,Rain
20188,114,1552842000,18,22,40,Rain
20189,115,1552842000,16,13,29,Rain
20190,2,1552845600,18,2,20,Clouds
20191,3,1552845600,13,7,20,Clouds
20192,4,1552845600,6,13,19,Clouds
20193,5,1552845600,29,11,40,Clouds
20194,6,1552845600,17,3,20,Clouds
20195,7,1552845600,11,18,29,Clouds
20196,8,1552845600,22,8,30,Clouds
20197,9,1552845600,0,24,24,Clouds
20198,10,1552845600,1,15,16,Clouds
20199,11,1552845600,30,0,30,Clouds
20200,12,1552845600,18,2,20,Clouds
20201,13,1552845600,21,9,30,Clouds
20202,14,1552845600,1,29,30,Clouds
20203,15,1552845600,12,4,16,Clouds
20204,16,1552845600,1,19,20,Clouds
20205,18,1552845600,1,29,30,Clouds
20206,19,1552845600,19,11,30,Clouds
20207,21,1552845600,8,22,30,Clouds
20208,22,1552845600,6,14,20,Clouds
20209,23,1552845600,0,0,0,Clouds
20210,24,1552845600,1,19,20,Clouds
20211,25,1552845600,0,0,0,Clouds
20212,26,1552845600,1,19,20,Clouds
20213,27,1552845600,10,10,20,Clouds
20214,28,1552845600,27,3,30,Clouds
20215,29,1552845600,5,24,29,Clouds
20216,30,1552845600,19,0,19,Clouds
20217,32,1552845600,13,17,30,Clouds
20218,33,1552845600,14,9,23,Clouds
20219,34,1552845600,28,2,30,Clouds
20220,35,1552845600,27,3,30,Clouds
20221,36,1552845600,5,35,40,Clouds
20222,38,1552845600,3,37,40,Clouds
20223,39,1552845600,0,20,20,Clouds
20224,40,1552845600,2,19,21,Clouds
20225,41,1552845600,3,17,20,Clouds
20226,43,1552845600,9,21,30,Clouds
20227,44,1552845600,29,1,30,Clouds
20228,45,1552845600,0,30,30,Clouds
20229,46,1552845600,3,17,20,Clouds
20230,47,1552845600,39,1,40,Clouds
20231,48,1552845600,27,13,40,Clouds
20232,49,1552845600,33,7,40,Clouds
20233,50,1552845600,40,0,40,Clouds
20234,51,1552845600,10,30,40,Clouds
20235,52,1552845600,8,24,32,Clouds
20236,53,1552845600,38,2,40,Clouds
20237,54,1552845600,20,13,33,Clouds
20238,55,1552845600,23,13,36,Clouds
20239,57,1552845600,19,4,23,Clouds
20240,58,1552845600,35,5,40,Clouds
20241,59,1552845600,15,5,20,Clouds
20242,60,1552845600,30,0,30,Clouds
20243,61,1552845600,25,0,25,Clouds
20244,62,1552845600,31,9,40,Clouds
20245,63,1552845600,17,18,35,Clouds
20246,64,1552845600,31,9,40,Clouds
20247,66,1552845600,38,2,40,Clouds
20248,67,1552845600,27,13,40,Clouds
20249,68,1552845600,33,7,40,Clouds
20250,69,1552845600,28,12,40,Clouds
20251,70,1552845600,26,2,28,Clouds
20252,72,1552845600,18,13,31,Clouds
20253,74,1552845600,15,15,30,Clouds
20254,77,1552845600,3,26,29,Clouds
20255,78,1552845600,26,14,40,Clouds
20256,79,1552845600,24,3,27,Clouds
20257,80,1552845600,37,3,40,Clouds
20258,81,1552845600,21,19,40,Clouds
20259,82,1552845600,22,0,22,Clouds
20260,83,1552845600,32,8,40,Clouds
20261,84,1552845600,30,0,30,Clouds
20262,85,1552845600,35,0,35,Clouds
20263,86,1552845600,23,15,38,Clouds
20264,87,1552845600,25,13,38,Clouds
20265,88,1552845600,22,8,30,Clouds
20266,89,1552845600,28,12,40,Clouds
20267,90,1552845600,26,14,40,Clouds
20268,91,1552845600,11,19,30,Clouds
20269,92,1552845600,32,8,40,Clouds
20270,93,1552845600,4,36,40,Clouds
20271,94,1552845600,16,24,40,Clouds
20272,95,1552845600,30,10,40,Clouds
20273,96,1552845600,25,5,30,Clouds
20274,97,1552845600,38,2,40,Clouds
20275,98,1552845600,2,38,40,Clouds
20276,99,1552845600,1,29,30,Clouds
20277,100,1552845600,9,16,25,Clouds
20278,103,1552845600,39,1,40,Clouds
20279,104,1552845600,39,1,40,Clouds
20280,105,1552845600,36,0,36,Clouds
20281,106,1552845600,40,0,40,Clouds
20282,107,1552845600,39,1,40,Clouds
20283,108,1552845600,36,4,40,Clouds
20284,109,1552845600,23,6,29,Clouds
20285,110,1552845600,39,1,40,Clouds
20286,111,1552845600,39,1,40,Clouds
20287,112,1552845600,29,1,30,Clouds
20288,113,1552845600,0,0,0,Clouds
20289,114,1552845600,16,24,40,Clouds
20290,115,1552845600,14,15,29,Clouds
20291,2,1552849200,18,2,20,Rain
20292,3,1552849200,15,5,20,Rain
20293,4,1552849200,5,14,19,Rain
20294,5,1552849200,28,12,40,Rain
20295,6,1552849200,15,5,20,Rain
20296,7,1552849200,9,20,29,Rain
20297,8,1552849200,19,11,30,Rain
20298,9,1552849200,1,23,24,Rain
20299,10,1552849200,1,15,16,Rain
20300,11,1552849200,30,0,30,Rain
20301,12,1552849200,10,10,20,Rain
20302,13,1552849200,22,8,30,Rain
20303,14,1552849200,0,30,30,Rain
20304,15,1552849200,13,3,16,Rain
20305,16,1552849200,13,7,20,Rain
20306,18,1552849200,0,30,30,Rain
20307,19,1552849200,23,7,30,Rain
20308,21,1552849200,11,19,30,Rain
20309,22,1552849200,8,12,20,Rain
20310,23,1552849200,0,0,0,Rain
20311,24,1552849200,4,16,20,Rain
20312,25,1552849200,0,0,0,Rain
20313,26,1552849200,4,16,20,Rain
20314,27,1552849200,15,5,20,Rain
20315,28,1552849200,29,1,30,Rain
20316,29,1552849200,3,26,29,Rain
20317,30,1552849200,17,2,19,Rain
20318,32,1552849200,14,16,30,Rain
20319,33,1552849200,14,9,23,Rain
20320,34,1552849200,23,7,30,Rain
20321,35,1552849200,28,2,30,Rain
20322,36,1552849200,6,34,40,Rain
20323,38,1552849200,4,36,40,Rain
20324,39,1552849200,4,16,20,Rain
20325,40,1552849200,6,15,21,Rain
20326,41,1552849200,2,18,20,Rain
20327,43,1552849200,10,20,30,Rain
20328,44,1552849200,30,0,30,Rain
20329,45,1552849200,5,25,30,Rain
20330,46,1552849200,4,16,20,Rain
20331,47,1552849200,38,2,40,Rain
20332,48,1552849200,26,14,40,Rain
20333,49,1552849200,33,7,40,Rain
20334,50,1552849200,38,2,40,Rain
20335,51,1552849200,9,31,40,Rain
20336,52,1552849200,5,27,32,Rain
20337,53,1552849200,39,1,40,Rain
20338,54,1552849200,17,16,33,Rain
20339,55,1552849200,21,15,36,Rain
20340,57,1552849200,19,4,23,Rain
20341,58,1552849200,37,3,40,Rain
20342,59,1552849200,20,0,20,Rain
20343,60,1552849200,27,3,30,Rain
20344,61,1552849200,25,0,25,Rain
20345,62,1552849200,30,10,40,Rain
20346,63,1552849200,19,16,35,Rain
20347,64,1552849200,30,10,40,Rain
20348,66,1552849200,40,0,40,Rain
20349,67,1552849200,27,13,40,Rain
20350,68,1552849200,32,8,40,Rain
20351,69,1552849200,27,13,40,Rain
20352,70,1552849200,24,4,28,Rain
20353,72,1552849200,14,17,31,Rain
20354,74,1552849200,16,14,30,Rain
20355,77,1552849200,4,25,29,Rain
20356,78,1552849200,26,14,40,Rain
20357,79,1552849200,15,12,27,Rain
20358,80,1552849200,38,2,40,Rain
20359,81,1552849200,23,17,40,Rain
20360,82,1552849200,20,2,22,Rain
20361,83,1552849200,29,11,40,Rain
20362,84,1552849200,27,3,30,Rain
20363,85,1552849200,35,0,35,Rain
20364,86,1552849200,24,14,38,Rain
20365,87,1552849200,25,13,38,Rain
20366,88,1552849200,22,8,30,Rain
20367,89,1552849200,29,11,40,Rain
20368,90,1552849200,27,13,40,Rain
20369,91,1552849200,13,17,30,Rain
20370,92,1552849200,31,9,40,Rain
20371,93,1552849200,4,36,40,Rain
20372,94,1552849200,16,24,40,Rain
20373,95,1552849200,32,8,40,Rain
20374,96,1552849200,26,4,30,Rain
20375,97,1552849200,34,6,40,Rain
20376,98,1552849200,2,38,40,Rain
20377,99,1552849200,3,27,30,Rain
20378,100,1552849200,9,16,25,Rain
20379,103,1552849200,38,2,40,Rain
20380,104,1552849200,39,1,40,Rain
20381,105,1552849200,36,0,36,Rain
20382,106,1552849200,40,0,40,Rain
20383,107,1552849200,40,0,40,Rain
20384,108,1552849200,36,4,40,Rain
20385,109,1552849200,23,6,29,Rain
20386,110,1552849200,37,3,40,Rain
20387,111,1552849200,40,0,40,Rain
20388,112,1552849200,30,0,30,Rain
20389,113,1552849200,0,0,0,Rain
20390,114,1552849200,18,22,40,Rain
20391,115,1552849200,15,14,29,Rain
20392,2,1552852800,20,0,20,Clouds
20393,3,1552852800,18,2,20,Clouds
20394,4,1552852800,3,16,19,Clouds
20395,5,1552852800,30,10,40,Clouds
20396,6,1552852800,18,2,20,Clouds
20397,7,1552852800,8,21,29,Clouds
20398,8,1552852800,20,10,30,Clouds
20399,9,1552852800,0,24,24,Clouds
20400,10,1552852800,4,12,16,Clouds
20401,11,1552852800,30,0,30,Clouds
20402,12,1552852800,11,9,20,Clouds
20403,13,1552852800,22,8,30,Clouds
20404,14,1552852800,5,25,30,Clouds
20405,15,1552852800,14,2,16,Clouds
20406,16,1552852800,13,7,20,Clouds
20407,18,1552852800,0,30,30,Clouds
20408,19,1552852800,25,5,30,Clouds
20409,21,1552852800,17,13,30,Clouds
20410,22,1552852800,5,15,20,Clouds
20411,23,1552852800,0,0,0,Clouds
20412,24,1552852800,7,13,20,Clouds
20413,25,1552852800,0,0,0,Clouds
20414,26,1552852800,3,17,20,Clouds
20415,27,1552852800,16,4,20,Clouds
20416,28,1552852800,29,1,30,Clouds
20417,29,1552852800,1,28,29,Clouds
20418,30,1552852800,19,0,19,Clouds
20419,32,1552852800,18,12,30,Clouds
20420,33,1552852800,13,10,23,Clouds
20421,34,1552852800,21,9,30,Clouds
20422,35,1552852800,30,0,30,Clouds
20423,36,1552852800,6,34,40,Clouds
20424,38,1552852800,5,35,40,Clouds
20425,39,1552852800,3,17,20,Clouds
20426,40,1552852800,2,19,21,Clouds
20427,41,1552852800,2,18,20,Clouds
20428,43,1552852800,8,22,30,Clouds
20429,44,1552852800,26,4,30,Clouds
20430,45,1552852800,7,23,30,Clouds
20431,46,1552852800,2,18,20,Clouds
20432,47,1552852800,36,4,40,Clouds
20433,48,1552852800,24,16,40,Clouds
20434,49,1552852800,31,9,40,Clouds
20435,50,1552852800,33,7,40,Clouds
20436,51,1552852800,11,29,40,Clouds
20437,52,1552852800,2,30,32,Clouds
20438,53,1552852800,39,1,40,Clouds
20439,54,1552852800,17,16,33,Clouds
20440,55,1552852800,20,16,36,Clouds
20441,57,1552852800,19,4,23,Clouds
20442,58,1552852800,37,3,40,Clouds
20443,59,1552852800,19,1,20,Clouds
20444,60,1552852800,28,2,30,Clouds
20445,61,1552852800,23,2,25,Clouds
20446,62,1552852800,31,9,40,Clouds
20447,63,1552852800,20,15,35,Clouds
20448,64,1552852800,29,11,40,Clouds
20449,66,1552852800,30,10,40,Clouds
20450,67,1552852800,20,20,40,Clouds
20451,68,1552852800,35,5,40,Clouds
20452,69,1552852800,32,8,40,Clouds
20453,70,1552852800,25,3,28,Clouds
20454,72,1552852800,18,13,31,Clouds
20455,74,1552852800,15,15,30,Clouds
20456,77,1552852800,0,29,29,Clouds
20457,78,1552852800,29,11,40,Clouds
20458,79,1552852800,16,11,27,Clouds
20459,80,1552852800,39,1,40,Clouds
20460,81,1552852800,23,17,40,Clouds
20461,82,1552852800,17,5,22,Clouds
20462,83,1552852800,28,12,40,Clouds
20463,84,1552852800,26,4,30,Clouds
20464,85,1552852800,34,1,35,Clouds
20465,86,1552852800,28,10,38,Clouds
20466,87,1552852800,25,13,38,Clouds
20467,88,1552852800,19,11,30,Clouds
20468,89,1552852800,30,10,40,Clouds
20469,90,1552852800,33,7,40,Clouds
20470,91,1552852800,13,17,30,Clouds
20471,92,1552852800,31,9,40,Clouds
20472,93,1552852800,4,36,40,Clouds
20473,94,1552852800,16,24,40,Clouds
20474,95,1552852800,29,11,40,Clouds
20475,96,1552852800,26,4,30,Clouds
20476,97,1552852800,36,4,40,Clouds
20477,98,1552852800,4,36,40,Clouds
20478,99,1552852800,3,27,30,Clouds
20479,100,1552852800,12,13,25,Clouds
20480,103,1552852800,38,2,40,Clouds
20481,104,1552852800,40,0,40,Clouds
20482,105,1552852800,36,0,36,Clouds
20483,106,1552852800,40,0,40,Clouds
20484,107,1552852800,40,0,40,Clouds
20485,108,1552852800,35,5,40,Clouds
20486,109,1552852800,25,4,29,Clouds
20487,110,1552852800,36,4,40,Clouds
20488,111,1552852800,39,1,40,Clouds
20489,112,1552852800,23,7,30,Clouds
20490,113,1552852800,0,0,0,Clouds
20491,114,1552852800,18,22,40,Clouds
20492,115,1552852800,11,18,29,Clouds
20493,2,1552856400,20,0,20,Clouds
20494,3,1552856400,16,4,20,Clouds
20495,4,1552856400,6,13,19,Clouds
20496,5,1552856400,30,10,40,Clouds
20497,6,1552856400,19,1,20,Clouds
20498,7,1552856400,9,20,29,Clouds
20499,8,1552856400,22,8,30,Clouds
20500,9,1552856400,2,22,24,Clouds
20501,10,1552856400,1,15,16,Clouds
20502,11,1552856400,29,1,30,Clouds
20503,12,1552856400,11,9,20,Clouds
20504,13,1552856400,20,10,30,Clouds
20505,14,1552856400,2,28,30,Clouds
20506,15,1552856400,16,0,16,Clouds
20507,16,1552856400,15,5,20,Clouds
20508,18,1552856400,0,30,30,Clouds
20509,19,1552856400,22,8,30,Clouds
20510,21,1552856400,22,8,30,Clouds
20511,22,1552856400,5,15,20,Clouds
20512,23,1552856400,0,0,0,Clouds
20513,24,1552856400,7,13,20,Clouds
20514,25,1552856400,0,0,0,Clouds
20515,26,1552856400,5,15,20,Clouds
20516,27,1552856400,18,2,20,Clouds
20517,28,1552856400,28,2,30,Clouds
20518,29,1552856400,4,25,29,Clouds
20519,30,1552856400,19,0,19,Clouds
20520,32,1552856400,22,8,30,Clouds
20521,33,1552856400,9,14,23,Clouds
20522,34,1552856400,22,7,29,Clouds
20523,35,1552856400,28,2,30,Clouds
20524,36,1552856400,5,35,40,Clouds
20525,38,1552856400,1,39,40,Clouds
20526,39,1552856400,3,17,20,Clouds
20527,40,1552856400,1,20,21,Clouds
20528,41,1552856400,3,17,20,Clouds
20529,43,1552856400,1,29,30,Clouds
20530,44,1552856400,27,3,30,Clouds
20531,45,1552856400,6,24,30,Clouds
20532,46,1552856400,2,18,20,Clouds
20533,47,1552856400,34,6,40,Clouds
20534,48,1552856400,20,20,40,Clouds
20535,49,1552856400,33,7,40,Clouds
20536,50,1552856400,36,4,40,Clouds
20537,51,1552856400,8,32,40,Clouds
20538,52,1552856400,4,28,32,Clouds
20539,53,1552856400,39,1,40,Clouds
20540,54,1552856400,20,13,33,Clouds
20541,55,1552856400,20,16,36,Clouds
20542,57,1552856400,21,2,23,Clouds
20543,58,1552856400,40,0,40,Clouds
20544,59,1552856400,20,0,20,Clouds
20545,60,1552856400,30,0,30,Clouds
20546,61,1552856400,25,0,25,Clouds
20547,62,1552856400,31,9,40,Clouds
20548,63,1552856400,22,13,35,Clouds
20549,64,1552856400,28,12,40,Clouds
20550,66,1552856400,25,15,40,Clouds
20551,67,1552856400,23,17,40,Clouds
20552,68,1552856400,36,4,40,Clouds
20553,69,1552856400,29,11,40,Clouds
20554,70,1552856400,23,5,28,Clouds
20555,72,1552856400,20,11,31,Clouds
20556,74,1552856400,20,10,30,Clouds
20557,77,1552856400,1,28,29,Clouds
20558,78,1552856400,30,10,40,Clouds
20559,79,1552856400,16,11,27,Clouds
20560,80,1552856400,39,1,40,Clouds
20561,81,1552856400,23,17,40,Clouds
20562,82,1552856400,17,5,22,Clouds
20563,83,1552856400,28,12,40,Clouds
20564,84,1552856400,28,2,30,Clouds
20565,85,1552856400,33,2,35,Clouds
20566,86,1552856400,28,10,38,Clouds
20567,87,1552856400,22,16,38,Clouds
20568,88,1552856400,20,10,30,Clouds
20569,89,1552856400,30,10,40,Clouds
20570,90,1552856400,33,7,40,Clouds
20571,91,1552856400,11,19,30,Clouds
20572,92,1552856400,30,10,40,Clouds
20573,93,1552856400,4,36,40,Clouds
20574,94,1552856400,16,24,40,Clouds
20575,95,1552856400,29,11,40,Clouds
20576,96,1552856400,27,3,30,Clouds
20577,97,1552856400,35,5,40,Clouds
20578,98,1552856400,3,37,40,Clouds
20579,99,1552856400,2,28,30,Clouds
20580,100,1552856400,13,12,25,Clouds
20581,103,1552856400,38,2,40,Clouds
20582,104,1552856400,40,0,40,Clouds
20583,105,1552856400,36,0,36,Clouds
20584,106,1552856400,40,0,40,Clouds
20585,107,1552856400,39,1,40,Clouds
20586,108,1552856400,37,3,40,Clouds
20587,109,1552856400,23,6,29,Clouds
20588,110,1552856400,35,5,40,Clouds
20589,111,1552856400,34,6,40,Clouds
20590,112,1552856400,22,8,30,Clouds
20591,113,1552856400,0,0,0,Clouds
20592,114,1552856400,17,23,40,Clouds
20593,115,1552856400,8,21,29,Clouds
20594,2,1552860000,18,2,20,Clouds
20595,3,1552860000,18,2,20,Clouds
20596,4,1552860000,6,13,19,Clouds
20597,5,1552860000,28,12,40,Clouds
20598,6,1552860000,19,1,20,Clouds
20599,7,1552860000,10,19,29,Clouds
20600,8,1552860000,22,8,30,Clouds
20601,9,1552860000,3,21,24,Clouds
20602,10,1552860000,4,12,16,Clouds
20603,11,1552860000,27,3,30,Clouds
20604,12,1552860000,11,9,20,Clouds
20605,13,1552860000,19,11,30,Clouds
20606,14,1552860000,0,30,30,Clouds
20607,15,1552860000,16,0,16,Clouds
20608,16,1552860000,16,4,20,Clouds
20609,18,1552860000,1,29,30,Clouds
20610,19,1552860000,22,8,30,Clouds
20611,21,1552860000,23,7,30,Clouds
20612,22,1552860000,7,13,20,Clouds
20613,23,1552860000,0,0,0,Clouds
20614,24,1552860000,8,12,20,Clouds
20615,25,1552860000,0,0,0,Clouds
20616,26,1552860000,6,14,20,Clouds
20617,27,1552860000,19,1,20,Clouds
20618,28,1552860000,28,2,30,Clouds
20619,29,1552860000,5,24,29,Clouds
20620,30,1552860000,19,0,19,Clouds
20621,32,1552860000,23,7,30,Clouds
20622,33,1552860000,10,13,23,Clouds
20623,34,1552860000,24,5,29,Clouds
20624,35,1552860000,27,3,30,Clouds
20625,36,1552860000,5,35,40,Clouds
20626,38,1552860000,4,36,40,Clouds
20627,39,1552860000,5,15,20,Clouds
20628,40,1552860000,0,21,21,Clouds
20629,41,1552860000,2,18,20,Clouds
20630,43,1552860000,0,30,30,Clouds
20631,44,1552860000,27,3,30,Clouds
20632,45,1552860000,7,23,30,Clouds
20633,46,1552860000,6,14,20,Clouds
20634,47,1552860000,37,3,40,Clouds
20635,48,1552860000,22,18,40,Clouds
20636,49,1552860000,33,7,40,Clouds
20637,50,1552860000,35,5,40,Clouds
20638,51,1552860000,9,31,40,Clouds
20639,52,1552860000,6,26,32,Clouds
20640,53,1552860000,39,1,40,Clouds
20641,54,1552860000,25,8,33,Clouds
20642,55,1552860000,21,15,36,Clouds
20643,57,1552860000,19,4,23,Clouds
20644,58,1552860000,38,2,40,Clouds
20645,59,1552860000,19,1,20,Clouds
20646,60,1552860000,30,0,30,Clouds
20647,61,1552860000,25,0,25,Clouds
20648,62,1552860000,32,8,40,Clouds
20649,63,1552860000,24,11,35,Clouds
20650,64,1552860000,29,11,40,Clouds
20651,66,1552860000,24,16,40,Clouds
20652,67,1552860000,21,19,40,Clouds
20653,68,1552860000,37,3,40,Clouds
20654,69,1552860000,33,7,40,Clouds
20655,70,1552860000,24,4,28,Clouds
20656,72,1552860000,18,13,31,Clouds
20657,74,1552860000,20,10,30,Clouds
20658,77,1552860000,1,28,29,Clouds
20659,78,1552860000,31,9,40,Clouds
20660,79,1552860000,17,10,27,Clouds
20661,80,1552860000,39,1,40,Clouds
20662,81,1552860000,23,17,40,Clouds
20663,82,1552860000,17,5,22,Clouds
20664,83,1552860000,26,14,40,Clouds
20665,84,1552860000,27,3,30,Clouds
20666,85,1552860000,34,1,35,Clouds
20667,86,1552860000,26,12,38,Clouds
20668,87,1552860000,23,15,38,Clouds
20669,88,1552860000,15,15,30,Clouds
20670,89,1552860000,30,10,40,Clouds
20671,90,1552860000,34,6,40,Clouds
20672,91,1552860000,6,24,30,Clouds
20673,92,1552860000,32,8,40,Clouds
20674,93,1552860000,5,35,40,Clouds
20675,94,1552860000,16,24,40,Clouds
20676,95,1552860000,26,14,40,Clouds
20677,96,1552860000,26,4,30,Clouds
20678,97,1552860000,35,5,40,Clouds
20679,98,1552860000,5,35,40,Clouds
20680,99,1552860000,2,28,30,Clouds
20681,100,1552860000,12,13,25,Clouds
20682,103,1552860000,38,2,40,Clouds
20683,104,1552860000,40,0,40,Clouds
20684,105,1552860000,36,0,36,Clouds
20685,106,1552860000,40,0,40,Clouds
20686,107,1552860000,35,5,40,Clouds
20687,108,1552860000,37,3,40,Clouds
20688,109,1552860000,24,5,29,Clouds
20689,110,1552860000,37,3,40,Clouds
20690,111,1552860000,31,9,40,Clouds
20691,112,1552860000,20,10,30,Clouds
20692,113,1552860000,0,0,0,Clouds
20693,114,1552860000,17,23,40,Clouds
20694,115,1552860000,8,21,29,Clouds
20695,2,1552863600,17,3,20,Clouds
20696,3,1552863600,12,8,20,Clouds
20697,4,1552863600,7,12,19,Clouds
20698,5,1552863600,31,9,40,Clouds
20699,6,1552863600,20,0,20,Clouds
20700,7,1552863600,13,16,29,Clouds
20701,8,1552863600,21,9,30,Clouds
20702,9,1552863600,11,13,24,Clouds
20703,10,1552863600,8,8,16,Clouds
20704,11,1552863600,27,3,30,Clouds
20705,12,1552863600,12,8,20,Clouds
20706,13,1552863600,21,9,30,Clouds
20707,14,1552863600,5,25,30,Clouds
20708,15,1552863600,16,0,16,Clouds
20709,16,1552863600,19,1,20,Clouds
20710,18,1552863600,1,29,30,Clouds
20711,19,1552863600,20,10,30,Clouds
20712,21,1552863600,26,4,30,Clouds
20713,22,1552863600,9,11,20,Clouds
20714,23,1552863600,0,0,0,Clouds
20715,24,1552863600,6,14,20,Clouds
20716,25,1552863600,0,0,0,Clouds
20717,26,1552863600,5,15,20,Clouds
20718,27,1552863600,20,0,20,Clouds
20719,28,1552863600,28,2,30,Clouds
20720,29,1552863600,1,28,29,Clouds
20721,30,1552863600,19,0,19,Clouds
20722,32,1552863600,22,8,30,Clouds
20723,33,1552863600,11,12,23,Clouds
20724,34,1552863600,17,12,29,Clouds
20725,35,1552863600,26,4,30,Clouds
20726,36,1552863600,5,35,40,Clouds
20727,38,1552863600,5,35,40,Clouds
20728,39,1552863600,6,14,20,Clouds
20729,40,1552863600,3,18,21,Clouds
20730,41,1552863600,1,19,20,Clouds
20731,43,1552863600,0,30,30,Clouds
20732,44,1552863600,25,5,30,Clouds
20733,45,1552863600,7,23,30,Clouds
20734,46,1552863600,5,15,20,Clouds
20735,47,1552863600,38,2,40,Clouds
20736,48,1552863600,25,15,40,Clouds
20737,49,1552863600,34,6,40,Clouds
20738,50,1552863600,36,4,40,Clouds
20739,51,1552863600,11,29,40,Clouds
20740,52,1552863600,7,25,32,Clouds
20741,53,1552863600,39,1,40,Clouds
20742,54,1552863600,27,6,33,Clouds
20743,55,1552863600,21,15,36,Clouds
20744,57,1552863600,19,4,23,Clouds
20745,58,1552863600,37,3,40,Clouds
20746,59,1552863600,18,2,20,Clouds
20747,60,1552863600,30,0,30,Clouds
20748,61,1552863600,25,0,25,Clouds
20749,62,1552863600,32,8,40,Clouds
20750,63,1552863600,24,11,35,Clouds
20751,64,1552863600,29,11,40,Clouds
20752,66,1552863600,23,17,40,Clouds
20753,67,1552863600,20,20,40,Clouds
20754,68,1552863600,35,5,40,Clouds
20755,69,1552863600,29,11,40,Clouds
20756,70,1552863600,19,9,28,Clouds
20757,72,1552863600,22,9,31,Clouds
20758,74,1552863600,17,13,30,Clouds
20759,77,1552863600,2,27,29,Clouds
20760,78,1552863600,32,8,40,Clouds
20761,79,1552863600,17,10,27,Clouds
20762,80,1552863600,38,2,40,Clouds
20763,81,1552863600,23,17,40,Clouds
20764,82,1552863600,16,6,22,Clouds
20765,83,1552863600,27,13,40,Clouds
20766,84,1552863600,27,3,30,Clouds
20767,85,1552863600,34,1,35,Clouds
20768,86,1552863600,28,10,38,Clouds
20769,87,1552863600,22,16,38,Clouds
20770,88,1552863600,12,18,30,Clouds
20771,89,1552863600,30,10,40,Clouds
20772,90,1552863600,32,8,40,Clouds
20773,91,1552863600,8,22,30,Clouds
20774,92,1552863600,33,7,40,Clouds
20775,93,1552863600,5,35,40,Clouds
20776,94,1552863600,16,24,40,Clouds
20777,95,1552863600,27,13,40,Clouds
20778,96,1552863600,26,4,30,Clouds
20779,97,1552863600,34,6,40,Clouds
20780,98,1552863600,8,32,40,Clouds
20781,99,1552863600,0,30,30,Clouds
20782,100,1552863600,13,12,25,Clouds
20783,103,1552863600,39,1,40,Clouds
20784,104,1552863600,40,0,40,Clouds
20785,105,1552863600,36,0,36,Clouds
20786,106,1552863600,40,0,40,Clouds
20787,107,1552863600,36,4,40,Clouds
20788,108,1552863600,35,5,40,Clouds
20789,109,1552863600,25,4,29,Clouds
20790,110,1552863600,37,3,40,Clouds
20791,111,1552863600,33,7,40,Clouds
20792,112,1552863600,18,12,30,Clouds
20793,113,1552863600,0,0,0,Clouds
20794,114,1552863600,18,22,40,Clouds
20795,115,1552863600,8,21,29,Clouds
20796,2,1552867200,16,4,20,Clouds
20797,3,1552867200,15,5,20,Clouds
20798,4,1552867200,8,11,19,Clouds
20799,5,1552867200,31,9,40,Clouds
20800,6,1552867200,20,0,20,Clouds
20801,7,1552867200,14,15,29,Clouds
20802,8,1552867200,24,6,30,Clouds
20803,9,1552867200,13,11,24,Clouds
20804,10,1552867200,7,9,16,Clouds
20805,11,1552867200,28,2,30,Clouds
20806,12,1552867200,12,8,20,Clouds
20807,13,1552867200,20,10,30,Clouds
20808,14,1552867200,9,21,30,Clouds
20809,15,1552867200,16,0,16,Clouds
20810,16,1552867200,20,0,20,Clouds
20811,18,1552867200,1,29,30,Clouds
20812,19,1552867200,20,10,30,Clouds
20813,21,1552867200,30,0,30,Clouds
20814,22,1552867200,13,7,20,Clouds
20815,23,1552867200,0,0,0,Clouds
20816,24,1552867200,10,10,20,Clouds
20817,25,1552867200,0,0,0,Clouds
20818,26,1552867200,5,15,20,Clouds
20819,27,1552867200,20,0,20,Clouds
20820,28,1552867200,30,0,30,Clouds
20821,29,1552867200,5,24,29,Clouds
20822,30,1552867200,18,1,19,Clouds
20823,32,1552867200,24,6,30,Clouds
20824,33,1552867200,9,14,23,Clouds
20825,34,1552867200,11,18,29,Clouds
20826,35,1552867200,26,4,30,Clouds
20827,36,1552867200,8,32,40,Clouds
20828,38,1552867200,6,34,40,Clouds
20829,39,1552867200,6,14,20,Clouds
20830,40,1552867200,2,19,21,Clouds
20831,41,1552867200,1,19,20,Clouds
20832,43,1552867200,0,30,30,Clouds
20833,44,1552867200,21,9,30,Clouds
20834,45,1552867200,7,23,30,Clouds
20835,46,1552867200,3,17,20,Clouds
20836,47,1552867200,38,2,40,Clouds
20837,48,1552867200,27,13,40,Clouds
20838,49,1552867200,35,5,40,Clouds
20839,50,1552867200,36,4,40,Clouds
20840,51,1552867200,10,30,40,Clouds
20841,52,1552867200,6,26,32,Clouds
20842,53,1552867200,39,1,40,Clouds
20843,54,1552867200,23,10,33,Clouds
20844,55,1552867200,21,15,36,Clouds
20845,57,1552867200,19,4,23,Clouds
20846,58,1552867200,34,6,40,Clouds
20847,59,1552867200,17,3,20,Clouds
20848,60,1552867200,27,3,30,Clouds
20849,61,1552867200,25,0,25,Clouds
20850,62,1552867200,33,7,40,Clouds
20851,63,1552867200,21,14,35,Clouds
20852,64,1552867200,29,11,40,Clouds
20853,66,1552867200,23,17,40,Clouds
20854,67,1552867200,30,10,40,Clouds
20855,68,1552867200,38,2,40,Clouds
20856,69,1552867200,30,10,40,Clouds
20857,70,1552867200,11,17,28,Clouds
20858,72,1552867200,20,11,31,Clouds
20859,74,1552867200,18,12,30,Clouds
20860,77,1552867200,2,27,29,Clouds
20861,78,1552867200,31,9,40,Clouds
20862,79,1552867200,17,10,27,Clouds
20863,80,1552867200,37,3,40,Clouds
20864,81,1552867200,23,17,40,Clouds
20865,82,1552867200,15,7,22,Clouds
20866,83,1552867200,28,12,40,Clouds
20867,84,1552867200,27,3,30,Clouds
20868,85,1552867200,34,1,35,Clouds
20869,86,1552867200,30,8,38,Clouds
20870,87,1552867200,21,17,38,Clouds
20871,88,1552867200,9,21,30,Clouds
20872,89,1552867200,31,9,40,Clouds
20873,90,1552867200,30,10,40,Clouds
20874,91,1552867200,8,22,30,Clouds
20875,92,1552867200,32,8,40,Clouds
20876,93,1552867200,5,35,40,Clouds
20877,94,1552867200,16,24,40,Clouds
20878,95,1552867200,28,12,40,Clouds
20879,96,1552867200,25,5,30,Clouds
20880,97,1552867200,33,7,40,Clouds
20881,98,1552867200,9,31,40,Clouds
20882,99,1552867200,0,30,30,Clouds
20883,100,1552867200,16,9,25,Clouds
20884,103,1552867200,39,1,40,Clouds
20885,104,1552867200,40,0,40,Clouds
20886,105,1552867200,36,0,36,Clouds
20887,106,1552867200,40,0,40,Clouds
20888,107,1552867200,37,3,40,Clouds
20889,108,1552867200,36,4,40,Clouds
20890,109,1552867200,25,4,29,Clouds
20891,110,1552867200,37,3,40,Clouds
20892,111,1552867200,30,10,40,Clouds
20893,112,1552867200,15,15,30,Clouds
20894,113,1552867200,0,0,0,Clouds
20895,114,1552867200,17,23,40,Clouds
20896,115,1552867200,7,22,29,Clouds
20897,2,1552870800,15,5,20,Clouds
20898,3,1552870800,14,6,20,Clouds
20899,4,1552870800,13,6,19,Clouds
20900,5,1552870800,34,6,40,Clouds
20901,6,1552870800,20,0,20,Clouds
20902,7,1552870800,14,15,29,Clouds
20903,8,1552870800,25,5,30,Clouds
20904,9,1552870800,20,4,24,Clouds
20905,10,1552870800,10,6,16,Clouds
20906,11,1552870800,28,2,30,Clouds
20907,12,1552870800,12,8,20,Clouds
20908,13,1552870800,20,10,30,Clouds
20909,14,1552870800,13,17,30,Clouds
20910,15,1552870800,14,2,16,Clouds
20911,16,1552870800,20,0,20,Clouds
20912,17,1552870800,9,11,20,Clouds
20913,18,1552870800,0,30,30,Clouds
20914,19,1552870800,21,9,30,Clouds
20915,21,1552870800,30,0,30,Clouds
20916,22,1552870800,13,7,20,Clouds
20917,23,1552870800,0,0,0,Clouds
20918,24,1552870800,19,1,20,Clouds
20919,25,1552870800,0,0,0,Clouds
20920,26,1552870800,6,14,20,Clouds
20921,27,1552870800,19,1,20,Clouds
20922,28,1552870800,28,2,30,Clouds
20923,29,1552870800,5,24,29,Clouds
20924,30,1552870800,18,1,19,Clouds
20925,32,1552870800,26,4,30,Clouds
20926,33,1552870800,8,15,23,Clouds
20927,34,1552870800,12,17,29,Clouds
20928,35,1552870800,27,3,30,Clouds
20929,36,1552870800,11,29,40,Clouds
20930,38,1552870800,9,31,40,Clouds
20931,39,1552870800,6,14,20,Clouds
20932,40,1552870800,3,18,21,Clouds
20933,41,1552870800,0,20,20,Clouds
20934,42,1552870800,28,2,30,Clouds
20935,43,1552870800,1,29,30,Clouds
20936,44,1552870800,18,12,30,Clouds
20937,45,1552870800,8,22,30,Clouds
20938,46,1552870800,1,19,20,Clouds
20939,47,1552870800,38,2,40,Clouds
20940,48,1552870800,28,12,40,Clouds
20941,49,1552870800,34,6,40,Clouds
20942,50,1552870800,32,8,40,Clouds
20943,51,1552870800,10,30,40,Clouds
20944,52,1552870800,9,23,32,Clouds
20945,53,1552870800,39,1,40,Clouds
20946,54,1552870800,24,9,33,Clouds
20947,55,1552870800,21,15,36,Clouds
20948,56,1552870800,4,36,40,Clouds
20949,57,1552870800,17,6,23,Clouds
20950,58,1552870800,34,6,40,Clouds
20951,59,1552870800,17,3,20,Clouds
20952,60,1552870800,28,2,30,Clouds
20953,61,1552870800,25,0,25,Clouds
20954,62,1552870800,33,7,40,Clouds
20955,63,1552870800,23,12,35,Clouds
20956,64,1552870800,28,12,40,Clouds
20957,65,1552870800,39,1,40,Clouds
20958,66,1552870800,19,21,40,Clouds
20959,67,1552870800,31,9,40,Clouds
20960,68,1552870800,40,0,40,Clouds
20961,69,1552870800,30,10,40,Clouds
20962,70,1552870800,8,20,28,Clouds
20963,71,1552870800,13,26,39,Clouds
20964,72,1552870800,20,11,31,Clouds
20965,73,1552870800,0,30,30,Clouds
20966,74,1552870800,16,14,30,Clouds
20967,75,1552870800,36,4,40,Clouds
20968,76,1552870800,23,15,38,Clouds
20969,77,1552870800,3,26,29,Clouds
20970,78,1552870800,29,11,40,Clouds
20971,79,1552870800,17,10,27,Clouds
20972,80,1552870800,36,4,40,Clouds
20973,81,1552870800,23,17,40,Clouds
20974,82,1552870800,14,8,22,Clouds
20975,83,1552870800,27,13,40,Clouds
20976,84,1552870800,26,4,30,Clouds
20977,85,1552870800,35,0,35,Clouds
20978,86,1552870800,30,8,38,Clouds
20979,87,1552870800,20,18,38,Clouds
20980,88,1552870800,8,22,30,Clouds
20981,89,1552870800,31,9,40,Clouds
20982,90,1552870800,29,11,40,Clouds
20983,91,1552870800,9,21,30,Clouds
20984,92,1552870800,31,9,40,Clouds
20985,93,1552870800,5,35,40,Clouds
20986,94,1552870800,16,24,40,Clouds
20987,95,1552870800,28,12,40,Clouds
20988,96,1552870800,25,5,30,Clouds
20989,97,1552870800,32,8,40,Clouds
20990,98,1552870800,9,31,40,Clouds
20991,99,1552870800,1,29,30,Clouds
20992,100,1552870800,16,9,25,Clouds
20993,101,1552870800,8,22,30,Clouds
20994,103,1552870800,39,1,40,Clouds
20995,104,1552870800,40,0,40,Clouds
20996,105,1552870800,36,0,36,Clouds
20997,106,1552870800,40,0,40,Clouds
20998,107,1552870800,37,3,40,Clouds
20999,108,1552870800,34,6,40,Clouds
21000,109,1552870800,24,5,29,Clouds
21001,110,1552870800,37,3,40,Clouds
21002,111,1552870800,28,12,40,Clouds
21003,112,1552870800,11,19,30,Clouds
21004,113,1552870800,0,0,0,Clouds
21005,114,1552870800,17,23,40,Clouds
21006,115,1552870800,6,23,29,Clouds
21007,2,1552874400,15,5,20,Clouds
21008,3,1552874400,13,7,20,Clouds
21009,4,1552874400,13,6,19,Clouds
21010,5,1552874400,35,5,40,Clouds
21011,6,1552874400,20,0,20,Clouds
21012,7,1552874400,14,15,29,Clouds
21013,8,1552874400,28,2,30,Clouds
21014,9,1552874400,20,4,24,Clouds
21015,10,1552874400,13,3,16,Clouds
21016,11,1552874400,27,3,30,Clouds
21017,12,1552874400,11,9,20,Clouds
21018,13,1552874400,20,10,30,Clouds
21019,14,1552874400,14,16,30,Clouds
21020,15,1552874400,14,2,16,Clouds
21021,16,1552874400,20,0,20,Clouds
21022,17,1552874400,7,13,20,Clouds
21023,18,1552874400,1,29,30,Clouds
21024,19,1552874400,22,8,30,Clouds
21025,21,1552874400,30,0,30,Clouds
21026,22,1552874400,13,7,20,Clouds
21027,23,1552874400,0,0,0,Clouds
21028,24,1552874400,20,0,20,Clouds
21029,25,1552874400,0,0,0,Clouds
21030,26,1552874400,5,15,20,Clouds
21031,27,1552874400,14,5,19,Clouds
21032,28,1552874400,28,2,30,Clouds
21033,29,1552874400,7,22,29,Clouds
21034,30,1552874400,17,2,19,Clouds
21035,31,1552874400,0,20,20,Clouds
21036,32,1552874400,26,4,30,Clouds
21037,33,1552874400,13,10,23,Clouds
21038,34,1552874400,15,14,29,Clouds
21039,35,1552874400,26,4,30,Clouds
21040,36,1552874400,13,27,40,Clouds
21041,37,1552874400,30,0,30,Clouds
21042,38,1552874400,11,29,40,Clouds
21043,39,1552874400,7,13,20,Clouds
21044,40,1552874400,2,19,21,Clouds
21045,41,1552874400,0,20,20,Clouds
21046,42,1552874400,0,30,30,Clouds
21047,43,1552874400,1,29,30,Clouds
21048,44,1552874400,16,14,30,Clouds
21049,45,1552874400,8,22,30,Clouds
21050,46,1552874400,3,17,20,Clouds
21051,47,1552874400,38,2,40,Clouds
21052,48,1552874400,27,13,40,Clouds
21053,49,1552874400,33,7,40,Clouds
21054,50,1552874400,30,10,40,Clouds
21055,51,1552874400,11,29,40,Clouds
21056,52,1552874400,10,22,32,Clouds
21057,53,1552874400,39,1,40,Clouds
21058,54,1552874400,25,8,33,Clouds
21059,55,1552874400,19,17,36,Clouds
21060,56,1552874400,4,36,40,Clouds
21061,57,1552874400,17,6,23,Clouds
21062,58,1552874400,33,7,40,Clouds
21063,59,1552874400,17,3,20,Clouds
21064,60,1552874400,28,2,30,Clouds
21065,61,1552874400,25,0,25,Clouds
21066,62,1552874400,33,7,40,Clouds
21067,63,1552874400,26,9,35,Clouds
21068,64,1552874400,28,12,40,Clouds
21069,65,1552874400,39,1,40,Clouds
21070,66,1552874400,19,21,40,Clouds
21071,67,1552874400,28,12,40,Clouds
21072,68,1552874400,39,1,40,Clouds
21073,69,1552874400,31,9,40,Clouds
21074,70,1552874400,7,21,28,Clouds
21075,71,1552874400,13,26,39,Clouds
21076,72,1552874400,20,11,31,Clouds
21077,73,1552874400,0,30,30,Clouds
21078,74,1552874400,17,13,30,Clouds
21079,75,1552874400,23,17,40,Clouds
21080,76,1552874400,23,15,38,Clouds
21081,77,1552874400,3,26,29,Clouds
21082,78,1552874400,28,12,40,Clouds
21083,79,1552874400,17,10,27,Clouds
21084,80,1552874400,36,4,40,Clouds
21085,81,1552874400,23,17,40,Clouds
21086,82,1552874400,13,9,22,Clouds
21087,83,1552874400,25,15,40,Clouds
21088,84,1552874400,26,4,30,Clouds
21089,85,1552874400,35,0,35,Clouds
21090,86,1552874400,30,8,38,Clouds
21091,87,1552874400,19,19,38,Clouds
21092,88,1552874400,9,21,30,Clouds
21093,89,1552874400,31,9,40,Clouds
21094,90,1552874400,29,11,40,Clouds
21095,91,1552874400,9,21,30,Clouds
21096,92,1552874400,31,9,40,Clouds
21097,93,1552874400,5,35,40,Clouds
21098,94,1552874400,16,24,40,Clouds
21099,95,1552874400,27,13,40,Clouds
21100,96,1552874400,25,5,30,Clouds
21101,97,1552874400,30,10,40,Clouds
21102,98,1552874400,9,31,40,Clouds
21103,99,1552874400,1,29,30,Clouds
21104,100,1552874400,16,9,25,Clouds
21105,101,1552874400,8,22,30,Clouds
21106,103,1552874400,39,1,40,Clouds
21107,104,1552874400,40,0,40,Clouds
21108,105,1552874400,36,0,36,Clouds
21109,106,1552874400,40,0,40,Clouds
21110,107,1552874400,37,3,40,Clouds
21111,108,1552874400,33,7,40,Clouds
21112,109,1552874400,24,5,29,Clouds
21113,110,1552874400,35,5,40,Clouds
21114,111,1552874400,27,13,40,Clouds
21115,112,1552874400,9,21,30,Clouds
21116,113,1552874400,0,0,0,Clouds
21117,114,1552874400,17,23,40,Clouds
21118,115,1552874400,3,27,30,Clouds
21119,2,1552878000,15,5,20,Rain
21120,3,1552878000,13,7,20,Rain
21121,4,1552878000,13,6,19,Rain
21122,5,1552878000,35,5,40,Rain
21123,6,1552878000,19,1,20,Rain
21124,7,1552878000,14,15,29,Rain
21125,8,1552878000,28,2,30,Rain
21126,9,1552878000,20,4,24,Rain
21127,10,1552878000,13,3,16,Rain
21128,11,1552878000,27,3,30,Rain
21129,12,1552878000,11,9,20,Rain
21130,13,1552878000,20,10,30,Rain
21131,14,1552878000,14,16,30,Rain
21132,15,1552878000,14,2,16,Rain
21133,16,1552878000,20,0,20,Rain
21134,17,1552878000,7,13,20,Rain
21135,18,1552878000,1,29,30,Rain
21136,19,1552878000,22,8,30,Rain
21137,21,1552878000,30,0,30,Rain
21138,22,1552878000,13,7,20,Rain
21139,23,1552878000,0,0,0,Rain
21140,24,1552878000,20,0,20,Rain
21141,25,1552878000,0,0,0,Rain
21142,26,1552878000,5,15,20,Rain
21143,27,1552878000,14,5,19,Rain
21144,28,1552878000,28,2,30,Rain
21145,29,1552878000,7,22,29,Rain
21146,30,1552878000,17,2,19,Rain
21147,31,1552878000,0,20,20,Rain
21148,32,1552878000,26,4,30,Rain
21149,33,1552878000,13,10,23,Rain
21150,34,1552878000,15,14,29,Rain
21151,35,1552878000,26,4,30,Rain
21152,36,1552878000,13,27,40,Rain
21153,37,1552878000,24,6,30,Rain
21154,38,1552878000,10,30,40,Rain
21155,39,1552878000,7,13,20,Rain
21156,40,1552878000,2,19,21,Rain
21157,41,1552878000,0,20,20,Rain
21158,42,1552878000,0,30,30,Rain
21159,43,1552878000,1,29,30,Rain
21160,44,1552878000,16,14,30,Rain
21161,45,1552878000,8,22,30,Rain
21162,46,1552878000,3,17,20,Rain
21163,47,1552878000,38,2,40,Rain
21164,48,1552878000,27,13,40,Rain
21165,49,1552878000,33,7,40,Rain
21166,50,1552878000,30,10,40,Rain
21167,51,1552878000,11,29,40,Rain
21168,52,1552878000,10,22,32,Rain
21169,53,1552878000,39,1,40,Rain
21170,54,1552878000,25,8,33,Rain
21171,55,1552878000,19,17,36,Rain
21172,56,1552878000,4,36,40,Rain
21173,57,1552878000,17,6,23,Rain
21174,58,1552878000,33,7,40,Rain
21175,59,1552878000,17,3,20,Rain
21176,60,1552878000,28,2,30,Rain
21177,61,1552878000,25,0,25,Rain
21178,62,1552878000,33,7,40,Rain
21179,63,1552878000,26,9,35,Rain
21180,64,1552878000,28,12,40,Rain
21181,65,1552878000,39,1,40,Rain
21182,66,1552878000,19,21,40,Rain
21183,67,1552878000,28,12,40,Rain
21184,68,1552878000,39,1,40,Rain
21185,69,1552878000,31,9,40,Rain
21186,70,1552878000,7,21,28,Rain
21187,71,1552878000,13,26,39,Rain
21188,72,1552878000,20,11,31,Rain
21189,73,1552878000,0,30,30,Rain
21190,74,1552878000,17,13,30,Rain
21191,75,1552878000,23,17,40,Rain
21192,76,1552878000,23,15,38,Rain
21193,77,1552878000,3,26,29,Rain
21194,78,1552878000,28,12,40,Rain
21195,79,1552878000,17,10,27,Rain
21196,80,1552878000,36,4,40,Rain
21197,81,1552878000,23,17,40,Rain
21198,82,1552878000,13,9,22,Rain
21199,83,1552878000,25,15,40,Rain
21200,84,1552878000,26,4,30,Rain
21201,85,1552878000,35,0,35,Rain
21202,86,1552878000,30,8,38,Rain
21203,87,1552878000,19,19,38,Rain
21204,88,1552878000,9,21,30,Rain
21205,89,1552878000,31,9,40,Rain
21206,90,1552878000,29,11,40,Rain
21207,91,1552878000,9,21,30,Rain
21208,92,1552878000,31,9,40,Rain
21209,93,1552878000,5,35,40,Rain
21210,94,1552878000,16,24,40,Rain
21211,95,1552878000,27,13,40,Rain
21212,96,1552878000,25,5,30,Rain
21213,97,1552878000,30,10,40,Rain
21214,98,1552878000,9,31,40,Rain
21215,99,1552878000,1,29,30,Rain
21216,100,1552878000,16,9,25,Rain
21217,101,1552878000,7,23,30,Rain
21218,103,1552878000,39,1,40,Rain
21219,104,1552878000,40,0,40,Rain
21220,105,1552878000,36,0,36,Rain
21221,106,1552878000,40,0,40,Rain
21222,107,1552878000,37,3,40,Rain
21223,108,1552878000,33,7,40,Rain
21224,109,1552878000,24,5,29,Rain
21225,110,1552878000,35,5,40,Rain
21226,111,1552878000,27,13,40,Rain
21227,112,1552878000,9,21,30,Rain
21228,113,1552878000,0,0,0,Rain
21229,114,1552878000,17,23,40,Rain
21230,115,1552878000,3,27,30,Rain
21231,2,1552881600,15,5,20,Rain
21232,3,1552881600,13,7,20,Rain
21233,4,1552881600,13,6,19,Rain
21234,5,1552881600,35,5,40,Rain
21235,6,1552881600,19,1,20,Rain
21236,7,1552881600,14,15,29,Rain
21237,8,1552881600,28,2,30,Rain
21238,9,1552881600,20,4,24,Rain
21239,10,1552881600,13,3,16,Rain
21240,11,1552881600,27,3,30,Rain
21241,12,1552881600,11,9,20,Rain
21242,13,1552881600,20,10,30,Rain
21243,14,1552881600,14,16,30,Rain
21244,15,1552881600,14,2,16,Rain
21245,16,1552881600,20,0,20,Rain
21246,17,1552881600,7,13,20,Rain
21247,18,1552881600,1,29,30,Rain
21248,19,1552881600,22,8,30,Rain
21249,21,1552881600,30,0,30,Rain
21250,22,1552881600,13,7,20,Rain
21251,23,1552881600,0,0,0,Rain
21252,24,1552881600,20,0,20,Rain
21253,25,1552881600,0,0,0,Rain
21254,26,1552881600,5,15,20,Rain
21255,27,1552881600,14,5,19,Rain
21256,28,1552881600,28,2,30,Rain
21257,29,1552881600,7,22,29,Rain
21258,30,1552881600,17,2,19,Rain
21259,31,1552881600,0,20,20,Rain
21260,32,1552881600,26,4,30,Rain
21261,33,1552881600,13,10,23,Rain
21262,34,1552881600,15,14,29,Rain
21263,35,1552881600,26,4,30,Rain
21264,36,1552881600,13,27,40,Rain
21265,37,1552881600,24,6,30,Rain
21266,38,1552881600,10,30,40,Rain
21267,39,1552881600,7,13,20,Rain
21268,40,1552881600,2,19,21,Rain
21269,41,1552881600,0,20,20,Rain
21270,42,1552881600,0,30,30,Rain
21271,43,1552881600,1,29,30,Rain
21272,44,1552881600,16,14,30,Rain
21273,45,1552881600,7,23,30,Rain
21274,46,1552881600,3,17,20,Rain
21275,47,1552881600,38,2,40,Rain
21276,48,1552881600,27,13,40,Rain
21277,49,1552881600,33,7,40,Rain
21278,50,1552881600,30,10,40,Rain
21279,51,1552881600,10,30,40,Rain
21280,52,1552881600,10,22,32,Rain
21281,53,1552881600,39,1,40,Rain
21282,54,1552881600,25,8,33,Rain
21283,55,1552881600,19,17,36,Rain
21284,56,1552881600,4,36,40,Rain
21285,57,1552881600,17,6,23,Rain
21286,58,1552881600,33,7,40,Rain
21287,59,1552881600,17,3,20,Rain
21288,60,1552881600,28,2,30,Rain
21289,61,1552881600,25,0,25,Rain
21290,62,1552881600,33,7,40,Rain
21291,63,1552881600,26,9,35,Rain
21292,64,1552881600,28,12,40,Rain
21293,65,1552881600,39,1,40,Rain
21294,66,1552881600,19,21,40,Rain
21295,67,1552881600,28,12,40,Rain
21296,68,1552881600,39,1,40,Rain
21297,69,1552881600,31,9,40,Rain
21298,70,1552881600,7,21,28,Rain
21299,71,1552881600,13,26,39,Rain
21300,72,1552881600,20,11,31,Rain
21301,73,1552881600,0,30,30,Rain
21302,74,1552881600,17,13,30,Rain
21303,75,1552881600,23,17,40,Rain
21304,76,1552881600,23,15,38,Rain
21305,77,1552881600,3,26,29,Rain
21306,78,1552881600,27,13,40,Rain
21307,79,1552881600,17,10,27,Rain
21308,80,1552881600,36,4,40,Rain
21309,81,1552881600,23,17,40,Rain
21310,82,1552881600,13,9,22,Rain
21311,83,1552881600,25,15,40,Rain
21312,84,1552881600,26,4,30,Rain
21313,85,1552881600,35,0,35,Rain
21314,86,1552881600,30,8,38,Rain
21315,87,1552881600,19,19,38,Rain
21316,88,1552881600,9,21,30,Rain
21317,89,1552881600,31,9,40,Rain
21318,90,1552881600,29,11,40,Rain
21319,91,1552881600,9,21,30,Rain
21320,92,1552881600,31,9,40,Rain
21321,93,1552881600,5,35,40,Rain
21322,94,1552881600,16,24,40,Rain
21323,95,1552881600,27,13,40,Rain
21324,96,1552881600,25,5,30,Rain
21325,97,1552881600,29,11,40,Rain
21326,98,1552881600,9,31,40,Rain
21327,99,1552881600,1,29,30,Rain
21328,100,1552881600,16,9,25,Rain
21329,101,1552881600,7,23,30,Rain
21330,103,1552881600,39,1,40,Rain
21331,104,1552881600,40,0,40,Rain
21332,105,1552881600,36,0,36,Rain
21333,106,1552881600,40,0,40,Rain
21334,107,1552881600,37,3,40,Rain
21335,108,1552881600,33,7,40,Rain
21336,109,1552881600,24,5,29,Rain
21337,110,1552881600,35,5,40,Rain
21338,111,1552881600,27,13,40,Rain
21339,112,1552881600,9,21,30,Rain
21340,113,1552881600,0,0,0,Rain
21341,114,1552881600,17,23,40,Rain
21342,115,1552881600,3,27,30,Rain
21343,2,1552885200,15,5,20,Rain
21344,3,1552885200,13,7,20,Rain
21345,4,1552885200,13,6,19,Rain
21346,5,1552885200,35,5,40,Rain
21347,6,1552885200,19,1,20,Rain
21348,7,1552885200,14,15,29,Rain
21349,8,1552885200,28,2,30,Rain
21350,9,1552885200,20,4,24,Rain
21351,10,1552885200,13,3,16,Rain
21352,11,1552885200,27,3,30,Rain
21353,12,1552885200,11,9,20,Rain
21354,13,1552885200,20,10,30,Rain
21355,14,1552885200,14,16,30,Rain
21356,15,1552885200,14,2,16,Rain
21357,16,1552885200,20,0,20,Rain
21358,17,1552885200,7,13,20,Rain
21359,18,1552885200,1,29,30,Rain
21360,19,1552885200,22,8,30,Rain
21361,21,1552885200,30,0,30,Rain
21362,22,1552885200,13,7,20,Rain
21363,23,1552885200,0,0,0,Rain
21364,24,1552885200,20,0,20,Rain
21365,25,1552885200,0,0,0,Rain
21366,26,1552885200,5,15,20,Rain
21367,27,1552885200,14,5,19,Rain
21368,28,1552885200,28,2,30,Rain
21369,29,1552885200,7,22,29,Rain
21370,30,1552885200,17,2,19,Rain
21371,31,1552885200,0,20,20,Rain
21372,32,1552885200,26,4,30,Rain
21373,33,1552885200,13,10,23,Rain
21374,34,1552885200,15,14,29,Rain
21375,35,1552885200,26,4,30,Rain
21376,36,1552885200,13,27,40,Rain
21377,37,1552885200,24,6,30,Rain
21378,38,1552885200,10,30,40,Rain
21379,39,1552885200,7,13,20,Rain
21380,40,1552885200,2,19,21,Rain
21381,41,1552885200,0,20,20,Rain
21382,42,1552885200,0,30,30,Rain
21383,43,1552885200,1,29,30,Rain
21384,44,1552885200,16,14,30,Rain
21385,45,1552885200,7,23,30,Rain
21386,46,1552885200,3,17,20,Rain
21387,47,1552885200,38,2,40,Rain
21388,48,1552885200,27,13,40,Rain
21389,49,1552885200,33,7,40,Rain
21390,50,1552885200,30,10,40,Rain
21391,51,1552885200,10,30,40,Rain
21392,52,1552885200,10,22,32,Rain
21393,53,1552885200,39,1,40,Rain
21394,54,1552885200,25,8,33,Rain
21395,55,1552885200,19,17,36,Rain
21396,56,1552885200,4,36,40,Rain
21397,57,1552885200,17,6,23,Rain
21398,58,1552885200,33,7,40,Rain
21399,59,1552885200,17,3,20,Rain
21400,60,1552885200,28,2,30,Rain
21401,61,1552885200,25,0,25,Rain
21402,62,1552885200,33,7,40,Rain
21403,63,1552885200,26,9,35,Rain
21404,64,1552885200,28,12,40,Rain
21405,65,1552885200,39,1,40,Rain
21406,66,1552885200,19,21,40,Rain
21407,67,1552885200,28,12,40,Rain
21408,68,1552885200,39,1,40,Rain
21409,69,1552885200,31,9,40,Rain
21410,70,1552885200,7,21,28,Rain
21411,71,1552885200,13,26,39,Rain
21412,72,1552885200,20,11,31,Rain
21413,73,1552885200,0,30,30,Rain
21414,74,1552885200,17,13,30,Rain
21415,75,1552885200,23,17,40,Rain
21416,76,1552885200,23,15,38,Rain
21417,77,1552885200,3,26,29,Rain
21418,78,1552885200,27,13,40,Rain
21419,79,1552885200,17,10,27,Rain
21420,80,1552885200,36,4,40,Rain
21421,81,1552885200,23,17,40,Rain
21422,82,1552885200,13,9,22,Rain
21423,83,1552885200,25,15,40,Rain
21424,84,1552885200,26,4,30,Rain
21425,85,1552885200,35,0,35,Rain
21426,86,1552885200,30,8,38,Rain
21427,87,1552885200,19,19,38,Rain
21428,88,1552885200,9,21,30,Rain
21429,89,1552885200,31,9,40,Rain
21430,90,1552885200,29,11,40,Rain
21431,91,1552885200,9,21,30,Rain
21432,92,1552885200,31,9,40,Rain
21433,93,1552885200,5,35,40,Rain
21434,94,1552885200,16,24,40,Rain
21435,95,1552885200,27,13,40,Rain
21436,96,1552885200,25,5,30,Rain
21437,97,1552885200,29,11,40,Rain
21438,98,1552885200,9,31,40,Rain
21439,99,1552885200,1,29,30,Rain
21440,100,1552885200,16,9,25,Rain
21441,101,1552885200,7,23,30,Rain
21442,102,1552885200,40,0,40,Rain
21443,103,1552885200,39,1,40,Rain
21444,104,1552885200,40,0,40,Rain
21445,105,1552885200,36,0,36,Rain
21446,106,1552885200,40,0,40,Rain
21447,107,1552885200,37,3,40,Rain
21448,108,1552885200,33,7,40,Rain
21449,109,1552885200,24,5,29,Rain
21450,110,1552885200,35,5,40,Rain
21451,111,1552885200,27,13,40,Rain
21452,112,1552885200,9,21,30,Rain
21453,113,1552885200,0,0,0,Rain
21454,114,1552885200,17,23,40,Rain
21455,2,1552888800,15,5,20,Rain
21456,3,1552888800,13,7,20,Rain
21457,4,1552888800,13,6,19,Rain
21458,5,1552888800,35,5,40,Rain
21459,6,1552888800,19,1,20,Rain
21460,7,1552888800,14,15,29,Rain
21461,8,1552888800,28,2,30,Rain
21462,9,1552888800,20,4,24,Rain
21463,10,1552888800,13,3,16,Rain
21464,11,1552888800,27,3,30,Rain
21465,12,1552888800,11,9,20,Rain
21466,13,1552888800,20,10,30,Rain
21467,14,1552888800,14,16,30,Rain
21468,15,1552888800,14,2,16,Rain
21469,16,1552888800,20,0,20,Rain
21470,17,1552888800,7,13,20,Rain
21471,18,1552888800,1,29,30,Rain
21472,19,1552888800,22,8,30,Rain
21473,21,1552888800,30,0,30,Rain
21474,22,1552888800,13,7,20,Rain
21475,23,1552888800,0,0,0,Rain
21476,24,1552888800,20,0,20,Rain
21477,25,1552888800,0,0,0,Rain
21478,26,1552888800,5,15,20,Rain
21479,27,1552888800,14,5,19,Rain
21480,28,1552888800,28,2,30,Rain
21481,29,1552888800,7,22,29,Rain
21482,30,1552888800,17,2,19,Rain
21483,31,1552888800,0,20,20,Rain
21484,32,1552888800,26,4,30,Rain
21485,33,1552888800,13,10,23,Rain
21486,34,1552888800,15,14,29,Rain
21487,35,1552888800,26,4,30,Rain
21488,36,1552888800,13,27,40,Rain
21489,37,1552888800,24,6,30,Rain
21490,38,1552888800,10,30,40,Rain
21491,39,1552888800,7,13,20,Rain
21492,40,1552888800,2,19,21,Rain
21493,41,1552888800,0,20,20,Rain
21494,42,1552888800,0,30,30,Rain
21495,43,1552888800,1,29,30,Rain
21496,44,1552888800,16,14,30,Rain
21497,45,1552888800,7,23,30,Rain
21498,46,1552888800,3,17,20,Rain
21499,47,1552888800,38,2,40,Rain
21500,48,1552888800,27,13,40,Rain
21501,49,1552888800,33,7,40,Rain
21502,50,1552888800,30,10,40,Rain
21503,51,1552888800,10,30,40,Rain
21504,52,1552888800,10,22,32,Rain
21505,53,1552888800,39,1,40,Rain
21506,54,1552888800,25,8,33,Rain
21507,55,1552888800,19,17,36,Rain
21508,56,1552888800,4,36,40,Rain
21509,57,1552888800,17,6,23,Rain
21510,58,1552888800,33,7,40,Rain
21511,59,1552888800,17,3,20,Rain
21512,60,1552888800,28,2,30,Rain
21513,61,1552888800,25,0,25,Rain
21514,62,1552888800,33,7,40,Rain
21515,63,1552888800,26,9,35,Rain
21516,64,1552888800,28,12,40,Rain
21517,65,1552888800,39,1,40,Rain
21518,66,1552888800,19,21,40,Rain
21519,67,1552888800,28,12,40,Rain
21520,68,1552888800,39,1,40,Rain
21521,69,1552888800,31,9,40,Rain
21522,70,1552888800,7,21,28,Rain
21523,71,1552888800,13,26,39,Rain
21524,72,1552888800,20,11,31,Rain
21525,73,1552888800,1,29,30,Rain
21526,74,1552888800,17,13,30,Rain
21527,75,1552888800,23,17,40,Rain
21528,76,1552888800,23,15,38,Rain
21529,77,1552888800,3,26,29,Rain
21530,78,1552888800,27,13,40,Rain
21531,79,1552888800,17,10,27,Rain
21532,80,1552888800,36,4,40,Rain
21533,81,1552888800,23,17,40,Rain
21534,82,1552888800,13,9,22,Rain
21535,83,1552888800,25,15,40,Rain
21536,84,1552888800,26,4,30,Rain
21537,85,1552888800,35,0,35,Rain
21538,86,1552888800,30,8,38,Rain
21539,87,1552888800,19,19,38,Rain
21540,88,1552888800,9,21,30,Rain
21541,89,1552888800,31,9,40,Rain
21542,90,1552888800,29,11,40,Rain
21543,91,1552888800,9,21,30,Rain
21544,92,1552888800,31,9,40,Rain
21545,93,1552888800,5,35,40,Rain
21546,94,1552888800,16,24,40,Rain
21547,95,1552888800,27,13,40,Rain
21548,96,1552888800,25,5,30,Rain
21549,97,1552888800,29,11,40,Rain
21550,98,1552888800,9,31,40,Rain
21551,99,1552888800,1,29,30,Rain
21552,100,1552888800,16,9,25,Rain
21553,101,1552888800,7,23,30,Rain
21554,102,1552888800,34,6,40,Rain
21555,103,1552888800,40,0,40,Rain
21556,104,1552888800,40,0,40,Rain
21557,105,1552888800,36,0,36,Rain
21558,106,1552888800,40,0,40,Rain
21559,107,1552888800,37,3,40,Rain
21560,108,1552888800,33,7,40,Rain
21561,109,1552888800,24,5,29,Rain
21562,110,1552888800,35,5,40,Rain
21563,111,1552888800,27,13,40,Rain
21564,112,1552888800,9,21,30,Rain
21565,113,1552888800,0,0,0,Rain
21566,114,1552888800,17,23,40,Rain
21567,2,1552892400,15,5,20,Rain
21568,3,1552892400,13,7,20,Rain
21569,4,1552892400,13,6,19,Rain
21570,5,1552892400,35,5,40,Rain
21571,6,1552892400,19,1,20,Rain
21572,7,1552892400,14,15,29,Rain
21573,8,1552892400,27,3,30,Rain
21574,9,1552892400,18,6,24,Rain
21575,10,1552892400,10,6,16,Rain
21576,11,1552892400,26,4,30,Rain
21577,12,1552892400,13,7,20,Rain
21578,13,1552892400,21,9,30,Rain
21579,14,1552892400,12,18,30,Rain
21580,15,1552892400,15,1,16,Rain
21581,16,1552892400,19,1,20,Rain
21582,17,1552892400,7,13,20,Rain
21583,18,1552892400,3,27,30,Rain
21584,19,1552892400,22,8,30,Rain
21585,21,1552892400,29,1,30,Rain
21586,22,1552892400,13,7,20,Rain
21587,23,1552892400,0,0,0,Rain
21588,24,1552892400,16,4,20,Rain
21589,25,1552892400,0,0,0,Rain
21590,26,1552892400,4,16,20,Rain
21591,27,1552892400,15,4,19,Rain
21592,28,1552892400,29,1,30,Rain
21593,29,1552892400,6,23,29,Rain
21594,30,1552892400,17,2,19,Rain
21595,31,1552892400,0,20,20,Rain
21596,32,1552892400,25,5,30,Rain
21597,33,1552892400,11,12,23,Rain
21598,34,1552892400,15,14,29,Rain
21599,35,1552892400,26,4,30,Rain
21600,36,1552892400,13,27,40,Rain
21601,37,1552892400,24,6,30,Rain
21602,38,1552892400,12,28,40,Rain
21603,39,1552892400,7,13,20,Rain
21604,40,1552892400,2,19,21,Rain
21605,41,1552892400,0,20,20,Rain
21606,42,1552892400,0,30,30,Rain
21607,43,1552892400,1,29,30,Rain
21608,44,1552892400,20,10,30,Rain
21609,45,1552892400,8,22,30,Rain
21610,46,1552892400,3,17,20,Rain
21611,47,1552892400,39,1,40,Rain
21612,48,1552892400,28,12,40,Rain
21613,49,1552892400,32,8,40,Rain
21614,50,1552892400,34,6,40,Rain
21615,51,1552892400,10,30,40,Rain
21616,52,1552892400,9,23,32,Rain
21617,53,1552892400,39,1,40,Rain
21618,54,1552892400,25,8,33,Rain
21619,55,1552892400,19,17,36,Rain
21620,56,1552892400,3,37,40,Rain
21621,57,1552892400,17,6,23,Rain
21622,58,1552892400,31,9,40,Rain
21623,59,1552892400,17,3,20,Rain
21624,60,1552892400,29,1,30,Rain
21625,61,1552892400,25,0,25,Rain
21626,62,1552892400,34,6,40,Rain
21627,63,1552892400,26,9,35,Rain
21628,64,1552892400,28,12,40,Rain
21629,65,1552892400,40,0,40,Rain
21630,66,1552892400,19,21,40,Rain
21631,67,1552892400,27,13,40,Rain
21632,68,1552892400,39,1,40,Rain
21633,69,1552892400,31,9,40,Rain
21634,70,1552892400,7,21,28,Rain
21635,71,1552892400,11,28,39,Rain
21636,72,1552892400,19,12,31,Rain
21637,73,1552892400,1,29,30,Rain
21638,74,1552892400,17,13,30,Rain
21639,75,1552892400,23,17,40,Rain
21640,76,1552892400,23,15,38,Rain
21641,77,1552892400,1,28,29,Rain
21642,78,1552892400,27,13,40,Rain
21643,79,1552892400,17,10,27,Rain
21644,80,1552892400,36,4,40,Rain
21645,81,1552892400,23,17,40,Rain
21646,82,1552892400,14,8,22,Rain
21647,83,1552892400,26,14,40,Rain
21648,84,1552892400,26,4,30,Rain
21649,85,1552892400,35,0,35,Rain
21650,86,1552892400,30,8,38,Rain
21651,87,1552892400,19,19,38,Rain
21652,88,1552892400,10,20,30,Rain
21653,89,1552892400,31,9,40,Rain
21654,90,1552892400,29,11,40,Rain
21655,91,1552892400,11,19,30,Rain
21656,92,1552892400,32,8,40,Rain
21657,93,1552892400,5,35,40,Rain
21658,94,1552892400,16,24,40,Rain
21659,95,1552892400,27,13,40,Rain
21660,96,1552892400,25,5,30,Rain
21661,97,1552892400,29,11,40,Rain
21662,98,1552892400,9,31,40,Rain
21663,99,1552892400,2,28,30,Rain
21664,100,1552892400,16,9,25,Rain
21665,101,1552892400,7,23,30,Rain
21666,102,1552892400,34,6,40,Rain
21667,103,1552892400,40,0,40,Rain
21668,104,1552892400,40,0,40,Rain
21669,105,1552892400,36,0,36,Rain
21670,106,1552892400,40,0,40,Rain
21671,107,1552892400,36,4,40,Rain
21672,108,1552892400,34,6,40,Rain
21673,109,1552892400,26,3,29,Rain
21674,110,1552892400,34,6,40,Rain
21675,111,1552892400,29,11,40,Rain
21676,112,1552892400,10,20,30,Rain
21677,113,1552892400,0,0,0,Rain
21678,114,1552892400,17,23,40,Rain
21679,2,1552896000,16,4,20,Rain
21680,3,1552896000,13,7,20,Rain
21681,4,1552896000,13,6,19,Rain
21682,5,1552896000,35,5,40,Rain
21683,6,1552896000,20,0,20,Rain
21684,7,1552896000,15,14,29,Rain
21685,8,1552896000,22,8,30,Rain
21686,9,1552896000,14,10,24,Rain
21687,10,1552896000,11,5,16,Rain
21688,11,1552896000,23,7,30,Rain
21689,12,1552896000,16,4,20,Rain
21690,13,1552896000,21,9,30,Rain
21691,14,1552896000,13,17,30,Rain
21692,15,1552896000,15,1,16,Rain
21693,16,1552896000,16,4,20,Rain
21694,17,1552896000,7,13,20,Rain
21695,18,1552896000,3,27,30,Rain
21696,19,1552896000,19,11,30,Rain
21697,21,1552896000,28,2,30,Rain
21698,22,1552896000,12,8,20,Rain
21699,23,1552896000,0,0,0,Rain
21700,24,1552896000,13,7,20,Rain
21701,25,1552896000,0,0,0,Rain
21702,26,1552896000,4,16,20,Rain
21703,27,1552896000,15,4,19,Rain
21704,28,1552896000,28,2,30,Rain
21705,29,1552896000,9,20,29,Rain
21706,30,1552896000,16,3,19,Rain
21707,31,1552896000,0,20,20,Rain
21708,32,1552896000,24,6,30,Rain
21709,33,1552896000,4,19,23,Rain
21710,34,1552896000,19,10,29,Rain
21711,35,1552896000,30,0,30,Rain
21712,36,1552896000,12,28,40,Rain
21713,37,1552896000,24,6,30,Rain
21714,38,1552896000,12,28,40,Rain
21715,39,1552896000,7,13,20,Rain
21716,40,1552896000,1,20,21,Rain
21717,41,1552896000,4,16,20,Rain
21718,42,1552896000,3,27,30,Rain
21719,43,1552896000,7,23,30,Rain
21720,44,1552896000,28,2,30,Rain
21721,45,1552896000,8,22,30,Rain
21722,46,1552896000,2,18,20,Rain
21723,47,1552896000,39,1,40,Rain
21724,48,1552896000,28,12,40,Rain
21725,49,1552896000,32,8,40,Rain
21726,50,1552896000,39,1,40,Rain
21727,51,1552896000,10,30,40,Rain
21728,52,1552896000,5,27,32,Rain
21729,53,1552896000,40,0,40,Rain
21730,54,1552896000,24,9,33,Rain
21731,55,1552896000,17,19,36,Rain
21732,56,1552896000,2,38,40,Rain
21733,57,1552896000,17,6,23,Rain
21734,58,1552896000,22,18,40,Rain
21735,59,1552896000,18,2,20,Rain
21736,60,1552896000,30,0,30,Rain
21737,61,1552896000,24,1,25,Rain
21738,62,1552896000,33,7,40,Rain
21739,63,1552896000,25,10,35,Rain
21740,64,1552896000,28,12,40,Rain
21741,65,1552896000,39,1,40,Rain
21742,66,1552896000,17,23,40,Rain
21743,67,1552896000,27,13,40,Rain
21744,68,1552896000,36,4,40,Rain
21745,69,1552896000,28,12,40,Rain
21746,70,1552896000,0,28,28,Rain
21747,71,1552896000,12,27,39,Rain
21748,72,1552896000,20,11,31,Rain
21749,73,1552896000,1,29,30,Rain
21750,74,1552896000,18,12,30,Rain
21751,75,1552896000,24,16,40,Rain
21752,76,1552896000,24,14,38,Rain
21753,77,1552896000,1,28,29,Rain
21754,78,1552896000,29,11,40,Rain
21755,79,1552896000,17,10,27,Rain
21756,80,1552896000,36,4,40,Rain
21757,81,1552896000,23,17,40,Rain
21758,82,1552896000,14,8,22,Rain
21759,83,1552896000,28,12,40,Rain
21760,84,1552896000,30,0,30,Rain
21761,85,1552896000,35,0,35,Rain
21762,86,1552896000,32,6,38,Rain
21763,87,1552896000,19,19,38,Rain
21764,88,1552896000,10,20,30,Rain
21765,89,1552896000,32,8,40,Rain
21766,90,1552896000,27,13,40,Rain
21767,91,1552896000,11,19,30,Rain
21768,92,1552896000,31,9,40,Rain
21769,93,1552896000,5,35,40,Rain
21770,94,1552896000,16,24,40,Rain
21771,95,1552896000,29,11,40,Rain
21772,96,1552896000,25,5,30,Rain
21773,97,1552896000,32,8,40,Rain
21774,98,1552896000,9,31,40,Rain
21775,99,1552896000,2,28,30,Rain
21776,100,1552896000,15,10,25,Rain
21777,101,1552896000,7,23,30,Rain
21778,102,1552896000,34,6,40,Rain
21779,103,1552896000,40,0,40,Rain
21780,104,1552896000,40,0,40,Rain
21781,105,1552896000,36,0,36,Rain
21782,106,1552896000,40,0,40,Rain
21783,107,1552896000,40,0,40,Rain
21784,108,1552896000,37,3,40,Rain
21785,109,1552896000,29,0,29,Rain
21786,110,1552896000,35,5,40,Rain
21787,111,1552896000,34,6,40,Rain
21788,112,1552896000,11,19,30,Rain
21789,113,1552896000,0,0,0,Rain
21790,114,1552896000,17,23,40,Rain
21791,2,1552899600,18,2,20,Clouds
21792,3,1552899600,16,4,20,Clouds
21793,4,1552899600,15,4,19,Clouds
21794,5,1552899600,32,8,40,Clouds
21795,6,1552899600,20,0,20,Clouds
21796,7,1552899600,17,12,29,Clouds
21797,8,1552899600,16,14,30,Clouds
21798,9,1552899600,12,12,24,Clouds
21799,10,1552899600,12,4,16,Clouds
21800,11,1552899600,23,7,30,Clouds
21801,12,1552899600,17,3,20,Clouds
21802,13,1552899600,21,9,30,Clouds
21803,14,1552899600,3,27,30,Clouds
21804,15,1552899600,14,2,16,Clouds
21805,16,1552899600,17,3,20,Clouds
21806,17,1552899600,7,13,20,Clouds
21807,18,1552899600,5,25,30,Clouds
21808,19,1552899600,14,16,30,Clouds
21809,21,1552899600,28,2,30,Clouds
21810,22,1552899600,11,9,20,Clouds
21811,23,1552899600,0,0,0,Clouds
21812,24,1552899600,14,6,20,Clouds
21813,25,1552899600,0,0,0,Clouds
21814,26,1552899600,2,18,20,Clouds
21815,27,1552899600,12,7,19,Clouds
21816,28,1552899600,29,1,30,Clouds
21817,29,1552899600,9,20,29,Clouds
21818,30,1552899600,11,8,19,Clouds
21819,31,1552899600,2,18,20,Clouds
21820,32,1552899600,20,10,30,Clouds
21821,33,1552899600,0,23,23,Clouds
21822,34,1552899600,30,0,30,Clouds
21823,35,1552899600,30,0,30,Clouds
21824,36,1552899600,12,28,40,Clouds
21825,37,1552899600,21,9,30,Clouds
21826,38,1552899600,5,35,40,Clouds
21827,39,1552899600,6,14,20,Clouds
21828,40,1552899600,1,20,21,Clouds
21829,41,1552899600,6,14,20,Clouds
21830,42,1552899600,11,19,30,Clouds
21831,43,1552899600,11,19,30,Clouds
21832,44,1552899600,30,0,30,Clouds
21833,45,1552899600,7,23,30,Clouds
21834,46,1552899600,3,17,20,Clouds
21835,47,1552899600,39,1,40,Clouds
21836,48,1552899600,33,7,40,Clouds
21837,49,1552899600,30,10,40,Clouds
21838,50,1552899600,39,1,40,Clouds
21839,51,1552899600,8,32,40,Clouds
21840,52,1552899600,0,32,32,Clouds
21841,53,1552899600,40,0,40,Clouds
21842,54,1552899600,25,8,33,Clouds
21843,55,1552899600,17,19,36,Clouds
21844,56,1552899600,0,40,40,Clouds
21845,57,1552899600,18,5,23,Clouds
21846,58,1552899600,20,20,40,Clouds
21847,59,1552899600,18,2,20,Clouds
21848,60,1552899600,30,0,30,Clouds
21849,61,1552899600,25,0,25,Clouds
21850,62,1552899600,34,6,40,Clouds
21851,63,1552899600,25,10,35,Clouds
21852,64,1552899600,26,14,40,Clouds
21853,65,1552899600,38,2,40,Clouds
21854,66,1552899600,19,21,40,Clouds
21855,67,1552899600,23,17,40,Clouds
21856,68,1552899600,28,12,40,Clouds
21857,69,1552899600,26,14,40,Clouds
21858,70,1552899600,0,28,28,Clouds
21859,71,1552899600,17,22,39,Clouds
21860,72,1552899600,20,11,31,Clouds
21861,73,1552899600,4,26,30,Clouds
21862,74,1552899600,22,8,30,Clouds
21863,75,1552899600,22,18,40,Clouds
21864,76,1552899600,24,14,38,Clouds
21865,77,1552899600,1,28,29,Clouds
21866,78,1552899600,31,9,40,Clouds
21867,79,1552899600,17,10,27,Clouds
21868,80,1552899600,40,0,40,Clouds
21869,81,1552899600,29,11,40,Clouds
21870,82,1552899600,14,8,22,Clouds
21871,83,1552899600,33,7,40,Clouds
21872,84,1552899600,30,0,30,Clouds
21873,85,1552899600,35,0,35,Clouds
21874,86,1552899600,32,6,38,Clouds
21875,87,1552899600,18,20,38,Clouds
21876,88,1552899600,14,16,30,Clouds
21877,89,1552899600,32,8,40,Clouds
21878,90,1552899600,18,22,40,Clouds
21879,91,1552899600,15,15,30,Clouds
21880,92,1552899600,31,9,40,Clouds
21881,93,1552899600,5,35,40,Clouds
21882,94,1552899600,16,24,40,Clouds
21883,95,1552899600,30,10,40,Clouds
21884,96,1552899600,28,2,30,Clouds
21885,97,1552899600,35,5,40,Clouds
21886,98,1552899600,6,34,40,Clouds
21887,99,1552899600,2,28,30,Clouds
21888,100,1552899600,15,10,25,Clouds
21889,101,1552899600,9,21,30,Clouds
21890,102,1552899600,36,4,40,Clouds
21891,103,1552899600,40,0,40,Clouds
21892,104,1552899600,40,0,40,Clouds
21893,105,1552899600,36,0,36,Clouds
21894,106,1552899600,40,0,40,Clouds
21895,107,1552899600,39,1,40,Clouds
21896,108,1552899600,35,5,40,Clouds
21897,109,1552899600,29,0,29,Clouds
21898,110,1552899600,38,2,40,Clouds
21899,111,1552899600,37,3,40,Clouds
21900,112,1552899600,20,10,30,Clouds
21901,113,1552899600,0,0,0,Clouds
21902,114,1552899600,10,30,40,Clouds
21903,2,1552903200,20,0,20,Clouds
21904,3,1552903200,17,3,20,Clouds
21905,4,1552903200,15,4,19,Clouds
21906,5,1552903200,36,4,40,Clouds
21907,6,1552903200,20,0,20,Clouds
21908,7,1552903200,19,10,29,Clouds
21909,8,1552903200,11,19,30,Clouds
21910,9,1552903200,6,18,24,Clouds
21911,10,1552903200,13,2,15,Clouds
21912,11,1552903200,26,4,30,Clouds
21913,12,1552903200,20,0,20,Clouds
21914,13,1552903200,18,12,30,Clouds
21915,14,1552903200,2,28,30,Clouds
21916,15,1552903200,16,0,16,Clouds
21917,16,1552903200,14,6,20,Clouds
21918,17,1552903200,7,13,20,Clouds
21919,18,1552903200,0,30,30,Clouds
21920,19,1552903200,3,27,30,Clouds
21921,21,1552903200,26,4,30,Clouds
21922,22,1552903200,10,10,20,Clouds
21923,23,1552903200,0,0,0,Clouds
21924,24,1552903200,20,0,20,Clouds
21925,25,1552903200,0,0,0,Clouds
21926,26,1552903200,1,19,20,Clouds
21927,27,1552903200,11,8,19,Clouds
21928,28,1552903200,29,1,30,Clouds
21929,29,1552903200,8,21,29,Clouds
21930,30,1552903200,11,8,19,Clouds
21931,31,1552903200,4,16,20,Clouds
21932,32,1552903200,16,14,30,Clouds
21933,33,1552903200,0,23,23,Clouds
21934,34,1552903200,29,1,30,Clouds
21935,35,1552903200,27,3,30,Clouds
21936,36,1552903200,12,28,40,Clouds
21937,37,1552903200,16,14,30,Clouds
21938,38,1552903200,10,30,40,Clouds
21939,39,1552903200,5,15,20,Clouds
21940,40,1552903200,0,21,21,Clouds
21941,41,1552903200,2,18,20,Clouds
21942,42,1552903200,19,10,29,Clouds
21943,43,1552903200,17,13,30,Clouds
21944,44,1552903200,30,0,30,Clouds
21945,45,1552903200,12,18,30,Clouds
21946,46,1552903200,2,17,19,Clouds
21947,47,1552903200,39,1,40,Clouds
21948,48,1552903200,31,9,40,Clouds
21949,49,1552903200,36,4,40,Clouds
21950,50,1552903200,40,0,40,Clouds
21951,51,1552903200,2,38,40,Clouds
21952,52,1552903200,0,32,32,Clouds
21953,53,1552903200,39,1,40,Clouds
21954,54,1552903200,22,11,33,Clouds
21955,55,1552903200,15,21,36,Clouds
21956,56,1552903200,0,39,39,Clouds
21957,57,1552903200,16,7,23,Clouds
21958,58,1552903200,4,36,40,Clouds
21959,59,1552903200,20,0,20,Clouds
21960,60,1552903200,29,1,30,Clouds
21961,61,1552903200,25,0,25,Clouds
21962,62,1552903200,31,9,40,Clouds
21963,63,1552903200,19,16,35,Clouds
21964,64,1552903200,28,12,40,Clouds
21965,65,1552903200,40,0,40,Clouds
21966,66,1552903200,17,23,40,Clouds
21967,67,1552903200,29,10,39,Clouds
21968,68,1552903200,29,10,39,Clouds
21969,69,1552903200,15,25,40,Clouds
21970,70,1552903200,0,28,28,Clouds
21971,71,1552903200,20,19,39,Clouds
21972,72,1552903200,24,7,31,Clouds
21973,73,1552903200,7,23,30,Clouds
21974,74,1552903200,23,7,30,Clouds
21975,75,1552903200,24,16,40,Clouds
21976,76,1552903200,27,11,38,Clouds
21977,77,1552903200,3,26,29,Clouds
21978,78,1552903200,30,10,40,Clouds
21979,79,1552903200,19,8,27,Clouds
21980,80,1552903200,40,0,40,Clouds
21981,81,1552903200,34,6,40,Clouds
21982,82,1552903200,13,8,21,Clouds
21983,83,1552903200,36,4,40,Clouds
21984,84,1552903200,30,0,30,Clouds
21985,85,1552903200,35,0,35,Clouds
21986,86,1552903200,32,6,38,Clouds
21987,87,1552903200,18,20,38,Clouds
21988,88,1552903200,17,13,30,Clouds
21989,89,1552903200,31,8,39,Clouds
21990,90,1552903200,14,25,39,Clouds
21991,91,1552903200,15,15,30,Clouds
21992,92,1552903200,34,6,40,Clouds
21993,93,1552903200,5,35,40,Clouds
21994,94,1552903200,17,23,40,Clouds
21995,95,1552903200,29,11,40,Clouds
21996,96,1552903200,29,1,30,Clouds
21997,97,1552903200,40,0,40,Clouds
21998,98,1552903200,6,34,40,Clouds
21999,99,1552903200,2,28,30,Clouds
22000,100,1552903200,16,9,25,Clouds
22001,101,1552903200,16,14,30,Clouds
22002,102,1552903200,38,2,40,Clouds
22003,103,1552903200,39,1,40,Clouds
22004,104,1552903200,40,0,40,Clouds
22005,105,1552903200,36,0,36,Clouds
22006,106,1552903200,40,0,40,Clouds
22007,107,1552903200,39,1,40,Clouds
22008,108,1552903200,37,3,40,Clouds
22009,109,1552903200,29,0,29,Clouds
22010,110,1552903200,40,0,40,Clouds
22011,111,1552903200,40,0,40,Clouds
22012,112,1552903200,25,5,30,Clouds
22013,113,1552903200,0,0,0,Clouds
22014,114,1552903200,0,39,39,Clouds
22015,2,1552906800,20,0,20,Clouds
22016,3,1552906800,20,0,20,Clouds
22017,4,1552906800,14,5,19,Clouds
22018,5,1552906800,36,4,40,Clouds
22019,6,1552906800,20,0,20,Clouds
22020,7,1552906800,20,9,29,Clouds
22021,8,1552906800,11,19,30,Clouds
22022,9,1552906800,2,22,24,Clouds
22023,10,1552906800,12,3,15,Clouds
22024,11,1552906800,26,4,30,Clouds
22025,12,1552906800,20,0,20,Clouds
22026,13,1552906800,19,11,30,Clouds
22027,14,1552906800,2,28,30,Clouds
22028,15,1552906800,16,0,16,Clouds
22029,16,1552906800,11,9,20,Clouds
22030,17,1552906800,7,13,20,Clouds
22031,18,1552906800,4,26,30,Clouds
22032,19,1552906800,0,30,30,Clouds
22033,21,1552906800,24,6,30,Clouds
22034,22,1552906800,11,9,20,Clouds
22035,23,1552906800,0,0,0,Clouds
22036,24,1552906800,20,0,20,Clouds
22037,25,1552906800,0,0,0,Clouds
22038,26,1552906800,1,19,20,Clouds
22039,27,1552906800,9,10,19,Clouds
22040,28,1552906800,30,0,30,Clouds
22041,29,1552906800,7,22,29,Clouds
22042,30,1552906800,10,9,19,Clouds
22043,31,1552906800,6,14,20,Clouds
22044,32,1552906800,15,15,30,Clouds
22045,33,1552906800,4,19,23,Clouds
22046,34,1552906800,30,0,30,Clouds
22047,35,1552906800,29,1,30,Clouds
22048,36,1552906800,11,29,40,Clouds
22049,37,1552906800,14,16,30,Clouds
22050,38,1552906800,11,29,40,Clouds
22051,39,1552906800,0,20,20,Clouds
22052,40,1552906800,0,21,21,Clouds
22053,41,1552906800,3,17,20,Clouds
22054,42,1552906800,18,11,29,Clouds
22055,43,1552906800,23,7,30,Clouds
22056,44,1552906800,30,0,30,Clouds
22057,45,1552906800,13,17,30,Clouds
22058,46,1552906800,7,13,20,Clouds
22059,47,1552906800,37,3,40,Clouds
22060,48,1552906800,37,3,40,Clouds
22061,49,1552906800,40,0,40,Clouds
22062,50,1552906800,40,0,40,Clouds
22063,51,1552906800,0,40,40,Clouds
22064,52,1552906800,0,32,32,Clouds
22065,53,1552906800,39,1,40,Clouds
22066,54,1552906800,20,13,33,Clouds
22067,55,1552906800,16,20,36,Clouds
22068,56,1552906800,1,39,40,Clouds
22069,57,1552906800,15,8,23,Clouds
22070,58,1552906800,0,40,40,Clouds
22071,59,1552906800,20,0,20,Clouds
22072,60,1552906800,30,0,30,Clouds
22073,61,1552906800,24,1,25,Clouds
22074,62,1552906800,30,10,40,Clouds
22075,63,1552906800,19,16,35,Clouds
22076,64,1552906800,27,13,40,Clouds
22077,65,1552906800,40,0,40,Clouds
22078,66,1552906800,14,26,40,Clouds
22079,67,1552906800,32,8,40,Clouds
22080,68,1552906800,21,19,40,Clouds
22081,69,1552906800,0,40,40,Clouds
22082,70,1552906800,0,28,28,Clouds
22083,71,1552906800,23,16,39,Clouds
22084,72,1552906800,27,4,31,Clouds
22085,73,1552906800,8,22,30,Clouds
22086,74,1552906800,25,5,30,Clouds
22087,75,1552906800,24,16,40,Clouds
22088,76,1552906800,27,11,38,Clouds
22089,77,1552906800,3,26,29,Clouds
22090,78,1552906800,33,7,40,Clouds
22091,79,1552906800,19,8,27,Clouds
22092,80,1552906800,40,0,40,Clouds
22093,81,1552906800,36,4,40,Clouds
22094,82,1552906800,14,7,21,Clouds
22095,83,1552906800,40,0,40,Clouds
22096,84,1552906800,30,0,30,Clouds
22097,85,1552906800,34,1,35,Clouds
22098,86,1552906800,30,8,38,Clouds
22099,87,1552906800,20,18,38,Clouds
22100,88,1552906800,18,12,30,Clouds
22101,89,1552906800,29,10,39,Clouds
22102,90,1552906800,9,31,40,Clouds
22103,91,1552906800,17,13,30,Clouds
22104,92,1552906800,36,4,40,Clouds
22105,93,1552906800,6,34,40,Clouds
22106,94,1552906800,17,23,40,Clouds
22107,95,1552906800,32,8,40,Clouds
22108,96,1552906800,30,0,30,Clouds
22109,97,1552906800,40,0,40,Clouds
22110,98,1552906800,5,35,40,Clouds
22111,99,1552906800,0,30,30,Clouds
22112,100,1552906800,15,10,25,Clouds
22113,101,1552906800,18,12,30,Clouds
22114,102,1552906800,38,2,40,Clouds
22115,103,1552906800,40,0,40,Clouds
22116,104,1552906800,40,0,40,Clouds
22117,105,1552906800,36,0,36,Clouds
22118,106,1552906800,40,0,40,Clouds
22119,107,1552906800,40,0,40,Clouds
22120,108,1552906800,37,3,40,Clouds
22121,109,1552906800,29,0,29,Clouds
22122,110,1552906800,40,0,40,Clouds
22123,111,1552906800,40,0,40,Clouds
22124,112,1552906800,27,3,30,Clouds
22125,113,1552906800,0,0,0,Clouds
22126,114,1552906800,0,39,39,Clouds
22127,2,1552910400,19,1,20,Drizzle
22128,3,1552910400,20,0,20,Drizzle
22129,4,1552910400,14,5,19,Drizzle
22130,5,1552910400,39,1,40,Drizzle
22131,6,1552910400,20,0,20,Drizzle
22132,7,1552910400,20,8,28,Drizzle
22133,8,1552910400,9,20,29,Drizzle
22134,9,1552910400,0,24,24,Drizzle
22135,10,1552910400,16,0,16,Drizzle
22136,11,1552910400,26,4,30,Drizzle
22137,12,1552910400,19,1,20,Drizzle
22138,13,1552910400,20,10,30,Drizzle
22139,14,1552910400,1,29,30,Drizzle
22140,15,1552910400,16,0,16,Drizzle
22141,16,1552910400,11,9,20,Drizzle
22142,17,1552910400,5,15,20,Drizzle
22143,18,1552910400,5,24,29,Drizzle
22144,19,1552910400,0,30,30,Drizzle
22145,21,1552910400,21,9,30,Drizzle
22146,22,1552910400,9,11,20,Drizzle
22147,23,1552910400,0,0,0,Drizzle
22148,24,1552910400,20,0,20,Drizzle
22149,25,1552910400,0,0,0,Drizzle
22150,26,1552910400,0,19,19,Drizzle
22151,27,1552910400,5,14,19,Drizzle
22152,28,1552910400,28,2,30,Drizzle
22153,29,1552910400,5,24,29,Drizzle
22154,30,1552910400,11,8,19,Drizzle
22155,31,1552910400,9,11,20,Drizzle
22156,32,1552910400,16,14,30,Drizzle
22157,33,1552910400,3,20,23,Drizzle
22158,34,1552910400,28,2,30,Drizzle
22159,35,1552910400,30,0,30,Drizzle
22160,36,1552910400,11,29,40,Drizzle
22161,37,1552910400,10,20,30,Drizzle
22162,38,1552910400,14,26,40,Drizzle
22163,39,1552910400,0,20,20,Drizzle
22164,40,1552910400,1,20,21,Drizzle
22165,41,1552910400,2,18,20,Drizzle
22166,42,1552910400,20,10,30,Drizzle
22167,43,1552910400,28,2,30,Drizzle
22168,44,1552910400,30,0,30,Drizzle
22169,45,1552910400,13,17,30,Drizzle
22170,46,1552910400,8,12,20,Drizzle
22171,47,1552910400,32,8,40,Drizzle
22172,48,1552910400,38,2,40,Drizzle
22173,49,1552910400,40,0,40,Drizzle
22174,50,1552910400,40,0,40,Drizzle
22175,51,1552910400,1,39,40,Drizzle
22176,52,1552910400,0,32,32,Drizzle
22177,53,1552910400,39,1,40,Drizzle
22178,54,1552910400,18,15,33,Drizzle
22179,55,1552910400,16,20,36,Drizzle
22180,56,1552910400,1,39,40,Drizzle
22181,57,1552910400,10,13,23,Drizzle
22182,58,1552910400,3,36,39,Drizzle
22183,59,1552910400,20,0,20,Drizzle
22184,60,1552910400,30,0,30,Drizzle
22185,61,1552910400,25,0,25,Drizzle
22186,62,1552910400,31,9,40,Drizzle
22187,63,1552910400,19,16,35,Drizzle
22188,64,1552910400,27,13,40,Drizzle
22189,65,1552910400,39,1,40,Drizzle
22190,66,1552910400,17,23,40,Drizzle
22191,67,1552910400,35,5,40,Drizzle
22192,68,1552910400,15,25,40,Drizzle
22193,69,1552910400,1,38,39,Drizzle
22194,70,1552910400,0,28,28,Drizzle
22195,71,1552910400,25,14,39,Drizzle
22196,72,1552910400,25,6,31,Drizzle
22197,73,1552910400,9,21,30,Drizzle
22198,74,1552910400,26,4,30,Drizzle
22199,75,1552910400,26,14,40,Drizzle
22200,76,1552910400,27,11,38,Drizzle
22201,77,1552910400,0,29,29,Drizzle
22202,78,1552910400,39,1,40,Drizzle
22203,79,1552910400,20,7,27,Drizzle
22204,80,1552910400,40,0,40,Drizzle
22205,81,1552910400,36,4,40,Drizzle
22206,82,1552910400,17,5,22,Drizzle
22207,83,1552910400,40,0,40,Drizzle
22208,84,1552910400,29,1,30,Drizzle
22209,85,1552910400,35,0,35,Drizzle
22210,86,1552910400,27,11,38,Drizzle
22211,87,1552910400,20,18,38,Drizzle
22212,88,1552910400,21,9,30,Drizzle
22213,89,1552910400,29,11,40,Drizzle
22214,90,1552910400,8,32,40,Drizzle
22215,91,1552910400,14,16,30,Drizzle
22216,92,1552910400,35,5,40,Drizzle
22217,93,1552910400,6,34,40,Drizzle
22218,94,1552910400,17,23,40,Drizzle
22219,95,1552910400,34,6,40,Drizzle
22220,96,1552910400,30,0,30,Drizzle
22221,97,1552910400,40,0,40,Drizzle
22222,98,1552910400,5,35,40,Drizzle
22223,99,1552910400,1,28,29,Drizzle
22224,100,1552910400,15,10,25,Drizzle
22225,101,1552910400,21,9,30,Drizzle
22226,102,1552910400,38,2,40,Drizzle
22227,103,1552910400,40,0,40,Drizzle
22228,104,1552910400,40,0,40,Drizzle
22229,105,1552910400,35,1,36,Drizzle
22230,106,1552910400,40,0,40,Drizzle
22231,107,1552910400,40,0,40,Drizzle
22232,108,1552910400,36,4,40,Drizzle
22233,109,1552910400,29,0,29,Drizzle
22234,110,1552910400,40,0,40,Drizzle
22235,111,1552910400,40,0,40,Drizzle
22236,112,1552910400,29,1,30,Drizzle
22237,113,1552910400,0,0,0,Drizzle
22238,114,1552910400,0,40,40,Drizzle
22239,2,1552914000,19,1,20,Clouds
22240,3,1552914000,18,2,20,Clouds
22241,4,1552914000,14,5,19,Clouds
22242,5,1552914000,39,1,40,Clouds
22243,6,1552914000,19,1,20,Clouds
22244,7,1552914000,20,8,28,Clouds
22245,8,1552914000,5,23,28,Clouds
22246,9,1552914000,0,24,24,Clouds
22247,10,1552914000,10,6,16,Clouds
22248,11,1552914000,26,4,30,Clouds
22249,12,1552914000,20,0,20,Clouds
22250,13,1552914000,20,10,30,Clouds
22251,14,1552914000,0,30,30,Clouds
22252,15,1552914000,16,0,16,Clouds
22253,16,1552914000,9,11,20,Clouds
22254,17,1552914000,4,16,20,Clouds
22255,18,1552914000,11,18,29,Clouds
22256,19,1552914000,1,29,30,Clouds
22257,21,1552914000,16,14,30,Clouds
22258,22,1552914000,13,6,19,Clouds
22259,23,1552914000,0,0,0,Clouds
22260,24,1552914000,19,1,20,Clouds
22261,25,1552914000,0,0,0,Clouds
22262,26,1552914000,0,19,19,Clouds
22263,27,1552914000,3,17,20,Clouds
22264,28,1552914000,30,0,30,Clouds
22265,29,1552914000,2,27,29,Clouds
22266,30,1552914000,14,5,19,Clouds
22267,31,1552914000,3,17,20,Clouds
22268,32,1552914000,11,19,30,Clouds
22269,33,1552914000,0,23,23,Clouds
22270,34,1552914000,30,0,30,Clouds
22271,35,1552914000,26,4,30,Clouds
22272,36,1552914000,10,30,40,Clouds
22273,37,1552914000,8,22,30,Clouds
22274,38,1552914000,20,20,40,Clouds
22275,39,1552914000,6,14,20,Clouds
22276,40,1552914000,2,19,21,Clouds
22277,41,1552914000,1,19,20,Clouds
22278,42,1552914000,28,2,30,Clouds
22279,43,1552914000,29,1,30,Clouds
22280,44,1552914000,30,0,30,Clouds
22281,45,1552914000,17,13,30,Clouds
22282,46,1552914000,2,18,20,Clouds
22283,47,1552914000,30,10,40,Clouds
22284,48,1552914000,38,2,40,Clouds
22285,49,1552914000,40,0,40,Clouds
22286,50,1552914000,39,1,40,Clouds
22287,51,1552914000,0,40,40,Clouds
22288,52,1552914000,0,32,32,Clouds
22289,53,1552914000,40,0,40,Clouds
22290,54,1552914000,18,15,33,Clouds
22291,55,1552914000,17,19,36,Clouds
22292,56,1552914000,1,39,40,Clouds
22293,57,1552914000,8,15,23,Clouds
22294,58,1552914000,3,36,39,Clouds
22295,59,1552914000,20,0,20,Clouds
22296,60,1552914000,30,0,30,Clouds
22297,61,1552914000,25,0,25,Clouds
22298,62,1552914000,31,9,40,Clouds
22299,63,1552914000,14,21,35,Clouds
22300,64,1552914000,27,13,40,Clouds
22301,65,1552914000,39,1,40,Clouds
22302,66,1552914000,19,20,39,Clouds
22303,67,1552914000,34,6,40,Clouds
22304,68,1552914000,22,18,40,Clouds
22305,69,1552914000,4,35,39,Clouds
22306,70,1552914000,1,27,28,Clouds
22307,71,1552914000,25,14,39,Clouds
22308,72,1552914000,26,5,31,Clouds
22309,73,1552914000,13,17,30,Clouds
22310,74,1552914000,29,1,30,Clouds
22311,75,1552914000,24,16,40,Clouds
22312,76,1552914000,29,9,38,Clouds
22313,77,1552914000,0,29,29,Clouds
22314,78,1552914000,40,0,40,Clouds
22315,79,1552914000,23,4,27,Clouds
22316,80,1552914000,40,0,40,Clouds
22317,81,1552914000,40,0,40,Clouds
22318,82,1552914000,20,2,22,Clouds
22319,83,1552914000,40,0,40,Clouds
22320,84,1552914000,30,0,30,Clouds
22321,85,1552914000,34,1,35,Clouds
22322,86,1552914000,27,11,38,Clouds
22323,87,1552914000,24,14,38,Clouds
22324,88,1552914000,24,6,30,Clouds
22325,89,1552914000,27,13,40,Clouds
22326,90,1552914000,12,28,40,Clouds
22327,91,1552914000,16,14,30,Clouds
22328,92,1552914000,35,5,40,Clouds
22329,93,1552914000,6,34,40,Clouds
22330,94,1552914000,17,23,40,Clouds
22331,95,1552914000,35,5,40,Clouds
22332,96,1552914000,30,0,30,Clouds
22333,97,1552914000,38,2,40,Clouds
22334,98,1552914000,7,33,40,Clouds
22335,99,1552914000,0,29,29,Clouds
22336,100,1552914000,18,7,25,Clouds
22337,101,1552914000,24,6,30,Clouds
22338,102,1552914000,39,1,40,Clouds
22339,103,1552914000,40,0,40,Clouds
22340,104,1552914000,40,0,40,Clouds
22341,105,1552914000,36,0,36,Clouds
22342,106,1552914000,40,0,40,Clouds
22343,107,1552914000,40,0,40,Clouds
22344,108,1552914000,40,0,40,Clouds
22345,109,1552914000,29,0,29,Clouds
22346,110,1552914000,39,1,40,Clouds
22347,111,1552914000,40,0,40,Clouds
22348,112,1552914000,26,4,30,Clouds
22349,113,1552914000,0,0,0,Clouds
22350,114,1552914000,1,39,40,Clouds
22351,2,1552917600,20,0,20,Clouds
22352,3,1552917600,20,0,20,Clouds
22353,4,1552917600,15,4,19,Clouds
22354,5,1552917600,40,0,40,Clouds
22355,6,1552917600,15,5,20,Clouds
22356,7,1552917600,24,4,28,Clouds
22357,8,1552917600,5,23,28,Clouds
22358,9,1552917600,0,24,24,Clouds
22359,10,1552917600,3,13,16,Clouds
22360,11,1552917600,27,3,30,Clouds
22361,12,1552917600,19,1,20,Clouds
22362,13,1552917600,19,11,30,Clouds
22363,14,1552917600,1,29,30,Clouds
22364,15,1552917600,16,0,16,Clouds
22365,16,1552917600,7,13,20,Clouds
22366,17,1552917600,5,15,20,Clouds
22367,18,1552917600,15,14,29,Clouds
22368,19,1552917600,7,23,30,Clouds
22369,21,1552917600,11,19,30,Clouds
22370,22,1552917600,9,10,19,Clouds
22371,23,1552917600,0,0,0,Clouds
22372,24,1552917600,16,4,20,Clouds
22373,25,1552917600,0,0,0,Clouds
22374,26,1552917600,0,19,19,Clouds
22375,27,1552917600,4,16,20,Clouds
22376,28,1552917600,30,0,30,Clouds
22377,29,1552917600,0,29,29,Clouds
22378,30,1552917600,17,2,19,Clouds
22379,31,1552917600,6,14,20,Clouds
22380,32,1552917600,4,26,30,Clouds
22381,33,1552917600,0,23,23,Clouds
22382,34,1552917600,30,0,30,Clouds
22383,35,1552917600,27,3,30,Clouds
22384,36,1552917600,9,31,40,Clouds
22385,37,1552917600,9,21,30,Clouds
22386,38,1552917600,19,21,40,Clouds
22387,39,1552917600,8,12,20,Clouds
22388,40,1552917600,1,20,21,Clouds
22389,41,1552917600,4,16,20,Clouds
22390,42,1552917600,26,4,30,Clouds
22391,43,1552917600,28,2,30,Clouds
22392,44,1552917600,28,2,30,Clouds
22393,45,1552917600,18,12,30,Clouds
22394,46,1552917600,1,19,20,Clouds
22395,47,1552917600,30,10,40,Clouds
22396,48,1552917600,36,4,40,Clouds
22397,49,1552917600,38,2,40,Clouds
22398,50,1552917600,40,0,40,Clouds
22399,51,1552917600,0,40,40,Clouds
22400,52,1552917600,0,32,32,Clouds
22401,53,1552917600,40,0,40,Clouds
22402,54,1552917600,21,12,33,Clouds
22403,55,1552917600,19,17,36,Clouds
22404,56,1552917600,7,33,40,Clouds
22405,57,1552917600,8,15,23,Clouds
22406,58,1552917600,1,39,40,Clouds
22407,59,1552917600,19,1,20,Clouds
22408,60,1552917600,30,0,30,Clouds
22409,61,1552917600,25,0,25,Clouds
22410,62,1552917600,33,7,40,Clouds
22411,63,1552917600,13,22,35,Clouds
22412,64,1552917600,26,14,40,Clouds
22413,65,1552917600,39,1,40,Clouds
22414,66,1552917600,19,20,39,Clouds
22415,67,1552917600,35,5,40,Clouds
22416,68,1552917600,18,22,40,Clouds
22417,69,1552917600,0,39,39,Clouds
22418,70,1552917600,3,25,28,Clouds
22419,71,1552917600,27,12,39,Clouds
22420,72,1552917600,27,4,31,Clouds
22421,73,1552917600,16,14,30,Clouds
22422,74,1552917600,27,3,30,Clouds
22423,75,1552917600,21,19,40,Clouds
22424,76,1552917600,30,8,38,Clouds
22425,77,1552917600,4,25,29,Clouds
22426,78,1552917600,38,2,40,Clouds
22427,79,1552917600,25,2,27,Clouds
22428,80,1552917600,40,0,40,Clouds
22429,81,1552917600,40,0,40,Clouds
22430,82,1552917600,20,2,22,Clouds
22431,83,1552917600,38,2,40,Clouds
22432,84,1552917600,29,1,30,Clouds
22433,85,1552917600,35,0,35,Clouds
22434,86,1552917600,30,8,38,Clouds
22435,87,1552917600,27,11,38,Clouds
22436,88,1552917600,26,4,30,Clouds
22437,89,1552917600,28,12,40,Clouds
22438,90,1552917600,10,30,40,Clouds
22439,91,1552917600,21,9,30,Clouds
22440,92,1552917600,36,4,40,Clouds
22441,93,1552917600,6,34,40,Clouds
22442,94,1552917600,17,23,40,Clouds
22443,95,1552917600,38,2,40,Clouds
22444,96,1552917600,30,0,30,Clouds
22445,97,1552917600,40,0,40,Clouds
22446,98,1552917600,6,34,40,Clouds
22447,99,1552917600,3,26,29,Clouds
22448,100,1552917600,16,9,25,Clouds
22449,101,1552917600,24,6,30,Clouds
22450,102,1552917600,40,0,40,Clouds
22451,103,1552917600,40,0,40,Clouds
22452,104,1552917600,40,0,40,Clouds
22453,105,1552917600,36,0,36,Clouds
22454,106,1552917600,40,0,40,Clouds
22455,107,1552917600,40,0,40,Clouds
22456,108,1552917600,40,0,40,Clouds
22457,109,1552917600,27,2,29,Clouds
22458,110,1552917600,39,1,40,Clouds
22459,111,1552917600,40,0,40,Clouds
22460,112,1552917600,29,1,30,Clouds
22461,113,1552917600,0,0,0,Clouds
22462,114,1552917600,2,38,40,Clouds
22463,2,1552921200,20,0,20,Clouds
22464,3,1552921200,20,0,20,Clouds
22465,4,1552921200,18,1,19,Clouds
22466,5,1552921200,40,0,40,Clouds
22467,6,1552921200,15,5,20,Clouds
22468,7,1552921200,25,3,28,Clouds
22469,8,1552921200,5,23,28,Clouds
22470,9,1552921200,1,23,24,Clouds
22471,10,1552921200,1,15,16,Clouds
22472,11,1552921200,28,2,30,Clouds
22473,12,1552921200,20,0,20,Clouds
22474,13,1552921200,16,14,30,Clouds
22475,14,1552921200,1,29,30,Clouds
22476,15,1552921200,15,1,16,Clouds
22477,16,1552921200,0,20,20,Clouds
22478,17,1552921200,3,17,20,Clouds
22479,18,1552921200,21,8,29,Clouds
22480,19,1552921200,12,18,30,Clouds
22481,21,1552921200,6,24,30,Clouds
22482,22,1552921200,5,14,19,Clouds
22483,23,1552921200,0,0,0,Clouds
22484,24,1552921200,14,6,20,Clouds
22485,25,1552921200,0,0,0,Clouds
22486,26,1552921200,0,19,19,Clouds
22487,27,1552921200,1,19,20,Clouds
22488,28,1552921200,30,0,30,Clouds
22489,29,1552921200,1,28,29,Clouds
22490,30,1552921200,19,0,19,Clouds
22491,31,1552921200,0,20,20,Clouds
22492,32,1552921200,4,26,30,Clouds
22493,33,1552921200,0,23,23,Clouds
22494,34,1552921200,30,0,30,Clouds
22495,35,1552921200,27,3,30,Clouds
22496,36,1552921200,10,30,40,Clouds
22497,37,1552921200,7,23,30,Clouds
22498,38,1552921200,15,25,40,Clouds
22499,39,1552921200,6,14,20,Clouds
22500,40,1552921200,2,19,21,Clouds
22501,41,1552921200,8,12,20,Clouds
22502,42,1552921200,26,4,30,Clouds
22503,43,1552921200,27,3,30,Clouds
22504,44,1552921200,27,3,30,Clouds
22505,45,1552921200,19,11,30,Clouds
22506,46,1552921200,0,20,20,Clouds
22507,47,1552921200,28,12,40,Clouds
22508,48,1552921200,35,5,40,Clouds
22509,49,1552921200,37,3,40,Clouds
22510,50,1552921200,37,3,40,Clouds
22511,51,1552921200,1,39,40,Clouds
22512,52,1552921200,1,31,32,Clouds
22513,53,1552921200,40,0,40,Clouds
22514,54,1552921200,20,13,33,Clouds
22515,55,1552921200,19,17,36,Clouds
22516,56,1552921200,8,32,40,Clouds
22517,57,1552921200,8,15,23,Clouds
22518,58,1552921200,1,39,40,Clouds
22519,59,1552921200,20,0,20,Clouds
22520,60,1552921200,28,2,30,Clouds
22521,61,1552921200,24,1,25,Clouds
22522,62,1552921200,34,6,40,Clouds
22523,63,1552921200,15,20,35,Clouds
22524,64,1552921200,25,15,40,Clouds
22525,65,1552921200,38,2,40,Clouds
22526,66,1552921200,19,20,39,Clouds
22527,67,1552921200,37,3,40,Clouds
22528,68,1552921200,18,21,39,Clouds
22529,69,1552921200,2,37,39,Clouds
22530,70,1552921200,9,19,28,Clouds
22531,71,1552921200,28,11,39,Clouds
22532,72,1552921200,27,4,31,Clouds
22533,73,1552921200,19,11,30,Clouds
22534,74,1552921200,26,4,30,Clouds
22535,75,1552921200,24,16,40,Clouds
22536,76,1552921200,31,7,38,Clouds
22537,77,1552921200,0,29,29,Clouds
22538,78,1552921200,40,0,40,Clouds
22539,79,1552921200,26,1,27,Clouds
22540,80,1552921200,40,0,40,Clouds
22541,81,1552921200,40,0,40,Clouds
22542,82,1552921200,20,2,22,Clouds
22543,83,1552921200,40,0,40,Clouds
22544,84,1552921200,28,2,30,Clouds
22545,85,1552921200,34,1,35,Clouds
22546,86,1552921200,36,2,38,Clouds
22547,87,1552921200,29,9,38,Clouds
22548,88,1552921200,28,2,30,Clouds
22549,89,1552921200,28,12,40,Clouds
22550,90,1552921200,10,30,40,Clouds
22551,91,1552921200,24,6,30,Clouds
22552,92,1552921200,36,4,40,Clouds
22553,93,1552921200,7,33,40,Clouds
22554,94,1552921200,17,23,40,Clouds
22555,95,1552921200,38,2,40,Clouds
22556,96,1552921200,30,0,30,Clouds
22557,97,1552921200,40,0,40,Clouds
22558,98,1552921200,8,32,40,Clouds
22559,99,1552921200,2,27,29,Clouds
22560,100,1552921200,20,5,25,Clouds
22561,101,1552921200,24,6,30,Clouds
22562,102,1552921200,39,1,40,Clouds
22563,103,1552921200,40,0,40,Clouds
22564,104,1552921200,40,0,40,Clouds
22565,105,1552921200,36,0,36,Clouds
22566,106,1552921200,40,0,40,Clouds
22567,107,1552921200,40,0,40,Clouds
22568,108,1552921200,39,1,40,Clouds
22569,109,1552921200,25,4,29,Clouds
22570,110,1552921200,40,0,40,Clouds
22571,111,1552921200,40,0,40,Clouds
22572,112,1552921200,29,1,30,Clouds
22573,113,1552921200,0,0,0,Clouds
22574,114,1552921200,3,37,40,Clouds
22575,2,1552924800,18,2,20,Drizzle
22576,3,1552924800,17,3,20,Drizzle
22577,4,1552924800,19,0,19,Drizzle
22578,5,1552924800,39,1,40,Drizzle
22579,6,1552924800,13,7,20,Drizzle
22580,7,1552924800,26,2,28,Drizzle
22581,8,1552924800,1,27,28,Drizzle
22582,9,1552924800,1,23,24,Drizzle
22583,10,1552924800,0,16,16,Drizzle
22584,11,1552924800,29,1,30,Drizzle
22585,12,1552924800,18,2,20,Drizzle
22586,13,1552924800,16,14,30,Drizzle
22587,14,1552924800,0,30,30,Drizzle
22588,15,1552924800,16,0,16,Drizzle
22589,16,1552924800,1,19,20,Drizzle
22590,17,1552924800,2,18,20,Drizzle
22591,18,1552924800,26,3,29,Drizzle
22592,19,1552924800,13,17,30,Drizzle
22593,21,1552924800,1,29,30,Drizzle
22594,22,1552924800,6,13,19,Drizzle
22595,23,1552924800,0,0,0,Drizzle
22596,24,1552924800,19,1,20,Drizzle
22597,25,1552924800,0,0,0,Drizzle
22598,26,1552924800,1,18,19,Drizzle
22599,27,1552924800,0,20,20,Drizzle
22600,28,1552924800,29,1,30,Drizzle
22601,29,1552924800,1,28,29,Drizzle
22602,30,1552924800,19,0,19,Drizzle
22603,31,1552924800,7,13,20,Drizzle
22604,32,1552924800,4,26,30,Drizzle
22605,33,1552924800,1,22,23,Drizzle
22606,34,1552924800,29,1,30,Drizzle
22607,35,1552924800,23,7,30,Drizzle
22608,36,1552924800,9,31,40,Drizzle
22609,37,1552924800,8,22,30,Drizzle
22610,38,1552924800,21,19,40,Drizzle
22611,39,1552924800,5,15,20,Drizzle
22612,40,1552924800,5,16,21,Drizzle
22613,41,1552924800,7,13,20,Drizzle
22614,42,1552924800,19,11,30,Drizzle
22615,43,1552924800,30,0,30,Drizzle
22616,44,1552924800,28,2,30,Drizzle
22617,45,1552924800,20,10,30,Drizzle
22618,46,1552924800,0,20,20,Drizzle
22619,47,1552924800,28,12,40,Drizzle
22620,48,1552924800,33,7,40,Drizzle
22621,49,1552924800,40,0,40,Drizzle
22622,50,1552924800,36,4,40,Drizzle
22623,51,1552924800,2,38,40,Drizzle
22624,52,1552924800,3,29,32,Drizzle
22625,53,1552924800,40,0,40,Drizzle
22626,54,1552924800,20,13,33,Drizzle
22627,55,1552924800,19,17,36,Drizzle
22628,56,1552924800,9,31,40,Drizzle
22629,57,1552924800,9,14,23,Drizzle
22630,58,1552924800,4,36,40,Drizzle
22631,59,1552924800,20,0,20,Drizzle
22632,60,1552924800,27,3,30,Drizzle
22633,61,1552924800,25,0,25,Drizzle
22634,62,1552924800,34,6,40,Drizzle
22635,63,1552924800,15,20,35,Drizzle
22636,64,1552924800,25,15,40,Drizzle
22637,65,1552924800,36,4,40,Drizzle
22638,66,1552924800,20,19,39,Drizzle
22639,67,1552924800,34,6,40,Drizzle
22640,68,1552924800,16,23,39,Drizzle
22641,69,1552924800,0,39,39,Drizzle
22642,70,1552924800,7,21,28,Drizzle
22643,71,1552924800,29,10,39,Drizzle
22644,72,1552924800,29,2,31,Drizzle
22645,73,1552924800,15,15,30,Drizzle
22646,74,1552924800,29,1,30,Drizzle
22647,75,1552924800,29,11,40,Drizzle
22648,76,1552924800,33,5,38,Drizzle
22649,77,1552924800,0,29,29,Drizzle
22650,78,1552924800,40,0,40,Drizzle
22651,79,1552924800,26,1,27,Drizzle
22652,80,1552924800,40,0,40,Drizzle
22653,81,1552924800,40,0,40,Drizzle
22654,82,1552924800,18,4,22,Drizzle
22655,83,1552924800,35,5,40,Drizzle
22656,84,1552924800,30,0,30,Drizzle
22657,85,1552924800,33,2,35,Drizzle
22658,86,1552924800,36,2,38,Drizzle
22659,87,1552924800,29,9,38,Drizzle
22660,88,1552924800,30,0,30,Drizzle
22661,89,1552924800,28,12,40,Drizzle
22662,90,1552924800,10,30,40,Drizzle
22663,91,1552924800,23,7,30,Drizzle
22664,92,1552924800,32,8,40,Drizzle
22665,93,1552924800,7,33,40,Drizzle
22666,94,1552924800,17,23,40,Drizzle
22667,95,1552924800,39,1,40,Drizzle
22668,96,1552924800,30,0,30,Drizzle
22669,97,1552924800,39,1,40,Drizzle
22670,98,1552924800,2,38,40,Drizzle
22671,99,1552924800,0,29,29,Drizzle
22672,100,1552924800,18,7,25,Drizzle
22673,101,1552924800,24,6,30,Drizzle
22674,102,1552924800,40,0,40,Drizzle
22675,103,1552924800,40,0,40,Drizzle
22676,104,1552924800,40,0,40,Drizzle
22677,105,1552924800,36,0,36,Drizzle
22678,106,1552924800,40,0,40,Drizzle
22679,107,1552924800,40,0,40,Drizzle
22680,108,1552924800,40,0,40,Drizzle
22681,109,1552924800,24,5,29,Drizzle
22682,110,1552924800,40,0,40,Drizzle
22683,111,1552924800,40,0,40,Drizzle
22684,112,1552924800,30,0,30,Drizzle
22685,113,1552924800,0,0,0,Drizzle
22686,114,1552924800,4,36,40,Drizzle
22687,2,1552928400,19,1,20,Clouds
22688,3,1552928400,20,0,20,Clouds
22689,4,1552928400,19,0,19,Clouds
22690,5,1552928400,36,4,40,Clouds
22691,6,1552928400,3,17,20,Clouds
22692,7,1552928400,28,0,28,Clouds
22693,8,1552928400,3,25,28,Clouds
22694,9,1552928400,1,23,24,Clouds
22695,10,1552928400,1,15,16,Clouds
22696,11,1552928400,29,1,30,Clouds
22697,12,1552928400,16,3,19,Clouds
22698,13,1552928400,17,13,30,Clouds
22699,14,1552928400,1,29,30,Clouds
22700,15,1552928400,16,0,16,Clouds
22701,16,1552928400,0,20,20,Clouds
22702,17,1552928400,0,20,20,Clouds
22703,18,1552928400,27,2,29,Clouds
22704,19,1552928400,11,19,30,Clouds
22705,21,1552928400,0,30,30,Clouds
22706,22,1552928400,7,12,19,Clouds
22707,23,1552928400,0,0,0,Clouds
22708,24,1552928400,17,3,20,Clouds
22709,25,1552928400,0,0,0,Clouds
22710,26,1552928400,0,19,19,Clouds
22711,27,1552928400,3,17,20,Clouds
22712,28,1552928400,29,1,30,Clouds
22713,29,1552928400,1,28,29,Clouds
22714,30,1552928400,19,0,19,Clouds
22715,31,1552928400,11,9,20,Clouds
22716,32,1552928400,2,28,30,Clouds
22717,33,1552928400,2,21,23,Clouds
22718,34,1552928400,29,1,30,Clouds
22719,35,1552928400,26,4,30,Clouds
22720,36,1552928400,6,34,40,Clouds
22721,37,1552928400,9,21,30,Clouds
22722,38,1552928400,22,18,40,Clouds
22723,39,1552928400,7,13,20,Clouds
22724,40,1552928400,2,19,21,Clouds
22725,41,1552928400,8,12,20,Clouds
22726,42,1552928400,18,12,30,Clouds
22727,43,1552928400,30,0,30,Clouds
22728,44,1552928400,30,0,30,Clouds
22729,45,1552928400,19,11,30,Clouds
22730,46,1552928400,0,20,20,Clouds
22731,47,1552928400,26,14,40,Clouds
22732,48,1552928400,36,4,40,Clouds
22733,49,1552928400,39,1,40,Clouds
22734,50,1552928400,39,1,40,Clouds
22735,51,1552928400,1,39,40,Clouds
22736,52,1552928400,6,26,32,Clouds
22737,53,1552928400,40,0,40,Clouds
22738,54,1552928400,21,12,33,Clouds
22739,55,1552928400,20,16,36,Clouds
22740,56,1552928400,12,28,40,Clouds
22741,57,1552928400,9,14,23,Clouds
22742,58,1552928400,10,30,40,Clouds
22743,59,1552928400,20,0,20,Clouds
22744,60,1552928400,30,0,30,Clouds
22745,61,1552928400,25,0,25,Clouds
22746,62,1552928400,34,6,40,Clouds
22747,63,1552928400,14,21,35,Clouds
22748,64,1552928400,25,15,40,Clouds
22749,65,1552928400,36,4,40,Clouds
22750,66,1552928400,19,20,39,Clouds
22751,67,1552928400,33,7,40,Clouds
22752,68,1552928400,10,29,39,Clouds
22753,69,1552928400,0,39,39,Clouds
22754,70,1552928400,8,20,28,Clouds
22755,71,1552928400,31,8,39,Clouds
22756,72,1552928400,26,5,31,Clouds
22757,73,1552928400,15,15,30,Clouds
22758,74,1552928400,27,3,30,Clouds
22759,75,1552928400,29,11,40,Clouds
22760,76,1552928400,32,6,38,Clouds
22761,77,1552928400,0,29,29,Clouds
22762,78,1552928400,39,1,40,Clouds
22763,79,1552928400,27,0,27,Clouds
22764,80,1552928400,39,1,40,Clouds
22765,81,1552928400,40,0,40,Clouds
22766,82,1552928400,19,3,22,Clouds
22767,83,1552928400,38,2,40,Clouds
22768,84,1552928400,30,0,30,Clouds
22769,85,1552928400,34,1,35,Clouds
22770,86,1552928400,34,4,38,Clouds
22771,87,1552928400,28,10,38,Clouds
22772,88,1552928400,27,3,30,Clouds
22773,89,1552928400,27,13,40,Clouds
22774,90,1552928400,15,25,40,Clouds
22775,91,1552928400,26,4,30,Clouds
22776,92,1552928400,34,6,40,Clouds
22777,93,1552928400,7,33,40,Clouds
22778,94,1552928400,17,23,40,Clouds
22779,95,1552928400,39,1,40,Clouds
22780,96,1552928400,30,0,30,Clouds
22781,97,1552928400,40,0,40,Clouds
22782,98,1552928400,3,37,40,Clouds
22783,99,1552928400,2,27,29,Clouds
22784,100,1552928400,19,6,25,Clouds
22785,101,1552928400,24,6,30,Clouds
22786,102,1552928400,39,1,40,Clouds
22787,103,1552928400,40,0,40,Clouds
22788,104,1552928400,39,1,40,Clouds
22789,105,1552928400,36,0,36,Clouds
22790,106,1552928400,39,1,40,Clouds
22791,107,1552928400,39,1,40,Clouds
22792,108,1552928400,40,0,40,Clouds
22793,109,1552928400,27,2,29,Clouds
22794,110,1552928400,40,0,40,Clouds
22795,111,1552928400,40,0,40,Clouds
22796,112,1552928400,28,2,30,Clouds
22797,113,1552928400,0,0,0,Clouds
22798,114,1552928400,6,34,40,Clouds
22799,2,1552932000,20,0,20,Clouds
22800,3,1552932000,16,4,20,Clouds
22801,4,1552932000,17,2,19,Clouds
22802,5,1552932000,29,11,40,Clouds
22803,6,1552932000,1,19,20,Clouds
22804,7,1552932000,28,0,28,Clouds
22805,8,1552932000,10,18,28,Clouds
22806,9,1552932000,3,21,24,Clouds
22807,10,1552932000,5,11,16,Clouds
22808,11,1552932000,29,1,30,Clouds
22809,12,1552932000,14,5,19,Clouds
22810,13,1552932000,17,13,30,Clouds
22811,14,1552932000,4,26,30,Clouds
22812,15,1552932000,16,0,16,Clouds
22813,16,1552932000,4,16,20,Clouds
22814,17,1552932000,1,19,20,Clouds
22815,18,1552932000,23,6,29,Clouds
22816,19,1552932000,10,20,30,Clouds
22817,21,1552932000,1,29,30,Clouds
22818,22,1552932000,6,13,19,Clouds
22819,23,1552932000,0,0,0,Clouds
22820,24,1552932000,18,2,20,Clouds
22821,25,1552932000,0,0,0,Clouds
22822,26,1552932000,0,19,19,Clouds
22823,27,1552932000,6,14,20,Clouds
22824,28,1552932000,29,1,30,Clouds
22825,29,1552932000,4,25,29,Clouds
22826,30,1552932000,19,0,19,Clouds
22827,31,1552932000,12,8,20,Clouds
22828,32,1552932000,0,30,30,Clouds
22829,33,1552932000,0,23,23,Clouds
22830,34,1552932000,18,12,30,Clouds
22831,35,1552932000,30,0,30,Clouds
22832,36,1552932000,5,35,40,Clouds
22833,37,1552932000,10,20,30,Clouds
22834,38,1552932000,23,17,40,Clouds
22835,39,1552932000,9,11,20,Clouds
22836,40,1552932000,0,21,21,Clouds
22837,41,1552932000,12,8,20,Clouds
22838,42,1552932000,14,16,30,Clouds
22839,43,1552932000,28,2,30,Clouds
22840,44,1552932000,29,1,30,Clouds
22841,45,1552932000,16,14,30,Clouds
22842,46,1552932000,4,16,20,Clouds
22843,47,1552932000,27,13,40,Clouds
22844,48,1552932000,31,9,40,Clouds
22845,49,1552932000,35,5,40,Clouds
22846,50,1552932000,40,0,40,Clouds
22847,51,1552932000,2,38,40,Clouds
22848,52,1552932000,9,23,32,Clouds
22849,53,1552932000,39,1,40,Clouds
22850,54,1552932000,24,9,33,Clouds
22851,55,1552932000,22,14,36,Clouds
22852,56,1552932000,9,31,40,Clouds
22853,57,1552932000,10,13,23,Clouds
22854,58,1552932000,14,26,40,Clouds
22855,59,1552932000,18,2,20,Clouds
22856,60,1552932000,30,0,30,Clouds
22857,61,1552932000,24,1,25,Clouds
22858,62,1552932000,33,7,40,Clouds
22859,63,1552932000,11,24,35,Clouds
22860,64,1552932000,23,17,40,Clouds
22861,65,1552932000,34,6,40,Clouds
22862,66,1552932000,16,23,39,Clouds
22863,67,1552932000,32,8,40,Clouds
22864,68,1552932000,9,30,39,Clouds
22865,69,1552932000,5,34,39,Clouds
22866,70,1552932000,16,12,28,Clouds
22867,71,1552932000,35,4,39,Clouds
22868,72,1552932000,23,8,31,Clouds
22869,73,1552932000,12,18,30,Clouds
22870,74,1552932000,28,2,30,Clouds
22871,75,1552932000,31,9,40,Clouds
22872,76,1552932000,33,5,38,Clouds
22873,77,1552932000,2,27,29,Clouds
22874,78,1552932000,40,0,40,Clouds
22875,79,1552932000,27,0,27,Clouds
22876,80,1552932000,37,3,40,Clouds
22877,81,1552932000,40,0,40,Clouds
22878,82,1552932000,17,5,22,Clouds
22879,83,1552932000,38,2,40,Clouds
22880,84,1552932000,29,1,30,Clouds
22881,85,1552932000,35,0,35,Clouds
22882,86,1552932000,34,4,38,Clouds
22883,87,1552932000,26,12,38,Clouds
22884,88,1552932000,20,10,30,Clouds
22885,89,1552932000,26,14,40,Clouds
22886,90,1552932000,22,18,40,Clouds
22887,91,1552932000,23,7,30,Clouds
22888,92,1552932000,35,5,40,Clouds
22889,93,1552932000,7,33,40,Clouds
22890,94,1552932000,17,23,40,Clouds
22891,95,1552932000,40,0,40,Clouds
22892,96,1552932000,30,0,30,Clouds
22893,97,1552932000,38,2,40,Clouds
22894,98,1552932000,9,31,40,Clouds
22895,99,1552932000,4,25,29,Clouds
22896,100,1552932000,21,4,25,Clouds
22897,101,1552932000,25,5,30,Clouds
22898,102,1552932000,38,2,40,Clouds
22899,103,1552932000,40,0,40,Clouds
22900,104,1552932000,39,1,40,Clouds
22901,105,1552932000,36,0,36,Clouds
22902,106,1552932000,39,1,40,Clouds
22903,107,1552932000,38,2,40,Clouds
22904,108,1552932000,38,2,40,Clouds
22905,109,1552932000,26,3,29,Clouds
22906,110,1552932000,39,1,40,Clouds
22907,111,1552932000,38,2,40,Clouds
22908,112,1552932000,26,4,30,Clouds
22909,113,1552932000,0,0,0,Clouds
22910,114,1552932000,14,26,40,Clouds
22911,2,1552935600,17,3,20,Clouds
22912,3,1552935600,19,1,20,Clouds
22913,4,1552935600,17,2,19,Clouds
22914,5,1552935600,28,12,40,Clouds
22915,6,1552935600,2,18,20,Clouds
22916,7,1552935600,27,1,28,Clouds
22917,8,1552935600,14,14,28,Clouds
22918,9,1552935600,1,23,24,Clouds
22919,10,1552935600,2,14,16,Clouds
22920,11,1552935600,28,2,30,Clouds
22921,12,1552935600,17,2,19,Clouds
22922,13,1552935600,17,13,30,Clouds
22923,14,1552935600,4,26,30,Clouds
22924,15,1552935600,16,0,16,Clouds
22925,16,1552935600,4,16,20,Clouds
22926,17,1552935600,5,15,20,Clouds
22927,18,1552935600,23,6,29,Clouds
22928,19,1552935600,19,11,30,Clouds
22929,21,1552935600,2,28,30,Clouds
22930,22,1552935600,10,9,19,Clouds
22931,23,1552935600,0,0,0,Clouds
22932,24,1552935600,20,0,20,Clouds
22933,25,1552935600,0,0,0,Clouds
22934,26,1552935600,1,18,19,Clouds
22935,27,1552935600,7,13,20,Clouds
22936,28,1552935600,30,0,30,Clouds
22937,29,1552935600,3,26,29,Clouds
22938,30,1552935600,17,2,19,Clouds
22939,31,1552935600,15,5,20,Clouds
22940,32,1552935600,2,28,30,Clouds
22941,33,1552935600,12,11,23,Clouds
22942,34,1552935600,10,20,30,Clouds
22943,35,1552935600,29,1,30,Clouds
22944,36,1552935600,6,34,40,Clouds
22945,37,1552935600,8,22,30,Clouds
22946,38,1552935600,23,17,40,Clouds
22947,39,1552935600,13,7,20,Clouds
22948,40,1552935600,2,19,21,Clouds
22949,41,1552935600,10,10,20,Clouds
22950,42,1552935600,15,15,30,Clouds
22951,43,1552935600,20,10,30,Clouds
22952,44,1552935600,30,0,30,Clouds
22953,45,1552935600,14,16,30,Clouds
22954,46,1552935600,2,18,20,Clouds
22955,47,1552935600,30,10,40,Clouds
22956,48,1552935600,35,5,40,Clouds
22957,49,1552935600,35,5,40,Clouds
22958,50,1552935600,35,5,40,Clouds
22959,51,1552935600,0,40,40,Clouds
22960,52,1552935600,8,24,32,Clouds
22961,53,1552935600,39,1,40,Clouds
22962,54,1552935600,24,9,33,Clouds
22963,55,1552935600,23,13,36,Clouds
22964,56,1552935600,7,33,40,Clouds
22965,57,1552935600,10,13,23,Clouds
22966,58,1552935600,14,26,40,Clouds
22967,59,1552935600,17,3,20,Clouds
22968,60,1552935600,29,1,30,Clouds
22969,61,1552935600,25,0,25,Clouds
22970,62,1552935600,35,5,40,Clouds
22971,63,1552935600,11,24,35,Clouds
22972,64,1552935600,23,17,40,Clouds
22973,65,1552935600,36,4,40,Clouds
22974,66,1552935600,15,24,39,Clouds
22975,67,1552935600,25,15,40,Clouds
22976,68,1552935600,3,36,39,Clouds
22977,69,1552935600,2,37,39,Clouds
22978,70,1552935600,23,5,28,Clouds
22979,71,1552935600,28,11,39,Clouds
22980,72,1552935600,24,7,31,Clouds
22981,73,1552935600,9,21,30,Clouds
22982,74,1552935600,28,2,30,Clouds
22983,75,1552935600,30,10,40,Clouds
22984,76,1552935600,31,7,38,Clouds
22985,77,1552935600,2,27,29,Clouds
22986,78,1552935600,38,2,40,Clouds
22987,79,1552935600,27,0,27,Clouds
22988,80,1552935600,38,2,40,Clouds
22989,81,1552935600,40,0,40,Clouds
22990,82,1552935600,18,4,22,Clouds
22991,83,1552935600,36,4,40,Clouds
22992,84,1552935600,26,4,30,Clouds
22993,85,1552935600,32,3,35,Clouds
22994,86,1552935600,37,1,38,Clouds
22995,87,1552935600,25,13,38,Clouds
22996,88,1552935600,22,8,30,Clouds
22997,89,1552935600,26,14,40,Clouds
22998,90,1552935600,22,18,40,Clouds
22999,91,1552935600,16,14,30,Clouds
23000,92,1552935600,38,2,40,Clouds
23001,93,1552935600,8,32,40,Clouds
23002,94,1552935600,17,23,40,Clouds
23003,95,1552935600,39,1,40,Clouds
23004,96,1552935600,29,1,30,Clouds
23005,97,1552935600,38,2,40,Clouds
23006,98,1552935600,11,29,40,Clouds
23007,99,1552935600,2,27,29,Clouds
23008,100,1552935600,21,4,25,Clouds
23009,101,1552935600,24,6,30,Clouds
23010,102,1552935600,37,3,40,Clouds
23011,103,1552935600,40,0,40,Clouds
23012,104,1552935600,40,0,40,Clouds
23013,105,1552935600,36,0,36,Clouds
23014,106,1552935600,38,2,40,Clouds
23015,107,1552935600,35,5,40,Clouds
23016,108,1552935600,40,0,40,Clouds
23017,109,1552935600,19,10,29,Clouds
23018,110,1552935600,39,1,40,Clouds
23019,111,1552935600,39,1,40,Clouds
23020,112,1552935600,26,4,30,Clouds
23021,113,1552935600,0,0,0,Clouds
23022,114,1552935600,20,20,40,Clouds
23023,2,1552939200,16,4,20,Drizzle
23024,3,1552939200,19,1,20,Drizzle
23025,4,1552939200,17,2,19,Drizzle
23026,5,1552939200,31,9,40,Drizzle
23027,6,1552939200,1,19,20,Drizzle
23028,7,1552939200,27,1,28,Drizzle
23029,8,1552939200,9,19,28,Drizzle
23030,9,1552939200,3,21,24,Drizzle
23031,10,1552939200,4,12,16,Drizzle
23032,11,1552939200,27,3,30,Drizzle
23033,12,1552939200,15,4,19,Drizzle
23034,13,1552939200,17,13,30,Drizzle
23035,14,1552939200,5,25,30,Drizzle
23036,15,1552939200,16,0,16,Drizzle
23037,16,1552939200,7,13,20,Drizzle
23038,17,1552939200,5,15,20,Drizzle
23039,18,1552939200,20,9,29,Drizzle
23040,19,1552939200,15,15,30,Drizzle
23041,21,1552939200,5,25,30,Drizzle
23042,22,1552939200,12,7,19,Drizzle
23043,23,1552939200,0,0,0,Drizzle
23044,24,1552939200,20,0,20,Drizzle
23045,25,1552939200,0,0,0,Drizzle
23046,26,1552939200,4,15,19,Drizzle
23047,27,1552939200,7,13,20,Drizzle
23048,28,1552939200,27,3,30,Drizzle
23049,29,1552939200,2,27,29,Drizzle
23050,30,1552939200,18,1,19,Drizzle
23051,31,1552939200,17,3,20,Drizzle
23052,32,1552939200,4,26,30,Drizzle
23053,33,1552939200,19,4,23,Drizzle
23054,34,1552939200,8,22,30,Drizzle
23055,35,1552939200,27,3,30,Drizzle
23056,36,1552939200,6,34,40,Drizzle
23057,37,1552939200,7,23,30,Drizzle
23058,38,1552939200,21,19,40,Drizzle
23059,39,1552939200,15,5,20,Drizzle
23060,40,1552939200,8,13,21,Drizzle
23061,41,1552939200,9,11,20,Drizzle
23062,42,1552939200,12,18,30,Drizzle
23063,43,1552939200,15,15,30,Drizzle
23064,44,1552939200,26,4,30,Drizzle
23065,45,1552939200,14,16,30,Drizzle
23066,46,1552939200,3,17,20,Drizzle
23067,47,1552939200,31,9,40,Drizzle
23068,48,1552939200,34,6,40,Drizzle
23069,49,1552939200,30,10,40,Drizzle
23070,50,1552939200,25,15,40,Drizzle
23071,51,1552939200,4,36,40,Drizzle
23072,52,1552939200,10,22,32,Drizzle
23073,53,1552939200,40,0,40,Drizzle
23074,54,1552939200,25,8,33,Drizzle
23075,55,1552939200,24,12,36,Drizzle
23076,56,1552939200,7,33,40,Drizzle
23077,57,1552939200,10,13,23,Drizzle
23078,58,1552939200,20,20,40,Drizzle
23079,59,1552939200,18,2,20,Drizzle
23080,60,1552939200,26,4,30,Drizzle
23081,61,1552939200,25,0,25,Drizzle
23082,62,1552939200,37,3,40,Drizzle
23083,63,1552939200,10,25,35,Drizzle
23084,64,1552939200,21,19,40,Drizzle
23085,65,1552939200,35,5,40,Drizzle
23086,66,1552939200,10,29,39,Drizzle
23087,67,1552939200,21,19,40,Drizzle
23088,68,1552939200,3,36,39,Drizzle
23089,69,1552939200,1,38,39,Drizzle
23090,70,1552939200,25,3,28,Drizzle
23091,71,1552939200,25,14,39,Drizzle
23092,72,1552939200,22,9,31,Drizzle
23093,73,1552939200,7,23,30,Drizzle
23094,74,1552939200,28,2,30,Drizzle
23095,75,1552939200,30,10,40,Drizzle
23096,76,1552939200,36,2,38,Drizzle
23097,77,1552939200,6,23,29,Drizzle
23098,78,1552939200,40,0,40,Drizzle
23099,79,1552939200,26,1,27,Drizzle
23100,80,1552939200,38,2,40,Drizzle
23101,81,1552939200,40,0,40,Drizzle
23102,82,1552939200,18,4,22,Drizzle
23103,83,1552939200,31,9,40,Drizzle
23104,84,1552939200,24,6,30,Drizzle
23105,85,1552939200,30,5,35,Drizzle
23106,86,1552939200,36,2,38,Drizzle
23107,87,1552939200,26,12,38,Drizzle
23108,88,1552939200,19,11,30,Drizzle
23109,89,1552939200,27,13,40,Drizzle
23110,90,1552939200,27,13,40,Drizzle
23111,91,1552939200,15,15,30,Drizzle
23112,92,1552939200,35,5,40,Drizzle
23113,93,1552939200,8,32,40,Drizzle
23114,94,1552939200,17,23,40,Drizzle
23115,95,1552939200,37,3,40,Drizzle
23116,96,1552939200,28,2,30,Drizzle
23117,97,1552939200,37,3,40,Drizzle
23118,98,1552939200,11,29,40,Drizzle
23119,99,1552939200,4,25,29,Drizzle
23120,100,1552939200,24,1,25,Drizzle
23121,101,1552939200,23,7,30,Drizzle
23122,102,1552939200,39,1,40,Drizzle
23123,103,1552939200,40,0,40,Drizzle
23124,104,1552939200,40,0,40,Drizzle
23125,105,1552939200,36,0,36,Drizzle
23126,106,1552939200,39,1,40,Drizzle
23127,107,1552939200,37,3,40,Drizzle
23128,108,1552939200,37,3,40,Drizzle
23129,109,1552939200,20,9,29,Drizzle
23130,110,1552939200,38,2,40,Drizzle
23131,111,1552939200,35,5,40,Drizzle
23132,112,1552939200,22,8,30,Drizzle
23133,113,1552939200,0,0,0,Drizzle
23134,114,1552939200,24,16,40,Drizzle
23135,2,1552942800,15,5,20,Clouds
23136,3,1552942800,19,1,20,Clouds
23137,4,1552942800,16,3,19,Clouds
23138,5,1552942800,29,11,40,Clouds
23139,6,1552942800,1,19,20,Clouds
23140,7,1552942800,24,4,28,Clouds
23141,8,1552942800,17,11,28,Clouds
23142,9,1552942800,6,18,24,Clouds
23143,10,1552942800,3,13,16,Clouds
23144,11,1552942800,26,4,30,Clouds
23145,12,1552942800,15,4,19,Clouds
23146,13,1552942800,14,16,30,Clouds
23147,14,1552942800,6,24,30,Clouds
23148,15,1552942800,16,0,16,Clouds
23149,16,1552942800,3,17,20,Clouds
23150,17,1552942800,6,14,20,Clouds
23151,18,1552942800,13,16,29,Clouds
23152,19,1552942800,12,18,30,Clouds
23153,21,1552942800,12,18,30,Clouds
23154,22,1552942800,15,4,19,Clouds
23155,23,1552942800,0,0,0,Clouds
23156,24,1552942800,20,0,20,Clouds
23157,25,1552942800,0,0,0,Clouds
23158,26,1552942800,3,16,19,Clouds
23159,27,1552942800,10,10,20,Clouds
23160,28,1552942800,27,3,30,Clouds
23161,29,1552942800,2,27,29,Clouds
23162,30,1552942800,19,0,19,Clouds
23163,31,1552942800,19,1,20,Clouds
23164,32,1552942800,9,21,30,Clouds
23165,33,1552942800,23,0,23,Clouds
23166,34,1552942800,2,28,30,Clouds
23167,35,1552942800,27,3,30,Clouds
23168,36,1552942800,8,32,40,Clouds
23169,37,1552942800,6,24,30,Clouds
23170,38,1552942800,26,14,40,Clouds
23171,39,1552942800,19,1,20,Clouds
23172,40,1552942800,9,12,21,Clouds
23173,41,1552942800,9,11,20,Clouds
23174,42,1552942800,13,17,30,Clouds
23175,43,1552942800,15,15,30,Clouds
23176,44,1552942800,22,8,30,Clouds
23177,45,1552942800,11,19,30,Clouds
23178,46,1552942800,4,16,20,Clouds
23179,47,1552942800,32,8,40,Clouds
23180,48,1552942800,34,6,40,Clouds
23181,49,1552942800,33,7,40,Clouds
23182,50,1552942800,23,17,40,Clouds
23183,51,1552942800,3,37,40,Clouds
23184,52,1552942800,9,23,32,Clouds
23185,53,1552942800,40,0,40,Clouds
23186,54,1552942800,24,9,33,Clouds
23187,55,1552942800,23,13,36,Clouds
23188,56,1552942800,8,32,40,Clouds
23189,57,1552942800,12,11,23,Clouds
23190,58,1552942800,24,16,40,Clouds
23191,59,1552942800,20,0,20,Clouds
23192,60,1552942800,25,5,30,Clouds
23193,61,1552942800,25,0,25,Clouds
23194,62,1552942800,36,4,40,Clouds
23195,63,1552942800,9,26,35,Clouds
23196,64,1552942800,22,18,40,Clouds
23197,65,1552942800,37,3,40,Clouds
23198,66,1552942800,10,29,39,Clouds
23199,67,1552942800,14,26,40,Clouds
23200,68,1552942800,4,35,39,Clouds
23201,69,1552942800,0,39,39,Clouds
23202,70,1552942800,24,4,28,Clouds
23203,71,1552942800,25,14,39,Clouds
23204,72,1552942800,20,11,31,Clouds
23205,73,1552942800,7,23,30,Clouds
23206,74,1552942800,28,2,30,Clouds
23207,75,1552942800,33,7,40,Clouds
23208,76,1552942800,34,4,38,Clouds
23209,77,1552942800,5,24,29,Clouds
23210,78,1552942800,35,5,40,Clouds
23211,79,1552942800,27,0,27,Clouds
23212,80,1552942800,40,0,40,Clouds
23213,81,1552942800,40,0,40,Clouds
23214,82,1552942800,17,5,22,Clouds
23215,83,1552942800,29,11,40,Clouds
23216,84,1552942800,22,8,30,Clouds
23217,85,1552942800,29,6,35,Clouds
23218,86,1552942800,37,1,38,Clouds
23219,87,1552942800,25,13,38,Clouds
23220,88,1552942800,19,11,30,Clouds
23221,89,1552942800,26,14,40,Clouds
23222,90,1552942800,28,12,40,Clouds
23223,91,1552942800,12,18,30,Clouds
23224,92,1552942800,34,6,40,Clouds
23225,93,1552942800,8,32,40,Clouds
23226,94,1552942800,17,23,40,Clouds
23227,95,1552942800,39,1,40,Clouds
23228,96,1552942800,27,3,30,Clouds
23229,97,1552942800,31,9,40,Clouds
23230,98,1552942800,12,28,40,Clouds
23231,99,1552942800,3,26,29,Clouds
23232,100,1552942800,23,2,25,Clouds
23233,101,1552942800,24,6,30,Clouds
23234,102,1552942800,38,2,40,Clouds
23235,103,1552942800,40,0,40,Clouds
23236,104,1552942800,40,0,40,Clouds
23237,105,1552942800,36,0,36,Clouds
23238,106,1552942800,40,0,40,Clouds
23239,107,1552942800,40,0,40,Clouds
23240,108,1552942800,34,6,40,Clouds
23241,109,1552942800,16,13,29,Clouds
23242,110,1552942800,38,2,40,Clouds
23243,111,1552942800,33,7,40,Clouds
23244,112,1552942800,25,5,30,Clouds
23245,113,1552942800,0,0,0,Clouds
23246,114,1552942800,26,14,40,Clouds
23247,2,1552946400,12,8,20,Drizzle
23248,3,1552946400,20,0,20,Drizzle
23249,4,1552946400,15,4,19,Drizzle
23250,5,1552946400,27,13,40,Drizzle
23251,6,1552946400,1,19,20,Drizzle
23252,7,1552946400,25,3,28,Drizzle
23253,8,1552946400,20,8,28,Drizzle
23254,9,1552946400,8,16,24,Drizzle
23255,10,1552946400,2,14,16,Drizzle
23256,11,1552946400,26,4,30,Drizzle
23257,12,1552946400,14,5,19,Drizzle
23258,13,1552946400,14,16,30,Drizzle
23259,14,1552946400,17,13,30,Drizzle
23260,15,1552946400,15,1,16,Drizzle
23261,16,1552946400,7,13,20,Drizzle
23262,17,1552946400,6,14,20,Drizzle
23263,18,1552946400,16,13,29,Drizzle
23264,19,1552946400,9,21,30,Drizzle
23265,21,1552946400,12,18,30,Drizzle
23266,22,1552946400,16,3,19,Drizzle
23267,23,1552946400,0,0,0,Drizzle
23268,24,1552946400,18,2,20,Drizzle
23269,25,1552946400,0,0,0,Drizzle
23270,26,1552946400,3,16,19,Drizzle
23271,27,1552946400,9,11,20,Drizzle
23272,28,1552946400,27,3,30,Drizzle
23273,29,1552946400,7,22,29,Drizzle
23274,30,1552946400,18,1,19,Drizzle
23275,31,1552946400,19,1,20,Drizzle
23276,32,1552946400,11,19,30,Drizzle
23277,33,1552946400,21,2,23,Drizzle
23278,34,1552946400,1,29,30,Drizzle
23279,35,1552946400,25,5,30,Drizzle
23280,36,1552946400,7,33,40,Drizzle
23281,37,1552946400,6,24,30,Drizzle
23282,38,1552946400,31,9,40,Drizzle
23283,39,1552946400,17,3,20,Drizzle
23284,40,1552946400,10,11,21,Drizzle
23285,41,1552946400,11,9,20,Drizzle
23286,42,1552946400,10,20,30,Drizzle
23287,43,1552946400,8,22,30,Drizzle
23288,44,1552946400,19,11,30,Drizzle
23289,45,1552946400,10,20,30,Drizzle
23290,46,1552946400,6,14,20,Drizzle
23291,47,1552946400,32,8,40,Drizzle
23292,48,1552946400,34,6,40,Drizzle
23293,49,1552946400,32,8,40,Drizzle
23294,50,1552946400,21,19,40,Drizzle
23295,51,1552946400,3,37,40,Drizzle
23296,52,1552946400,12,20,32,Drizzle
23297,53,1552946400,40,0,40,Drizzle
23298,54,1552946400,24,9,33,Drizzle
23299,55,1552946400,23,13,36,Drizzle
23300,56,1552946400,13,27,40,Drizzle
23301,57,1552946400,12,11,23,Drizzle
23302,58,1552946400,21,19,40,Drizzle
23303,59,1552946400,20,0,20,Drizzle
23304,60,1552946400,25,5,30,Drizzle
23305,61,1552946400,25,0,25,Drizzle
23306,62,1552946400,36,4,40,Drizzle
23307,63,1552946400,10,25,35,Drizzle
23308,64,1552946400,26,14,40,Drizzle
23309,65,1552946400,39,1,40,Drizzle
23310,66,1552946400,9,30,39,Drizzle
23311,67,1552946400,14,26,40,Drizzle
23312,68,1552946400,2,37,39,Drizzle
23313,69,1552946400,0,39,39,Drizzle
23314,70,1552946400,24,4,28,Drizzle
23315,71,1552946400,25,14,39,Drizzle
23316,72,1552946400,19,12,31,Drizzle
23317,73,1552946400,7,23,30,Drizzle
23318,74,1552946400,29,1,30,Drizzle
23319,75,1552946400,39,1,40,Drizzle
23320,76,1552946400,34,4,38,Drizzle
23321,77,1552946400,5,24,29,Drizzle
23322,78,1552946400,34,6,40,Drizzle
23323,79,1552946400,27,0,27,Drizzle
23324,80,1552946400,40,0,40,Drizzle
23325,81,1552946400,39,1,40,Drizzle
23326,82,1552946400,18,4,22,Drizzle
23327,83,1552946400,25,15,40,Drizzle
23328,84,1552946400,21,9,30,Drizzle
23329,85,1552946400,23,12,35,Drizzle
23330,86,1552946400,38,0,38,Drizzle
23331,87,1552946400,24,14,38,Drizzle
23332,88,1552946400,20,10,30,Drizzle
23333,89,1552946400,26,14,40,Drizzle
23334,90,1552946400,25,15,40,Drizzle
23335,91,1552946400,11,19,30,Drizzle
23336,92,1552946400,33,7,40,Drizzle
23337,93,1552946400,8,32,40,Drizzle
23338,94,1552946400,17,23,40,Drizzle
23339,95,1552946400,39,1,40,Drizzle
23340,96,1552946400,27,3,30,Drizzle
23341,97,1552946400,30,10,40,Drizzle
23342,98,1552946400,12,28,40,Drizzle
23343,99,1552946400,3,26,29,Drizzle
23344,100,1552946400,7,18,25,Drizzle
23345,101,1552946400,26,4,30,Drizzle
23346,102,1552946400,39,1,40,Drizzle
23347,103,1552946400,40,0,40,Drizzle
23348,104,1552946400,40,0,40,Drizzle
23349,105,1552946400,36,0,36,Drizzle
23350,106,1552946400,40,0,40,Drizzle
23351,107,1552946400,39,1,40,Drizzle
23352,108,1552946400,33,7,40,Drizzle
23353,109,1552946400,13,16,29,Drizzle
23354,110,1552946400,37,3,40,Drizzle
23355,111,1552946400,31,9,40,Drizzle
23356,112,1552946400,24,6,30,Drizzle
23357,113,1552946400,0,0,0,Drizzle
23358,114,1552946400,29,11,40,Drizzle
23359,2,1552950000,11,9,20,Rain
23360,3,1552950000,20,0,20,Rain
23361,4,1552950000,15,4,19,Rain
23362,5,1552950000,28,12,40,Rain
23363,6,1552950000,3,17,20,Rain
23364,7,1552950000,26,2,28,Rain
23365,8,1552950000,19,9,28,Rain
23366,9,1552950000,8,16,24,Rain
23367,10,1552950000,1,15,16,Rain
23368,11,1552950000,26,4,30,Rain
23369,12,1552950000,14,5,19,Rain
23370,13,1552950000,14,16,30,Rain
23371,14,1552950000,24,6,30,Rain
23372,15,1552950000,15,1,16,Rain
23373,16,1552950000,6,14,20,Rain
23374,17,1552950000,6,14,20,Rain
23375,18,1552950000,19,10,29,Rain
23376,19,1552950000,10,20,30,Rain
23377,21,1552950000,12,18,30,Rain
23378,22,1552950000,16,3,19,Rain
23379,23,1552950000,0,0,0,Rain
23380,24,1552950000,20,0,20,Rain
23381,25,1552950000,0,0,0,Rain
23382,26,1552950000,3,16,19,Rain
23383,27,1552950000,8,12,20,Rain
23384,28,1552950000,25,5,30,Rain
23385,29,1552950000,8,21,29,Rain
23386,30,1552950000,18,1,19,Rain
23387,31,1552950000,20,0,20,Rain
23388,32,1552950000,14,16,30,Rain
23389,33,1552950000,22,1,23,Rain
23390,34,1552950000,3,27,30,Rain
23391,35,1552950000,24,6,30,Rain
23392,36,1552950000,26,14,40,Rain
23393,37,1552950000,5,25,30,Rain
23394,38,1552950000,30,10,40,Rain
23395,39,1552950000,17,3,20,Rain
23396,40,1552950000,12,9,21,Rain
23397,41,1552950000,10,10,20,Rain
23398,42,1552950000,10,20,30,Rain
23399,43,1552950000,7,23,30,Rain
23400,44,1552950000,18,12,30,Rain
23401,45,1552950000,9,21,30,Rain
23402,46,1552950000,11,9,20,Rain
23403,47,1552950000,32,8,40,Rain
23404,48,1552950000,30,10,40,Rain
23405,49,1552950000,35,5,40,Rain
23406,50,1552950000,17,23,40,Rain
23407,51,1552950000,3,37,40,Rain
23408,52,1552950000,12,20,32,Rain
23409,53,1552950000,39,1,40,Rain
23410,54,1552950000,25,8,33,Rain
23411,55,1552950000,23,13,36,Rain
23412,56,1552950000,11,29,40,Rain
23413,57,1552950000,12,11,23,Rain
23414,58,1552950000,22,18,40,Rain
23415,59,1552950000,20,0,20,Rain
23416,60,1552950000,23,7,30,Rain
23417,61,1552950000,25,0,25,Rain
23418,62,1552950000,36,4,40,Rain
23419,63,1552950000,12,23,35,Rain
23420,64,1552950000,24,16,40,Rain
23421,65,1552950000,38,2,40,Rain
23422,66,1552950000,7,32,39,Rain
23423,67,1552950000,15,25,40,Rain
23424,68,1552950000,1,39,40,Rain
23425,69,1552950000,0,39,39,Rain
23426,70,1552950000,24,4,28,Rain
23427,71,1552950000,24,15,39,Rain
23428,72,1552950000,17,14,31,Rain
23429,73,1552950000,7,23,30,Rain
23430,74,1552950000,26,4,30,Rain
23431,75,1552950000,37,3,40,Rain
23432,76,1552950000,34,4,38,Rain
23433,77,1552950000,5,24,29,Rain
23434,78,1552950000,35,5,40,Rain
23435,79,1552950000,27,0,27,Rain
23436,80,1552950000,40,0,40,Rain
23437,81,1552950000,39,1,40,Rain
23438,82,1552950000,17,5,22,Rain
23439,83,1552950000,23,17,40,Rain
23440,84,1552950000,21,9,30,Rain
23441,85,1552950000,24,11,35,Rain
23442,86,1552950000,38,0,38,Rain
23443,87,1552950000,23,15,38,Rain
23444,88,1552950000,22,8,30,Rain
23445,89,1552950000,26,14,40,Rain
23446,90,1552950000,26,14,40,Rain
23447,91,1552950000,12,18,30,Rain
23448,92,1552950000,21,19,40,Rain
23449,93,1552950000,8,32,40,Rain
23450,94,1552950000,17,23,40,Rain
23451,95,1552950000,40,0,40,Rain
23452,96,1552950000,27,3,30,Rain
23453,97,1552950000,30,10,40,Rain
23454,98,1552950000,13,27,40,Rain
23455,99,1552950000,1,28,29,Rain
23456,100,1552950000,10,15,25,Rain
23457,101,1552950000,26,4,30,Rain
23458,102,1552950000,40,0,40,Rain
23459,103,1552950000,40,0,40,Rain
23460,104,1552950000,40,0,40,Rain
23461,105,1552950000,36,0,36,Rain
23462,106,1552950000,40,0,40,Rain
23463,107,1552950000,39,1,40,Rain
23464,108,1552950000,32,8,40,Rain
23465,109,1552950000,11,18,29,Rain
23466,110,1552950000,38,2,40,Rain
23467,111,1552950000,31,9,40,Rain
23468,112,1552950000,21,9,30,Rain
23469,113,1552950000,0,0,0,Rain
23470,114,1552950000,30,10,40,Rain
23471,2,1552953600,11,9,20,Drizzle
23472,3,1552953600,18,2,20,Drizzle
23473,4,1552953600,16,3,19,Drizzle
23474,5,1552953600,27,13,40,Drizzle
23475,6,1552953600,5,15,20,Drizzle
23476,7,1552953600,24,4,28,Drizzle
23477,8,1552953600,18,10,28,Drizzle
23478,9,1552953600,10,14,24,Drizzle
23479,10,1552953600,3,13,16,Drizzle
23480,11,1552953600,26,4,30,Drizzle
23481,12,1552953600,14,5,19,Drizzle
23482,13,1552953600,15,15,30,Drizzle
23483,14,1552953600,26,4,30,Drizzle
23484,15,1552953600,16,0,16,Drizzle
23485,16,1552953600,8,12,20,Drizzle
23486,17,1552953600,4,16,20,Drizzle
23487,18,1552953600,17,12,29,Drizzle
23488,19,1552953600,9,21,30,Drizzle
23489,21,1552953600,14,16,30,Drizzle
23490,22,1552953600,18,1,19,Drizzle
23491,23,1552953600,0,0,0,Drizzle
23492,24,1552953600,19,1,20,Drizzle
23493,25,1552953600,0,0,0,Drizzle
23494,26,1552953600,1,18,19,Drizzle
23495,27,1552953600,15,5,20,Drizzle
23496,28,1552953600,20,10,30,Drizzle
23497,29,1552953600,23,6,29,Drizzle
23498,30,1552953600,18,1,19,Drizzle
23499,31,1552953600,20,0,20,Drizzle
23500,32,1552953600,13,17,30,Drizzle
23501,33,1552953600,23,0,23,Drizzle
23502,34,1552953600,4,26,30,Drizzle
23503,35,1552953600,23,7,30,Drizzle
23504,36,1552953600,26,14,40,Drizzle
23505,37,1552953600,4,26,30,Drizzle
23506,38,1552953600,30,10,40,Drizzle
23507,39,1552953600,15,5,20,Drizzle
23508,40,1552953600,12,9,21,Drizzle
23509,41,1552953600,9,11,20,Drizzle
23510,42,1552953600,13,17,30,Drizzle
23511,43,1552953600,5,25,30,Drizzle
23512,44,1552953600,18,12,30,Drizzle
23513,45,1552953600,9,21,30,Drizzle
23514,46,1552953600,13,7,20,Drizzle
23515,47,1552953600,32,8,40,Drizzle
23516,48,1552953600,32,8,40,Drizzle
23517,49,1552953600,30,10,40,Drizzle
23518,50,1552953600,16,24,40,Drizzle
23519,51,1552953600,3,37,40,Drizzle
23520,52,1552953600,12,20,32,Drizzle
23521,53,1552953600,39,1,40,Drizzle
23522,54,1552953600,27,6,33,Drizzle
23523,55,1552953600,23,13,36,Drizzle
23524,56,1552953600,11,29,40,Drizzle
23525,57,1552953600,12,11,23,Drizzle
23526,58,1552953600,23,17,40,Drizzle
23527,59,1552953600,20,0,20,Drizzle
23528,60,1552953600,22,8,30,Drizzle
23529,61,1552953600,25,0,25,Drizzle
23530,62,1552953600,36,4,40,Drizzle
23531,63,1552953600,13,22,35,Drizzle
23532,64,1552953600,26,14,40,Drizzle
23533,65,1552953600,38,2,40,Drizzle
23534,66,1552953600,9,30,39,Drizzle
23535,67,1552953600,17,23,40,Drizzle
23536,68,1552953600,3,37,40,Drizzle
23537,69,1552953600,0,39,39,Drizzle
23538,70,1552953600,21,7,28,Drizzle
23539,71,1552953600,23,16,39,Drizzle
23540,72,1552953600,15,16,31,Drizzle
23541,73,1552953600,6,24,30,Drizzle
23542,74,1552953600,26,4,30,Drizzle
23543,75,1552953600,37,3,40,Drizzle
23544,76,1552953600,31,7,38,Drizzle
23545,77,1552953600,20,9,29,Drizzle
23546,78,1552953600,33,7,40,Drizzle
23547,79,1552953600,27,0,27,Drizzle
23548,80,1552953600,37,3,40,Drizzle
23549,81,1552953600,39,1,40,Drizzle
23550,82,1552953600,18,4,22,Drizzle
23551,83,1552953600,26,14,40,Drizzle
23552,84,1552953600,20,10,30,Drizzle
23553,85,1552953600,24,11,35,Drizzle
23554,86,1552953600,38,0,38,Drizzle
23555,87,1552953600,24,14,38,Drizzle
23556,88,1552953600,23,7,30,Drizzle
23557,89,1552953600,26,14,40,Drizzle
23558,90,1552953600,26,14,40,Drizzle
23559,91,1552953600,12,18,30,Drizzle
23560,92,1552953600,0,40,40,Drizzle
23561,93,1552953600,9,31,40,Drizzle
23562,94,1552953600,17,23,40,Drizzle
23563,95,1552953600,40,0,40,Drizzle
23564,96,1552953600,27,3,30,Drizzle
23565,97,1552953600,28,12,40,Drizzle
23566,98,1552953600,16,24,40,Drizzle
23567,99,1552953600,1,28,29,Drizzle
23568,100,1552953600,14,11,25,Drizzle
23569,101,1552953600,21,9,30,Drizzle
23570,102,1552953600,38,2,40,Drizzle
23571,103,1552953600,40,0,40,Drizzle
23572,104,1552953600,40,0,40,Drizzle
23573,105,1552953600,36,0,36,Drizzle
23574,106,1552953600,40,0,40,Drizzle
23575,107,1552953600,39,1,40,Drizzle
23576,108,1552953600,33,7,40,Drizzle
23577,109,1552953600,10,19,29,Drizzle
23578,110,1552953600,37,3,40,Drizzle
23579,111,1552953600,27,13,40,Drizzle
23580,112,1552953600,17,13,30,Drizzle
23581,113,1552953600,0,0,0,Drizzle
23582,114,1552953600,30,10,40,Drizzle
23583,2,1552957200,11,9,20,Drizzle
23584,3,1552957200,20,0,20,Drizzle
23585,4,1552957200,16,3,19,Drizzle
23586,5,1552957200,25,15,40,Drizzle
23587,6,1552957200,9,11,20,Drizzle
23588,7,1552957200,24,4,28,Drizzle
23589,8,1552957200,20,8,28,Drizzle
23590,9,1552957200,10,14,24,Drizzle
23591,10,1552957200,4,12,16,Drizzle
23592,11,1552957200,26,4,30,Drizzle
23593,12,1552957200,14,5,19,Drizzle
23594,13,1552957200,15,15,30,Drizzle
23595,14,1552957200,28,2,30,Drizzle
23596,15,1552957200,16,0,16,Drizzle
23597,16,1552957200,9,11,20,Drizzle
23598,17,1552957200,4,16,20,Drizzle
23599,18,1552957200,20,9,29,Drizzle
23600,19,1552957200,10,20,30,Drizzle
23601,21,1552957200,16,14,30,Drizzle
23602,22,1552957200,16,3,19,Drizzle
23603,23,1552957200,0,0,0,Drizzle
23604,24,1552957200,20,0,20,Drizzle
23605,25,1552957200,0,0,0,Drizzle
23606,26,1552957200,2,17,19,Drizzle
23607,27,1552957200,17,3,20,Drizzle
23608,28,1552957200,21,9,30,Drizzle
23609,29,1552957200,26,3,29,Drizzle
23610,30,1552957200,19,0,19,Drizzle
23611,31,1552957200,20,0,20,Drizzle
23612,32,1552957200,13,17,30,Drizzle
23613,33,1552957200,23,0,23,Drizzle
23614,34,1552957200,6,24,30,Drizzle
23615,35,1552957200,23,7,30,Drizzle
23616,36,1552957200,26,14,40,Drizzle
23617,37,1552957200,21,9,30,Drizzle
23618,38,1552957200,33,7,40,Drizzle
23619,39,1552957200,13,7,20,Drizzle
23620,40,1552957200,12,9,21,Drizzle
23621,41,1552957200,9,11,20,Drizzle
23622,42,1552957200,12,18,30,Drizzle
23623,43,1552957200,1,29,30,Drizzle
23624,44,1552957200,18,12,30,Drizzle
23625,45,1552957200,9,21,30,Drizzle
23626,46,1552957200,13,7,20,Drizzle
23627,47,1552957200,31,9,40,Drizzle
23628,48,1552957200,32,8,40,Drizzle
23629,49,1552957200,29,11,40,Drizzle
23630,50,1552957200,15,25,40,Drizzle
23631,51,1552957200,4,36,40,Drizzle
23632,52,1552957200,11,21,32,Drizzle
23633,53,1552957200,38,2,40,Drizzle
23634,54,1552957200,27,6,33,Drizzle
23635,55,1552957200,23,13,36,Drizzle
23636,56,1552957200,11,29,40,Drizzle
23637,57,1552957200,12,11,23,Drizzle
23638,58,1552957200,23,17,40,Drizzle
23639,59,1552957200,20,0,20,Drizzle
23640,60,1552957200,20,10,30,Drizzle
23641,61,1552957200,25,0,25,Drizzle
23642,62,1552957200,36,4,40,Drizzle
23643,63,1552957200,14,21,35,Drizzle
23644,64,1552957200,28,12,40,Drizzle
23645,65,1552957200,38,2,40,Drizzle
23646,66,1552957200,6,33,39,Drizzle
23647,67,1552957200,19,21,40,Drizzle
23648,68,1552957200,3,37,40,Drizzle
23649,69,1552957200,0,39,39,Drizzle
23650,70,1552957200,21,7,28,Drizzle
23651,71,1552957200,25,14,39,Drizzle
23652,72,1552957200,15,16,31,Drizzle
23653,73,1552957200,7,23,30,Drizzle
23654,74,1552957200,25,5,30,Drizzle
23655,75,1552957200,33,7,40,Drizzle
23656,76,1552957200,32,6,38,Drizzle
23657,77,1552957200,17,12,29,Drizzle
23658,78,1552957200,31,9,40,Drizzle
23659,79,1552957200,27,0,27,Drizzle
23660,80,1552957200,38,2,40,Drizzle
23661,81,1552957200,39,1,40,Drizzle
23662,82,1552957200,17,5,22,Drizzle
23663,83,1552957200,26,14,40,Drizzle
23664,84,1552957200,20,10,30,Drizzle
23665,85,1552957200,24,11,35,Drizzle
23666,86,1552957200,3,35,38,Drizzle
23667,87,1552957200,24,14,38,Drizzle
23668,88,1552957200,22,8,30,Drizzle
23669,89,1552957200,26,14,40,Drizzle
23670,90,1552957200,26,14,40,Drizzle
23671,91,1552957200,14,16,30,Drizzle
23672,92,1552957200,0,40,40,Drizzle
23673,93,1552957200,9,31,40,Drizzle
23674,94,1552957200,17,23,40,Drizzle
23675,95,1552957200,39,1,40,Drizzle
23676,96,1552957200,27,3,30,Drizzle
23677,97,1552957200,27,13,40,Drizzle
23678,98,1552957200,16,24,40,Drizzle
23679,99,1552957200,0,29,29,Drizzle
23680,100,1552957200,14,11,25,Drizzle
23681,101,1552957200,20,10,30,Drizzle
23682,102,1552957200,39,1,40,Drizzle
23683,103,1552957200,40,0,40,Drizzle
23684,104,1552957200,40,0,40,Drizzle
23685,105,1552957200,36,0,36,Drizzle
23686,106,1552957200,40,0,40,Drizzle
23687,107,1552957200,39,1,40,Drizzle
23688,108,1552957200,33,7,40,Drizzle
23689,109,1552957200,9,20,29,Drizzle
23690,110,1552957200,35,5,40,Drizzle
23691,111,1552957200,28,12,40,Drizzle
23692,112,1552957200,14,16,30,Drizzle
23693,113,1552957200,0,0,0,Drizzle
23694,114,1552957200,31,9,40,Drizzle
23695,2,1552960800,10,10,20,Clouds
23696,3,1552960800,18,2,20,Clouds
23697,4,1552960800,16,3,19,Clouds
23698,5,1552960800,8,32,40,Clouds
23699,6,1552960800,11,9,20,Clouds
23700,7,1552960800,24,4,28,Clouds
23701,8,1552960800,20,8,28,Clouds
23702,9,1552960800,13,11,24,Clouds
23703,10,1552960800,4,12,16,Clouds
23704,11,1552960800,26,4,30,Clouds
23705,12,1552960800,13,6,19,Clouds
23706,13,1552960800,15,15,30,Clouds
23707,14,1552960800,27,3,30,Clouds
23708,15,1552960800,16,0,16,Clouds
23709,16,1552960800,11,9,20,Clouds
23710,17,1552960800,4,16,20,Clouds
23711,18,1552960800,21,8,29,Clouds
23712,19,1552960800,29,1,30,Clouds
23713,21,1552960800,16,14,30,Clouds
23714,22,1552960800,16,3,19,Clouds
23715,23,1552960800,0,0,0,Clouds
23716,24,1552960800,16,4,20,Clouds
23717,25,1552960800,0,0,0,Clouds
23718,26,1552960800,3,16,19,Clouds
23719,27,1552960800,19,1,20,Clouds
23720,28,1552960800,19,11,30,Clouds
23721,29,1552960800,27,2,29,Clouds
23722,30,1552960800,19,0,19,Clouds
23723,31,1552960800,20,0,20,Clouds
23724,32,1552960800,13,17,30,Clouds
23725,33,1552960800,23,0,23,Clouds
23726,34,1552960800,6,24,30,Clouds
23727,35,1552960800,23,7,30,Clouds
23728,36,1552960800,26,14,40,Clouds
23729,37,1552960800,21,9,30,Clouds
23730,38,1552960800,36,4,40,Clouds
23731,39,1552960800,12,8,20,Clouds
23732,40,1552960800,12,9,21,Clouds
23733,41,1552960800,9,11,20,Clouds
23734,42,1552960800,12,18,30,Clouds
23735,43,1552960800,0,30,30,Clouds
23736,44,1552960800,18,12,30,Clouds
23737,45,1552960800,9,21,30,Clouds
23738,46,1552960800,14,6,20,Clouds
23739,47,1552960800,31,9,40,Clouds
23740,48,1552960800,32,8,40,Clouds
23741,49,1552960800,31,9,40,Clouds
23742,50,1552960800,14,26,40,Clouds
23743,51,1552960800,4,36,40,Clouds
23744,52,1552960800,12,20,32,Clouds
23745,53,1552960800,38,2,40,Clouds
23746,54,1552960800,28,5,33,Clouds
23747,55,1552960800,23,13,36,Clouds
23748,56,1552960800,28,12,40,Clouds
23749,57,1552960800,12,11,23,Clouds
23750,58,1552960800,22,18,40,Clouds
23751,59,1552960800,19,1,20,Clouds
23752,60,1552960800,18,12,30,Clouds
23753,61,1552960800,25,0,25,Clouds
23754,62,1552960800,36,4,40,Clouds
23755,63,1552960800,14,21,35,Clouds
23756,64,1552960800,27,13,40,Clouds
23757,65,1552960800,38,2,40,Clouds
23758,66,1552960800,6,33,39,Clouds
23759,67,1552960800,18,22,40,Clouds
23760,68,1552960800,3,37,40,Clouds
23761,69,1552960800,0,39,39,Clouds
23762,70,1552960800,21,7,28,Clouds
23763,71,1552960800,25,14,39,Clouds
23764,72,1552960800,15,16,31,Clouds
23765,73,1552960800,7,23,30,Clouds
23766,74,1552960800,24,6,30,Clouds
23767,75,1552960800,33,7,40,Clouds
23768,76,1552960800,31,7,38,Clouds
23769,77,1552960800,17,12,29,Clouds
23770,78,1552960800,31,9,40,Clouds
23771,79,1552960800,27,0,27,Clouds
23772,80,1552960800,38,2,40,Clouds
23773,81,1552960800,39,1,40,Clouds
23774,82,1552960800,15,7,22,Clouds
23775,83,1552960800,25,15,40,Clouds
23776,84,1552960800,19,11,30,Clouds
23777,85,1552960800,23,12,35,Clouds
23778,86,1552960800,3,35,38,Clouds
23779,87,1552960800,24,14,38,Clouds
23780,88,1552960800,21,9,30,Clouds
23781,89,1552960800,26,14,40,Clouds
23782,90,1552960800,26,14,40,Clouds
23783,91,1552960800,14,16,30,Clouds
23784,92,1552960800,0,40,40,Clouds
23785,93,1552960800,9,31,40,Clouds
23786,94,1552960800,17,23,40,Clouds
23787,95,1552960800,39,1,40,Clouds
23788,96,1552960800,27,3,30,Clouds
23789,97,1552960800,27,13,40,Clouds
23790,98,1552960800,17,23,40,Clouds
23791,99,1552960800,0,29,29,Clouds
23792,100,1552960800,14,11,25,Clouds
23793,101,1552960800,19,11,30,Clouds
23794,102,1552960800,39,1,40,Clouds
23795,103,1552960800,40,0,40,Clouds
23796,104,1552960800,40,0,40,Clouds
23797,105,1552960800,36,0,36,Clouds
23798,106,1552960800,39,1,40,Clouds
23799,107,1552960800,39,1,40,Clouds
23800,108,1552960800,33,7,40,Clouds
23801,109,1552960800,9,20,29,Clouds
23802,110,1552960800,34,6,40,Clouds
23803,111,1552960800,27,13,40,Clouds
23804,112,1552960800,12,18,30,Clouds
23805,113,1552960800,0,0,0,Clouds
23806,114,1552960800,31,9,40,Clouds
23807,2,1552964400,10,10,20,Clouds
23808,3,1552964400,18,2,20,Clouds
23809,4,1552964400,16,3,19,Clouds
23810,5,1552964400,8,32,40,Clouds
23811,6,1552964400,11,9,20,Clouds
23812,7,1552964400,24,4,28,Clouds
23813,8,1552964400,20,8,28,Clouds
23814,9,1552964400,13,11,24,Clouds
23815,10,1552964400,4,12,16,Clouds
23816,11,1552964400,26,4,30,Clouds
23817,12,1552964400,13,6,19,Clouds
23818,13,1552964400,15,15,30,Clouds
23819,14,1552964400,27,3,30,Clouds
23820,15,1552964400,16,0,16,Clouds
23821,16,1552964400,11,9,20,Clouds
23822,17,1552964400,4,16,20,Clouds
23823,18,1552964400,21,8,29,Clouds
23824,19,1552964400,29,1,30,Clouds
23825,21,1552964400,16,14,30,Clouds
23826,22,1552964400,16,3,19,Clouds
23827,23,1552964400,0,0,0,Clouds
23828,24,1552964400,16,4,20,Clouds
23829,25,1552964400,0,0,0,Clouds
23830,26,1552964400,3,16,19,Clouds
23831,27,1552964400,19,1,20,Clouds
23832,28,1552964400,19,11,30,Clouds
23833,29,1552964400,27,2,29,Clouds
23834,30,1552964400,19,0,19,Clouds
23835,31,1552964400,20,0,20,Clouds
23836,32,1552964400,13,17,30,Clouds
23837,33,1552964400,23,0,23,Clouds
23838,34,1552964400,6,24,30,Clouds
23839,35,1552964400,23,7,30,Clouds
23840,36,1552964400,26,14,40,Clouds
23841,37,1552964400,21,9,30,Clouds
23842,38,1552964400,36,4,40,Clouds
23843,39,1552964400,12,8,20,Clouds
23844,40,1552964400,12,9,21,Clouds
23845,41,1552964400,9,11,20,Clouds
23846,42,1552964400,12,18,30,Clouds
23847,43,1552964400,0,30,30,Clouds
23848,44,1552964400,18,12,30,Clouds
23849,45,1552964400,9,21,30,Clouds
23850,46,1552964400,14,6,20,Clouds
23851,47,1552964400,31,9,40,Clouds
23852,48,1552964400,32,8,40,Clouds
23853,49,1552964400,31,9,40,Clouds
23854,50,1552964400,14,26,40,Clouds
23855,51,1552964400,4,36,40,Clouds
23856,52,1552964400,12,20,32,Clouds
23857,53,1552964400,38,2,40,Clouds
23858,54,1552964400,28,5,33,Clouds
23859,55,1552964400,23,13,36,Clouds
23860,56,1552964400,28,12,40,Clouds
23861,57,1552964400,12,11,23,Clouds
23862,58,1552964400,22,18,40,Clouds
23863,59,1552964400,19,1,20,Clouds
23864,60,1552964400,18,12,30,Clouds
23865,61,1552964400,25,0,25,Clouds
23866,62,1552964400,36,4,40,Clouds
23867,63,1552964400,14,21,35,Clouds
23868,64,1552964400,27,13,40,Clouds
23869,65,1552964400,38,2,40,Clouds
23870,66,1552964400,6,33,39,Clouds
23871,67,1552964400,18,22,40,Clouds
23872,68,1552964400,3,37,40,Clouds
23873,69,1552964400,0,39,39,Clouds
23874,70,1552964400,20,8,28,Clouds
23875,71,1552964400,25,14,39,Clouds
23876,72,1552964400,15,16,31,Clouds
23877,73,1552964400,7,23,30,Clouds
23878,74,1552964400,24,6,30,Clouds
23879,75,1552964400,33,7,40,Clouds
23880,76,1552964400,31,7,38,Clouds
23881,77,1552964400,17,12,29,Clouds
23882,78,1552964400,31,9,40,Clouds
23883,79,1552964400,27,0,27,Clouds
23884,80,1552964400,38,2,40,Clouds
23885,81,1552964400,39,1,40,Clouds
23886,82,1552964400,15,7,22,Clouds
23887,83,1552964400,25,15,40,Clouds
23888,84,1552964400,19,11,30,Clouds
23889,85,1552964400,23,12,35,Clouds
23890,86,1552964400,3,35,38,Clouds
23891,87,1552964400,24,14,38,Clouds
23892,88,1552964400,21,9,30,Clouds
23893,89,1552964400,26,14,40,Clouds
23894,90,1552964400,26,14,40,Clouds
23895,91,1552964400,14,16,30,Clouds
23896,92,1552964400,0,40,40,Clouds
23897,93,1552964400,9,31,40,Clouds
23898,94,1552964400,17,23,40,Clouds
23899,95,1552964400,39,1,40,Clouds
23900,96,1552964400,27,3,30,Clouds
23901,97,1552964400,27,13,40,Clouds
23902,98,1552964400,17,23,40,Clouds
23903,99,1552964400,0,29,29,Clouds
23904,100,1552964400,14,11,25,Clouds
23905,101,1552964400,19,11,30,Clouds
23906,102,1552964400,39,1,40,Clouds
23907,103,1552964400,40,0,40,Clouds
23908,104,1552964400,40,0,40,Clouds
23909,105,1552964400,36,0,36,Clouds
23910,106,1552964400,39,1,40,Clouds
23911,107,1552964400,39,1,40,Clouds
23912,108,1552964400,33,7,40,Clouds
23913,109,1552964400,9,20,29,Clouds
23914,110,1552964400,34,6,40,Clouds
23915,111,1552964400,27,13,40,Clouds
23916,112,1552964400,12,18,30,Clouds
23917,113,1552964400,0,0,0,Clouds
23918,114,1552964400,31,9,40,Clouds
23919,2,1552968000,10,10,20,Clouds
23920,3,1552968000,18,2,20,Clouds
23921,4,1552968000,16,3,19,Clouds
23922,5,1552968000,8,32,40,Clouds
23923,6,1552968000,11,9,20,Clouds
23924,7,1552968000,24,4,28,Clouds
23925,8,1552968000,20,8,28,Clouds
23926,9,1552968000,13,11,24,Clouds
23927,10,1552968000,4,12,16,Clouds
23928,11,1552968000,26,4,30,Clouds
23929,12,1552968000,13,6,19,Clouds
23930,13,1552968000,15,15,30,Clouds
23931,14,1552968000,27,3,30,Clouds
23932,15,1552968000,16,0,16,Clouds
23933,16,1552968000,11,9,20,Clouds
23934,17,1552968000,4,16,20,Clouds
23935,18,1552968000,21,8,29,Clouds
23936,19,1552968000,29,1,30,Clouds
23937,21,1552968000,16,14,30,Clouds
23938,22,1552968000,16,3,19,Clouds
23939,23,1552968000,0,0,0,Clouds
23940,24,1552968000,16,4,20,Clouds
23941,25,1552968000,0,0,0,Clouds
23942,26,1552968000,3,16,19,Clouds
23943,27,1552968000,19,1,20,Clouds
23944,28,1552968000,19,11,30,Clouds
23945,29,1552968000,27,2,29,Clouds
23946,30,1552968000,19,0,19,Clouds
23947,31,1552968000,20,0,20,Clouds
23948,32,1552968000,13,17,30,Clouds
23949,33,1552968000,23,0,23,Clouds
23950,34,1552968000,6,24,30,Clouds
23951,35,1552968000,23,7,30,Clouds
23952,36,1552968000,26,14,40,Clouds
23953,37,1552968000,21,9,30,Clouds
23954,38,1552968000,36,4,40,Clouds
23955,39,1552968000,12,8,20,Clouds
23956,40,1552968000,12,9,21,Clouds
23957,41,1552968000,9,11,20,Clouds
23958,42,1552968000,12,18,30,Clouds
23959,43,1552968000,0,30,30,Clouds
23960,44,1552968000,18,12,30,Clouds
23961,45,1552968000,9,21,30,Clouds
23962,46,1552968000,14,6,20,Clouds
23963,47,1552968000,31,9,40,Clouds
23964,48,1552968000,32,8,40,Clouds
23965,49,1552968000,31,9,40,Clouds
23966,50,1552968000,14,26,40,Clouds
23967,51,1552968000,4,36,40,Clouds
23968,52,1552968000,29,3,32,Clouds
23969,53,1552968000,38,2,40,Clouds
23970,54,1552968000,28,5,33,Clouds
23971,55,1552968000,23,13,36,Clouds
23972,56,1552968000,28,12,40,Clouds
23973,57,1552968000,12,11,23,Clouds
23974,58,1552968000,22,18,40,Clouds
23975,59,1552968000,19,1,20,Clouds
23976,60,1552968000,18,12,30,Clouds
23977,61,1552968000,25,0,25,Clouds
23978,62,1552968000,36,4,40,Clouds
23979,63,1552968000,14,21,35,Clouds
23980,64,1552968000,27,13,40,Clouds
23981,65,1552968000,38,2,40,Clouds
23982,66,1552968000,6,33,39,Clouds
23983,67,1552968000,18,22,40,Clouds
23984,68,1552968000,3,37,40,Clouds
23985,69,1552968000,0,39,39,Clouds
23986,70,1552968000,20,8,28,Clouds
23987,71,1552968000,25,14,39,Clouds
23988,72,1552968000,15,16,31,Clouds
23989,73,1552968000,7,23,30,Clouds
23990,74,1552968000,24,6,30,Clouds
23991,75,1552968000,33,7,40,Clouds
23992,76,1552968000,31,7,38,Clouds
23993,77,1552968000,17,12,29,Clouds
23994,78,1552968000,31,9,40,Clouds
23995,79,1552968000,27,0,27,Clouds
23996,80,1552968000,38,2,40,Clouds
23997,81,1552968000,39,1,40,Clouds
23998,82,1552968000,15,7,22,Clouds
23999,83,1552968000,25,15,40,Clouds
24000,84,1552968000,19,11,30,Clouds
24001,85,1552968000,23,12,35,Clouds
24002,86,1552968000,0,38,38,Clouds
24003,87,1552968000,24,14,38,Clouds
24004,88,1552968000,21,9,30,Clouds
24005,89,1552968000,26,14,40,Clouds
24006,90,1552968000,26,14,40,Clouds
24007,91,1552968000,14,16,30,Clouds
24008,92,1552968000,0,40,40,Clouds
24009,93,1552968000,9,31,40,Clouds
24010,94,1552968000,17,23,40,Clouds
24011,95,1552968000,39,1,40,Clouds
24012,96,1552968000,27,3,30,Clouds
24013,97,1552968000,27,13,40,Clouds
24014,98,1552968000,17,23,40,Clouds
24015,99,1552968000,0,29,29,Clouds
24016,100,1552968000,0,25,25,Clouds
24017,101,1552968000,19,11,30,Clouds
24018,102,1552968000,39,1,40,Clouds
24019,103,1552968000,40,0,40,Clouds
24020,104,1552968000,40,0,40,Clouds
24021,105,1552968000,36,0,36,Clouds
24022,106,1552968000,39,1,40,Clouds
24023,107,1552968000,39,1,40,Clouds
24024,108,1552968000,33,7,40,Clouds
24025,109,1552968000,9,20,29,Clouds
24026,110,1552968000,34,6,40,Clouds
24027,111,1552968000,27,13,40,Clouds
24028,112,1552968000,12,18,30,Clouds
24029,113,1552968000,0,0,0,Clouds
24030,114,1552968000,31,9,40,Clouds
24031,2,1552971600,10,10,20,Clouds
24032,3,1552971600,18,2,20,Clouds
24033,4,1552971600,16,3,19,Clouds
24034,5,1552971600,0,40,40,Clouds
24035,6,1552971600,11,9,20,Clouds
24036,7,1552971600,24,4,28,Clouds
24037,8,1552971600,20,8,28,Clouds
24038,9,1552971600,13,11,24,Clouds
24039,10,1552971600,4,12,16,Clouds
24040,11,1552971600,26,4,30,Clouds
24041,12,1552971600,13,6,19,Clouds
24042,13,1552971600,15,15,30,Clouds
24043,14,1552971600,27,3,30,Clouds
24044,15,1552971600,16,0,16,Clouds
24045,16,1552971600,11,9,20,Clouds
24046,17,1552971600,4,16,20,Clouds
24047,18,1552971600,21,8,29,Clouds
24048,19,1552971600,29,1,30,Clouds
24049,21,1552971600,16,14,30,Clouds
24050,22,1552971600,16,3,19,Clouds
24051,23,1552971600,0,0,0,Clouds
24052,24,1552971600,16,4,20,Clouds
24053,25,1552971600,0,0,0,Clouds
24054,26,1552971600,3,16,19,Clouds
24055,27,1552971600,19,1,20,Clouds
24056,28,1552971600,19,11,30,Clouds
24057,29,1552971600,27,2,29,Clouds
24058,30,1552971600,19,0,19,Clouds
24059,31,1552971600,20,0,20,Clouds
24060,32,1552971600,27,3,30,Clouds
24061,33,1552971600,23,0,23,Clouds
24062,34,1552971600,0,30,30,Clouds
24063,35,1552971600,23,7,30,Clouds
24064,36,1552971600,26,14,40,Clouds
24065,37,1552971600,21,9,30,Clouds
24066,38,1552971600,36,4,40,Clouds
24067,39,1552971600,12,8,20,Clouds
24068,40,1552971600,12,9,21,Clouds
24069,41,1552971600,9,11,20,Clouds
24070,42,1552971600,12,18,30,Clouds
24071,43,1552971600,0,30,30,Clouds
24072,44,1552971600,18,12,30,Clouds
24073,45,1552971600,9,21,30,Clouds
24074,46,1552971600,14,6,20,Clouds
24075,47,1552971600,31,9,40,Clouds
24076,48,1552971600,32,8,40,Clouds
24077,49,1552971600,31,9,40,Clouds
24078,50,1552971600,14,26,40,Clouds
24079,51,1552971600,4,36,40,Clouds
24080,52,1552971600,29,3,32,Clouds
24081,53,1552971600,38,2,40,Clouds
24082,54,1552971600,28,5,33,Clouds
24083,55,1552971600,23,13,36,Clouds
24084,56,1552971600,28,12,40,Clouds
24085,57,1552971600,12,11,23,Clouds
24086,58,1552971600,22,18,40,Clouds
24087,59,1552971600,19,1,20,Clouds
24088,60,1552971600,1,29,30,Clouds
24089,61,1552971600,25,0,25,Clouds
24090,62,1552971600,36,4,40,Clouds
24091,63,1552971600,14,21,35,Clouds
24092,64,1552971600,27,13,40,Clouds
24093,65,1552971600,38,2,40,Clouds
24094,66,1552971600,6,33,39,Clouds
24095,67,1552971600,18,22,40,Clouds
24096,68,1552971600,3,37,40,Clouds
24097,69,1552971600,0,39,39,Clouds
24098,70,1552971600,20,8,28,Clouds
24099,71,1552971600,25,14,39,Clouds
24100,72,1552971600,15,16,31,Clouds
24101,73,1552971600,7,23,30,Clouds
24102,74,1552971600,24,6,30,Clouds
24103,75,1552971600,33,7,40,Clouds
24104,76,1552971600,31,7,38,Clouds
24105,77,1552971600,17,12,29,Clouds
24106,78,1552971600,31,9,40,Clouds
24107,79,1552971600,27,0,27,Clouds
24108,80,1552971600,38,2,40,Clouds
24109,81,1552971600,39,1,40,Clouds
24110,82,1552971600,15,7,22,Clouds
24111,83,1552971600,25,15,40,Clouds
24112,84,1552971600,19,11,30,Clouds
24113,85,1552971600,23,12,35,Clouds
24114,86,1552971600,0,38,38,Clouds
24115,87,1552971600,24,14,38,Clouds
24116,88,1552971600,21,9,30,Clouds
24117,89,1552971600,26,14,40,Clouds
24118,90,1552971600,26,14,40,Clouds
24119,91,1552971600,14,16,30,Clouds
24120,92,1552971600,0,40,40,Clouds
24121,93,1552971600,9,31,40,Clouds
24122,94,1552971600,17,23,40,Clouds
24123,95,1552971600,39,1,40,Clouds
24124,96,1552971600,27,3,30,Clouds
24125,97,1552971600,27,13,40,Clouds
24126,98,1552971600,17,23,40,Clouds
24127,99,1552971600,0,29,29,Clouds
24128,100,1552971600,0,25,25,Clouds
24129,101,1552971600,19,11,30,Clouds
24130,102,1552971600,39,1,40,Clouds
24131,103,1552971600,40,0,40,Clouds
24132,104,1552971600,40,0,40,Clouds
24133,105,1552971600,36,0,36,Clouds
24134,106,1552971600,39,1,40,Clouds
24135,107,1552971600,39,1,40,Clouds
24136,108,1552971600,33,7,40,Clouds
24137,109,1552971600,9,20,29,Clouds
24138,110,1552971600,34,6,40,Clouds
24139,111,1552971600,27,13,40,Clouds
24140,112,1552971600,12,18,30,Clouds
24141,113,1552971600,0,0,0,Clouds
24142,114,1552971600,31,9,40,Clouds
24143,2,1552975200,10,10,20,Clouds
24144,3,1552975200,18,2,20,Clouds
24145,4,1552975200,16,3,19,Clouds
24146,5,1552975200,0,40,40,Clouds
24147,6,1552975200,11,9,20,Clouds
24148,7,1552975200,24,4,28,Clouds
24149,8,1552975200,20,8,28,Clouds
24150,9,1552975200,13,11,24,Clouds
24151,10,1552975200,4,12,16,Clouds
24152,11,1552975200,26,4,30,Clouds
24153,12,1552975200,13,6,19,Clouds
24154,13,1552975200,15,15,30,Clouds
24155,14,1552975200,27,3,30,Clouds
24156,15,1552975200,16,0,16,Clouds
24157,16,1552975200,11,9,20,Clouds
24158,17,1552975200,4,16,20,Clouds
24159,18,1552975200,21,8,29,Clouds
24160,19,1552975200,29,1,30,Clouds
24161,21,1552975200,16,14,30,Clouds
24162,22,1552975200,16,3,19,Clouds
24163,23,1552975200,0,0,0,Clouds
24164,24,1552975200,16,4,20,Clouds
24165,25,1552975200,0,0,0,Clouds
24166,26,1552975200,3,16,19,Clouds
24167,27,1552975200,19,1,20,Clouds
24168,28,1552975200,2,28,30,Clouds
24169,29,1552975200,27,2,29,Clouds
24170,30,1552975200,19,0,19,Clouds
24171,31,1552975200,20,0,20,Clouds
24172,32,1552975200,27,3,30,Clouds
24173,33,1552975200,23,0,23,Clouds
24174,34,1552975200,0,30,30,Clouds
24175,35,1552975200,23,7,30,Clouds
24176,36,1552975200,26,14,40,Clouds
24177,37,1552975200,21,9,30,Clouds
24178,38,1552975200,36,4,40,Clouds
24179,39,1552975200,12,8,20,Clouds
24180,40,1552975200,12,9,21,Clouds
24181,41,1552975200,9,11,20,Clouds
24182,42,1552975200,12,18,30,Clouds
24183,43,1552975200,0,30,30,Clouds
24184,44,1552975200,18,12,30,Clouds
24185,45,1552975200,9,21,30,Clouds
24186,46,1552975200,14,6,20,Clouds
24187,47,1552975200,31,9,40,Clouds
24188,48,1552975200,32,8,40,Clouds
24189,49,1552975200,31,9,40,Clouds
24190,50,1552975200,14,26,40,Clouds
24191,51,1552975200,4,36,40,Clouds
24192,52,1552975200,29,3,32,Clouds
24193,53,1552975200,38,2,40,Clouds
24194,54,1552975200,28,5,33,Clouds
24195,55,1552975200,23,13,36,Clouds
24196,56,1552975200,28,12,40,Clouds
24197,57,1552975200,12,11,23,Clouds
24198,58,1552975200,22,18,40,Clouds
24199,59,1552975200,19,1,20,Clouds
24200,60,1552975200,1,29,30,Clouds
24201,61,1552975200,25,0,25,Clouds
24202,62,1552975200,36,4,40,Clouds
24203,63,1552975200,14,21,35,Clouds
24204,64,1552975200,27,13,40,Clouds
24205,65,1552975200,38,2,40,Clouds
24206,66,1552975200,23,16,39,Clouds
24207,67,1552975200,18,22,40,Clouds
24208,68,1552975200,3,37,40,Clouds
24209,69,1552975200,0,39,39,Clouds
24210,70,1552975200,20,8,28,Clouds
24211,71,1552975200,25,14,39,Clouds
24212,72,1552975200,15,16,31,Clouds
24213,73,1552975200,7,23,30,Clouds
24214,74,1552975200,24,6,30,Clouds
24215,75,1552975200,33,7,40,Clouds
24216,76,1552975200,31,7,38,Clouds
24217,77,1552975200,17,12,29,Clouds
24218,78,1552975200,31,9,40,Clouds
24219,79,1552975200,27,0,27,Clouds
24220,80,1552975200,40,0,40,Clouds
24221,81,1552975200,39,1,40,Clouds
24222,82,1552975200,15,7,22,Clouds
24223,83,1552975200,25,15,40,Clouds
24224,84,1552975200,19,11,30,Clouds
24225,85,1552975200,23,12,35,Clouds
24226,86,1552975200,0,38,38,Clouds
24227,87,1552975200,24,14,38,Clouds
24228,88,1552975200,21,9,30,Clouds
24229,89,1552975200,26,14,40,Clouds
24230,90,1552975200,26,14,40,Clouds
24231,91,1552975200,14,16,30,Clouds
24232,92,1552975200,0,40,40,Clouds
24233,93,1552975200,9,31,40,Clouds
24234,94,1552975200,17,23,40,Clouds
24235,95,1552975200,39,1,40,Clouds
24236,96,1552975200,27,3,30,Clouds
24237,97,1552975200,27,13,40,Clouds
24238,98,1552975200,17,23,40,Clouds
24239,99,1552975200,0,29,29,Clouds
24240,100,1552975200,0,25,25,Clouds
24241,101,1552975200,19,11,30,Clouds
24242,102,1552975200,39,1,40,Clouds
24243,103,1552975200,40,0,40,Clouds
24244,104,1552975200,40,0,40,Clouds
24245,105,1552975200,36,0,36,Clouds
24246,106,1552975200,39,1,40,Clouds
24247,107,1552975200,39,1,40,Clouds
24248,108,1552975200,33,7,40,Clouds
24249,109,1552975200,9,20,29,Clouds
24250,110,1552975200,34,6,40,Clouds
24251,111,1552975200,27,13,40,Clouds
24252,112,1552975200,12,18,30,Clouds
24253,113,1552975200,0,0,0,Clouds
24254,114,1552975200,31,9,40,Clouds
24255,2,1552978800,11,9,20,Drizzle
24256,3,1552978800,20,0,20,Drizzle
24257,4,1552978800,16,3,19,Drizzle
24258,5,1552978800,1,39,40,Drizzle
24259,6,1552978800,11,9,20,Drizzle
24260,7,1552978800,24,4,28,Drizzle
24261,8,1552978800,19,9,28,Drizzle
24262,9,1552978800,6,18,24,Drizzle
24263,10,1552978800,1,15,16,Drizzle
24264,11,1552978800,25,5,30,Drizzle
24265,12,1552978800,15,4,19,Drizzle
24266,13,1552978800,15,15,30,Drizzle
24267,14,1552978800,20,10,30,Drizzle
24268,15,1552978800,16,0,16,Drizzle
24269,16,1552978800,10,10,20,Drizzle
24270,17,1552978800,5,15,20,Drizzle
24271,18,1552978800,19,10,29,Drizzle
24272,19,1552978800,28,2,30,Drizzle
24273,21,1552978800,15,15,30,Drizzle
24274,22,1552978800,15,4,19,Drizzle
24275,23,1552978800,0,0,0,Drizzle
24276,24,1552978800,15,5,20,Drizzle
24277,25,1552978800,0,0,0,Drizzle
24278,26,1552978800,2,17,19,Drizzle
24279,27,1552978800,19,1,20,Drizzle
24280,28,1552978800,7,23,30,Drizzle
24281,29,1552978800,25,4,29,Drizzle
24282,30,1552978800,18,1,19,Drizzle
24283,31,1552978800,19,1,20,Drizzle
24284,32,1552978800,22,8,30,Drizzle
24285,33,1552978800,15,8,23,Drizzle
24286,34,1552978800,3,27,30,Drizzle
24287,35,1552978800,26,4,30,Drizzle
24288,36,1552978800,25,15,40,Drizzle
24289,37,1552978800,21,9,30,Drizzle
24290,38,1552978800,38,2,40,Drizzle
24291,39,1552978800,13,7,20,Drizzle
24292,40,1552978800,11,10,21,Drizzle
24293,41,1552978800,8,12,20,Drizzle
24294,42,1552978800,14,16,30,Drizzle
24295,43,1552978800,3,27,30,Drizzle
24296,44,1552978800,22,8,30,Drizzle
24297,45,1552978800,10,20,30,Drizzle
24298,46,1552978800,16,4,20,Drizzle
24299,47,1552978800,31,9,40,Drizzle
24300,48,1552978800,33,7,40,Drizzle
24301,49,1552978800,26,14,40,Drizzle
24302,50,1552978800,17,23,40,Drizzle
24303,51,1552978800,4,36,40,Drizzle
24304,52,1552978800,20,12,32,Drizzle
24305,53,1552978800,38,2,40,Drizzle
24306,54,1552978800,28,5,33,Drizzle
24307,55,1552978800,23,13,36,Drizzle
24308,56,1552978800,31,9,40,Drizzle
24309,57,1552978800,11,12,23,Drizzle
24310,58,1552978800,20,20,40,Drizzle
24311,59,1552978800,19,1,20,Drizzle
24312,60,1552978800,7,23,30,Drizzle
24313,61,1552978800,25,0,25,Drizzle
24314,62,1552978800,35,5,40,Drizzle
24315,63,1552978800,14,21,35,Drizzle
24316,64,1552978800,27,13,40,Drizzle
24317,65,1552978800,38,2,40,Drizzle
24318,66,1552978800,24,15,39,Drizzle
24319,67,1552978800,18,22,40,Drizzle
24320,68,1552978800,4,36,40,Drizzle
24321,69,1552978800,13,26,39,Drizzle
24322,70,1552978800,16,12,28,Drizzle
24323,71,1552978800,28,11,39,Drizzle
24324,72,1552978800,16,15,31,Drizzle
24325,73,1552978800,12,18,30,Drizzle
24326,74,1552978800,25,5,30,Drizzle
24327,75,1552978800,35,5,40,Drizzle
24328,76,1552978800,32,6,38,Drizzle
24329,77,1552978800,18,11,29,Drizzle
24330,78,1552978800,34,6,40,Drizzle
24331,79,1552978800,9,18,27,Drizzle
24332,80,1552978800,40,0,40,Drizzle
24333,81,1552978800,39,1,40,Drizzle
24334,82,1552978800,15,7,22,Drizzle
24335,83,1552978800,29,11,40,Drizzle
24336,84,1552978800,21,9,30,Drizzle
24337,85,1552978800,23,12,35,Drizzle
24338,86,1552978800,0,38,38,Drizzle
24339,87,1552978800,26,12,38,Drizzle
24340,88,1552978800,19,11,30,Drizzle
24341,89,1552978800,27,13,40,Drizzle
24342,90,1552978800,40,0,40,Drizzle
24343,91,1552978800,14,16,30,Drizzle
24344,92,1552978800,1,39,40,Drizzle
24345,93,1552978800,3,37,40,Drizzle
24346,94,1552978800,5,35,40,Drizzle
24347,95,1552978800,40,0,40,Drizzle
24348,96,1552978800,27,3,30,Drizzle
24349,97,1552978800,30,10,40,Drizzle
24350,98,1552978800,18,22,40,Drizzle
24351,99,1552978800,15,14,29,Drizzle
24352,100,1552978800,0,25,25,Drizzle
24353,101,1552978800,27,3,30,Drizzle
24354,102,1552978800,40,0,40,Drizzle
24355,103,1552978800,40,0,40,Drizzle
24356,104,1552978800,40,0,40,Drizzle
24357,105,1552978800,36,0,36,Drizzle
24358,106,1552978800,40,0,40,Drizzle
24359,107,1552978800,40,0,40,Drizzle
24360,108,1552978800,35,5,40,Drizzle
24361,109,1552978800,15,14,29,Drizzle
24362,110,1552978800,33,7,40,Drizzle
24363,111,1552978800,24,16,40,Drizzle
24364,112,1552978800,16,14,30,Drizzle
24365,113,1552978800,0,0,0,Drizzle
24366,114,1552978800,29,11,40,Drizzle
24367,2,1552982400,20,0,20,Rain
24368,3,1552982400,20,0,20,Rain
24369,4,1552982400,15,4,19,Rain
24370,5,1552982400,15,25,40,Rain
24371,6,1552982400,14,6,20,Rain
24372,7,1552982400,24,4,28,Rain
24373,8,1552982400,15,13,28,Rain
24374,9,1552982400,16,8,24,Rain
24375,10,1552982400,2,14,16,Rain
24376,11,1552982400,22,8,30,Rain
24377,12,1552982400,19,0,19,Rain
24378,13,1552982400,14,16,30,Rain
24379,14,1552982400,16,14,30,Rain
24380,15,1552982400,16,0,16,Rain
24381,16,1552982400,12,8,20,Rain
24382,17,1552982400,5,15,20,Rain
24383,18,1552982400,16,12,28,Rain
24384,19,1552982400,18,12,30,Rain
24385,21,1552982400,14,16,30,Rain
24386,22,1552982400,8,11,19,Rain
24387,23,1552982400,0,0,0,Rain
24388,24,1552982400,14,6,20,Rain
24389,25,1552982400,0,0,0,Rain
24390,26,1552982400,0,19,19,Rain
24391,27,1552982400,11,9,20,Rain
24392,28,1552982400,16,14,30,Rain
24393,29,1552982400,24,5,29,Rain
24394,30,1552982400,1,18,19,Rain
24395,31,1552982400,19,1,20,Rain
24396,32,1552982400,15,15,30,Rain
24397,33,1552982400,14,9,23,Rain
24398,34,1552982400,22,8,30,Rain
24399,35,1552982400,28,2,30,Rain
24400,36,1552982400,23,17,40,Rain
24401,37,1552982400,22,8,30,Rain
24402,38,1552982400,35,5,40,Rain
24403,39,1552982400,10,10,20,Rain
24404,40,1552982400,7,14,21,Rain
24405,41,1552982400,8,12,20,Rain
24406,42,1552982400,23,7,30,Rain
24407,43,1552982400,18,12,30,Rain
24408,44,1552982400,30,0,30,Rain
24409,45,1552982400,13,17,30,Rain
24410,46,1552982400,14,6,20,Rain
24411,47,1552982400,27,13,40,Rain
24412,48,1552982400,37,3,40,Rain
24413,49,1552982400,26,14,40,Rain
24414,50,1552982400,24,16,40,Rain
24415,51,1552982400,18,22,40,Rain
24416,52,1552982400,17,15,32,Rain
24417,53,1552982400,36,4,40,Rain
24418,54,1552982400,23,10,33,Rain
24419,55,1552982400,19,17,36,Rain
24420,56,1552982400,28,12,40,Rain
24421,57,1552982400,14,9,23,Rain
24422,58,1552982400,9,31,40,Rain
24423,59,1552982400,20,0,20,Rain
24424,60,1552982400,24,6,30,Rain
24425,61,1552982400,25,0,25,Rain
24426,62,1552982400,34,6,40,Rain
24427,63,1552982400,12,23,35,Rain
24428,64,1552982400,23,17,40,Rain
24429,65,1552982400,29,11,40,Rain
24430,66,1552982400,9,30,39,Rain
24431,67,1552982400,11,29,40,Rain
24432,68,1552982400,25,15,40,Rain
24433,69,1552982400,1,38,39,Rain
24434,70,1552982400,7,21,28,Rain
24435,71,1552982400,31,8,39,Rain
24436,72,1552982400,21,10,31,Rain
24437,73,1552982400,23,7,30,Rain
24438,74,1552982400,27,3,30,Rain
24439,75,1552982400,37,3,40,Rain
24440,76,1552982400,38,0,38,Rain
24441,77,1552982400,20,9,29,Rain
24442,78,1552982400,39,1,40,Rain
24443,79,1552982400,11,16,27,Rain
24444,80,1552982400,40,0,40,Rain
24445,81,1552982400,20,20,40,Rain
24446,82,1552982400,16,6,22,Rain
24447,83,1552982400,34,6,40,Rain
24448,84,1552982400,25,5,30,Rain
24449,85,1552982400,28,7,35,Rain
24450,86,1552982400,5,33,38,Rain
24451,87,1552982400,28,10,38,Rain
24452,88,1552982400,23,7,30,Rain
24453,89,1552982400,26,14,40,Rain
24454,90,1552982400,25,15,40,Rain
24455,91,1552982400,28,2,30,Rain
24456,92,1552982400,2,38,40,Rain
24457,93,1552982400,10,30,40,Rain
24458,94,1552982400,6,34,40,Rain
24459,95,1552982400,40,0,40,Rain
24460,96,1552982400,29,1,30,Rain
24461,97,1552982400,40,0,40,Rain
24462,98,1552982400,17,23,40,Rain
24463,99,1552982400,13,16,29,Rain
24464,100,1552982400,10,15,25,Rain
24465,101,1552982400,30,0,30,Rain
24466,102,1552982400,40,0,40,Rain
24467,103,1552982400,38,2,40,Rain
24468,104,1552982400,40,0,40,Rain
24469,105,1552982400,34,2,36,Rain
24470,106,1552982400,26,14,40,Rain
24471,107,1552982400,40,0,40,Rain
24472,108,1552982400,40,0,40,Rain
24473,109,1552982400,22,7,29,Rain
24474,110,1552982400,37,3,40,Rain
24475,111,1552982400,18,22,40,Rain
24476,112,1552982400,30,0,30,Rain
24477,113,1552982400,0,0,0,Rain
24478,114,1552982400,25,15,40,Rain
24479,115,1552982400,0,30,30,Rain
24480,2,1552986000,19,1,20,Drizzle
24481,3,1552986000,20,0,20,Drizzle
24482,4,1552986000,18,1,19,Drizzle
24483,5,1552986000,40,0,40,Drizzle
24484,6,1552986000,18,2,20,Drizzle
24485,7,1552986000,28,0,28,Drizzle
24486,8,1552986000,14,14,28,Drizzle
24487,9,1552986000,14,10,24,Drizzle
24488,10,1552986000,3,13,16,Drizzle
24489,11,1552986000,16,14,30,Drizzle
24490,12,1552986000,18,1,19,Drizzle
24491,13,1552986000,26,4,30,Drizzle
24492,14,1552986000,12,18,30,Drizzle
24493,15,1552986000,16,0,16,Drizzle
24494,16,1552986000,17,3,20,Drizzle
24495,17,1552986000,4,16,20,Drizzle
24496,18,1552986000,11,17,28,Drizzle
24497,19,1552986000,13,17,30,Drizzle
24498,21,1552986000,11,19,30,Drizzle
24499,22,1552986000,9,10,19,Drizzle
24500,23,1552986000,0,0,0,Drizzle
24501,24,1552986000,20,0,20,Drizzle
24502,25,1552986000,0,0,0,Drizzle
24503,26,1552986000,0,19,19,Drizzle
24504,27,1552986000,3,17,20,Drizzle
24505,28,1552986000,26,4,30,Drizzle
24506,29,1552986000,25,4,29,Drizzle
24507,30,1552986000,7,12,19,Drizzle
24508,31,1552986000,17,3,20,Drizzle
24509,32,1552986000,13,17,30,Drizzle
24510,33,1552986000,9,14,23,Drizzle
24511,34,1552986000,30,0,30,Drizzle
24512,35,1552986000,30,0,30,Drizzle
24513,36,1552986000,21,19,40,Drizzle
24514,37,1552986000,20,10,30,Drizzle
24515,38,1552986000,29,11,40,Drizzle
24516,39,1552986000,13,7,20,Drizzle
24517,40,1552986000,3,18,21,Drizzle
24518,41,1552986000,13,7,20,Drizzle
24519,42,1552986000,30,0,30,Drizzle
24520,43,1552986000,20,10,30,Drizzle
24521,44,1552986000,20,10,30,Drizzle
24522,45,1552986000,12,18,30,Drizzle
24523,46,1552986000,17,3,20,Drizzle
24524,47,1552986000,30,10,40,Drizzle
24525,48,1552986000,34,6,40,Drizzle
24526,49,1552986000,36,4,40,Drizzle
24527,50,1552986000,39,1,40,Drizzle
24528,51,1552986000,15,25,40,Drizzle
24529,52,1552986000,21,11,32,Drizzle
24530,53,1552986000,32,8,40,Drizzle
24531,54,1552986000,23,10,33,Drizzle
24532,55,1552986000,11,25,36,Drizzle
24533,56,1552986000,27,13,40,Drizzle
24534,57,1552986000,5,18,23,Drizzle
24535,58,1552986000,10,30,40,Drizzle
24536,59,1552986000,17,3,20,Drizzle
24537,60,1552986000,25,5,30,Drizzle
24538,61,1552986000,25,0,25,Drizzle
24539,62,1552986000,35,5,40,Drizzle
24540,63,1552986000,5,30,35,Drizzle
24541,64,1552986000,21,19,40,Drizzle
24542,65,1552986000,20,20,40,Drizzle
24543,66,1552986000,1,38,39,Drizzle
24544,67,1552986000,7,33,40,Drizzle
24545,68,1552986000,15,24,39,Drizzle
24546,69,1552986000,2,37,39,Drizzle
24547,70,1552986000,6,22,28,Drizzle
24548,71,1552986000,33,6,39,Drizzle
24549,72,1552986000,30,1,31,Drizzle
24550,73,1552986000,30,0,30,Drizzle
24551,74,1552986000,30,0,30,Drizzle
24552,75,1552986000,40,0,40,Drizzle
24553,76,1552986000,38,0,38,Drizzle
24554,77,1552986000,23,6,29,Drizzle
24555,78,1552986000,35,5,40,Drizzle
24556,79,1552986000,20,7,27,Drizzle
24557,80,1552986000,39,1,40,Drizzle
24558,81,1552986000,29,11,40,Drizzle
24559,82,1552986000,22,0,22,Drizzle
24560,83,1552986000,40,0,40,Drizzle
24561,84,1552986000,30,0,30,Drizzle
24562,85,1552986000,35,0,35,Drizzle
24563,86,1552986000,17,21,38,Drizzle
24564,87,1552986000,31,7,38,Drizzle
24565,88,1552986000,30,0,30,Drizzle
24566,89,1552986000,19,21,40,Drizzle
24567,90,1552986000,9,31,40,Drizzle
24568,91,1552986000,29,1,30,Drizzle
24569,92,1552986000,13,27,40,Drizzle
24570,93,1552986000,17,23,40,Drizzle
24571,94,1552986000,13,27,40,Drizzle
24572,95,1552986000,40,0,40,Drizzle
24573,96,1552986000,30,0,30,Drizzle
24574,97,1552986000,40,0,40,Drizzle
24575,98,1552986000,16,24,40,Drizzle
24576,99,1552986000,11,18,29,Drizzle
24577,100,1552986000,25,0,25,Drizzle
24578,101,1552986000,30,0,30,Drizzle
24579,102,1552986000,40,0,40,Drizzle
24580,103,1552986000,36,4,40,Drizzle
24581,104,1552986000,38,2,40,Drizzle
24582,105,1552986000,33,3,36,Drizzle
24583,106,1552986000,36,4,40,Drizzle
24584,107,1552986000,40,0,40,Drizzle
24585,108,1552986000,40,0,40,Drizzle
24586,109,1552986000,29,0,29,Drizzle
24587,110,1552986000,40,0,40,Drizzle
24588,111,1552986000,33,7,40,Drizzle
24589,112,1552986000,30,0,30,Drizzle
24590,113,1552986000,35,3,38,Drizzle
24591,114,1552986000,0,40,40,Drizzle
24592,115,1552986000,7,23,30,Drizzle
24593,2,1552989600,20,0,20,Drizzle
24594,3,1552989600,19,1,20,Drizzle
24595,4,1552989600,15,4,19,Drizzle
24596,5,1552989600,40,0,40,Drizzle
24597,6,1552989600,20,0,20,Drizzle
24598,7,1552989600,27,1,28,Drizzle
24599,8,1552989600,14,14,28,Drizzle
24600,9,1552989600,14,10,24,Drizzle
24601,10,1552989600,16,0,16,Drizzle
24602,11,1552989600,1,29,30,Drizzle
24603,12,1552989600,18,1,19,Drizzle
24604,13,1552989600,15,15,30,Drizzle
24605,14,1552989600,29,1,30,Drizzle
24606,15,1552989600,14,2,16,Drizzle
24607,16,1552989600,13,7,20,Drizzle
24608,17,1552989600,19,1,20,Drizzle
24609,18,1552989600,27,2,29,Drizzle
24610,19,1552989600,0,30,30,Drizzle
24611,21,1552989600,6,24,30,Drizzle
24612,22,1552989600,16,3,19,Drizzle
24613,23,1552989600,28,2,30,Drizzle
24614,24,1552989600,16,4,20,Drizzle
24615,25,1552989600,7,21,28,Drizzle
24616,26,1552989600,8,11,19,Drizzle
24617,27,1552989600,10,10,20,Drizzle
24618,28,1552989600,30,0,30,Drizzle
24619,29,1552989600,27,2,29,Drizzle
24620,30,1552989600,19,0,19,Drizzle
24621,31,1552989600,20,0,20,Drizzle
24622,32,1552989600,15,15,30,Drizzle
24623,33,1552989600,23,0,23,Drizzle
24624,34,1552989600,23,7,30,Drizzle
24625,35,1552989600,28,2,30,Drizzle
24626,36,1552989600,4,36,40,Drizzle
24627,37,1552989600,18,12,30,Drizzle
24628,38,1552989600,40,0,40,Drizzle
24629,39,1552989600,19,1,20,Drizzle
24630,40,1552989600,18,3,21,Drizzle
24631,41,1552989600,20,0,20,Drizzle
24632,42,1552989600,30,0,30,Drizzle
24633,43,1552989600,30,0,30,Drizzle
24634,44,1552989600,30,0,30,Drizzle
24635,45,1552989600,30,0,30,Drizzle
24636,46,1552989600,19,1,20,Drizzle
24637,47,1552989600,4,36,40,Drizzle
24638,48,1552989600,22,18,40,Drizzle
24639,49,1552989600,33,7,40,Drizzle
24640,50,1552989600,40,0,40,Drizzle
24641,51,1552989600,10,30,40,Drizzle
24642,52,1552989600,17,15,32,Drizzle
24643,53,1552989600,24,16,40,Drizzle
24644,54,1552989600,24,9,33,Drizzle
24645,55,1552989600,12,24,36,Drizzle
24646,56,1552989600,12,28,40,Drizzle
24647,57,1552989600,0,23,23,Drizzle
24648,58,1552989600,7,33,40,Drizzle
24649,59,1552989600,20,0,20,Drizzle
24650,60,1552989600,30,0,30,Drizzle
24651,61,1552989600,24,1,25,Drizzle
24652,62,1552989600,21,19,40,Drizzle
24653,63,1552989600,1,34,35,Drizzle
24654,64,1552989600,2,38,40,Drizzle
24655,65,1552989600,23,17,40,Drizzle
24656,66,1552989600,4,35,39,Drizzle
24657,67,1552989600,6,34,40,Drizzle
24658,68,1552989600,0,39,39,Drizzle
24659,69,1552989600,1,38,39,Drizzle
24660,70,1552989600,5,23,28,Drizzle
24661,71,1552989600,36,3,39,Drizzle
24662,72,1552989600,29,2,31,Drizzle
24663,73,1552989600,30,0,30,Drizzle
24664,74,1552989600,29,1,30,Drizzle
24665,75,1552989600,40,0,40,Drizzle
24666,76,1552989600,38,0,38,Drizzle
24667,77,1552989600,28,1,29,Drizzle
24668,78,1552989600,29,11,40,Drizzle
24669,79,1552989600,27,0,27,Drizzle
24670,80,1552989600,39,1,40,Drizzle
24671,81,1552989600,40,0,40,Drizzle
24672,82,1552989600,22,0,22,Drizzle
24673,83,1552989600,40,0,40,Drizzle
24674,84,1552989600,30,0,30,Drizzle
24675,85,1552989600,34,1,35,Drizzle
24676,86,1552989600,38,0,38,Drizzle
24677,87,1552989600,38,0,38,Drizzle
24678,88,1552989600,30,0,30,Drizzle
24679,89,1552989600,12,28,40,Drizzle
24680,90,1552989600,0,40,40,Drizzle
24681,91,1552989600,28,2,30,Drizzle
24682,92,1552989600,40,0,40,Drizzle
24683,93,1552989600,40,0,40,Drizzle
24684,94,1552989600,40,0,40,Drizzle
24685,95,1552989600,40,0,40,Drizzle
24686,96,1552989600,30,0,30,Drizzle
24687,97,1552989600,40,0,40,Drizzle
24688,98,1552989600,12,28,40,Drizzle
24689,99,1552989600,1,28,29,Drizzle
24690,100,1552989600,25,0,25,Drizzle
24691,101,1552989600,30,0,30,Drizzle
24692,102,1552989600,40,0,40,Drizzle
24693,103,1552989600,39,1,40,Drizzle
24694,104,1552989600,40,0,40,Drizzle
24695,105,1552989600,36,0,36,Drizzle
24696,106,1552989600,40,0,40,Drizzle
24697,107,1552989600,40,0,40,Drizzle
24698,108,1552989600,40,0,40,Drizzle
24699,109,1552989600,26,3,29,Drizzle
24700,110,1552989600,40,0,40,Drizzle
24701,111,1552989600,39,1,40,Drizzle
24702,112,1552989600,30,0,30,Drizzle
24703,113,1552989600,26,14,40,Drizzle
24704,114,1552989600,0,40,40,Drizzle
24705,115,1552989600,29,1,30,Drizzle
24706,2,1552993200,20,0,20,Clouds
24707,3,1552993200,18,2,20,Clouds
24708,4,1552993200,13,6,19,Clouds
24709,5,1552993200,40,0,40,Clouds
24710,6,1552993200,20,0,20,Clouds
24711,7,1552993200,28,0,28,Clouds
24712,8,1552993200,13,17,30,Clouds
24713,9,1552993200,8,15,23,Clouds
24714,10,1552993200,13,3,16,Clouds
24715,11,1552993200,20,10,30,Clouds
24716,12,1552993200,19,0,19,Clouds
24717,13,1552993200,4,26,30,Clouds
24718,14,1552993200,27,3,30,Clouds
24719,15,1552993200,16,0,16,Clouds
24720,16,1552993200,19,1,20,Clouds
24721,17,1552993200,20,0,20,Clouds
24722,18,1552993200,29,0,29,Clouds
24723,19,1552993200,0,30,30,Clouds
24724,21,1552993200,0,30,30,Clouds
24725,22,1552993200,13,7,20,Clouds
24726,23,1552993200,28,2,30,Clouds
24727,24,1552993200,19,1,20,Clouds
24728,25,1552993200,0,28,28,Clouds
24729,26,1552993200,0,19,19,Clouds
24730,27,1552993200,0,20,20,Clouds
24731,28,1552993200,19,11,30,Clouds
24732,29,1552993200,24,5,29,Clouds
24733,30,1552993200,19,0,19,Clouds
24734,31,1552993200,16,4,20,Clouds
24735,32,1552993200,14,16,30,Clouds
24736,33,1552993200,19,4,23,Clouds
24737,34,1552993200,14,16,30,Clouds
24738,35,1552993200,30,0,30,Clouds
24739,36,1552993200,2,38,40,Clouds
24740,37,1552993200,19,11,30,Clouds
24741,38,1552993200,40,0,40,Clouds
24742,39,1552993200,9,11,20,Clouds
24743,40,1552993200,19,2,21,Clouds
24744,41,1552993200,9,11,20,Clouds
24745,42,1552993200,30,0,30,Clouds
24746,43,1552993200,13,17,30,Clouds
24747,44,1552993200,30,0,30,Clouds
24748,45,1552993200,28,2,30,Clouds
24749,46,1552993200,18,2,20,Clouds
24750,47,1552993200,0,40,40,Clouds
24751,48,1552993200,13,27,40,Clouds
24752,49,1552993200,8,32,40,Clouds
24753,50,1552993200,40,0,40,Clouds
24754,51,1552993200,17,23,40,Clouds
24755,52,1552993200,19,13,32,Clouds
24756,53,1552993200,15,25,40,Clouds
24757,54,1552993200,22,11,33,Clouds
24758,55,1552993200,7,29,36,Clouds
24759,56,1552993200,1,39,40,Clouds
24760,57,1552993200,0,23,23,Clouds
24761,58,1552993200,0,40,40,Clouds
24762,59,1552993200,20,0,20,Clouds
24763,60,1552993200,30,0,30,Clouds
24764,61,1552993200,25,0,25,Clouds
24765,62,1552993200,8,32,40,Clouds
24766,63,1552993200,1,34,35,Clouds
24767,64,1552993200,1,39,40,Clouds
24768,65,1552993200,9,31,40,Clouds
24769,66,1552993200,1,39,40,Clouds
24770,67,1552993200,2,38,40,Clouds
24771,68,1552993200,1,38,39,Clouds
24772,69,1552993200,0,39,39,Clouds
24773,70,1552993200,0,28,28,Clouds
24774,71,1552993200,37,2,39,Clouds
24775,72,1552993200,31,0,31,Clouds
24776,73,1552993200,25,5,30,Clouds
24777,74,1552993200,29,1,30,Clouds
24778,75,1552993200,40,0,40,Clouds
24779,76,1552993200,38,0,38,Clouds
24780,77,1552993200,27,2,29,Clouds
24781,78,1552993200,40,0,40,Clouds
24782,79,1552993200,27,0,27,Clouds
24783,80,1552993200,39,1,40,Clouds
24784,81,1552993200,39,1,40,Clouds
24785,82,1552993200,21,1,22,Clouds
24786,83,1552993200,40,0,40,Clouds
24787,84,1552993200,30,0,30,Clouds
24788,85,1552993200,35,0,35,Clouds
24789,86,1552993200,36,2,38,Clouds
24790,87,1552993200,38,0,38,Clouds
24791,88,1552993200,30,0,30,Clouds
24792,89,1552993200,0,40,40,Clouds
24793,90,1552993200,2,38,40,Clouds
24794,91,1552993200,16,14,30,Clouds
24795,92,1552993200,39,1,40,Clouds
24796,93,1552993200,40,0,40,Clouds
24797,94,1552993200,40,0,40,Clouds
24798,95,1552993200,40,0,40,Clouds
24799,96,1552993200,30,0,30,Clouds
24800,97,1552993200,40,0,40,Clouds
24801,98,1552993200,16,24,40,Clouds
24802,99,1552993200,1,28,29,Clouds
24803,100,1552993200,19,6,25,Clouds
24804,101,1552993200,29,1,30,Clouds
24805,102,1552993200,40,0,40,Clouds
24806,103,1552993200,40,0,40,Clouds
24807,104,1552993200,40,0,40,Clouds
24808,105,1552993200,36,0,36,Clouds
24809,106,1552993200,40,0,40,Clouds
24810,107,1552993200,40,0,40,Clouds
24811,108,1552993200,40,0,40,Clouds
24812,109,1552993200,28,1,29,Clouds
24813,110,1552993200,40,0,40,Clouds
24814,111,1552993200,40,0,40,Clouds
24815,112,1552993200,29,1,30,Clouds
24816,113,1552993200,14,26,40,Clouds
24817,114,1552993200,0,40,40,Clouds
24818,115,1552993200,30,0,30,Clouds
24819,2,1552996800,20,0,20,Clouds
24820,3,1552996800,20,0,20,Clouds
24821,4,1552996800,15,4,19,Clouds
24822,5,1552996800,7,33,40,Clouds
24823,6,1552996800,18,2,20,Clouds
24824,7,1552996800,28,0,28,Clouds
24825,8,1552996800,16,14,30,Clouds
24826,9,1552996800,7,16,23,Clouds
24827,10,1552996800,16,0,16,Clouds
24828,11,1552996800,17,13,30,Clouds
24829,12,1552996800,19,0,19,Clouds
24830,13,1552996800,7,23,30,Clouds
24831,14,1552996800,24,6,30,Clouds
24832,15,1552996800,16,0,16,Clouds
24833,16,1552996800,17,3,20,Clouds
24834,17,1552996800,16,4,20,Clouds
24835,18,1552996800,26,3,29,Clouds
24836,19,1552996800,10,20,30,Clouds
24837,21,1552996800,0,30,30,Clouds
24838,22,1552996800,15,5,20,Clouds
24839,23,1552996800,24,6,30,Clouds
24840,24,1552996800,19,1,20,Clouds
24841,25,1552996800,0,28,28,Clouds
24842,26,1552996800,0,20,20,Clouds
24843,27,1552996800,0,20,20,Clouds
24844,28,1552996800,30,0,30,Clouds
24845,29,1552996800,25,4,29,Clouds
24846,30,1552996800,20,0,20,Clouds
24847,31,1552996800,16,4,20,Clouds
24848,32,1552996800,9,21,30,Clouds
24849,33,1552996800,18,5,23,Clouds
24850,34,1552996800,25,5,30,Clouds
24851,35,1552996800,30,0,30,Clouds
24852,36,1552996800,2,38,40,Clouds
24853,37,1552996800,18,12,30,Clouds
24854,38,1552996800,37,3,40,Clouds
24855,39,1552996800,13,7,20,Clouds
24856,40,1552996800,20,1,21,Clouds
24857,41,1552996800,9,11,20,Clouds
24858,42,1552996800,30,0,30,Clouds
24859,43,1552996800,15,15,30,Clouds
24860,44,1552996800,30,0,30,Clouds
24861,45,1552996800,28,2,30,Clouds
24862,46,1552996800,20,0,20,Clouds
24863,47,1552996800,10,30,40,Clouds
24864,48,1552996800,11,29,40,Clouds
24865,49,1552996800,3,37,40,Clouds
24866,50,1552996800,40,0,40,Clouds
24867,51,1552996800,16,24,40,Clouds
24868,52,1552996800,18,14,32,Clouds
24869,53,1552996800,16,24,40,Clouds
24870,54,1552996800,21,12,33,Clouds
24871,55,1552996800,8,28,36,Clouds
24872,56,1552996800,12,28,40,Clouds
24873,57,1552996800,1,22,23,Clouds
24874,58,1552996800,7,33,40,Clouds
24875,59,1552996800,20,0,20,Clouds
24876,60,1552996800,30,0,30,Clouds
24877,61,1552996800,25,0,25,Clouds
24878,62,1552996800,8,32,40,Clouds
24879,63,1552996800,1,34,35,Clouds
24880,64,1552996800,0,40,40,Clouds
24881,65,1552996800,7,33,40,Clouds
24882,66,1552996800,6,34,40,Clouds
24883,67,1552996800,8,32,40,Clouds
24884,68,1552996800,5,35,40,Clouds
24885,69,1552996800,1,39,40,Clouds
24886,70,1552996800,1,27,28,Clouds
24887,71,1552996800,37,2,39,Clouds
24888,72,1552996800,30,1,31,Clouds
24889,73,1552996800,30,0,30,Clouds
24890,74,1552996800,28,2,30,Clouds
24891,75,1552996800,38,2,40,Clouds
24892,76,1552996800,37,1,38,Clouds
24893,77,1552996800,29,0,29,Clouds
24894,78,1552996800,40,0,40,Clouds
24895,79,1552996800,27,0,27,Clouds
24896,80,1552996800,40,0,40,Clouds
24897,81,1552996800,40,0,40,Clouds
24898,82,1552996800,22,0,22,Clouds
24899,83,1552996800,40,0,40,Clouds
24900,84,1552996800,30,0,30,Clouds
24901,85,1552996800,34,1,35,Clouds
24902,86,1552996800,35,3,38,Clouds
24903,87,1552996800,38,0,38,Clouds
24904,88,1552996800,30,0,30,Clouds
24905,89,1552996800,7,33,40,Clouds
24906,90,1552996800,2,38,40,Clouds
24907,91,1552996800,14,16,30,Clouds
24908,92,1552996800,40,0,40,Clouds
24909,93,1552996800,40,0,40,Clouds
24910,94,1552996800,40,0,40,Clouds
24911,95,1552996800,40,0,40,Clouds
24912,96,1552996800,30,0,30,Clouds
24913,97,1552996800,40,0,40,Clouds
24914,98,1552996800,11,29,40,Clouds
24915,99,1552996800,1,29,30,Clouds
24916,100,1552996800,25,0,25,Clouds
24917,101,1552996800,30,0,30,Clouds
24918,102,1552996800,40,0,40,Clouds
24919,103,1552996800,40,0,40,Clouds
24920,104,1552996800,40,0,40,Clouds
24921,105,1552996800,36,0,36,Clouds
24922,106,1552996800,40,0,40,Clouds
24923,107,1552996800,40,0,40,Clouds
24924,108,1552996800,40,0,40,Clouds
24925,109,1552996800,29,0,29,Clouds
24926,110,1552996800,40,0,40,Clouds
24927,111,1552996800,40,0,40,Clouds
24928,112,1552996800,30,0,30,Clouds
24929,113,1552996800,7,33,40,Clouds
24930,114,1552996800,14,26,40,Clouds
24931,115,1552996800,19,11,30,Clouds
24932,2,1553000400,20,0,20,Clouds
24933,3,1553000400,18,2,20,Clouds
24934,4,1553000400,17,3,20,Clouds
24935,5,1553000400,7,33,40,Clouds
24936,6,1553000400,19,1,20,Clouds
24937,7,1553000400,29,0,29,Clouds
24938,8,1553000400,16,14,30,Clouds
24939,9,1553000400,6,17,23,Clouds
24940,10,1553000400,15,1,16,Clouds
24941,11,1553000400,17,13,30,Clouds
24942,12,1553000400,20,0,20,Clouds
24943,13,1553000400,9,21,30,Clouds
24944,14,1553000400,23,7,30,Clouds
24945,15,1553000400,14,2,16,Clouds
24946,16,1553000400,15,5,20,Clouds
24947,17,1553000400,18,2,20,Clouds
24948,18,1553000400,24,5,29,Clouds
24949,19,1553000400,1,29,30,Clouds
24950,21,1553000400,0,30,30,Clouds
24951,22,1553000400,17,3,20,Clouds
24952,23,1553000400,25,5,30,Clouds
24953,24,1553000400,20,0,20,Clouds
24954,25,1553000400,2,26,28,Clouds
24955,26,1553000400,3,17,20,Clouds
24956,27,1553000400,1,19,20,Clouds
24957,28,1553000400,30,0,30,Clouds
24958,29,1553000400,24,5,29,Clouds
24959,30,1553000400,15,5,20,Clouds
24960,31,1553000400,20,0,20,Clouds
24961,32,1553000400,6,24,30,Clouds
24962,33,1553000400,20,3,23,Clouds
24963,34,1553000400,24,6,30,Clouds
24964,35,1553000400,30,0,30,Clouds
24965,36,1553000400,3,37,40,Clouds
24966,37,1553000400,17,13,30,Clouds
24967,38,1553000400,37,3,40,Clouds
24968,39,1553000400,18,2,20,Clouds
24969,40,1553000400,13,8,21,Clouds
24970,41,1553000400,14,6,20,Clouds
24971,42,1553000400,29,1,30,Clouds
24972,43,1553000400,16,14,30,Clouds
24973,44,1553000400,28,2,30,Clouds
24974,45,1553000400,30,0,30,Clouds
24975,46,1553000400,18,2,20,Clouds
24976,47,1553000400,5,35,40,Clouds
24977,48,1553000400,5,35,40,Clouds
24978,49,1553000400,1,39,40,Clouds
24979,50,1553000400,39,1,40,Clouds
24980,51,1553000400,16,24,40,Clouds
24981,52,1553000400,18,14,32,Clouds
24982,53,1553000400,15,25,40,Clouds
24983,54,1553000400,21,12,33,Clouds
24984,55,1553000400,7,29,36,Clouds
24985,56,1553000400,15,25,40,Clouds
24986,57,1553000400,2,21,23,Clouds
24987,58,1553000400,10,30,40,Clouds
24988,59,1553000400,20,0,20,Clouds
24989,60,1553000400,30,0,30,Clouds
24990,61,1553000400,25,0,25,Clouds
24991,62,1553000400,4,36,40,Clouds
24992,63,1553000400,0,35,35,Clouds
24993,64,1553000400,1,39,40,Clouds
24994,65,1553000400,5,35,40,Clouds
24995,66,1553000400,6,34,40,Clouds
24996,67,1553000400,14,26,40,Clouds
24997,68,1553000400,1,39,40,Clouds
24998,69,1553000400,6,34,40,Clouds
24999,70,1553000400,4,24,28,Clouds
25000,71,1553000400,38,1,39,Clouds
25001,72,1553000400,31,0,31,Clouds
25002,73,1553000400,29,1,30,Clouds
25003,74,1553000400,30,0,30,Clouds
25004,75,1553000400,40,0,40,Clouds
25005,76,1553000400,38,0,38,Clouds
25006,77,1553000400,27,2,29,Clouds
25007,78,1553000400,40,0,40,Clouds
25008,79,1553000400,27,0,27,Clouds
25009,80,1553000400,39,1,40,Clouds
25010,81,1553000400,40,0,40,Clouds
25011,82,1553000400,22,0,22,Clouds
25012,83,1553000400,40,0,40,Clouds
25013,84,1553000400,30,0,30,Clouds
25014,85,1553000400,35,0,35,Clouds
25015,86,1553000400,37,1,38,Clouds
25016,87,1553000400,38,0,38,Clouds
25017,88,1553000400,29,1,30,Clouds
25018,89,1553000400,6,34,40,Clouds
25019,90,1553000400,3,37,40,Clouds
25020,91,1553000400,18,12,30,Clouds
25021,92,1553000400,40,0,40,Clouds
25022,93,1553000400,40,0,40,Clouds
25023,94,1553000400,40,0,40,Clouds
25024,95,1553000400,40,0,40,Clouds
25025,96,1553000400,30,0,30,Clouds
25026,97,1553000400,40,0,40,Clouds
25027,98,1553000400,4,36,40,Clouds
25028,99,1553000400,1,29,30,Clouds
25029,100,1553000400,23,2,25,Clouds
25030,101,1553000400,28,2,30,Clouds
25031,102,1553000400,38,2,40,Clouds
25032,103,1553000400,40,0,40,Clouds
25033,104,1553000400,33,7,40,Clouds
25034,105,1553000400,36,0,36,Clouds
25035,106,1553000400,34,6,40,Clouds
25036,107,1553000400,40,0,40,Clouds
25037,108,1553000400,40,0,40,Clouds
25038,109,1553000400,29,0,29,Clouds
25039,110,1553000400,40,0,40,Clouds
25040,111,1553000400,40,0,40,Clouds
25041,112,1553000400,29,1,30,Clouds
25042,113,1553000400,7,33,40,Clouds
25043,114,1553000400,13,27,40,Clouds
25044,115,1553000400,20,10,30,Clouds
25045,2,1553004000,20,0,20,Clouds
25046,3,1553004000,18,2,20,Clouds
25047,4,1553004000,18,2,20,Clouds
25048,5,1553004000,8,32,40,Clouds
25049,6,1553004000,20,0,20,Clouds
25050,7,1553004000,29,0,29,Clouds
25051,8,1553004000,24,6,30,Clouds
25052,9,1553004000,7,16,23,Clouds
25053,10,1553004000,15,1,16,Clouds
25054,11,1553004000,25,5,30,Clouds
25055,12,1553004000,20,0,20,Clouds
25056,13,1553004000,10,20,30,Clouds
25057,14,1553004000,16,14,30,Clouds
25058,15,1553004000,15,1,16,Clouds
25059,16,1553004000,20,0,20,Clouds
25060,17,1553004000,20,0,20,Clouds
25061,18,1553004000,27,2,29,Clouds
25062,19,1553004000,5,25,30,Clouds
25063,21,1553004000,3,27,30,Clouds
25064,22,1553004000,20,0,20,Clouds
25065,23,1553004000,27,3,30,Clouds
25066,24,1553004000,20,0,20,Clouds
25067,25,1553004000,3,25,28,Clouds
25068,26,1553004000,1,19,20,Clouds
25069,27,1553004000,1,19,20,Clouds
25070,28,1553004000,19,11,30,Clouds
25071,29,1553004000,29,0,29,Clouds
25072,30,1553004000,20,0,20,Clouds
25073,31,1553004000,17,3,20,Clouds
25074,32,1553004000,17,13,30,Clouds
25075,33,1553004000,23,0,23,Clouds
25076,34,1553004000,28,2,30,Clouds
25077,35,1553004000,28,2,30,Clouds
25078,36,1553004000,5,35,40,Clouds
25079,37,1553004000,8,22,30,Clouds
25080,38,1553004000,38,2,40,Clouds
25081,39,1553004000,17,3,20,Clouds
25082,40,1553004000,19,2,21,Clouds
25083,41,1553004000,13,7,20,Clouds
25084,42,1553004000,28,2,30,Clouds
25085,43,1553004000,20,10,30,Clouds
25086,44,1553004000,30,0,30,Clouds
25087,45,1553004000,29,1,30,Clouds
25088,46,1553004000,20,0,20,Clouds
25089,47,1553004000,6,34,40,Clouds
25090,48,1553004000,4,36,40,Clouds
25091,49,1553004000,2,38,40,Clouds
25092,50,1553004000,39,1,40,Clouds
25093,51,1553004000,19,21,40,Clouds
25094,52,1553004000,15,17,32,Clouds
25095,53,1553004000,6,34,40,Clouds
25096,54,1553004000,20,13,33,Clouds
25097,55,1553004000,9,27,36,Clouds
25098,56,1553004000,21,19,40,Clouds
25099,57,1553004000,2,21,23,Clouds
25100,58,1553004000,17,23,40,Clouds
25101,59,1553004000,20,0,20,Clouds
25102,60,1553004000,28,2,30,Clouds
25103,61,1553004000,25,0,25,Clouds
25104,62,1553004000,6,34,40,Clouds
25105,63,1553004000,9,26,35,Clouds
25106,64,1553004000,11,29,40,Clouds
25107,65,1553004000,14,26,40,Clouds
25108,66,1553004000,6,34,40,Clouds
25109,67,1553004000,18,22,40,Clouds
25110,68,1553004000,0,40,40,Clouds
25111,69,1553004000,6,34,40,Clouds
25112,70,1553004000,8,20,28,Clouds
25113,71,1553004000,38,2,40,Clouds
25114,72,1553004000,28,3,31,Clouds
25115,73,1553004000,28,2,30,Clouds
25116,74,1553004000,28,2,30,Clouds
25117,75,1553004000,39,1,40,Clouds
25118,76,1553004000,37,1,38,Clouds
25119,77,1553004000,28,1,29,Clouds
25120,78,1553004000,39,1,40,Clouds
25121,79,1553004000,27,0,27,Clouds
25122,80,1553004000,28,12,40,Clouds
25123,81,1553004000,40,0,40,Clouds
25124,82,1553004000,22,0,22,Clouds
25125,83,1553004000,40,0,40,Clouds
25126,84,1553004000,30,0,30,Clouds
25127,85,1553004000,35,0,35,Clouds
25128,86,1553004000,38,0,38,Clouds
25129,87,1553004000,38,0,38,Clouds
25130,88,1553004000,30,0,30,Clouds
25131,89,1553004000,11,29,40,Clouds
25132,90,1553004000,10,30,40,Clouds
25133,91,1553004000,16,14,30,Clouds
25134,92,1553004000,40,0,40,Clouds
25135,93,1553004000,40,0,40,Clouds
25136,94,1553004000,40,0,40,Clouds
25137,95,1553004000,40,0,40,Clouds
25138,96,1553004000,29,1,30,Clouds
25139,97,1553004000,39,1,40,Clouds
25140,98,1553004000,2,38,40,Clouds
25141,99,1553004000,0,30,30,Clouds
25142,100,1553004000,25,0,25,Clouds
25143,101,1553004000,29,1,30,Clouds
25144,102,1553004000,40,0,40,Clouds
25145,103,1553004000,40,0,40,Clouds
25146,104,1553004000,34,6,40,Clouds
25147,105,1553004000,36,0,36,Clouds
25148,106,1553004000,36,4,40,Clouds
25149,107,1553004000,40,0,40,Clouds
25150,108,1553004000,39,1,40,Clouds
25151,109,1553004000,29,0,29,Clouds
25152,110,1553004000,36,4,40,Clouds
25153,111,1553004000,40,0,40,Clouds
25154,112,1553004000,26,4,30,Clouds
25155,113,1553004000,8,32,40,Clouds
25156,114,1553004000,18,22,40,Clouds
25157,115,1553004000,22,8,30,Clouds
25158,2,1553007600,18,2,20,Clouds
25159,3,1553007600,15,5,20,Clouds
25160,4,1553007600,19,1,20,Clouds
25161,5,1553007600,12,28,40,Clouds
25162,6,1553007600,18,2,20,Clouds
25163,7,1553007600,29,0,29,Clouds
25164,8,1553007600,23,6,29,Clouds
25165,9,1553007600,18,6,24,Clouds
25166,10,1553007600,12,4,16,Clouds
25167,11,1553007600,28,2,30,Clouds
25168,12,1553007600,19,1,20,Clouds
25169,13,1553007600,11,19,30,Clouds
25170,14,1553007600,10,20,30,Clouds
25171,15,1553007600,11,5,16,Clouds
25172,16,1553007600,14,6,20,Clouds
25173,17,1553007600,18,2,20,Clouds
25174,18,1553007600,25,5,30,Clouds
25175,19,1553007600,5,25,30,Clouds
25176,21,1553007600,24,6,30,Clouds
25177,22,1553007600,20,0,20,Clouds
25178,23,1553007600,22,8,30,Clouds
25179,24,1553007600,16,4,20,Clouds
25180,25,1553007600,10,20,30,Clouds
25181,26,1553007600,7,13,20,Clouds
25182,27,1553007600,4,16,20,Clouds
25183,28,1553007600,28,2,30,Clouds
25184,29,1553007600,27,2,29,Clouds
25185,30,1553007600,11,9,20,Clouds
25186,31,1553007600,18,2,20,Clouds
25187,32,1553007600,15,15,30,Clouds
25188,33,1553007600,19,4,23,Clouds
25189,34,1553007600,30,0,30,Clouds
25190,35,1553007600,29,1,30,Clouds
25191,36,1553007600,3,37,40,Clouds
25192,37,1553007600,9,21,30,Clouds
25193,38,1553007600,37,3,40,Clouds
25194,39,1553007600,15,5,20,Clouds
25195,40,1553007600,20,1,21,Clouds
25196,41,1553007600,14,6,20,Clouds
25197,42,1553007600,30,0,30,Clouds
25198,43,1553007600,28,2,30,Clouds
25199,44,1553007600,29,1,30,Clouds
25200,45,1553007600,30,0,30,Clouds
25201,46,1553007600,19,1,20,Clouds
25202,47,1553007600,3,37,40,Clouds
25203,48,1553007600,9,31,40,Clouds
25204,49,1553007600,0,40,40,Clouds
25205,50,1553007600,39,1,40,Clouds
25206,51,1553007600,19,21,40,Clouds
25207,52,1553007600,16,16,32,Clouds
25208,53,1553007600,7,33,40,Clouds
25209,54,1553007600,18,15,33,Clouds
25210,55,1553007600,10,26,36,Clouds
25211,56,1553007600,11,29,40,Clouds
25212,57,1553007600,3,20,23,Clouds
25213,58,1553007600,10,30,40,Clouds
25214,59,1553007600,19,1,20,Clouds
25215,60,1553007600,26,4,30,Clouds
25216,61,1553007600,24,1,25,Clouds
25217,62,1553007600,0,40,40,Clouds
25218,63,1553007600,3,32,35,Clouds
25219,64,1553007600,1,39,40,Clouds
25220,65,1553007600,11,29,40,Clouds
25221,66,1553007600,11,29,40,Clouds
25222,67,1553007600,17,23,40,Clouds
25223,68,1553007600,12,28,40,Clouds
25224,69,1553007600,3,37,40,Clouds
25225,70,1553007600,7,21,28,Clouds
25226,71,1553007600,39,1,40,Clouds
25227,72,1553007600,30,1,31,Clouds
25228,73,1553007600,28,2,30,Clouds
25229,74,1553007600,29,1,30,Clouds
25230,75,1553007600,40,0,40,Clouds
25231,76,1553007600,37,1,38,Clouds
25232,77,1553007600,26,3,29,Clouds
25233,78,1553007600,37,3,40,Clouds
25234,79,1553007600,27,0,27,Clouds
25235,80,1553007600,32,8,40,Clouds
25236,81,1553007600,40,0,40,Clouds
25237,82,1553007600,22,0,22,Clouds
25238,83,1553007600,34,6,40,Clouds
25239,84,1553007600,30,0,30,Clouds
25240,85,1553007600,35,0,35,Clouds
25241,86,1553007600,37,1,38,Clouds
25242,87,1553007600,38,0,38,Clouds
25243,88,1553007600,28,2,30,Clouds
25244,89,1553007600,14,26,40,Clouds
25245,90,1553007600,6,34,40,Clouds
25246,91,1553007600,20,10,30,Clouds
25247,92,1553007600,40,0,40,Clouds
25248,93,1553007600,40,0,40,Clouds
25249,94,1553007600,40,0,40,Clouds
25250,95,1553007600,35,5,40,Clouds
25251,96,1553007600,30,0,30,Clouds
25252,97,1553007600,34,6,40,Clouds
25253,98,1553007600,3,37,40,Clouds
25254,99,1553007600,1,29,30,Clouds
25255,100,1553007600,24,1,25,Clouds
25256,101,1553007600,30,0,30,Clouds
25257,102,1553007600,40,0,40,Clouds
25258,103,1553007600,40,0,40,Clouds
25259,104,1553007600,35,5,40,Clouds
25260,105,1553007600,36,0,36,Clouds
25261,106,1553007600,38,2,40,Clouds
25262,107,1553007600,39,1,40,Clouds
25263,108,1553007600,39,1,40,Clouds
25264,109,1553007600,27,2,29,Clouds
25265,110,1553007600,39,1,40,Clouds
25266,111,1553007600,40,0,40,Clouds
25267,112,1553007600,26,4,30,Clouds
25268,113,1553007600,7,33,40,Clouds
25269,114,1553007600,15,25,40,Clouds
25270,115,1553007600,25,5,30,Clouds
25271,2,1553011200,20,0,20,Clouds
25272,3,1553011200,20,0,20,Clouds
25273,4,1553011200,20,0,20,Clouds
25274,5,1553011200,10,30,40,Clouds
25275,6,1553011200,17,3,20,Clouds
25276,7,1553011200,29,0,29,Clouds
25277,8,1553011200,23,7,30,Clouds
25278,9,1553011200,21,3,24,Clouds
25279,10,1553011200,10,6,16,Clouds
25280,11,1553011200,26,4,30,Clouds
25281,12,1553011200,20,0,20,Clouds
25282,13,1553011200,10,20,30,Clouds
25283,14,1553011200,8,22,30,Clouds
25284,15,1553011200,10,6,16,Clouds
25285,16,1553011200,14,6,20,Clouds
25286,17,1553011200,20,0,20,Clouds
25287,18,1553011200,28,2,30,Clouds
25288,19,1553011200,3,27,30,Clouds
25289,21,1553011200,25,5,30,Clouds
25290,22,1553011200,11,9,20,Clouds
25291,23,1553011200,22,8,30,Clouds
25292,24,1553011200,18,2,20,Clouds
25293,25,1553011200,9,21,30,Clouds
25294,26,1553011200,1,19,20,Clouds
25295,27,1553011200,10,10,20,Clouds
25296,28,1553011200,19,11,30,Clouds
25297,29,1553011200,27,2,29,Clouds
25298,30,1553011200,13,7,20,Clouds
25299,31,1553011200,19,1,20,Clouds
25300,32,1553011200,5,25,30,Clouds
25301,33,1553011200,20,3,23,Clouds
25302,34,1553011200,30,0,30,Clouds
25303,35,1553011200,29,1,30,Clouds
25304,36,1553011200,5,35,40,Clouds
25305,37,1553011200,11,19,30,Clouds
25306,38,1553011200,29,11,40,Clouds
25307,39,1553011200,16,4,20,Clouds
25308,40,1553011200,18,3,21,Clouds
25309,41,1553011200,10,10,20,Clouds
25310,42,1553011200,30,0,30,Clouds
25311,43,1553011200,26,4,30,Clouds
25312,44,1553011200,30,0,30,Clouds
25313,45,1553011200,27,3,30,Clouds
25314,46,1553011200,18,2,20,Clouds
25315,47,1553011200,3,37,40,Clouds
25316,48,1553011200,9,31,40,Clouds
25317,49,1553011200,0,40,40,Clouds
25318,50,1553011200,39,1,40,Clouds
25319,51,1553011200,17,23,40,Clouds
25320,52,1553011200,20,12,32,Clouds
25321,53,1553011200,6,34,40,Clouds
25322,54,1553011200,20,13,33,Clouds
25323,55,1553011200,7,29,36,Clouds
25324,56,1553011200,5,35,40,Clouds
25325,57,1553011200,5,18,23,Clouds
25326,58,1553011200,5,35,40,Clouds
25327,59,1553011200,20,0,20,Clouds
25328,60,1553011200,23,7,30,Clouds
25329,61,1553011200,23,2,25,Clouds
25330,62,1553011200,1,39,40,Clouds
25331,63,1553011200,2,33,35,Clouds
25332,64,1553011200,17,23,40,Clouds
25333,65,1553011200,11,29,40,Clouds
25334,66,1553011200,8,32,40,Clouds
25335,67,1553011200,16,24,40,Clouds
25336,68,1553011200,17,23,40,Clouds
25337,69,1553011200,13,27,40,Clouds
25338,70,1553011200,12,16,28,Clouds
25339,71,1553011200,33,7,40,Clouds
25340,72,1553011200,14,17,31,Clouds
25341,73,1553011200,26,4,30,Clouds
25342,74,1553011200,30,0,30,Clouds
25343,75,1553011200,35,5,40,Clouds
25344,76,1553011200,38,0,38,Clouds
25345,77,1553011200,27,2,29,Clouds
25346,78,1553011200,36,4,40,Clouds
25347,79,1553011200,25,2,27,Clouds
25348,80,1553011200,32,8,40,Clouds
25349,81,1553011200,40,0,40,Clouds
25350,82,1553011200,22,0,22,Clouds
25351,83,1553011200,36,4,40,Clouds
25352,84,1553011200,30,0,30,Clouds
25353,85,1553011200,35,0,35,Clouds
25354,86,1553011200,35,3,38,Clouds
25355,87,1553011200,36,2,38,Clouds
25356,88,1553011200,28,2,30,Clouds
25357,89,1553011200,13,27,40,Clouds
25358,90,1553011200,8,32,40,Clouds
25359,91,1553011200,17,13,30,Clouds
25360,92,1553011200,39,1,40,Clouds
25361,93,1553011200,40,0,40,Clouds
25362,94,1553011200,40,0,40,Clouds
25363,95,1553011200,33,7,40,Clouds
25364,96,1553011200,28,2,30,Clouds
25365,97,1553011200,33,7,40,Clouds
25366,98,1553011200,6,34,40,Clouds
25367,99,1553011200,2,28,30,Clouds
25368,100,1553011200,20,5,25,Clouds
25369,101,1553011200,30,0,30,Clouds
25370,102,1553011200,40,0,40,Clouds
25371,103,1553011200,40,0,40,Clouds
25372,104,1553011200,31,9,40,Clouds
25373,105,1553011200,36,0,36,Clouds
25374,106,1553011200,38,2,40,Clouds
25375,107,1553011200,37,3,40,Clouds
25376,108,1553011200,33,7,40,Clouds
25377,109,1553011200,27,2,29,Clouds
25378,110,1553011200,40,0,40,Clouds
25379,111,1553011200,33,7,40,Clouds
25380,112,1553011200,26,4,30,Clouds
25381,113,1553011200,1,39,40,Clouds
25382,114,1553011200,15,25,40,Clouds
25383,115,1553011200,29,1,30,Clouds
25384,2,1553014800,20,0,20,Clouds
25385,3,1553014800,17,3,20,Clouds
25386,4,1553014800,18,2,20,Clouds
25387,5,1553014800,11,29,40,Clouds
25388,6,1553014800,16,4,20,Clouds
25389,7,1553014800,29,0,29,Clouds
25390,8,1553014800,25,5,30,Clouds
25391,9,1553014800,17,7,24,Clouds
25392,10,1553014800,8,8,16,Clouds
25393,11,1553014800,19,11,30,Clouds
25394,12,1553014800,18,2,20,Clouds
25395,13,1553014800,12,18,30,Clouds
25396,14,1553014800,24,6,30,Clouds
25397,15,1553014800,12,4,16,Clouds
25398,16,1553014800,15,5,20,Clouds
25399,17,1553014800,20,0,20,Clouds
25400,18,1553014800,27,3,30,Clouds
25401,19,1553014800,9,21,30,Clouds
25402,21,1553014800,24,6,30,Clouds
25403,22,1553014800,6,14,20,Clouds
25404,23,1553014800,11,19,30,Clouds
25405,24,1553014800,14,6,20,Clouds
25406,25,1553014800,15,15,30,Clouds
25407,26,1553014800,2,18,20,Clouds
25408,27,1553014800,12,8,20,Clouds
25409,28,1553014800,23,7,30,Clouds
25410,29,1553014800,27,2,29,Clouds
25411,30,1553014800,14,6,20,Clouds
25412,31,1553014800,15,5,20,Clouds
25413,32,1553014800,16,14,30,Clouds
25414,33,1553014800,17,6,23,Clouds
25415,34,1553014800,25,5,30,Clouds
25416,35,1553014800,26,4,30,Clouds
25417,36,1553014800,4,36,40,Clouds
25418,37,1553014800,12,18,30,Clouds
25419,38,1553014800,23,17,40,Clouds
25420,39,1553014800,10,10,20,Clouds
25421,40,1553014800,19,2,21,Clouds
25422,41,1553014800,9,11,20,Clouds
25423,42,1553014800,30,0,30,Clouds
25424,43,1553014800,23,7,30,Clouds
25425,44,1553014800,30,0,30,Clouds
25426,45,1553014800,21,9,30,Clouds
25427,46,1553014800,18,2,20,Clouds
25428,47,1553014800,5,35,40,Clouds
25429,48,1553014800,9,31,40,Clouds
25430,49,1553014800,4,36,40,Clouds
25431,50,1553014800,40,0,40,Clouds
25432,51,1553014800,20,20,40,Clouds
25433,52,1553014800,18,14,32,Clouds
25434,53,1553014800,9,31,40,Clouds
25435,54,1553014800,23,10,33,Clouds
25436,55,1553014800,11,25,36,Clouds
25437,56,1553014800,10,30,40,Clouds
25438,57,1553014800,6,17,23,Clouds
25439,58,1553014800,9,31,40,Clouds
25440,59,1553014800,20,0,20,Clouds
25441,60,1553014800,21,9,30,Clouds
25442,61,1553014800,25,0,25,Clouds
25443,62,1553014800,5,35,40,Clouds
25444,63,1553014800,2,33,35,Clouds
25445,64,1553014800,24,16,40,Clouds
25446,65,1553014800,11,29,40,Clouds
25447,66,1553014800,16,24,40,Clouds
25448,67,1553014800,19,21,40,Clouds
25449,68,1553014800,17,23,40,Clouds
25450,69,1553014800,7,33,40,Clouds
25451,70,1553014800,13,15,28,Clouds
25452,71,1553014800,38,2,40,Clouds
25453,72,1553014800,13,18,31,Clouds
25454,73,1553014800,27,3,30,Clouds
25455,74,1553014800,30,0,30,Clouds
25456,75,1553014800,35,5,40,Clouds
25457,76,1553014800,38,0,38,Clouds
25458,77,1553014800,29,0,29,Clouds
25459,78,1553014800,40,0,40,Clouds
25460,79,1553014800,27,0,27,Clouds
25461,80,1553014800,17,23,40,Clouds
25462,81,1553014800,40,0,40,Clouds
25463,82,1553014800,22,0,22,Clouds
25464,83,1553014800,35,5,40,Clouds
25465,84,1553014800,29,1,30,Clouds
25466,85,1553014800,35,0,35,Clouds
25467,86,1553014800,38,0,38,Clouds
25468,87,1553014800,38,0,38,Clouds
25469,88,1553014800,27,3,30,Clouds
25470,89,1553014800,12,28,40,Clouds
25471,90,1553014800,17,23,40,Clouds
25472,91,1553014800,22,8,30,Clouds
25473,92,1553014800,39,1,40,Clouds
25474,93,1553014800,39,1,40,Clouds
25475,94,1553014800,39,1,40,Clouds
25476,95,1553014800,38,2,40,Clouds
25477,96,1553014800,29,1,30,Clouds
25478,97,1553014800,32,8,40,Clouds
25479,98,1553014800,9,31,40,Clouds
25480,99,1553014800,4,26,30,Clouds
25481,100,1553014800,13,12,25,Clouds
25482,101,1553014800,30,0,30,Clouds
25483,102,1553014800,40,0,40,Clouds
25484,103,1553014800,39,1,40,Clouds
25485,104,1553014800,31,9,40,Clouds
25486,105,1553014800,35,1,36,Clouds
25487,106,1553014800,39,1,40,Clouds
25488,107,1553014800,37,3,40,Clouds
25489,108,1553014800,35,5,40,Clouds
25490,109,1553014800,26,3,29,Clouds
25491,110,1553014800,38,2,40,Clouds
25492,111,1553014800,35,5,40,Clouds
25493,112,1553014800,28,2,30,Clouds
25494,113,1553014800,1,39,40,Clouds
25495,114,1553014800,20,20,40,Clouds
25496,115,1553014800,30,0,30,Clouds
25497,2,1553018400,19,1,20,Clouds
25498,3,1553018400,20,0,20,Clouds
25499,4,1553018400,20,0,20,Clouds
25500,5,1553018400,0,40,40,Clouds
25501,6,1553018400,19,1,20,Clouds
25502,7,1553018400,25,4,29,Clouds
25503,8,1553018400,13,17,30,Clouds
25504,9,1553018400,23,1,24,Clouds
25505,10,1553018400,13,3,16,Clouds
25506,11,1553018400,30,0,30,Clouds
25507,12,1553018400,20,0,20,Clouds
25508,13,1553018400,13,17,30,Clouds
25509,14,1553018400,17,13,30,Clouds
25510,15,1553018400,14,2,16,Clouds
25511,16,1553018400,6,14,20,Clouds
25512,17,1553018400,20,0,20,Clouds
25513,18,1553018400,25,5,30,Clouds
25514,19,1553018400,30,0,30,Clouds
25515,21,1553018400,19,11,30,Clouds
25516,22,1553018400,1,19,20,Clouds
25517,23,1553018400,17,13,30,Clouds
25518,24,1553018400,20,0,20,Clouds
25519,25,1553018400,30,0,30,Clouds
25520,26,1553018400,0,20,20,Clouds
25521,27,1553018400,16,4,20,Clouds
25522,28,1553018400,30,0,30,Clouds
25523,29,1553018400,29,0,29,Clouds
25524,30,1553018400,20,0,20,Clouds
25525,31,1553018400,14,6,20,Clouds
25526,32,1553018400,0,30,30,Clouds
25527,33,1553018400,15,8,23,Clouds
25528,34,1553018400,11,19,30,Clouds
25529,35,1553018400,28,2,30,Clouds
25530,36,1553018400,7,33,40,Clouds
25531,37,1553018400,18,12,30,Clouds
25532,38,1553018400,8,32,40,Clouds
25533,39,1553018400,18,2,20,Clouds
25534,40,1553018400,18,3,21,Clouds
25535,41,1553018400,14,6,20,Clouds
25536,42,1553018400,28,2,30,Clouds
25537,43,1553018400,17,13,30,Clouds
25538,44,1553018400,29,1,30,Clouds
25539,45,1553018400,18,12,30,Clouds
25540,46,1553018400,15,5,20,Clouds
25541,47,1553018400,20,20,40,Clouds
25542,48,1553018400,5,35,40,Clouds
25543,49,1553018400,1,39,40,Clouds
25544,50,1553018400,40,0,40,Clouds
25545,51,1553018400,27,13,40,Clouds
25546,52,1553018400,24,8,32,Clouds
25547,53,1553018400,16,24,40,Clouds
25548,54,1553018400,33,0,33,Clouds
25549,55,1553018400,30,6,36,Clouds
25550,56,1553018400,40,0,40,Clouds
25551,57,1553018400,14,9,23,Clouds
25552,58,1553018400,30,10,40,Clouds
25553,59,1553018400,19,1,20,Clouds
25554,60,1553018400,8,22,30,Clouds
25555,61,1553018400,25,0,25,Clouds
25556,62,1553018400,14,26,40,Clouds
25557,63,1553018400,0,35,35,Clouds
25558,64,1553018400,22,18,40,Clouds
25559,65,1553018400,0,40,40,Clouds
25560,66,1553018400,39,1,40,Clouds
25561,67,1553018400,21,19,40,Clouds
25562,68,1553018400,13,27,40,Clouds
25563,69,1553018400,23,17,40,Clouds
25564,70,1553018400,13,15,28,Clouds
25565,71,1553018400,39,1,40,Clouds
25566,72,1553018400,23,8,31,Clouds
25567,73,1553018400,27,3,30,Clouds
25568,74,1553018400,8,22,30,Clouds
25569,75,1553018400,30,10,40,Clouds
25570,76,1553018400,19,19,38,Clouds
25571,77,1553018400,28,1,29,Clouds
25572,78,1553018400,39,1,40,Clouds
25573,79,1553018400,27,0,27,Clouds
25574,80,1553018400,26,14,40,Clouds
25575,81,1553018400,40,0,40,Clouds
25576,82,1553018400,21,1,22,Clouds
25577,83,1553018400,32,8,40,Clouds
25578,84,1553018400,28,2,30,Clouds
25579,85,1553018400,28,7,35,Clouds
25580,86,1553018400,31,7,38,Clouds
25581,87,1553018400,37,1,38,Clouds
25582,88,1553018400,28,2,30,Clouds
25583,89,1553018400,18,22,40,Clouds
25584,90,1553018400,27,13,40,Clouds
25585,91,1553018400,25,5,30,Clouds
25586,92,1553018400,29,11,40,Clouds
25587,93,1553018400,31,9,40,Clouds
25588,94,1553018400,39,1,40,Clouds
25589,95,1553018400,39,1,40,Clouds
25590,96,1553018400,28,2,30,Clouds
25591,97,1553018400,32,8,40,Clouds
25592,98,1553018400,14,26,40,Clouds
25593,99,1553018400,3,27,30,Clouds
25594,100,1553018400,0,25,25,Clouds
25595,101,1553018400,30,0,30,Clouds
25596,102,1553018400,38,2,40,Clouds
25597,103,1553018400,38,2,40,Clouds
25598,104,1553018400,32,8,40,Clouds
25599,105,1553018400,34,2,36,Clouds
25600,106,1553018400,37,3,40,Clouds
25601,107,1553018400,37,3,40,Clouds
25602,108,1553018400,34,6,40,Clouds
25603,109,1553018400,22,7,29,Clouds
25604,110,1553018400,38,2,40,Clouds
25605,111,1553018400,38,2,40,Clouds
25606,112,1553018400,28,2,30,Clouds
25607,113,1553018400,3,37,40,Clouds
25608,114,1553018400,40,0,40,Clouds
25609,115,1553018400,22,8,30,Clouds
25610,2,1553022000,18,2,20,Clouds
25611,3,1553022000,20,0,20,Clouds
25612,4,1553022000,17,3,20,Clouds
25613,5,1553022000,19,21,40,Clouds
25614,6,1553022000,17,3,20,Clouds
25615,7,1553022000,27,2,29,Clouds
25616,8,1553022000,14,15,29,Clouds
25617,9,1553022000,23,1,24,Clouds
25618,10,1553022000,15,1,16,Clouds
25619,11,1553022000,22,8,30,Clouds
25620,12,1553022000,15,5,20,Clouds
25621,13,1553022000,30,0,30,Clouds
25622,14,1553022000,14,16,30,Clouds
25623,15,1553022000,14,2,16,Clouds
25624,16,1553022000,0,20,20,Clouds
25625,17,1553022000,18,2,20,Clouds
25626,18,1553022000,19,11,30,Clouds
25627,19,1553022000,30,0,30,Clouds
25628,21,1553022000,15,15,30,Clouds
25629,22,1553022000,0,20,20,Clouds
25630,23,1553022000,1,29,30,Clouds
25631,24,1553022000,14,6,20,Clouds
25632,25,1553022000,30,0,30,Clouds
25633,26,1553022000,2,18,20,Clouds
25634,27,1553022000,19,1,20,Clouds
25635,28,1553022000,27,3,30,Clouds
25636,29,1553022000,25,4,29,Clouds
25637,30,1553022000,20,0,20,Clouds
25638,31,1553022000,18,2,20,Clouds
25639,32,1553022000,0,30,30,Clouds
25640,33,1553022000,5,18,23,Clouds
25641,34,1553022000,1,29,30,Clouds
25642,35,1553022000,25,5,30,Clouds
25643,36,1553022000,38,2,40,Clouds
25644,37,1553022000,30,0,30,Clouds
25645,38,1553022000,8,32,40,Clouds
25646,39,1553022000,20,0,20,Clouds
25647,40,1553022000,21,0,21,Clouds
25648,41,1553022000,20,0,20,Clouds
25649,42,1553022000,24,6,30,Clouds
25650,43,1553022000,0,30,30,Clouds
25651,44,1553022000,20,10,30,Clouds
25652,45,1553022000,13,17,30,Clouds
25653,46,1553022000,19,1,20,Clouds
25654,47,1553022000,40,0,40,Clouds
25655,48,1553022000,10,30,40,Clouds
25656,49,1553022000,20,20,40,Clouds
25657,50,1553022000,27,13,40,Clouds
25658,51,1553022000,39,1,40,Clouds
25659,52,1553022000,29,3,32,Clouds
25660,53,1553022000,36,4,40,Clouds
25661,54,1553022000,33,0,33,Clouds
25662,55,1553022000,36,0,36,Clouds
25663,56,1553022000,39,1,40,Clouds
25664,57,1553022000,23,0,23,Clouds
25665,58,1553022000,40,0,40,Clouds
25666,59,1553022000,20,0,20,Clouds
25667,60,1553022000,4,26,30,Clouds
25668,61,1553022000,25,0,25,Clouds
25669,62,1553022000,35,5,40,Clouds
25670,63,1553022000,16,19,35,Clouds
25671,64,1553022000,18,22,40,Clouds
25672,65,1553022000,40,0,40,Clouds
25673,66,1553022000,36,4,40,Clouds
25674,67,1553022000,23,17,40,Clouds
25675,68,1553022000,40,0,40,Clouds
25676,69,1553022000,38,2,40,Clouds
25677,70,1553022000,26,2,28,Clouds
25678,71,1553022000,34,6,40,Clouds
25679,72,1553022000,31,0,31,Clouds
25680,73,1553022000,28,2,30,Clouds
25681,74,1553022000,12,18,30,Clouds
25682,75,1553022000,17,23,40,Clouds
25683,76,1553022000,18,20,38,Clouds
25684,77,1553022000,29,0,29,Clouds
25685,78,1553022000,32,8,40,Clouds
25686,79,1553022000,27,0,27,Clouds
25687,80,1553022000,26,14,40,Clouds
25688,81,1553022000,25,15,40,Clouds
25689,82,1553022000,20,2,22,Clouds
25690,83,1553022000,25,15,40,Clouds
25691,84,1553022000,28,2,30,Clouds
25692,85,1553022000,26,9,35,Clouds
25693,86,1553022000,11,27,38,Clouds
25694,87,1553022000,32,6,38,Clouds
25695,88,1553022000,19,11,30,Clouds
25696,89,1553022000,40,0,40,Clouds
25697,90,1553022000,40,0,40,Clouds
25698,91,1553022000,26,4,30,Clouds
25699,92,1553022000,1,39,40,Clouds
25700,93,1553022000,0,40,40,Clouds
25701,94,1553022000,16,24,40,Clouds
25702,95,1553022000,26,14,40,Clouds
25703,96,1553022000,26,4,30,Clouds
25704,97,1553022000,23,17,40,Clouds
25705,98,1553022000,22,18,40,Clouds
25706,99,1553022000,10,20,30,Clouds
25707,100,1553022000,4,21,25,Clouds
25708,101,1553022000,27,3,30,Clouds
25709,102,1553022000,38,2,40,Clouds
25710,103,1553022000,39,1,40,Clouds
25711,104,1553022000,37,3,40,Clouds
25712,105,1553022000,34,2,36,Clouds
25713,106,1553022000,37,3,40,Clouds
25714,107,1553022000,36,4,40,Clouds
25715,108,1553022000,31,9,40,Clouds
25716,109,1553022000,27,2,29,Clouds
25717,110,1553022000,37,3,40,Clouds
25718,111,1553022000,40,0,40,Clouds
25719,112,1553022000,23,7,30,Clouds
25720,113,1553022000,29,11,40,Clouds
25721,114,1553022000,38,2,40,Clouds
25722,115,1553022000,16,14,30,Clouds
25723,2,1553025600,15,5,20,Clouds
25724,3,1553025600,17,3,20,Clouds
25725,4,1553025600,19,1,20,Clouds
25726,5,1553025600,7,33,40,Clouds
25727,6,1553025600,20,0,20,Clouds
25728,7,1553025600,24,5,29,Clouds
25729,8,1553025600,21,8,29,Clouds
25730,9,1553025600,23,1,24,Clouds
25731,10,1553025600,16,0,16,Clouds
25732,11,1553025600,30,0,30,Clouds
25733,12,1553025600,11,9,20,Clouds
25734,13,1553025600,30,0,30,Clouds
25735,14,1553025600,22,8,30,Clouds
25736,15,1553025600,15,1,16,Clouds
25737,16,1553025600,1,19,20,Clouds
25738,17,1553025600,16,4,20,Clouds
25739,18,1553025600,17,13,30,Clouds
25740,19,1553025600,27,3,30,Clouds
25741,21,1553025600,13,17,30,Clouds
25742,22,1553025600,0,20,20,Clouds
25743,23,1553025600,4,26,30,Clouds
25744,24,1553025600,14,6,20,Clouds
25745,25,1553025600,30,0,30,Clouds
25746,26,1553025600,13,7,20,Clouds
25747,27,1553025600,20,0,20,Clouds
25748,28,1553025600,25,5,30,Clouds
25749,29,1553025600,29,0,29,Clouds
25750,30,1553025600,20,0,20,Clouds
25751,31,1553025600,19,1,20,Clouds
25752,32,1553025600,4,26,30,Clouds
25753,33,1553025600,16,7,23,Clouds
25754,34,1553025600,7,23,30,Clouds
25755,35,1553025600,25,5,30,Clouds
25756,36,1553025600,30,10,40,Clouds
25757,37,1553025600,27,3,30,Clouds
25758,38,1553025600,4,36,40,Clouds
25759,39,1553025600,19,1,20,Clouds
25760,40,1553025600,21,0,21,Clouds
25761,41,1553025600,17,3,20,Clouds
25762,42,1553025600,5,25,30,Clouds
25763,43,1553025600,14,16,30,Clouds
25764,44,1553025600,11,19,30,Clouds
25765,45,1553025600,1,29,30,Clouds
25766,46,1553025600,17,3,20,Clouds
25767,47,1553025600,39,1,40,Clouds
25768,48,1553025600,19,21,40,Clouds
25769,49,1553025600,36,4,40,Clouds
25770,50,1553025600,10,30,40,Clouds
25771,51,1553025600,31,9,40,Clouds
25772,52,1553025600,31,1,32,Clouds
25773,53,1553025600,40,0,40,Clouds
25774,54,1553025600,31,2,33,Clouds
25775,55,1553025600,36,0,36,Clouds
25776,56,1553025600,27,13,40,Clouds
25777,57,1553025600,21,2,23,Clouds
25778,58,1553025600,38,2,40,Clouds
25779,59,1553025600,20,0,20,Clouds
25780,60,1553025600,1,29,30,Clouds
25781,61,1553025600,23,2,25,Clouds
25782,62,1553025600,40,0,40,Clouds
25783,63,1553025600,28,7,35,Clouds
25784,64,1553025600,15,25,40,Clouds
25785,65,1553025600,40,0,40,Clouds
25786,66,1553025600,39,1,40,Clouds
25787,67,1553025600,26,14,40,Clouds
25788,68,1553025600,40,0,40,Clouds
25789,69,1553025600,37,3,40,Clouds
25790,70,1553025600,27,1,28,Clouds
25791,71,1553025600,36,4,40,Clouds
25792,72,1553025600,19,12,31,Clouds
25793,73,1553025600,26,4,30,Clouds
25794,74,1553025600,4,26,30,Clouds
25795,75,1553025600,19,21,40,Clouds
25796,76,1553025600,14,24,38,Clouds
25797,77,1553025600,29,0,29,Clouds
25798,78,1553025600,25,15,40,Clouds
25799,79,1553025600,24,3,27,Clouds
25800,80,1553025600,26,14,40,Clouds
25801,81,1553025600,25,15,40,Clouds
25802,82,1553025600,15,7,22,Clouds
25803,83,1553025600,13,27,40,Clouds
25804,84,1553025600,17,13,30,Clouds
25805,85,1553025600,18,17,35,Clouds
25806,86,1553025600,0,38,38,Clouds
25807,87,1553025600,24,14,38,Clouds
25808,88,1553025600,20,10,30,Clouds
25809,89,1553025600,40,0,40,Clouds
25810,90,1553025600,40,0,40,Clouds
25811,91,1553025600,18,12,30,Clouds
25812,92,1553025600,0,40,40,Clouds
25813,93,1553025600,0,40,40,Clouds
25814,94,1553025600,6,34,40,Clouds
25815,95,1553025600,11,29,40,Clouds
25816,96,1553025600,27,3,30,Clouds
25817,97,1553025600,16,24,40,Clouds
25818,98,1553025600,34,6,40,Clouds
25819,99,1553025600,14,16,30,Clouds
25820,100,1553025600,0,25,25,Clouds
25821,101,1553025600,25,5,30,Clouds
25822,102,1553025600,38,2,40,Clouds
25823,103,1553025600,40,0,40,Clouds
25824,104,1553025600,38,2,40,Clouds
25825,105,1553025600,36,0,36,Clouds
25826,106,1553025600,35,5,40,Clouds
25827,107,1553025600,33,7,40,Clouds
25828,108,1553025600,31,9,40,Clouds
25829,109,1553025600,23,6,29,Clouds
25830,110,1553025600,33,7,40,Clouds
25831,111,1553025600,33,7,40,Clouds
25832,112,1553025600,16,14,30,Clouds
25833,113,1553025600,40,0,40,Clouds
25834,114,1553025600,40,0,40,Clouds
25835,115,1553025600,11,19,30,Clouds
25836,2,1553029200,20,0,20,Clouds
25837,3,1553029200,20,0,20,Clouds
25838,4,1553029200,20,0,20,Clouds
25839,5,1553029200,18,22,40,Clouds
25840,6,1553029200,16,4,20,Clouds
25841,7,1553029200,29,0,29,Clouds
25842,8,1553029200,26,4,30,Clouds
25843,9,1553029200,24,0,24,Clouds
25844,10,1553029200,12,4,16,Clouds
25845,11,1553029200,28,2,30,Clouds
25846,12,1553029200,5,15,20,Clouds
25847,13,1553029200,30,0,30,Clouds
25848,14,1553029200,30,0,30,Clouds
25849,15,1553029200,16,0,16,Clouds
25850,16,1553029200,3,17,20,Clouds
25851,17,1553029200,18,2,20,Clouds
25852,18,1553029200,19,11,30,Clouds
25853,19,1553029200,27,3,30,Clouds
25854,21,1553029200,20,10,30,Clouds
25855,22,1553029200,9,11,20,Clouds
25856,23,1553029200,1,29,30,Clouds
25857,24,1553029200,17,3,20,Clouds
25858,25,1553029200,28,2,30,Clouds
25859,26,1553029200,15,5,20,Clouds
25860,27,1553029200,20,0,20,Clouds
25861,28,1553029200,22,8,30,Clouds
25862,29,1553029200,26,3,29,Clouds
25863,30,1553029200,20,0,20,Clouds
25864,31,1553029200,18,2,20,Clouds
25865,32,1553029200,16,13,29,Clouds
25866,33,1553029200,15,8,23,Clouds
25867,34,1553029200,0,30,30,Clouds
25868,35,1553029200,21,9,30,Clouds
25869,36,1553029200,38,2,40,Clouds
25870,37,1553029200,30,0,30,Clouds
25871,38,1553029200,6,34,40,Clouds
25872,39,1553029200,15,5,20,Clouds
25873,40,1553029200,21,0,21,Clouds
25874,41,1553029200,20,0,20,Clouds
25875,42,1553029200,3,27,30,Clouds
25876,43,1553029200,3,27,30,Clouds
25877,44,1553029200,4,26,30,Clouds
25878,45,1553029200,0,30,30,Clouds
25879,46,1553029200,16,4,20,Clouds
25880,47,1553029200,40,0,40,Clouds
25881,48,1553029200,24,16,40,Clouds
25882,49,1553029200,39,1,40,Clouds
25883,50,1553029200,9,31,40,Clouds
25884,51,1553029200,36,4,40,Clouds
25885,52,1553029200,32,0,32,Clouds
25886,53,1553029200,40,0,40,Clouds
25887,54,1553029200,31,2,33,Clouds
25888,55,1553029200,36,0,36,Clouds
25889,56,1553029200,38,2,40,Clouds
25890,57,1553029200,20,3,23,Clouds
25891,58,1553029200,37,3,40,Clouds
25892,59,1553029200,20,0,20,Clouds
25893,60,1553029200,0,30,30,Clouds
25894,61,1553029200,25,0,25,Clouds
25895,62,1553029200,40,0,40,Clouds
25896,63,1553029200,31,4,35,Clouds
25897,64,1553029200,8,32,40,Clouds
25898,65,1553029200,40,0,40,Clouds
25899,66,1553029200,35,5,40,Clouds
25900,67,1553029200,17,23,40,Clouds
25901,68,1553029200,22,18,40,Clouds
25902,69,1553029200,38,2,40,Clouds
25903,70,1553029200,27,1,28,Clouds
25904,71,1553029200,40,0,40,Clouds
25905,72,1553029200,13,18,31,Clouds
25906,73,1553029200,20,10,30,Clouds
25907,74,1553029200,4,26,30,Clouds
25908,75,1553029200,19,21,40,Clouds
25909,76,1553029200,12,26,38,Clouds
25910,77,1553029200,28,1,29,Clouds
25911,78,1553029200,22,18,40,Clouds
25912,79,1553029200,24,3,27,Clouds
25913,80,1553029200,24,16,40,Clouds
25914,81,1553029200,28,12,40,Clouds
25915,82,1553029200,10,12,22,Clouds
25916,83,1553029200,7,33,40,Clouds
25917,84,1553029200,9,21,30,Clouds
25918,85,1553029200,12,23,35,Clouds
25919,86,1553029200,0,38,38,Clouds
25920,87,1553029200,18,20,38,Clouds
25921,88,1553029200,16,14,30,Clouds
25922,89,1553029200,39,1,40,Clouds
25923,90,1553029200,40,0,40,Clouds
25924,91,1553029200,12,18,30,Clouds
25925,92,1553029200,0,40,40,Clouds
25926,93,1553029200,0,40,40,Clouds
25927,94,1553029200,0,40,40,Clouds
25928,95,1553029200,2,38,40,Clouds
25929,96,1553029200,20,10,30,Clouds
25930,97,1553029200,9,31,40,Clouds
25931,98,1553029200,40,0,40,Clouds
25932,99,1553029200,22,8,30,Clouds
25933,100,1553029200,0,25,25,Clouds
25934,101,1553029200,23,7,30,Clouds
25935,102,1553029200,35,5,40,Clouds
25936,103,1553029200,40,0,40,Clouds
25937,104,1553029200,40,0,40,Clouds
25938,105,1553029200,36,0,36,Clouds
25939,106,1553029200,35,5,40,Clouds
25940,107,1553029200,34,6,40,Clouds
25941,108,1553029200,30,10,40,Clouds
25942,109,1553029200,16,13,29,Clouds
25943,110,1553029200,34,6,40,Clouds
25944,111,1553029200,23,17,40,Clouds
25945,112,1553029200,10,20,30,Clouds
25946,113,1553029200,40,0,40,Clouds
25947,114,1553029200,39,1,40,Clouds
25948,115,1553029200,0,30,30,Clouds
25949,2,1553032800,15,5,20,Clouds
25950,3,1553032800,18,2,20,Clouds
25951,4,1553032800,20,0,20,Clouds
25952,5,1553032800,13,27,40,Clouds
25953,6,1553032800,20,0,20,Clouds
25954,7,1553032800,27,2,29,Clouds
25955,8,1553032800,30,0,30,Clouds
25956,9,1553032800,23,1,24,Clouds
25957,10,1553032800,16,0,16,Clouds
25958,11,1553032800,30,0,30,Clouds
25959,12,1553032800,5,15,20,Clouds
25960,13,1553032800,29,1,30,Clouds
25961,14,1553032800,30,0,30,Clouds
25962,15,1553032800,16,0,16,Clouds
25963,16,1553032800,6,14,20,Clouds
25964,17,1553032800,16,4,20,Clouds
25965,18,1553032800,19,11,30,Clouds
25966,19,1553032800,25,5,30,Clouds
25967,21,1553032800,30,0,30,Clouds
25968,22,1553032800,11,9,20,Clouds
25969,23,1553032800,2,28,30,Clouds
25970,24,1553032800,20,0,20,Clouds
25971,25,1553032800,29,1,30,Clouds
25972,26,1553032800,13,7,20,Clouds
25973,27,1553032800,20,0,20,Clouds
25974,28,1553032800,22,8,30,Clouds
25975,29,1553032800,29,0,29,Clouds
25976,30,1553032800,19,1,20,Clouds
25977,31,1553032800,20,0,20,Clouds
25978,32,1553032800,22,8,30,Clouds
25979,33,1553032800,22,1,23,Clouds
25980,34,1553032800,1,29,30,Clouds
25981,35,1553032800,17,13,30,Clouds
25982,36,1553032800,40,0,40,Clouds
25983,37,1553032800,30,0,30,Clouds
25984,38,1553032800,7,33,40,Clouds
25985,39,1553032800,15,5,20,Clouds
25986,40,1553032800,21,0,21,Clouds
25987,41,1553032800,18,2,20,Clouds
25988,42,1553032800,6,24,30,Clouds
25989,43,1553032800,0,30,30,Clouds
25990,44,1553032800,0,30,30,Clouds
25991,45,1553032800,5,25,30,Clouds
25992,46,1553032800,15,5,20,Clouds
25993,47,1553032800,38,2,40,Clouds
25994,48,1553032800,31,9,40,Clouds
25995,49,1553032800,40,0,40,Clouds
25996,50,1553032800,0,40,40,Clouds
25997,51,1553032800,40,0,40,Clouds
25998,52,1553032800,32,0,32,Clouds
25999,53,1553032800,40,0,40,Clouds
26000,54,1553032800,33,0,33,Clouds
26001,55,1553032800,36,0,36,Clouds
26002,56,1553032800,39,1,40,Clouds
26003,57,1553032800,21,2,23,Clouds
26004,58,1553032800,39,1,40,Clouds
26005,59,1553032800,20,0,20,Clouds
26006,60,1553032800,0,30,30,Clouds
26007,61,1553032800,23,2,25,Clouds
26008,62,1553032800,40,0,40,Clouds
26009,63,1553032800,29,6,35,Clouds
26010,64,1553032800,11,29,40,Clouds
26011,65,1553032800,40,0,40,Clouds
26012,66,1553032800,33,7,40,Clouds
26013,67,1553032800,7,33,40,Clouds
26014,68,1553032800,33,7,40,Clouds
26015,69,1553032800,38,2,40,Clouds
26016,70,1553032800,26,2,28,Clouds
26017,71,1553032800,40,0,40,Clouds
26018,72,1553032800,17,14,31,Clouds
26019,73,1553032800,15,15,30,Clouds
26020,74,1553032800,3,27,30,Clouds
26021,75,1553032800,15,25,40,Clouds
26022,76,1553032800,10,28,38,Clouds
26023,77,1553032800,23,6,29,Clouds
26024,78,1553032800,19,21,40,Clouds
26025,79,1553032800,26,1,27,Clouds
26026,80,1553032800,25,15,40,Clouds
26027,81,1553032800,29,11,40,Clouds
26028,82,1553032800,8,14,22,Clouds
26029,83,1553032800,1,39,40,Clouds
26030,84,1553032800,5,25,30,Clouds
26031,85,1553032800,10,25,35,Clouds
26032,86,1553032800,0,38,38,Clouds
26033,87,1553032800,11,27,38,Clouds
26034,88,1553032800,10,20,30,Clouds
26035,89,1553032800,39,1,40,Clouds
26036,90,1553032800,40,0,40,Clouds
26037,91,1553032800,8,22,30,Clouds
26038,92,1553032800,0,40,40,Clouds
26039,93,1553032800,0,40,40,Clouds
26040,94,1553032800,0,40,40,Clouds
26041,95,1553032800,4,36,40,Clouds
26042,96,1553032800,20,10,30,Clouds
26043,97,1553032800,6,34,40,Clouds
26044,98,1553032800,40,0,40,Clouds
26045,99,1553032800,26,4,30,Clouds
26046,100,1553032800,1,24,25,Clouds
26047,101,1553032800,24,6,30,Clouds
26048,102,1553032800,36,4,40,Clouds
26049,103,1553032800,39,1,40,Clouds
26050,104,1553032800,40,0,40,Clouds
26051,105,1553032800,36,0,36,Clouds
26052,106,1553032800,35,5,40,Clouds
26053,107,1553032800,30,10,40,Clouds
26054,108,1553032800,25,15,40,Clouds
26055,109,1553032800,10,19,29,Clouds
26056,110,1553032800,30,10,40,Clouds
26057,111,1553032800,17,23,40,Clouds
26058,112,1553032800,3,27,30,Clouds
26059,113,1553032800,40,0,40,Clouds
26060,114,1553032800,40,0,40,Clouds
26061,115,1553032800,0,30,30,Clouds
26062,2,1553036400,14,6,20,Clouds
26063,3,1553036400,15,5,20,Clouds
26064,4,1553036400,19,1,20,Clouds
26065,5,1553036400,11,29,40,Clouds
26066,6,1553036400,18,2,20,Clouds
26067,7,1553036400,28,1,29,Clouds
26068,8,1553036400,25,5,30,Clouds
26069,9,1553036400,13,11,24,Clouds
26070,10,1553036400,15,1,16,Clouds
26071,11,1553036400,30,0,30,Clouds
26072,12,1553036400,4,16,20,Clouds
26073,13,1553036400,30,0,30,Clouds
26074,14,1553036400,30,0,30,Clouds
26075,15,1553036400,15,1,16,Clouds
26076,16,1553036400,5,15,20,Clouds
26077,17,1553036400,16,4,20,Clouds
26078,18,1553036400,21,9,30,Clouds
26079,19,1553036400,29,1,30,Clouds
26080,21,1553036400,30,0,30,Clouds
26081,22,1553036400,20,0,20,Clouds
26082,23,1553036400,3,27,30,Clouds
26083,24,1553036400,19,1,20,Clouds
26084,25,1553036400,30,0,30,Clouds
26085,26,1553036400,17,3,20,Clouds
26086,27,1553036400,20,0,20,Clouds
26087,28,1553036400,17,13,30,Clouds
26088,29,1553036400,29,0,29,Clouds
26089,30,1553036400,20,0,20,Clouds
26090,31,1553036400,19,1,20,Clouds
26091,32,1553036400,30,0,30,Clouds
26092,33,1553036400,22,1,23,Clouds
26093,34,1553036400,15,15,30,Clouds
26094,35,1553036400,16,14,30,Clouds
26095,36,1553036400,31,9,40,Clouds
26096,37,1553036400,29,1,30,Clouds
26097,38,1553036400,15,25,40,Clouds
26098,39,1553036400,15,5,20,Clouds
26099,40,1553036400,21,0,21,Clouds
26100,41,1553036400,20,0,20,Clouds
26101,42,1553036400,5,25,30,Clouds
26102,43,1553036400,2,28,30,Clouds
26103,44,1553036400,1,29,30,Clouds
26104,45,1553036400,3,27,30,Clouds
26105,46,1553036400,19,1,20,Clouds
26106,47,1553036400,39,1,40,Clouds
26107,48,1553036400,37,3,40,Clouds
26108,49,1553036400,40,0,40,Clouds
26109,50,1553036400,0,40,40,Clouds
26110,51,1553036400,40,0,40,Clouds
26111,52,1553036400,32,0,32,Clouds
26112,53,1553036400,40,0,40,Clouds
26113,54,1553036400,32,1,33,Clouds
26114,55,1553036400,35,1,36,Clouds
26115,56,1553036400,39,1,40,Clouds
26116,57,1553036400,21,2,23,Clouds
26117,58,1553036400,38,2,40,Clouds
26118,59,1553036400,20,0,20,Clouds
26119,60,1553036400,0,30,30,Clouds
26120,61,1553036400,21,4,25,Clouds
26121,62,1553036400,38,2,40,Clouds
26122,63,1553036400,30,5,35,Clouds
26123,64,1553036400,15,25,40,Clouds
26124,65,1553036400,40,0,40,Clouds
26125,66,1553036400,40,0,40,Clouds
26126,67,1553036400,4,36,40,Clouds
26127,68,1553036400,40,0,40,Clouds
26128,69,1553036400,39,1,40,Clouds
26129,70,1553036400,24,4,28,Clouds
26130,71,1553036400,39,1,40,Clouds
26131,72,1553036400,13,18,31,Clouds
26132,73,1553036400,10,20,30,Clouds
26133,74,1553036400,2,28,30,Clouds
26134,75,1553036400,16,24,40,Clouds
26135,76,1553036400,11,27,38,Clouds
26136,77,1553036400,27,2,29,Clouds
26137,78,1553036400,9,31,40,Clouds
26138,79,1553036400,26,1,27,Clouds
26139,80,1553036400,26,14,40,Clouds
26140,81,1553036400,29,11,40,Clouds
26141,82,1553036400,9,13,22,Clouds
26142,83,1553036400,6,34,40,Clouds
26143,84,1553036400,3,27,30,Clouds
26144,85,1553036400,15,20,35,Clouds
26145,86,1553036400,3,35,38,Clouds
26146,87,1553036400,7,31,38,Clouds
26147,88,1553036400,6,24,30,Clouds
26148,89,1553036400,40,0,40,Clouds
26149,90,1553036400,39,1,40,Clouds
26150,91,1553036400,6,24,30,Clouds
26151,92,1553036400,10,30,40,Clouds
26152,93,1553036400,0,40,40,Clouds
26153,94,1553036400,0,40,40,Clouds
26154,95,1553036400,3,37,40,Clouds
26155,96,1553036400,19,11,30,Clouds
26156,97,1553036400,4,36,40,Clouds
26157,98,1553036400,40,0,40,Clouds
26158,99,1553036400,30,0,30,Clouds
26159,100,1553036400,2,23,25,Clouds
26160,101,1553036400,27,3,30,Clouds
26161,102,1553036400,36,4,40,Clouds
26162,103,1553036400,37,3,40,Clouds
26163,104,1553036400,40,0,40,Clouds
26164,105,1553036400,36,0,36,Clouds
26165,106,1553036400,14,26,40,Clouds
26166,107,1553036400,28,12,40,Clouds
26167,108,1553036400,23,17,40,Clouds
26168,109,1553036400,6,23,29,Clouds
26169,110,1553036400,30,10,40,Clouds
26170,111,1553036400,14,26,40,Clouds
26171,112,1553036400,8,22,30,Clouds
26172,113,1553036400,40,0,40,Clouds
26173,114,1553036400,40,0,40,Clouds
26174,115,1553036400,7,23,30,Clouds
26175,2,1553040000,15,5,20,Clouds
26176,3,1553040000,16,4,20,Clouds
26177,4,1553040000,20,0,20,Clouds
26178,5,1553040000,8,32,40,Clouds
26179,6,1553040000,20,0,20,Clouds
26180,7,1553040000,29,0,29,Clouds
26181,8,1553040000,28,2,30,Clouds
26182,9,1553040000,24,0,24,Clouds
26183,10,1553040000,16,0,16,Clouds
26184,11,1553040000,30,0,30,Clouds
26185,12,1553040000,4,16,20,Clouds
26186,13,1553040000,30,0,30,Clouds
26187,14,1553040000,27,3,30,Clouds
26188,15,1553040000,15,1,16,Clouds
26189,16,1553040000,4,16,20,Clouds
26190,17,1553040000,16,4,20,Clouds
26191,18,1553040000,23,7,30,Clouds
26192,19,1553040000,27,3,30,Clouds
26193,21,1553040000,30,0,30,Clouds
26194,22,1553040000,16,4,20,Clouds
26195,23,1553040000,7,23,30,Clouds
26196,24,1553040000,18,2,20,Clouds
26197,25,1553040000,30,0,30,Clouds
26198,26,1553040000,19,1,20,Clouds
26199,27,1553040000,20,0,20,Clouds
26200,28,1553040000,13,17,30,Clouds
26201,29,1553040000,29,0,29,Clouds
26202,30,1553040000,19,1,20,Clouds
26203,31,1553040000,14,6,20,Clouds
26204,32,1553040000,27,3,30,Clouds
26205,33,1553040000,23,0,23,Clouds
26206,34,1553040000,13,17,30,Clouds
26207,35,1553040000,18,12,30,Clouds
26208,36,1553040000,34,6,40,Clouds
26209,37,1553040000,23,7,30,Clouds
26210,38,1553040000,18,22,40,Clouds
26211,39,1553040000,14,6,20,Clouds
26212,40,1553040000,20,1,21,Clouds
26213,41,1553040000,20,0,20,Clouds
26214,42,1553040000,6,24,30,Clouds
26215,43,1553040000,1,29,30,Clouds
26216,44,1553040000,0,30,30,Clouds
26217,45,1553040000,1,29,30,Clouds
26218,46,1553040000,19,1,20,Clouds
26219,47,1553040000,39,1,40,Clouds
26220,48,1553040000,35,5,40,Clouds
26221,49,1553040000,40,0,40,Clouds
26222,50,1553040000,1,39,40,Clouds
26223,51,1553040000,33,7,40,Clouds
26224,52,1553040000,32,0,32,Clouds
26225,53,1553040000,40,0,40,Clouds
26226,54,1553040000,31,2,33,Clouds
26227,55,1553040000,36,0,36,Clouds
26228,56,1553040000,37,3,40,Clouds
26229,57,1553040000,23,0,23,Clouds
26230,58,1553040000,40,0,40,Clouds
26231,59,1553040000,20,0,20,Clouds
26232,60,1553040000,12,18,30,Clouds
26233,61,1553040000,23,2,25,Clouds
26234,62,1553040000,40,0,40,Clouds
26235,63,1553040000,33,2,35,Clouds
26236,64,1553040000,16,24,40,Clouds
26237,65,1553040000,40,0,40,Clouds
26238,66,1553040000,39,1,40,Clouds
26239,67,1553040000,9,31,40,Clouds
26240,68,1553040000,39,1,40,Clouds
26241,69,1553040000,40,0,40,Clouds
26242,70,1553040000,16,12,28,Clouds
26243,71,1553040000,36,4,40,Clouds
26244,72,1553040000,15,16,31,Clouds
26245,73,1553040000,10,20,30,Clouds
26246,74,1553040000,2,28,30,Clouds
26247,75,1553040000,15,25,40,Clouds
26248,76,1553040000,8,30,38,Clouds
26249,77,1553040000,25,4,29,Clouds
26250,78,1553040000,8,32,40,Clouds
26251,79,1553040000,26,1,27,Clouds
26252,80,1553040000,25,15,40,Clouds
26253,81,1553040000,28,12,40,Clouds
26254,82,1553040000,8,14,22,Clouds
26255,83,1553040000,7,33,40,Clouds
26256,84,1553040000,0,30,30,Clouds
26257,85,1553040000,10,25,35,Clouds
26258,86,1553040000,13,25,38,Clouds
26259,87,1553040000,6,32,38,Clouds
26260,88,1553040000,8,22,30,Clouds
26261,89,1553040000,40,0,40,Clouds
26262,90,1553040000,39,1,40,Clouds
26263,91,1553040000,12,18,30,Clouds
26264,92,1553040000,10,30,40,Clouds
26265,93,1553040000,0,40,40,Clouds
26266,94,1553040000,0,40,40,Clouds
26267,95,1553040000,2,38,40,Clouds
26268,96,1553040000,19,11,30,Clouds
26269,97,1553040000,3,37,40,Clouds
26270,98,1553040000,40,0,40,Clouds
26271,99,1553040000,30,0,30,Clouds
26272,100,1553040000,1,24,25,Clouds
26273,101,1553040000,24,6,30,Clouds
26274,102,1553040000,36,4,40,Clouds
26275,103,1553040000,38,2,40,Clouds
26276,104,1553040000,40,0,40,Clouds
26277,105,1553040000,36,0,36,Clouds
26278,106,1553040000,14,26,40,Clouds
26279,107,1553040000,28,12,40,Clouds
26280,108,1553040000,20,20,40,Clouds
26281,109,1553040000,3,26,29,Clouds
26282,110,1553040000,31,9,40,Clouds
26283,111,1553040000,8,32,40,Clouds
26284,112,1553040000,9,21,30,Clouds
26285,113,1553040000,40,0,40,Clouds
26286,114,1553040000,39,1,40,Clouds
26287,115,1553040000,5,25,30,Clouds
26288,2,1553043600,13,7,20,Clouds
26289,3,1553043600,16,4,20,Clouds
26290,4,1553043600,20,0,20,Clouds
26291,5,1553043600,8,32,40,Clouds
26292,6,1553043600,20,0,20,Clouds
26293,7,1553043600,28,1,29,Clouds
26294,8,1553043600,28,2,30,Clouds
26295,9,1553043600,24,0,24,Clouds
26296,10,1553043600,16,0,16,Clouds
26297,11,1553043600,30,0,30,Clouds
26298,12,1553043600,3,17,20,Clouds
26299,13,1553043600,30,0,30,Clouds
26300,14,1553043600,28,2,30,Clouds
26301,15,1553043600,11,5,16,Clouds
26302,16,1553043600,5,15,20,Clouds
26303,17,1553043600,19,1,20,Clouds
26304,18,1553043600,24,6,30,Clouds
26305,19,1553043600,28,2,30,Clouds
26306,21,1553043600,30,0,30,Clouds
26307,22,1553043600,18,2,20,Clouds
26308,23,1553043600,7,23,30,Clouds
26309,24,1553043600,14,6,20,Clouds
26310,25,1553043600,30,0,30,Clouds
26311,26,1553043600,20,0,20,Clouds
26312,27,1553043600,20,0,20,Clouds
26313,28,1553043600,20,10,30,Clouds
26314,29,1553043600,28,1,29,Clouds
26315,30,1553043600,17,3,20,Clouds
26316,31,1553043600,16,4,20,Clouds
26317,32,1553043600,30,0,30,Clouds
26318,33,1553043600,23,0,23,Clouds
26319,34,1553043600,10,20,30,Clouds
26320,35,1553043600,19,11,30,Clouds
26321,36,1553043600,40,0,40,Clouds
26322,37,1553043600,26,4,30,Clouds
26323,38,1553043600,17,23,40,Clouds
26324,39,1553043600,15,5,20,Clouds
26325,40,1553043600,21,0,21,Clouds
26326,41,1553043600,19,1,20,Clouds
26327,42,1553043600,5,25,30,Clouds
26328,43,1553043600,1,29,30,Clouds
26329,44,1553043600,0,30,30,Clouds
26330,45,1553043600,1,29,30,Clouds
26331,46,1553043600,20,0,20,Clouds
26332,47,1553043600,39,1,40,Clouds
26333,48,1553043600,35,5,40,Clouds
26334,49,1553043600,33,7,40,Clouds
26335,50,1553043600,1,39,40,Clouds
26336,51,1553043600,34,6,40,Clouds
26337,52,1553043600,32,0,32,Clouds
26338,53,1553043600,40,0,40,Clouds
26339,54,1553043600,29,4,33,Clouds
26340,55,1553043600,36,0,36,Clouds
26341,56,1553043600,37,3,40,Clouds
26342,57,1553043600,23,0,23,Clouds
26343,58,1553043600,40,0,40,Clouds
26344,59,1553043600,19,1,20,Clouds
26345,60,1553043600,10,20,30,Clouds
26346,61,1553043600,22,3,25,Clouds
26347,62,1553043600,40,0,40,Clouds
26348,63,1553043600,33,2,35,Clouds
26349,64,1553043600,15,25,40,Clouds
26350,65,1553043600,40,0,40,Clouds
26351,66,1553043600,34,6,40,Clouds
26352,67,1553043600,16,24,40,Clouds
26353,68,1553043600,40,0,40,Clouds
26354,69,1553043600,37,3,40,Clouds
26355,70,1553043600,13,15,28,Clouds
26356,71,1553043600,32,8,40,Clouds
26357,72,1553043600,18,13,31,Clouds
26358,73,1553043600,11,19,30,Clouds
26359,74,1553043600,2,28,30,Clouds
26360,75,1553043600,15,25,40,Clouds
26361,76,1553043600,9,29,38,Clouds
26362,77,1553043600,26,3,29,Clouds
26363,78,1553043600,5,35,40,Clouds
26364,79,1553043600,26,1,27,Clouds
26365,80,1553043600,24,16,40,Clouds
26366,81,1553043600,29,11,40,Clouds
26367,82,1553043600,7,15,22,Clouds
26368,83,1553043600,6,34,40,Clouds
26369,84,1553043600,0,30,30,Clouds
26370,85,1553043600,8,27,35,Clouds
26371,86,1553043600,12,26,38,Clouds
26372,87,1553043600,4,34,38,Clouds
26373,88,1553043600,8,22,30,Clouds
26374,89,1553043600,40,0,40,Clouds
26375,90,1553043600,38,2,40,Clouds
26376,91,1553043600,11,19,30,Clouds
26377,92,1553043600,10,30,40,Clouds
26378,93,1553043600,0,40,40,Clouds
26379,94,1553043600,0,40,40,Clouds
26380,95,1553043600,1,39,40,Clouds
26381,96,1553043600,19,11,30,Clouds
26382,97,1553043600,3,37,40,Clouds
26383,98,1553043600,39,1,40,Clouds
26384,99,1553043600,29,1,30,Clouds
26385,100,1553043600,2,23,25,Clouds
26386,101,1553043600,23,7,30,Clouds
26387,102,1553043600,34,6,40,Clouds
26388,103,1553043600,38,2,40,Clouds
26389,104,1553043600,40,0,40,Clouds
26390,105,1553043600,36,0,36,Clouds
26391,106,1553043600,12,28,40,Clouds
26392,107,1553043600,27,13,40,Clouds
26393,108,1553043600,19,21,40,Clouds
26394,109,1553043600,3,26,29,Clouds
26395,110,1553043600,29,11,40,Clouds
26396,111,1553043600,7,33,40,Clouds
26397,112,1553043600,5,24,29,Clouds
26398,113,1553043600,40,0,40,Clouds
26399,114,1553043600,40,0,40,Clouds
26400,115,1553043600,11,19,30,Clouds
26401,2,1553047200,12,8,20,Clouds
26402,3,1553047200,17,3,20,Clouds
26403,4,1553047200,20,0,20,Clouds
26404,5,1553047200,8,32,40,Clouds
26405,6,1553047200,20,0,20,Clouds
26406,7,1553047200,29,0,29,Clouds
26407,8,1553047200,28,2,30,Clouds
26408,9,1553047200,24,0,24,Clouds
26409,10,1553047200,15,1,16,Clouds
26410,11,1553047200,30,0,30,Clouds
26411,12,1553047200,3,17,20,Clouds
26412,13,1553047200,30,0,30,Clouds
26413,14,1553047200,30,0,30,Clouds
26414,15,1553047200,11,5,16,Clouds
26415,16,1553047200,5,15,20,Clouds
26416,17,1553047200,19,1,20,Clouds
26417,18,1553047200,24,6,30,Clouds
26418,19,1553047200,29,1,30,Clouds
26419,21,1553047200,30,0,30,Clouds
26420,22,1553047200,19,1,20,Clouds
26421,23,1553047200,7,23,30,Clouds
26422,24,1553047200,20,0,20,Clouds
26423,25,1553047200,30,0,30,Clouds
26424,26,1553047200,20,0,20,Clouds
26425,27,1553047200,20,0,20,Clouds
26426,28,1553047200,21,9,30,Clouds
26427,29,1553047200,27,2,29,Clouds
26428,30,1553047200,17,3,20,Clouds
26429,31,1553047200,17,3,20,Clouds
26430,32,1553047200,30,0,30,Clouds
26431,33,1553047200,23,0,23,Clouds
26432,34,1553047200,9,21,30,Clouds
26433,35,1553047200,20,10,30,Clouds
26434,36,1553047200,40,0,40,Clouds
26435,37,1553047200,20,10,30,Clouds
26436,38,1553047200,16,24,40,Clouds
26437,39,1553047200,15,5,20,Clouds
26438,40,1553047200,21,0,21,Clouds
26439,41,1553047200,19,1,20,Clouds
26440,42,1553047200,5,25,30,Clouds
26441,43,1553047200,1,29,30,Clouds
26442,44,1553047200,1,29,30,Clouds
26443,45,1553047200,0,30,30,Clouds
26444,46,1553047200,20,0,20,Clouds
26445,47,1553047200,39,1,40,Clouds
26446,48,1553047200,35,5,40,Clouds
26447,49,1553047200,36,4,40,Clouds
26448,50,1553047200,0,40,40,Clouds
26449,51,1553047200,36,4,40,Clouds
26450,52,1553047200,32,0,32,Clouds
26451,53,1553047200,40,0,40,Clouds
26452,54,1553047200,27,6,33,Clouds
26453,55,1553047200,36,0,36,Clouds
26454,56,1553047200,36,4,40,Clouds
26455,57,1553047200,23,0,23,Clouds
26456,58,1553047200,39,1,40,Clouds
26457,59,1553047200,19,1,20,Clouds
26458,60,1553047200,8,22,30,Clouds
26459,61,1553047200,22,3,25,Clouds
26460,62,1553047200,39,1,40,Clouds
26461,63,1553047200,33,2,35,Clouds
26462,64,1553047200,15,25,40,Clouds
26463,65,1553047200,40,0,40,Clouds
26464,66,1553047200,36,4,40,Clouds
26465,67,1553047200,16,24,40,Clouds
26466,68,1553047200,40,0,40,Clouds
26467,69,1553047200,36,4,40,Clouds
26468,70,1553047200,12,16,28,Clouds
26469,71,1553047200,32,8,40,Clouds
26470,72,1553047200,18,13,31,Clouds
26471,73,1553047200,11,19,30,Clouds
26472,74,1553047200,2,28,30,Clouds
26473,75,1553047200,15,25,40,Clouds
26474,76,1553047200,9,29,38,Clouds
26475,77,1553047200,26,3,29,Clouds
26476,78,1553047200,3,37,40,Clouds
26477,79,1553047200,26,1,27,Clouds
26478,80,1553047200,23,17,40,Clouds
26479,81,1553047200,29,11,40,Clouds
26480,82,1553047200,6,16,22,Clouds
26481,83,1553047200,6,34,40,Clouds
26482,84,1553047200,0,30,30,Clouds
26483,85,1553047200,8,27,35,Clouds
26484,86,1553047200,13,25,38,Clouds
26485,87,1553047200,4,34,38,Clouds
26486,88,1553047200,8,22,30,Clouds
26487,89,1553047200,40,0,40,Clouds
26488,90,1553047200,38,2,40,Clouds
26489,91,1553047200,12,18,30,Clouds
26490,92,1553047200,9,31,40,Clouds
26491,93,1553047200,0,40,40,Clouds
26492,94,1553047200,0,40,40,Clouds
26493,95,1553047200,1,39,40,Clouds
26494,96,1553047200,19,11,30,Clouds
26495,97,1553047200,3,37,40,Clouds
26496,98,1553047200,40,0,40,Clouds
26497,99,1553047200,29,1,30,Clouds
26498,100,1553047200,2,23,25,Clouds
26499,101,1553047200,22,8,30,Clouds
26500,102,1553047200,34,6,40,Clouds
26501,103,1553047200,38,2,40,Clouds
26502,104,1553047200,40,0,40,Clouds
26503,105,1553047200,36,0,36,Clouds
26504,106,1553047200,12,28,40,Clouds
26505,107,1553047200,26,14,40,Clouds
26506,108,1553047200,18,22,40,Clouds
26507,109,1553047200,2,27,29,Clouds
26508,110,1553047200,30,10,40,Clouds
26509,111,1553047200,7,33,40,Clouds
26510,112,1553047200,4,26,30,Clouds
26511,113,1553047200,40,0,40,Clouds
26512,114,1553047200,40,0,40,Clouds
26513,115,1553047200,11,19,30,Clouds
26514,2,1553050800,12,8,20,Clouds
26515,3,1553050800,17,3,20,Clouds
26516,4,1553050800,20,0,20,Clouds
26517,5,1553050800,8,32,40,Clouds
26518,6,1553050800,20,0,20,Clouds
26519,7,1553050800,29,0,29,Clouds
26520,8,1553050800,28,2,30,Clouds
26521,9,1553050800,24,0,24,Clouds
26522,10,1553050800,15,1,16,Clouds
26523,11,1553050800,30,0,30,Clouds
26524,12,1553050800,3,17,20,Clouds
26525,13,1553050800,30,0,30,Clouds
26526,14,1553050800,30,0,30,Clouds
26527,15,1553050800,11,5,16,Clouds
26528,16,1553050800,5,15,20,Clouds
26529,17,1553050800,19,1,20,Clouds
26530,18,1553050800,24,6,30,Clouds
26531,19,1553050800,29,1,30,Clouds
26532,21,1553050800,30,0,30,Clouds
26533,22,1553050800,19,1,20,Clouds
26534,23,1553050800,7,23,30,Clouds
26535,24,1553050800,20,0,20,Clouds
26536,25,1553050800,30,0,30,Clouds
26537,26,1553050800,20,0,20,Clouds
26538,27,1553050800,20,0,20,Clouds
26539,28,1553050800,19,11,30,Clouds
26540,29,1553050800,27,2,29,Clouds
26541,30,1553050800,17,3,20,Clouds
26542,31,1553050800,16,4,20,Clouds
26543,32,1553050800,30,0,30,Clouds
26544,33,1553050800,23,0,23,Clouds
26545,34,1553050800,9,21,30,Clouds
26546,35,1553050800,20,10,30,Clouds
26547,36,1553050800,40,0,40,Clouds
26548,37,1553050800,20,10,30,Clouds
26549,38,1553050800,16,24,40,Clouds
26550,39,1553050800,15,5,20,Clouds
26551,40,1553050800,21,0,21,Clouds
26552,41,1553050800,19,1,20,Clouds
26553,42,1553050800,5,25,30,Clouds
26554,43,1553050800,1,29,30,Clouds
26555,44,1553050800,1,29,30,Clouds
26556,45,1553050800,0,30,30,Clouds
26557,46,1553050800,20,0,20,Clouds
26558,47,1553050800,39,1,40,Clouds
26559,48,1553050800,35,5,40,Clouds
26560,49,1553050800,36,4,40,Clouds
26561,50,1553050800,0,40,40,Clouds
26562,51,1553050800,36,4,40,Clouds
26563,52,1553050800,32,0,32,Clouds
26564,53,1553050800,40,0,40,Clouds
26565,54,1553050800,27,6,33,Clouds
26566,55,1553050800,36,0,36,Clouds
26567,56,1553050800,36,4,40,Clouds
26568,57,1553050800,23,0,23,Clouds
26569,58,1553050800,39,1,40,Clouds
26570,59,1553050800,19,1,20,Clouds
26571,60,1553050800,8,22,30,Clouds
26572,61,1553050800,22,3,25,Clouds
26573,62,1553050800,39,1,40,Clouds
26574,63,1553050800,33,2,35,Clouds
26575,64,1553050800,15,25,40,Clouds
26576,65,1553050800,40,0,40,Clouds
26577,66,1553050800,35,5,40,Clouds
26578,67,1553050800,16,24,40,Clouds
26579,68,1553050800,40,0,40,Clouds
26580,69,1553050800,36,4,40,Clouds
26581,70,1553050800,12,16,28,Clouds
26582,71,1553050800,32,8,40,Clouds
26583,72,1553050800,18,13,31,Clouds
26584,73,1553050800,11,19,30,Clouds
26585,74,1553050800,2,28,30,Clouds
26586,75,1553050800,15,25,40,Clouds
26587,76,1553050800,9,29,38,Clouds
26588,77,1553050800,26,3,29,Clouds
26589,78,1553050800,3,37,40,Clouds
26590,79,1553050800,26,1,27,Clouds
26591,80,1553050800,23,17,40,Clouds
26592,81,1553050800,29,11,40,Clouds
26593,82,1553050800,6,16,22,Clouds
26594,83,1553050800,6,34,40,Clouds
26595,84,1553050800,0,30,30,Clouds
26596,85,1553050800,8,27,35,Clouds
26597,86,1553050800,13,25,38,Clouds
26598,87,1553050800,4,34,38,Clouds
26599,88,1553050800,8,22,30,Clouds
26600,89,1553050800,40,0,40,Clouds
26601,90,1553050800,38,2,40,Clouds
26602,91,1553050800,12,18,30,Clouds
26603,92,1553050800,9,31,40,Clouds
26604,93,1553050800,0,40,40,Clouds
26605,94,1553050800,0,40,40,Clouds
26606,95,1553050800,1,39,40,Clouds
26607,96,1553050800,19,11,30,Clouds
26608,97,1553050800,3,37,40,Clouds
26609,98,1553050800,40,0,40,Clouds
26610,99,1553050800,29,1,30,Clouds
26611,100,1553050800,2,23,25,Clouds
26612,101,1553050800,22,8,30,Clouds
26613,102,1553050800,34,6,40,Clouds
26614,103,1553050800,38,2,40,Clouds
26615,104,1553050800,40,0,40,Clouds
26616,105,1553050800,36,0,36,Clouds
26617,106,1553050800,12,28,40,Clouds
26618,107,1553050800,26,14,40,Clouds
26619,108,1553050800,18,22,40,Clouds
26620,109,1553050800,2,27,29,Clouds
26621,110,1553050800,30,10,40,Clouds
26622,111,1553050800,7,33,40,Clouds
26623,112,1553050800,3,27,30,Clouds
26624,113,1553050800,40,0,40,Clouds
26625,114,1553050800,40,0,40,Clouds
26626,115,1553050800,11,19,30,Clouds
26627,2,1553054400,12,8,20,Clouds
26628,3,1553054400,17,3,20,Clouds
26629,4,1553054400,20,0,20,Clouds
26630,5,1553054400,8,32,40,Clouds
26631,6,1553054400,20,0,20,Clouds
26632,7,1553054400,29,0,29,Clouds
26633,8,1553054400,28,2,30,Clouds
26634,9,1553054400,24,0,24,Clouds
26635,10,1553054400,15,1,16,Clouds
26636,11,1553054400,30,0,30,Clouds
26637,12,1553054400,3,17,20,Clouds
26638,13,1553054400,30,0,30,Clouds
26639,14,1553054400,30,0,30,Clouds
26640,15,1553054400,11,5,16,Clouds
26641,16,1553054400,5,15,20,Clouds
26642,17,1553054400,19,1,20,Clouds
26643,18,1553054400,24,6,30,Clouds
26644,19,1553054400,29,1,30,Clouds
26645,21,1553054400,30,0,30,Clouds
26646,22,1553054400,19,1,20,Clouds
26647,23,1553054400,7,23,30,Clouds
26648,24,1553054400,20,0,20,Clouds
26649,25,1553054400,30,0,30,Clouds
26650,26,1553054400,20,0,20,Clouds
26651,27,1553054400,20,0,20,Clouds
26652,28,1553054400,19,11,30,Clouds
26653,29,1553054400,27,2,29,Clouds
26654,30,1553054400,17,3,20,Clouds
26655,31,1553054400,16,4,20,Clouds
26656,32,1553054400,30,0,30,Clouds
26657,33,1553054400,23,0,23,Clouds
26658,34,1553054400,9,21,30,Clouds
26659,35,1553054400,20,10,30,Clouds
26660,36,1553054400,40,0,40,Clouds
26661,37,1553054400,20,10,30,Clouds
26662,38,1553054400,16,24,40,Clouds
26663,39,1553054400,15,5,20,Clouds
26664,40,1553054400,21,0,21,Clouds
26665,41,1553054400,19,1,20,Clouds
26666,42,1553054400,5,25,30,Clouds
26667,43,1553054400,1,29,30,Clouds
26668,44,1553054400,1,29,30,Clouds
26669,45,1553054400,0,30,30,Clouds
26670,46,1553054400,20,0,20,Clouds
26671,47,1553054400,39,1,40,Clouds
26672,48,1553054400,35,5,40,Clouds
26673,49,1553054400,36,4,40,Clouds
26674,50,1553054400,0,40,40,Clouds
26675,51,1553054400,36,4,40,Clouds
26676,52,1553054400,32,0,32,Clouds
26677,53,1553054400,40,0,40,Clouds
26678,54,1553054400,27,6,33,Clouds
26679,55,1553054400,36,0,36,Clouds
26680,56,1553054400,36,4,40,Clouds
26681,57,1553054400,23,0,23,Clouds
26682,58,1553054400,39,1,40,Clouds
26683,59,1553054400,19,1,20,Clouds
26684,60,1553054400,8,22,30,Clouds
26685,61,1553054400,22,3,25,Clouds
26686,62,1553054400,39,1,40,Clouds
26687,63,1553054400,33,2,35,Clouds
26688,64,1553054400,15,25,40,Clouds
26689,65,1553054400,40,0,40,Clouds
26690,66,1553054400,35,5,40,Clouds
26691,67,1553054400,16,24,40,Clouds
26692,68,1553054400,40,0,40,Clouds
26693,69,1553054400,36,4,40,Clouds
26694,70,1553054400,12,16,28,Clouds
26695,71,1553054400,32,8,40,Clouds
26696,72,1553054400,18,13,31,Clouds
26697,73,1553054400,11,19,30,Clouds
26698,74,1553054400,2,28,30,Clouds
26699,75,1553054400,15,25,40,Clouds
26700,76,1553054400,9,29,38,Clouds
26701,77,1553054400,26,3,29,Clouds
26702,78,1553054400,3,37,40,Clouds
26703,79,1553054400,26,1,27,Clouds
26704,80,1553054400,23,17,40,Clouds
26705,81,1553054400,29,11,40,Clouds
26706,82,1553054400,6,16,22,Clouds
26707,83,1553054400,6,34,40,Clouds
26708,84,1553054400,0,30,30,Clouds
26709,85,1553054400,8,27,35,Clouds
26710,86,1553054400,13,25,38,Clouds
26711,87,1553054400,4,34,38,Clouds
26712,88,1553054400,8,22,30,Clouds
26713,89,1553054400,40,0,40,Clouds
26714,90,1553054400,38,2,40,Clouds
26715,91,1553054400,12,18,30,Clouds
26716,92,1553054400,9,31,40,Clouds
26717,93,1553054400,0,40,40,Clouds
26718,94,1553054400,0,40,40,Clouds
26719,95,1553054400,1,39,40,Clouds
26720,96,1553054400,19,11,30,Clouds
26721,97,1553054400,3,37,40,Clouds
26722,98,1553054400,40,0,40,Clouds
26723,99,1553054400,29,1,30,Clouds
26724,100,1553054400,2,23,25,Clouds
26725,101,1553054400,22,8,30,Clouds
26726,102,1553054400,34,6,40,Clouds
26727,103,1553054400,38,2,40,Clouds
26728,104,1553054400,40,0,40,Clouds
26729,105,1553054400,36,0,36,Clouds
26730,106,1553054400,12,28,40,Clouds
26731,107,1553054400,26,14,40,Clouds
26732,108,1553054400,18,22,40,Clouds
26733,109,1553054400,2,27,29,Clouds
26734,110,1553054400,30,10,40,Clouds
26735,111,1553054400,7,33,40,Clouds
26736,112,1553054400,3,27,30,Clouds
26737,113,1553054400,40,0,40,Clouds
26738,114,1553054400,40,0,40,Clouds
26739,115,1553054400,11,19,30,Clouds
26740,2,1553058000,12,8,20,Clouds
26741,3,1553058000,17,3,20,Clouds
26742,4,1553058000,20,0,20,Clouds
26743,5,1553058000,8,32,40,Clouds
26744,6,1553058000,20,0,20,Clouds
26745,7,1553058000,29,0,29,Clouds
26746,8,1553058000,28,2,30,Clouds
26747,9,1553058000,24,0,24,Clouds
26748,10,1553058000,15,1,16,Clouds
26749,11,1553058000,30,0,30,Clouds
26750,12,1553058000,3,17,20,Clouds
26751,13,1553058000,30,0,30,Clouds
26752,14,1553058000,30,0,30,Clouds
26753,15,1553058000,11,5,16,Clouds
26754,16,1553058000,5,15,20,Clouds
26755,17,1553058000,19,1,20,Clouds
26756,18,1553058000,24,6,30,Clouds
26757,19,1553058000,29,1,30,Clouds
26758,21,1553058000,30,0,30,Clouds
26759,22,1553058000,19,1,20,Clouds
26760,23,1553058000,7,23,30,Clouds
26761,24,1553058000,20,0,20,Clouds
26762,25,1553058000,30,0,30,Clouds
26763,26,1553058000,20,0,20,Clouds
26764,27,1553058000,20,0,20,Clouds
26765,28,1553058000,19,11,30,Clouds
26766,29,1553058000,27,2,29,Clouds
26767,30,1553058000,17,3,20,Clouds
26768,31,1553058000,16,4,20,Clouds
26769,32,1553058000,30,0,30,Clouds
26770,33,1553058000,23,0,23,Clouds
26771,34,1553058000,9,21,30,Clouds
26772,35,1553058000,20,10,30,Clouds
26773,36,1553058000,40,0,40,Clouds
26774,37,1553058000,20,10,30,Clouds
26775,38,1553058000,16,24,40,Clouds
26776,39,1553058000,15,5,20,Clouds
26777,40,1553058000,21,0,21,Clouds
26778,41,1553058000,19,1,20,Clouds
26779,42,1553058000,5,25,30,Clouds
26780,43,1553058000,1,29,30,Clouds
26781,44,1553058000,1,29,30,Clouds
26782,45,1553058000,0,30,30,Clouds
26783,46,1553058000,20,0,20,Clouds
26784,47,1553058000,39,1,40,Clouds
26785,48,1553058000,35,5,40,Clouds
26786,49,1553058000,36,4,40,Clouds
26787,50,1553058000,0,40,40,Clouds
26788,51,1553058000,36,4,40,Clouds
26789,52,1553058000,32,0,32,Clouds
26790,53,1553058000,40,0,40,Clouds
26791,54,1553058000,27,6,33,Clouds
26792,55,1553058000,36,0,36,Clouds
26793,56,1553058000,36,4,40,Clouds
26794,57,1553058000,23,0,23,Clouds
26795,58,1553058000,39,1,40,Clouds
26796,59,1553058000,19,1,20,Clouds
26797,60,1553058000,8,22,30,Clouds
26798,61,1553058000,22,3,25,Clouds
26799,62,1553058000,39,1,40,Clouds
26800,63,1553058000,33,2,35,Clouds
26801,64,1553058000,15,25,40,Clouds
26802,65,1553058000,40,0,40,Clouds
26803,66,1553058000,35,5,40,Clouds
26804,67,1553058000,16,24,40,Clouds
26805,68,1553058000,40,0,40,Clouds
26806,69,1553058000,36,4,40,Clouds
26807,70,1553058000,12,16,28,Clouds
26808,71,1553058000,32,8,40,Clouds
26809,72,1553058000,18,13,31,Clouds
26810,73,1553058000,11,19,30,Clouds
26811,74,1553058000,2,28,30,Clouds
26812,75,1553058000,15,25,40,Clouds
26813,76,1553058000,9,29,38,Clouds
26814,77,1553058000,26,3,29,Clouds
26815,78,1553058000,3,37,40,Clouds
26816,79,1553058000,26,1,27,Clouds
26817,80,1553058000,23,17,40,Clouds
26818,81,1553058000,29,11,40,Clouds
26819,82,1553058000,6,16,22,Clouds
26820,83,1553058000,6,34,40,Clouds
26821,84,1553058000,0,30,30,Clouds
26822,85,1553058000,8,27,35,Clouds
26823,86,1553058000,13,25,38,Clouds
26824,87,1553058000,4,34,38,Clouds
26825,88,1553058000,8,22,30,Clouds
26826,89,1553058000,40,0,40,Clouds
26827,90,1553058000,38,2,40,Clouds
26828,91,1553058000,12,18,30,Clouds
26829,92,1553058000,9,31,40,Clouds
26830,93,1553058000,0,40,40,Clouds
26831,94,1553058000,0,40,40,Clouds
26832,95,1553058000,1,39,40,Clouds
26833,96,1553058000,19,11,30,Clouds
26834,97,1553058000,3,37,40,Clouds
26835,98,1553058000,40,0,40,Clouds
26836,99,1553058000,29,1,30,Clouds
26837,100,1553058000,2,23,25,Clouds
26838,101,1553058000,22,8,30,Clouds
26839,102,1553058000,34,6,40,Clouds
26840,103,1553058000,38,2,40,Clouds
26841,104,1553058000,40,0,40,Clouds
26842,105,1553058000,36,0,36,Clouds
26843,106,1553058000,12,28,40,Clouds
26844,107,1553058000,26,14,40,Clouds
26845,108,1553058000,18,22,40,Clouds
26846,109,1553058000,2,27,29,Clouds
26847,110,1553058000,30,10,40,Clouds
26848,111,1553058000,7,33,40,Clouds
26849,112,1553058000,3,27,30,Clouds
26850,113,1553058000,40,0,40,Clouds
26851,114,1553058000,40,0,40,Clouds
26852,115,1553058000,11,19,30,Clouds
26853,2,1553061600,12,8,20,Clouds
26854,3,1553061600,17,3,20,Clouds
26855,4,1553061600,20,0,20,Clouds
26856,5,1553061600,8,32,40,Clouds
26857,6,1553061600,20,0,20,Clouds
26858,7,1553061600,29,0,29,Clouds
26859,8,1553061600,28,2,30,Clouds
26860,9,1553061600,24,0,24,Clouds
26861,10,1553061600,15,1,16,Clouds
26862,11,1553061600,30,0,30,Clouds
26863,12,1553061600,3,17,20,Clouds
26864,13,1553061600,30,0,30,Clouds
26865,14,1553061600,30,0,30,Clouds
26866,15,1553061600,11,5,16,Clouds
26867,16,1553061600,5,15,20,Clouds
26868,17,1553061600,19,1,20,Clouds
26869,18,1553061600,24,6,30,Clouds
26870,19,1553061600,29,1,30,Clouds
26871,21,1553061600,30,0,30,Clouds
26872,22,1553061600,19,1,20,Clouds
26873,23,1553061600,7,23,30,Clouds
26874,24,1553061600,20,0,20,Clouds
26875,25,1553061600,30,0,30,Clouds
26876,26,1553061600,20,0,20,Clouds
26877,27,1553061600,20,0,20,Clouds
26878,28,1553061600,19,11,30,Clouds
26879,29,1553061600,27,2,29,Clouds
26880,30,1553061600,17,3,20,Clouds
26881,31,1553061600,16,4,20,Clouds
26882,32,1553061600,30,0,30,Clouds
26883,33,1553061600,23,0,23,Clouds
26884,34,1553061600,9,21,30,Clouds
26885,35,1553061600,20,10,30,Clouds
26886,36,1553061600,40,0,40,Clouds
26887,37,1553061600,20,10,30,Clouds
26888,38,1553061600,16,24,40,Clouds
26889,39,1553061600,15,5,20,Clouds
26890,40,1553061600,21,0,21,Clouds
26891,41,1553061600,19,1,20,Clouds
26892,42,1553061600,5,25,30,Clouds
26893,43,1553061600,1,29,30,Clouds
26894,44,1553061600,1,29,30,Clouds
26895,45,1553061600,0,30,30,Clouds
26896,46,1553061600,20,0,20,Clouds
26897,47,1553061600,39,1,40,Clouds
26898,48,1553061600,35,5,40,Clouds
26899,49,1553061600,36,4,40,Clouds
26900,50,1553061600,0,40,40,Clouds
26901,51,1553061600,36,4,40,Clouds
26902,52,1553061600,32,0,32,Clouds
26903,53,1553061600,40,0,40,Clouds
26904,54,1553061600,27,6,33,Clouds
26905,55,1553061600,36,0,36,Clouds
26906,56,1553061600,36,4,40,Clouds
26907,57,1553061600,23,0,23,Clouds
26908,58,1553061600,39,1,40,Clouds
26909,59,1553061600,19,1,20,Clouds
26910,60,1553061600,8,22,30,Clouds
26911,61,1553061600,22,3,25,Clouds
26912,62,1553061600,39,1,40,Clouds
26913,63,1553061600,33,2,35,Clouds
26914,64,1553061600,15,25,40,Clouds
26915,65,1553061600,40,0,40,Clouds
26916,66,1553061600,35,5,40,Clouds
26917,67,1553061600,16,24,40,Clouds
26918,68,1553061600,40,0,40,Clouds
26919,69,1553061600,36,4,40,Clouds
26920,70,1553061600,12,16,28,Clouds
26921,71,1553061600,32,8,40,Clouds
26922,72,1553061600,18,13,31,Clouds
26923,73,1553061600,11,19,30,Clouds
26924,74,1553061600,2,28,30,Clouds
26925,75,1553061600,15,25,40,Clouds
26926,76,1553061600,9,29,38,Clouds
26927,77,1553061600,26,3,29,Clouds
26928,78,1553061600,3,37,40,Clouds
26929,79,1553061600,26,1,27,Clouds
26930,80,1553061600,25,15,40,Clouds
26931,81,1553061600,29,11,40,Clouds
26932,82,1553061600,6,16,22,Clouds
26933,83,1553061600,6,34,40,Clouds
26934,84,1553061600,0,30,30,Clouds
26935,85,1553061600,8,27,35,Clouds
26936,86,1553061600,13,25,38,Clouds
26937,87,1553061600,4,34,38,Clouds
26938,88,1553061600,8,22,30,Clouds
26939,89,1553061600,40,0,40,Clouds
26940,90,1553061600,38,2,40,Clouds
26941,91,1553061600,12,18,30,Clouds
26942,92,1553061600,9,31,40,Clouds
26943,93,1553061600,0,40,40,Clouds
26944,94,1553061600,0,40,40,Clouds
26945,95,1553061600,1,39,40,Clouds
26946,96,1553061600,19,11,30,Clouds
26947,97,1553061600,3,37,40,Clouds
26948,98,1553061600,40,0,40,Clouds
26949,99,1553061600,29,1,30,Clouds
26950,100,1553061600,2,23,25,Clouds
26951,101,1553061600,22,8,30,Clouds
26952,102,1553061600,34,6,40,Clouds
26953,103,1553061600,38,2,40,Clouds
26954,104,1553061600,40,0,40,Clouds
26955,105,1553061600,36,0,36,Clouds
26956,106,1553061600,12,28,40,Clouds
26957,107,1553061600,26,14,40,Clouds
26958,108,1553061600,18,22,40,Clouds
26959,109,1553061600,2,27,29,Clouds
26960,110,1553061600,30,10,40,Clouds
26961,111,1553061600,7,33,40,Clouds
26962,112,1553061600,3,27,30,Clouds
26963,113,1553061600,40,0,40,Clouds
26964,114,1553061600,40,0,40,Clouds
26965,115,1553061600,11,19,30,Clouds
26966,2,1553065200,13,7,20,Clouds
26967,3,1553065200,18,2,20,Clouds
26968,4,1553065200,20,0,20,Clouds
26969,5,1553065200,9,31,40,Clouds
26970,6,1553065200,19,1,20,Clouds
26971,7,1553065200,21,8,29,Clouds
26972,8,1553065200,25,5,30,Clouds
26973,9,1553065200,21,3,24,Clouds
26974,10,1553065200,15,1,16,Clouds
26975,11,1553065200,30,0,30,Clouds
26976,12,1553065200,3,17,20,Clouds
26977,13,1553065200,30,0,30,Clouds
26978,14,1553065200,19,11,30,Clouds
26979,15,1553065200,10,6,16,Clouds
26980,16,1553065200,20,0,20,Clouds
26981,17,1553065200,19,1,20,Clouds
26982,18,1553065200,4,26,30,Clouds
26983,19,1553065200,27,3,30,Clouds
26984,21,1553065200,29,1,30,Clouds
26985,22,1553065200,18,2,20,Clouds
26986,23,1553065200,8,22,30,Clouds
26987,24,1553065200,15,5,20,Clouds
26988,25,1553065200,30,0,30,Clouds
26989,26,1553065200,20,0,20,Clouds
26990,27,1553065200,18,2,20,Clouds
26991,28,1553065200,22,8,30,Clouds
26992,29,1553065200,26,3,29,Clouds
26993,30,1553065200,16,4,20,Clouds
26994,31,1553065200,19,1,20,Clouds
26995,32,1553065200,25,5,30,Clouds
26996,33,1553065200,16,7,23,Clouds
26997,34,1553065200,10,20,30,Clouds
26998,35,1553065200,25,5,30,Clouds
26999,36,1553065200,36,4,40,Clouds
27000,37,1553065200,30,0,30,Clouds
27001,38,1553065200,15,25,40,Clouds
27002,39,1553065200,17,3,20,Clouds
27003,40,1553065200,20,1,21,Clouds
27004,41,1553065200,19,1,20,Clouds
27005,42,1553065200,5,25,30,Clouds
27006,43,1553065200,7,23,30,Clouds
27007,44,1553065200,5,25,30,Clouds
27008,45,1553065200,2,28,30,Clouds
27009,46,1553065200,20,0,20,Clouds
27010,47,1553065200,40,0,40,Clouds
27011,48,1553065200,36,4,40,Clouds
27012,49,1553065200,29,11,40,Clouds
27013,50,1553065200,3,37,40,Clouds
27014,51,1553065200,36,4,40,Clouds
27015,52,1553065200,25,7,32,Clouds
27016,53,1553065200,40,0,40,Clouds
27017,54,1553065200,28,5,33,Clouds
27018,55,1553065200,36,0,36,Clouds
27019,56,1553065200,40,0,40,Clouds
27020,57,1553065200,22,1,23,Clouds
27021,58,1553065200,37,3,40,Clouds
27022,59,1553065200,20,0,20,Clouds
27023,60,1553065200,13,17,30,Clouds
27024,61,1553065200,24,1,25,Clouds
27025,62,1553065200,38,2,40,Clouds
27026,63,1553065200,33,2,35,Clouds
27027,64,1553065200,23,17,40,Clouds
27028,65,1553065200,40,0,40,Clouds
27029,66,1553065200,34,6,40,Clouds
27030,67,1553065200,32,8,40,Clouds
27031,68,1553065200,36,4,40,Clouds
27032,69,1553065200,32,8,40,Clouds
27033,70,1553065200,10,18,28,Clouds
27034,71,1553065200,31,9,40,Clouds
27035,72,1553065200,19,12,31,Clouds
27036,73,1553065200,16,14,30,Clouds
27037,74,1553065200,4,26,30,Clouds
27038,75,1553065200,16,24,40,Clouds
27039,76,1553065200,9,29,38,Clouds
27040,77,1553065200,26,3,29,Clouds
27041,78,1553065200,6,34,40,Clouds
27042,79,1553065200,9,18,27,Clouds
27043,80,1553065200,26,14,40,Clouds
27044,81,1553065200,29,11,40,Clouds
27045,82,1553065200,6,16,22,Clouds
27046,83,1553065200,9,31,40,Clouds
27047,84,1553065200,3,27,30,Clouds
27048,85,1553065200,8,27,35,Clouds
27049,86,1553065200,14,24,38,Clouds
27050,87,1553065200,4,34,38,Clouds
27051,88,1553065200,10,20,30,Clouds
27052,89,1553065200,40,0,40,Clouds
27053,90,1553065200,38,2,40,Clouds
27054,91,1553065200,12,18,30,Clouds
27055,92,1553065200,11,29,40,Clouds
27056,93,1553065200,0,40,40,Clouds
27057,94,1553065200,0,40,40,Clouds
27058,95,1553065200,4,36,40,Clouds
27059,96,1553065200,19,11,30,Clouds
27060,97,1553065200,7,33,40,Clouds
27061,98,1553065200,40,0,40,Clouds
27062,99,1553065200,29,1,30,Clouds
27063,100,1553065200,3,22,25,Clouds
27064,101,1553065200,26,4,30,Clouds
27065,102,1553065200,34,6,40,Clouds
27066,103,1553065200,39,1,40,Clouds
27067,104,1553065200,40,0,40,Clouds
27068,105,1553065200,36,0,36,Clouds
27069,106,1553065200,12,28,40,Clouds
27070,107,1553065200,32,8,40,Clouds
27071,108,1553065200,20,20,40,Clouds
27072,109,1553065200,9,20,29,Clouds
27073,110,1553065200,18,22,40,Clouds
27074,111,1553065200,9,31,40,Clouds
27075,112,1553065200,6,24,30,Clouds
27076,113,1553065200,40,0,40,Clouds
27077,114,1553065200,40,0,40,Clouds
27078,115,1553065200,11,19,30,Clouds
27079,2,1553068800,20,0,20,Clouds
27080,3,1553068800,19,1,20,Clouds
27081,4,1553068800,18,2,20,Clouds
27082,5,1553068800,11,29,40,Clouds
27083,6,1553068800,19,1,20,Clouds
27084,7,1553068800,10,19,29,Clouds
27085,8,1553068800,17,13,30,Clouds
27086,9,1553068800,24,0,24,Clouds
27087,10,1553068800,13,3,16,Clouds
27088,11,1553068800,27,3,30,Clouds
27089,12,1553068800,11,9,20,Clouds
27090,13,1553068800,27,3,30,Clouds
27091,14,1553068800,22,8,30,Clouds
27092,15,1553068800,16,0,16,Clouds
27093,16,1553068800,19,1,20,Clouds
27094,17,1553068800,20,0,20,Clouds
27095,18,1553068800,2,28,30,Clouds
27096,19,1553068800,23,7,30,Clouds
27097,21,1553068800,23,6,29,Clouds
27098,22,1553068800,18,2,20,Clouds
27099,23,1553068800,24,6,30,Clouds
27100,24,1553068800,13,7,20,Clouds
27101,25,1553068800,27,3,30,Clouds
27102,26,1553068800,14,6,20,Clouds
27103,27,1553068800,9,11,20,Clouds
27104,28,1553068800,9,21,30,Clouds
27105,29,1553068800,25,4,29,Clouds
27106,30,1553068800,1,19,20,Clouds
27107,31,1553068800,17,3,20,Clouds
27108,32,1553068800,22,8,30,Clouds
27109,33,1553068800,13,10,23,Clouds
27110,34,1553068800,30,0,30,Clouds
27111,35,1553068800,28,2,30,Clouds
27112,36,1553068800,35,5,40,Clouds
27113,37,1553068800,30,0,30,Clouds
27114,38,1553068800,9,31,40,Clouds
27115,39,1553068800,16,4,20,Clouds
27116,40,1553068800,17,4,21,Clouds
27117,41,1553068800,16,4,20,Clouds
27118,42,1553068800,17,13,30,Clouds
27119,43,1553068800,19,11,30,Clouds
27120,44,1553068800,24,6,30,Clouds
27121,45,1553068800,6,24,30,Clouds
27122,46,1553068800,18,2,20,Clouds
27123,47,1553068800,39,1,40,Clouds
27124,48,1553068800,35,5,40,Clouds
27125,49,1553068800,23,17,40,Clouds
27126,50,1553068800,8,32,40,Clouds
27127,51,1553068800,36,4,40,Clouds
27128,52,1553068800,23,9,32,Clouds
27129,53,1553068800,38,2,40,Clouds
27130,54,1553068800,21,12,33,Clouds
27131,55,1553068800,30,6,36,Clouds
27132,56,1553068800,40,0,40,Clouds
27133,57,1553068800,23,0,23,Clouds
27134,58,1553068800,28,12,40,Clouds
27135,59,1553068800,20,0,20,Clouds
27136,60,1553068800,30,0,30,Clouds
27137,61,1553068800,25,0,25,Clouds
27138,62,1553068800,34,6,40,Clouds
27139,63,1553068800,33,2,35,Clouds
27140,64,1553068800,19,21,40,Clouds
27141,65,1553068800,34,6,40,Clouds
27142,66,1553068800,21,18,39,Clouds
27143,67,1553068800,28,12,40,Clouds
27144,68,1553068800,24,16,40,Clouds
27145,69,1553068800,27,13,40,Clouds
27146,70,1553068800,17,11,28,Clouds
27147,71,1553068800,38,2,40,Clouds
27148,72,1553068800,23,8,31,Clouds
27149,73,1553068800,23,7,30,Clouds
27150,74,1553068800,8,22,30,Clouds
27151,75,1553068800,18,22,40,Clouds
27152,76,1553068800,15,23,38,Clouds
27153,77,1553068800,29,0,29,Clouds
27154,78,1553068800,13,27,40,Clouds
27155,79,1553068800,11,16,27,Clouds
27156,80,1553068800,28,12,40,Clouds
27157,81,1553068800,27,13,40,Clouds
27158,82,1553068800,7,15,22,Clouds
27159,83,1553068800,14,26,40,Clouds
27160,84,1553068800,3,27,30,Clouds
27161,85,1553068800,14,21,35,Clouds
27162,86,1553068800,11,27,38,Clouds
27163,87,1553068800,4,34,38,Clouds
27164,88,1553068800,16,14,30,Clouds
27165,89,1553068800,38,2,40,Clouds
27166,90,1553068800,20,20,40,Clouds
27167,91,1553068800,29,1,30,Clouds
27168,92,1553068800,2,38,40,Clouds
27169,93,1553068800,8,32,40,Clouds
27170,94,1553068800,2,38,40,Clouds
27171,95,1553068800,8,32,40,Clouds
27172,96,1553068800,19,11,30,Clouds
27173,97,1553068800,19,21,40,Clouds
27174,98,1553068800,39,1,40,Clouds
27175,99,1553068800,26,4,30,Clouds
27176,100,1553068800,10,15,25,Clouds
27177,101,1553068800,30,0,30,Clouds
27178,102,1553068800,37,3,40,Clouds
27179,103,1553068800,40,0,40,Clouds
27180,104,1553068800,40,0,40,Clouds
27181,105,1553068800,34,2,36,Clouds
27182,106,1553068800,13,27,40,Clouds
27183,107,1553068800,34,6,40,Clouds
27184,108,1553068800,24,16,40,Clouds
27185,109,1553068800,14,15,29,Clouds
27186,110,1553068800,16,24,40,Clouds
27187,111,1553068800,15,25,40,Clouds
27188,112,1553068800,20,10,30,Clouds
27189,113,1553068800,38,1,39,Clouds
27190,114,1553068800,33,7,40,Clouds
27191,115,1553068800,14,16,30,Clouds
27192,2,1553072400,19,1,20,Clouds
27193,3,1553072400,19,1,20,Clouds
27194,4,1553072400,17,3,20,Clouds
27195,5,1553072400,40,0,40,Clouds
27196,6,1553072400,18,2,20,Clouds
27197,7,1553072400,24,5,29,Clouds
27198,8,1553072400,19,11,30,Clouds
27199,9,1553072400,14,10,24,Clouds
27200,10,1553072400,8,8,16,Clouds
27201,11,1553072400,22,8,30,Clouds
27202,12,1553072400,16,4,20,Clouds
27203,13,1553072400,23,7,30,Clouds
27204,14,1553072400,16,13,29,Clouds
27205,15,1553072400,16,0,16,Clouds
27206,16,1553072400,16,4,20,Clouds
27207,17,1553072400,20,0,20,Clouds
27208,18,1553072400,11,18,29,Clouds
27209,19,1553072400,23,7,30,Clouds
27210,21,1553072400,24,5,29,Clouds
27211,22,1553072400,15,5,20,Clouds
27212,23,1553072400,26,4,30,Clouds
27213,24,1553072400,19,1,20,Clouds
27214,25,1553072400,18,12,30,Clouds
27215,26,1553072400,5,15,20,Clouds
27216,27,1553072400,4,16,20,Clouds
27217,28,1553072400,26,4,30,Clouds
27218,29,1553072400,23,6,29,Clouds
27219,30,1553072400,6,14,20,Clouds
27220,31,1553072400,18,2,20,Clouds
27221,32,1553072400,21,9,30,Clouds
27222,33,1553072400,11,12,23,Clouds
27223,34,1553072400,22,8,30,Clouds
27224,35,1553072400,30,0,30,Clouds
27225,36,1553072400,27,13,40,Clouds
27226,37,1553072400,29,1,30,Clouds
27227,38,1553072400,12,28,40,Clouds
27228,39,1553072400,16,4,20,Clouds
27229,40,1553072400,12,9,21,Clouds
27230,41,1553072400,19,1,20,Clouds
27231,42,1553072400,30,0,30,Clouds
27232,43,1553072400,30,0,30,Clouds
27233,44,1553072400,30,0,30,Clouds
27234,45,1553072400,8,22,30,Clouds
27235,46,1553072400,18,2,20,Clouds
27236,47,1553072400,34,6,40,Clouds
27237,48,1553072400,34,5,39,Clouds
27238,49,1553072400,24,16,40,Clouds
27239,50,1553072400,34,6,40,Clouds
27240,51,1553072400,39,1,40,Clouds
27241,52,1553072400,19,13,32,Clouds
27242,53,1553072400,30,10,40,Clouds
27243,54,1553072400,19,14,33,Clouds
27244,55,1553072400,22,14,36,Clouds
27245,56,1553072400,31,9,40,Clouds
27246,57,1553072400,16,7,23,Clouds
27247,58,1553072400,21,18,39,Clouds
27248,59,1553072400,16,4,20,Clouds
27249,60,1553072400,30,0,30,Clouds
27250,61,1553072400,7,18,25,Clouds
27251,62,1553072400,29,11,40,Clouds
27252,63,1553072400,28,6,34,Clouds
27253,64,1553072400,35,5,40,Clouds
27254,65,1553072400,22,18,40,Clouds
27255,66,1553072400,1,39,40,Clouds
27256,67,1553072400,24,16,40,Clouds
27257,68,1553072400,5,35,40,Clouds
27258,69,1553072400,7,31,38,Clouds
27259,70,1553072400,13,15,28,Clouds
27260,71,1553072400,35,5,40,Clouds
27261,72,1553072400,31,0,31,Clouds
27262,73,1553072400,28,2,30,Clouds
27263,74,1553072400,19,11,30,Clouds
27264,75,1553072400,31,9,40,Clouds
27265,76,1553072400,24,14,38,Clouds
27266,77,1553072400,28,1,29,Clouds
27267,78,1553072400,18,22,40,Clouds
27268,79,1553072400,12,15,27,Clouds
27269,80,1553072400,31,9,40,Clouds
27270,81,1553072400,26,14,40,Clouds
27271,82,1553072400,11,11,22,Clouds
27272,83,1553072400,18,22,40,Clouds
27273,84,1553072400,18,12,30,Clouds
27274,85,1553072400,29,5,34,Clouds
27275,86,1553072400,31,7,38,Clouds
27276,87,1553072400,15,23,38,Clouds
27277,88,1553072400,25,5,30,Clouds
27278,89,1553072400,31,8,39,Clouds
27279,90,1553072400,12,28,40,Clouds
27280,91,1553072400,28,2,30,Clouds
27281,92,1553072400,15,25,40,Clouds
27282,93,1553072400,23,17,40,Clouds
27283,94,1553072400,8,32,40,Clouds
27284,95,1553072400,22,18,40,Clouds
27285,96,1553072400,26,4,30,Clouds
27286,97,1553072400,38,2,40,Clouds
27287,98,1553072400,34,6,40,Clouds
27288,99,1553072400,24,6,30,Clouds
27289,100,1553072400,24,1,25,Clouds
27290,101,1553072400,30,0,30,Clouds
27291,102,1553072400,40,0,40,Clouds
27292,103,1553072400,37,3,40,Clouds
27293,104,1553072400,39,1,40,Clouds
27294,105,1553072400,33,3,36,Clouds
27295,106,1553072400,22,18,40,Clouds
27296,107,1553072400,37,3,40,Clouds
27297,108,1553072400,30,10,40,Clouds
27298,109,1553072400,20,9,29,Clouds
27299,110,1553072400,24,16,40,Clouds
27300,111,1553072400,32,8,40,Clouds
27301,112,1553072400,30,0,30,Clouds
27302,113,1553072400,33,6,39,Clouds
27303,114,1553072400,37,3,40,Clouds
27304,115,1553072400,11,18,29,Clouds
27305,2,1553076000,20,0,20,Clouds
27306,3,1553076000,17,3,20,Clouds
27307,4,1553076000,20,0,20,Clouds
27308,5,1553076000,39,1,40,Clouds
27309,6,1553076000,18,2,20,Clouds
27310,7,1553076000,28,1,29,Clouds
27311,8,1553076000,14,16,30,Clouds
27312,9,1553076000,10,14,24,Clouds
27313,10,1553076000,10,6,16,Clouds
27314,11,1553076000,11,19,30,Clouds
27315,12,1553076000,20,0,20,Clouds
27316,13,1553076000,8,22,30,Clouds
27317,14,1553076000,10,19,29,Clouds
27318,15,1553076000,15,1,16,Clouds
27319,16,1553076000,16,4,20,Clouds
27320,17,1553076000,18,2,20,Clouds
27321,18,1553076000,28,1,29,Clouds
27322,19,1553076000,19,11,30,Clouds
27323,21,1553076000,21,9,30,Clouds
27324,22,1553076000,20,0,20,Clouds
27325,23,1553076000,21,9,30,Clouds
27326,24,1553076000,18,2,20,Clouds
27327,25,1553076000,6,24,30,Clouds
27328,26,1553076000,15,5,20,Clouds
27329,27,1553076000,1,19,20,Clouds
27330,28,1553076000,30,0,30,Clouds
27331,29,1553076000,29,0,29,Clouds
27332,30,1553076000,19,1,20,Clouds
27333,31,1553076000,14,6,20,Clouds
27334,32,1553076000,9,21,30,Clouds
27335,33,1553076000,12,11,23,Clouds
27336,34,1553076000,28,2,30,Clouds
27337,35,1553076000,30,0,30,Clouds
27338,36,1553076000,9,30,39,Clouds
27339,37,1553076000,21,9,30,Clouds
27340,38,1553076000,26,14,40,Clouds
27341,39,1553076000,16,4,20,Clouds
27342,40,1553076000,15,6,21,Clouds
27343,41,1553076000,17,3,20,Clouds
27344,42,1553076000,30,0,30,Clouds
27345,43,1553076000,28,2,30,Clouds
27346,44,1553076000,29,1,30,Clouds
27347,45,1553076000,29,1,30,Clouds
27348,46,1553076000,20,0,20,Clouds
27349,47,1553076000,8,32,40,Clouds
27350,48,1553076000,24,15,39,Clouds
27351,49,1553076000,1,39,40,Clouds
27352,50,1553076000,40,0,40,Clouds
27353,51,1553076000,34,6,40,Clouds
27354,52,1553076000,13,19,32,Clouds
27355,53,1553076000,20,20,40,Clouds
27356,54,1553076000,15,18,33,Clouds
27357,55,1553076000,5,31,36,Clouds
27358,56,1553076000,17,23,40,Clouds
27359,57,1553076000,3,20,23,Clouds
27360,58,1553076000,1,37,38,Clouds
27361,59,1553076000,20,0,20,Clouds
27362,60,1553076000,30,0,30,Clouds
27363,61,1553076000,25,0,25,Clouds
27364,62,1553076000,1,39,40,Clouds
27365,63,1553076000,14,20,34,Clouds
27366,64,1553076000,18,22,40,Clouds
27367,65,1553076000,2,38,40,Clouds
27368,66,1553076000,1,39,40,Clouds
27369,67,1553076000,23,17,40,Clouds
27370,68,1553076000,0,40,40,Clouds
27371,69,1553076000,0,36,36,Clouds
27372,70,1553076000,1,27,28,Clouds
27373,71,1553076000,40,0,40,Clouds
27374,72,1553076000,31,0,31,Clouds
27375,73,1553076000,30,0,30,Clouds
27376,74,1553076000,30,0,30,Clouds
27377,75,1553076000,38,2,40,Clouds
27378,76,1553076000,38,0,38,Clouds
27379,77,1553076000,27,2,29,Clouds
27380,78,1553076000,40,0,40,Clouds
27381,79,1553076000,26,1,27,Clouds
27382,80,1553076000,38,2,40,Clouds
27383,81,1553076000,39,1,40,Clouds
27384,82,1553076000,22,0,22,Clouds
27385,83,1553076000,40,0,40,Clouds
27386,84,1553076000,30,0,30,Clouds
27387,85,1553076000,34,0,34,Clouds
27388,86,1553076000,38,0,38,Clouds
27389,87,1553076000,38,0,38,Clouds
27390,88,1553076000,29,1,30,Clouds
27391,89,1553076000,29,11,40,Clouds
27392,90,1553076000,0,40,40,Clouds
27393,91,1553076000,23,6,29,Clouds
27394,92,1553076000,40,0,40,Clouds
27395,93,1553076000,40,0,40,Clouds
27396,94,1553076000,38,2,40,Clouds
27397,95,1553076000,38,2,40,Clouds
27398,96,1553076000,30,0,30,Clouds
27399,97,1553076000,40,0,40,Clouds
27400,98,1553076000,29,11,40,Clouds
27401,99,1553076000,12,18,30,Clouds
27402,100,1553076000,25,0,25,Clouds
27403,101,1553076000,30,0,30,Clouds
27404,102,1553076000,40,0,40,Clouds
27405,103,1553076000,38,2,40,Clouds
27406,104,1553076000,40,0,40,Clouds
27407,105,1553076000,36,0,36,Clouds
27408,106,1553076000,40,0,40,Clouds
27409,107,1553076000,40,0,40,Clouds
27410,108,1553076000,39,1,40,Clouds
27411,109,1553076000,29,0,29,Clouds
27412,110,1553076000,33,7,40,Clouds
27413,111,1553076000,25,15,40,Clouds
27414,112,1553076000,30,0,30,Clouds
27415,113,1553076000,27,12,39,Clouds
27416,114,1553076000,18,22,40,Clouds
27417,115,1553076000,28,1,29,Clouds
27418,2,1553079600,19,1,20,Clouds
27419,3,1553079600,20,0,20,Clouds
27420,4,1553079600,20,0,20,Clouds
27421,5,1553079600,33,7,40,Clouds
27422,6,1553079600,18,2,20,Clouds
27423,7,1553079600,27,2,29,Clouds
27424,8,1553079600,17,13,30,Clouds
27425,9,1553079600,2,22,24,Clouds
27426,10,1553079600,13,3,16,Clouds
27427,11,1553079600,4,26,30,Clouds
27428,12,1553079600,20,0,20,Clouds
27429,13,1553079600,7,23,30,Clouds
27430,14,1553079600,6,23,29,Clouds
27431,15,1553079600,16,0,16,Clouds
27432,16,1553079600,13,7,20,Clouds
27433,17,1553079600,19,1,20,Clouds
27434,18,1553079600,28,1,29,Clouds
27435,19,1553079600,0,30,30,Clouds
27436,21,1553079600,16,14,30,Clouds
27437,22,1553079600,17,3,20,Clouds
27438,23,1553079600,27,3,30,Clouds
27439,24,1553079600,15,5,20,Clouds
27440,25,1553079600,1,29,30,Clouds
27441,26,1553079600,12,8,20,Clouds
27442,27,1553079600,1,19,20,Clouds
27443,28,1553079600,19,11,30,Clouds
27444,29,1553079600,26,3,29,Clouds
27445,30,1553079600,20,0,20,Clouds
27446,31,1553079600,17,3,20,Clouds
27447,32,1553079600,10,20,30,Clouds
27448,33,1553079600,17,6,23,Clouds
27449,34,1553079600,30,0,30,Clouds
27450,35,1553079600,30,0,30,Clouds
27451,36,1553079600,1,38,39,Clouds
27452,37,1553079600,22,8,30,Clouds
27453,38,1553079600,35,5,40,Clouds
27454,39,1553079600,8,12,20,Clouds
27455,40,1553079600,16,5,21,Clouds
27456,41,1553079600,12,8,20,Clouds
27457,42,1553079600,30,0,30,Clouds
27458,43,1553079600,28,2,30,Clouds
27459,44,1553079600,30,0,30,Clouds
27460,45,1553079600,29,1,30,Clouds
27461,46,1553079600,16,4,20,Clouds
27462,47,1553079600,0,40,40,Clouds
27463,48,1553079600,1,39,40,Clouds
27464,49,1553079600,7,33,40,Clouds
27465,50,1553079600,38,2,40,Clouds
27466,51,1553079600,31,9,40,Clouds
27467,52,1553079600,5,27,32,Clouds
27468,53,1553079600,11,29,40,Clouds
27469,54,1553079600,9,24,33,Clouds
27470,55,1553079600,7,29,36,Clouds
27471,56,1553079600,12,28,40,Clouds
27472,57,1553079600,0,23,23,Clouds
27473,58,1553079600,16,24,40,Clouds
27474,59,1553079600,20,0,20,Clouds
27475,60,1553079600,30,0,30,Clouds
27476,61,1553079600,25,0,25,Clouds
27477,62,1553079600,0,40,40,Clouds
27478,63,1553079600,14,21,35,Clouds
27479,64,1553079600,0,40,40,Clouds
27480,65,1553079600,4,36,40,Clouds
27481,66,1553079600,2,38,40,Clouds
27482,67,1553079600,14,26,40,Clouds
27483,68,1553079600,10,30,40,Clouds
27484,69,1553079600,0,40,40,Clouds
27485,70,1553079600,1,27,28,Clouds
27486,71,1553079600,39,1,40,Clouds
27487,72,1553079600,30,1,31,Clouds
27488,73,1553079600,29,1,30,Clouds
27489,74,1553079600,30,0,30,Clouds
27490,75,1553079600,38,2,40,Clouds
27491,76,1553079600,38,0,38,Clouds
27492,77,1553079600,26,3,29,Clouds
27493,78,1553079600,28,12,40,Clouds
27494,79,1553079600,27,0,27,Clouds
27495,80,1553079600,40,0,40,Clouds
27496,81,1553079600,40,0,40,Clouds
27497,82,1553079600,22,0,22,Clouds
27498,83,1553079600,40,0,40,Clouds
27499,84,1553079600,28,2,30,Clouds
27500,85,1553079600,34,0,34,Clouds
27501,86,1553079600,38,0,38,Clouds
27502,87,1553079600,38,0,38,Clouds
27503,88,1553079600,30,0,30,Clouds
27504,89,1553079600,22,18,40,Clouds
27505,90,1553079600,0,40,40,Clouds
27506,91,1553079600,19,11,30,Clouds
27507,92,1553079600,39,1,40,Clouds
27508,93,1553079600,40,0,40,Clouds
27509,94,1553079600,40,0,40,Clouds
27510,95,1553079600,38,2,40,Clouds
27511,96,1553079600,30,0,30,Clouds
27512,97,1553079600,39,1,40,Clouds
27513,98,1553079600,25,15,40,Clouds
27514,99,1553079600,1,29,30,Clouds
27515,100,1553079600,25,0,25,Clouds
27516,101,1553079600,30,0,30,Clouds
27517,102,1553079600,40,0,40,Clouds
27518,103,1553079600,39,1,40,Clouds
27519,104,1553079600,40,0,40,Clouds
27520,105,1553079600,36,0,36,Clouds
27521,106,1553079600,40,0,40,Clouds
27522,107,1553079600,40,0,40,Clouds
27523,108,1553079600,40,0,40,Clouds
27524,109,1553079600,28,1,29,Clouds
27525,110,1553079600,38,2,40,Clouds
27526,111,1553079600,38,2,40,Clouds
27527,112,1553079600,30,0,30,Clouds
27528,113,1553079600,18,21,39,Clouds
27529,114,1553079600,0,40,40,Clouds
27530,115,1553079600,29,0,29,Clouds
27531,2,1553083200,19,1,20,Clouds
27532,3,1553083200,20,0,20,Clouds
27533,4,1553083200,20,0,20,Clouds
27534,5,1553083200,32,8,40,Clouds
27535,6,1553083200,19,1,20,Clouds
27536,7,1553083200,29,0,29,Clouds
27537,8,1553083200,12,18,30,Clouds
27538,9,1553083200,3,21,24,Clouds
27539,10,1553083200,14,2,16,Clouds
27540,11,1553083200,6,24,30,Clouds
27541,12,1553083200,20,0,20,Clouds
27542,13,1553083200,7,23,30,Clouds
27543,14,1553083200,5,24,29,Clouds
27544,15,1553083200,16,0,16,Clouds
27545,16,1553083200,10,10,20,Clouds
27546,17,1553083200,17,3,20,Clouds
27547,18,1553083200,26,3,29,Clouds
27548,19,1553083200,8,22,30,Clouds
27549,21,1553083200,8,22,30,Clouds
27550,22,1553083200,18,2,20,Clouds
27551,23,1553083200,24,6,30,Clouds
27552,24,1553083200,14,6,20,Clouds
27553,25,1553083200,2,28,30,Clouds
27554,26,1553083200,10,10,20,Clouds
27555,27,1553083200,2,18,20,Clouds
27556,28,1553083200,30,0,30,Clouds
27557,29,1553083200,28,1,29,Clouds
27558,30,1553083200,20,0,20,Clouds
27559,31,1553083200,16,4,20,Clouds
27560,32,1553083200,4,26,30,Clouds
27561,33,1553083200,15,8,23,Clouds
27562,34,1553083200,27,3,30,Clouds
27563,35,1553083200,29,1,30,Clouds
27564,36,1553083200,6,33,39,Clouds
27565,37,1553083200,20,10,30,Clouds
27566,38,1553083200,38,1,39,Clouds
27567,39,1553083200,1,19,20,Clouds
27568,40,1553083200,11,10,21,Clouds
27569,41,1553083200,12,8,20,Clouds
27570,42,1553083200,30,0,30,Clouds
27571,43,1553083200,29,1,30,Clouds
27572,44,1553083200,28,2,30,Clouds
27573,45,1553083200,29,1,30,Clouds
27574,46,1553083200,17,3,20,Clouds
27575,47,1553083200,5,35,40,Clouds
27576,48,1553083200,1,39,40,Clouds
27577,49,1553083200,2,38,40,Clouds
27578,50,1553083200,40,0,40,Clouds
27579,51,1553083200,27,13,40,Clouds
27580,52,1553083200,2,30,32,Clouds
27581,53,1553083200,13,27,40,Clouds
27582,54,1553083200,7,26,33,Clouds
27583,55,1553083200,9,27,36,Clouds
27584,56,1553083200,17,23,40,Clouds
27585,57,1553083200,1,22,23,Clouds
27586,58,1553083200,19,21,40,Clouds
27587,59,1553083200,20,0,20,Clouds
27588,60,1553083200,16,14,30,Clouds
27589,61,1553083200,25,0,25,Clouds
27590,62,1553083200,0,40,40,Clouds
27591,63,1553083200,13,22,35,Clouds
27592,64,1553083200,1,39,40,Clouds
27593,65,1553083200,2,38,40,Clouds
27594,66,1553083200,13,26,39,Clouds
27595,67,1553083200,17,23,40,Clouds
27596,68,1553083200,6,34,40,Clouds
27597,69,1553083200,1,39,40,Clouds
27598,70,1553083200,3,25,28,Clouds
27599,71,1553083200,38,2,40,Clouds
27600,72,1553083200,31,0,31,Clouds
27601,73,1553083200,29,1,30,Clouds
27602,74,1553083200,30,0,30,Clouds
27603,75,1553083200,38,1,39,Clouds
27604,76,1553083200,38,0,38,Clouds
27605,77,1553083200,29,0,29,Clouds
27606,78,1553083200,29,11,40,Clouds
27607,79,1553083200,27,0,27,Clouds
27608,80,1553083200,38,2,40,Clouds
27609,81,1553083200,40,0,40,Clouds
27610,82,1553083200,22,0,22,Clouds
27611,83,1553083200,40,0,40,Clouds
27612,84,1553083200,16,14,30,Clouds
27613,85,1553083200,34,0,34,Clouds
27614,86,1553083200,37,1,38,Clouds
27615,87,1553083200,38,0,38,Clouds
27616,88,1553083200,30,0,30,Clouds
27617,89,1553083200,23,17,40,Clouds
27618,90,1553083200,0,40,40,Clouds
27619,91,1553083200,18,12,30,Clouds
27620,92,1553083200,40,0,40,Clouds
27621,93,1553083200,40,0,40,Clouds
27622,94,1553083200,40,0,40,Clouds
27623,95,1553083200,40,0,40,Clouds
27624,96,1553083200,30,0,30,Clouds
27625,97,1553083200,39,1,40,Clouds
27626,98,1553083200,21,19,40,Clouds
27627,99,1553083200,1,29,30,Clouds
27628,100,1553083200,22,3,25,Clouds
27629,101,1553083200,29,1,30,Clouds
27630,102,1553083200,40,0,40,Clouds
27631,103,1553083200,40,0,40,Clouds
27632,104,1553083200,40,0,40,Clouds
27633,105,1553083200,36,0,36,Clouds
27634,106,1553083200,40,0,40,Clouds
27635,107,1553083200,40,0,40,Clouds
27636,108,1553083200,40,0,40,Clouds
27637,109,1553083200,29,0,29,Clouds
27638,110,1553083200,39,1,40,Clouds
27639,111,1553083200,40,0,40,Clouds
27640,112,1553083200,29,1,30,Clouds
27641,113,1553083200,17,22,39,Clouds
27642,114,1553083200,5,35,40,Clouds
27643,115,1553083200,29,1,30,Clouds
27644,2,1553086800,17,3,20,Clouds
27645,3,1553086800,18,2,20,Clouds
27646,4,1553086800,18,2,20,Clouds
27647,5,1553086800,40,0,40,Clouds
27648,6,1553086800,20,0,20,Clouds
27649,7,1553086800,29,0,29,Clouds
27650,8,1553086800,9,21,30,Clouds
27651,9,1553086800,2,22,24,Clouds
27652,10,1553086800,15,1,16,Clouds
27653,11,1553086800,3,27,30,Clouds
27654,12,1553086800,20,0,20,Clouds
27655,13,1553086800,7,23,30,Clouds
27656,14,1553086800,6,23,29,Clouds
27657,15,1553086800,16,0,16,Clouds
27658,16,1553086800,12,8,20,Clouds
27659,17,1553086800,18,2,20,Clouds
27660,18,1553086800,28,1,29,Clouds
27661,19,1553086800,8,22,30,Clouds
27662,21,1553086800,6,24,30,Clouds
27663,22,1553086800,17,3,20,Clouds
27664,23,1553086800,26,4,30,Clouds
27665,24,1553086800,14,6,20,Clouds
27666,25,1553086800,1,29,30,Clouds
27667,26,1553086800,6,14,20,Clouds
27668,27,1553086800,5,15,20,Clouds
27669,28,1553086800,27,3,30,Clouds
27670,29,1553086800,27,2,29,Clouds
27671,30,1553086800,20,0,20,Clouds
27672,31,1553086800,18,2,20,Clouds
27673,32,1553086800,1,29,30,Clouds
27674,33,1553086800,17,6,23,Clouds
27675,34,1553086800,30,0,30,Clouds
27676,35,1553086800,27,3,30,Clouds
27677,36,1553086800,5,34,39,Clouds
27678,37,1553086800,21,9,30,Clouds
27679,38,1553086800,36,3,39,Clouds
27680,39,1553086800,1,19,20,Clouds
27681,40,1553086800,13,8,21,Clouds
27682,41,1553086800,13,7,20,Clouds
27683,42,1553086800,30,0,30,Clouds
27684,43,1553086800,29,1,30,Clouds
27685,44,1553086800,30,0,30,Clouds
27686,45,1553086800,26,4,30,Clouds
27687,46,1553086800,20,0,20,Clouds
27688,47,1553086800,3,37,40,Clouds
27689,48,1553086800,1,39,40,Clouds
27690,49,1553086800,0,40,40,Clouds
27691,50,1553086800,38,2,40,Clouds
27692,51,1553086800,28,12,40,Clouds
27693,52,1553086800,3,29,32,Clouds
27694,53,1553086800,12,28,40,Clouds
27695,54,1553086800,7,26,33,Clouds
27696,55,1553086800,8,28,36,Clouds
27697,56,1553086800,22,18,40,Clouds
27698,57,1553086800,0,23,23,Clouds
27699,58,1553086800,18,22,40,Clouds
27700,59,1553086800,20,0,20,Clouds
27701,60,1553086800,24,6,30,Clouds
27702,61,1553086800,15,10,25,Clouds
27703,62,1553086800,1,39,40,Clouds
27704,63,1553086800,8,27,35,Clouds
27705,64,1553086800,4,36,40,Clouds
27706,65,1553086800,4,36,40,Clouds
27707,66,1553086800,11,28,39,Clouds
27708,67,1553086800,15,25,40,Clouds
27709,68,1553086800,2,38,40,Clouds
27710,69,1553086800,3,37,40,Clouds
27711,70,1553086800,5,23,28,Clouds
27712,71,1553086800,35,5,40,Clouds
27713,72,1553086800,31,0,31,Clouds
27714,73,1553086800,30,0,30,Clouds
27715,74,1553086800,30,0,30,Clouds
27716,75,1553086800,39,0,39,Clouds
27717,76,1553086800,37,1,38,Clouds
27718,77,1553086800,29,0,29,Clouds
27719,78,1553086800,34,6,40,Clouds
27720,79,1553086800,27,0,27,Clouds
27721,80,1553086800,40,0,40,Clouds
27722,81,1553086800,40,0,40,Clouds
27723,82,1553086800,22,0,22,Clouds
27724,83,1553086800,40,0,40,Clouds
27725,84,1553086800,18,12,30,Clouds
27726,85,1553086800,34,0,34,Clouds
27727,86,1553086800,38,0,38,Clouds
27728,87,1553086800,38,0,38,Clouds
27729,88,1553086800,30,0,30,Clouds
27730,89,1553086800,21,19,40,Clouds
27731,90,1553086800,2,38,40,Clouds
27732,91,1553086800,17,13,30,Clouds
27733,92,1553086800,40,0,40,Clouds
27734,93,1553086800,40,0,40,Clouds
27735,94,1553086800,40,0,40,Clouds
27736,95,1553086800,39,1,40,Clouds
27737,96,1553086800,30,0,30,Clouds
27738,97,1553086800,38,2,40,Clouds
27739,98,1553086800,22,18,40,Clouds
27740,99,1553086800,1,29,30,Clouds
27741,100,1553086800,23,2,25,Clouds
27742,101,1553086800,30,0,30,Clouds
27743,102,1553086800,40,0,40,Clouds
27744,103,1553086800,40,0,40,Clouds
27745,104,1553086800,40,0,40,Clouds
27746,105,1553086800,36,0,36,Clouds
27747,106,1553086800,40,0,40,Clouds
27748,107,1553086800,39,1,40,Clouds
27749,108,1553086800,40,0,40,Clouds
27750,109,1553086800,27,2,29,Clouds
27751,110,1553086800,40,0,40,Clouds
27752,111,1553086800,39,1,40,Clouds
27753,112,1553086800,27,3,30,Clouds
27754,113,1553086800,17,22,39,Clouds
27755,114,1553086800,4,36,40,Clouds
27756,115,1553086800,21,9,30,Clouds
27757,2,1553090400,20,0,20,Clouds
27758,3,1553090400,17,3,20,Clouds
27759,4,1553090400,20,0,20,Clouds
27760,5,1553090400,34,6,40,Clouds
27761,6,1553090400,19,1,20,Clouds
27762,7,1553090400,29,0,29,Clouds
27763,8,1553090400,16,14,30,Clouds
27764,9,1553090400,13,11,24,Clouds
27765,10,1553090400,15,1,16,Clouds
27766,11,1553090400,16,14,30,Clouds
27767,12,1553090400,16,4,20,Clouds
27768,13,1553090400,10,20,30,Clouds
27769,14,1553090400,6,23,29,Clouds
27770,15,1553090400,16,0,16,Clouds
27771,16,1553090400,8,12,20,Clouds
27772,17,1553090400,18,2,20,Clouds
27773,18,1553090400,20,9,29,Clouds
27774,19,1553090400,15,15,30,Clouds
27775,21,1553090400,0,30,30,Clouds
27776,22,1553090400,10,10,20,Clouds
27777,23,1553090400,29,1,30,Clouds
27778,24,1553090400,18,2,20,Clouds
27779,25,1553090400,2,28,30,Clouds
27780,26,1553090400,5,15,20,Clouds
27781,27,1553090400,1,19,20,Clouds
27782,28,1553090400,11,19,30,Clouds
27783,29,1553090400,29,0,29,Clouds
27784,30,1553090400,20,0,20,Clouds
27785,31,1553090400,18,2,20,Clouds
27786,32,1553090400,28,2,30,Clouds
27787,33,1553090400,9,14,23,Clouds
27788,34,1553090400,25,5,30,Clouds
27789,35,1553090400,28,2,30,Clouds
27790,36,1553090400,2,37,39,Clouds
27791,37,1553090400,27,3,30,Clouds
27792,38,1553090400,34,5,39,Clouds
27793,39,1553090400,0,20,20,Clouds
27794,40,1553090400,21,0,21,Clouds
27795,41,1553090400,20,0,20,Clouds
27796,42,1553090400,28,2,30,Clouds
27797,43,1553090400,26,4,30,Clouds
27798,44,1553090400,29,1,30,Clouds
27799,45,1553090400,30,0,30,Clouds
27800,46,1553090400,17,3,20,Clouds
27801,47,1553090400,7,33,40,Clouds
27802,48,1553090400,11,29,40,Clouds
27803,49,1553090400,10,30,40,Clouds
27804,50,1553090400,39,1,40,Clouds
27805,51,1553090400,27,13,40,Clouds
27806,52,1553090400,1,31,32,Clouds
27807,53,1553090400,9,31,40,Clouds
27808,54,1553090400,4,29,33,Clouds
27809,55,1553090400,16,20,36,Clouds
27810,56,1553090400,32,8,40,Clouds
27811,57,1553090400,1,22,23,Clouds
27812,58,1553090400,35,5,40,Clouds
27813,59,1553090400,20,0,20,Clouds
27814,60,1553090400,28,2,30,Clouds
27815,61,1553090400,21,4,25,Clouds
27816,62,1553090400,11,29,40,Clouds
27817,63,1553090400,5,30,35,Clouds
27818,64,1553090400,10,30,40,Clouds
27819,65,1553090400,13,27,40,Clouds
27820,66,1553090400,19,20,39,Clouds
27821,67,1553090400,14,26,40,Clouds
27822,68,1553090400,1,39,40,Clouds
27823,69,1553090400,0,40,40,Clouds
27824,70,1553090400,4,24,28,Clouds
27825,71,1553090400,32,8,40,Clouds
27826,72,1553090400,29,2,31,Clouds
27827,73,1553090400,27,3,30,Clouds
27828,74,1553090400,25,5,30,Clouds
27829,75,1553090400,39,0,39,Clouds
27830,76,1553090400,37,1,38,Clouds
27831,77,1553090400,28,1,29,Clouds
27832,78,1553090400,37,3,40,Clouds
27833,79,1553090400,27,0,27,Clouds
27834,80,1553090400,40,0,40,Clouds
27835,81,1553090400,40,0,40,Clouds
27836,82,1553090400,22,0,22,Clouds
27837,83,1553090400,39,1,40,Clouds
27838,84,1553090400,24,6,30,Clouds
27839,85,1553090400,34,0,34,Clouds
27840,86,1553090400,38,0,38,Clouds
27841,87,1553090400,38,0,38,Clouds
27842,88,1553090400,29,1,30,Clouds
27843,89,1553090400,18,22,40,Clouds
27844,90,1553090400,13,27,40,Clouds
27845,91,1553090400,21,9,30,Clouds
27846,92,1553090400,40,0,40,Clouds
27847,93,1553090400,40,0,40,Clouds
27848,94,1553090400,40,0,40,Clouds
27849,95,1553090400,38,2,40,Clouds
27850,96,1553090400,30,0,30,Clouds
27851,97,1553090400,37,3,40,Clouds
27852,98,1553090400,16,24,40,Clouds
27853,99,1553090400,1,29,30,Clouds
27854,100,1553090400,22,3,25,Clouds
27855,101,1553090400,30,0,30,Clouds
27856,102,1553090400,40,0,40,Clouds
27857,103,1553090400,40,0,40,Clouds
27858,104,1553090400,40,0,40,Clouds
27859,105,1553090400,36,0,36,Clouds
27860,106,1553090400,40,0,40,Clouds
27861,107,1553090400,39,1,40,Clouds
27862,108,1553090400,40,0,40,Clouds
27863,109,1553090400,28,1,29,Clouds
27864,110,1553090400,39,1,40,Clouds
27865,111,1553090400,38,2,40,Clouds
27866,112,1553090400,27,3,30,Clouds
27867,113,1553090400,15,24,39,Clouds
27868,114,1553090400,2,38,40,Clouds
27869,115,1553090400,24,6,30,Clouds
27870,2,1553094000,17,3,20,Clouds
27871,3,1553094000,14,6,20,Clouds
27872,4,1553094000,19,1,20,Clouds
27873,5,1553094000,30,10,40,Clouds
27874,6,1553094000,19,1,20,Clouds
27875,7,1553094000,18,11,29,Clouds
27876,8,1553094000,14,16,30,Clouds
27877,9,1553094000,7,17,24,Clouds
27878,10,1553094000,14,2,16,Clouds
27879,11,1553094000,12,18,30,Clouds
27880,12,1553094000,18,2,20,Clouds
27881,13,1553094000,10,20,30,Clouds
27882,14,1553094000,3,26,29,Clouds
27883,15,1553094000,16,0,16,Clouds
27884,16,1553094000,11,9,20,Clouds
27885,17,1553094000,17,3,20,Clouds
27886,18,1553094000,24,5,29,Clouds
27887,19,1553094000,13,17,30,Clouds
27888,21,1553094000,14,16,30,Clouds
27889,22,1553094000,17,3,20,Clouds
27890,23,1553094000,21,9,30,Clouds
27891,24,1553094000,14,6,20,Clouds
27892,25,1553094000,1,29,30,Clouds
27893,26,1553094000,4,16,20,Clouds
27894,27,1553094000,5,15,20,Clouds
27895,28,1553094000,30,0,30,Clouds
27896,29,1553094000,29,0,29,Clouds
27897,30,1553094000,15,5,20,Clouds
27898,31,1553094000,18,2,20,Clouds
27899,32,1553094000,28,2,30,Clouds
27900,33,1553094000,2,21,23,Clouds
27901,34,1553094000,30,0,30,Clouds
27902,35,1553094000,30,0,30,Clouds
27903,36,1553094000,5,34,39,Clouds
27904,37,1553094000,26,4,30,Clouds
27905,38,1553094000,32,7,39,Clouds
27906,39,1553094000,6,14,20,Clouds
27907,40,1553094000,20,1,21,Clouds
27908,41,1553094000,15,5,20,Clouds
27909,42,1553094000,30,0,30,Clouds
27910,43,1553094000,28,2,30,Clouds
27911,44,1553094000,28,2,30,Clouds
27912,45,1553094000,30,0,30,Clouds
27913,46,1553094000,20,0,20,Clouds
27914,47,1553094000,5,35,40,Clouds
27915,48,1553094000,14,26,40,Clouds
27916,49,1553094000,8,32,40,Clouds
27917,50,1553094000,40,0,40,Clouds
27918,51,1553094000,23,17,40,Clouds
27919,52,1553094000,1,31,32,Clouds
27920,53,1553094000,6,34,40,Clouds
27921,54,1553094000,6,27,33,Clouds
27922,55,1553094000,15,21,36,Clouds
27923,56,1553094000,35,5,40,Clouds
27924,57,1553094000,1,22,23,Clouds
27925,58,1553094000,18,21,39,Clouds
27926,59,1553094000,19,1,20,Clouds
27927,60,1553094000,30,0,30,Clouds
27928,61,1553094000,25,0,25,Clouds
27929,62,1553094000,3,37,40,Clouds
27930,63,1553094000,0,35,35,Clouds
27931,64,1553094000,9,31,40,Clouds
27932,65,1553094000,5,35,40,Clouds
27933,66,1553094000,11,28,39,Clouds
27934,67,1553094000,15,25,40,Clouds
27935,68,1553094000,9,31,40,Clouds
27936,69,1553094000,0,40,40,Clouds
27937,70,1553094000,2,26,28,Clouds
27938,71,1553094000,39,1,40,Clouds
27939,72,1553094000,30,1,31,Clouds
27940,73,1553094000,29,1,30,Clouds
27941,74,1553094000,26,4,30,Clouds
27942,75,1553094000,38,2,40,Clouds
27943,76,1553094000,38,0,38,Clouds
27944,77,1553094000,29,0,29,Clouds
27945,78,1553094000,39,1,40,Clouds
27946,79,1553094000,27,0,27,Clouds
27947,80,1553094000,33,7,40,Clouds
27948,81,1553094000,40,0,40,Clouds
27949,82,1553094000,21,1,22,Clouds
27950,83,1553094000,33,7,40,Clouds
27951,84,1553094000,30,0,30,Clouds
27952,85,1553094000,28,7,35,Clouds
27953,86,1553094000,38,0,38,Clouds
27954,87,1553094000,38,0,38,Clouds
27955,88,1553094000,30,0,30,Clouds
27956,89,1553094000,16,24,40,Clouds
27957,90,1553094000,4,36,40,Clouds
27958,91,1553094000,17,13,30,Clouds
27959,92,1553094000,39,1,40,Clouds
27960,93,1553094000,40,0,40,Clouds
27961,94,1553094000,39,1,40,Clouds
27962,95,1553094000,38,2,40,Clouds
27963,96,1553094000,28,2,30,Clouds
27964,97,1553094000,32,8,40,Clouds
27965,98,1553094000,13,27,40,Clouds
27966,99,1553094000,1,29,30,Clouds
27967,100,1553094000,23,2,25,Clouds
27968,101,1553094000,30,0,30,Clouds
27969,102,1553094000,39,1,40,Clouds
27970,103,1553094000,39,1,40,Clouds
27971,104,1553094000,40,0,40,Clouds
27972,105,1553094000,36,0,36,Clouds
27973,106,1553094000,40,0,40,Clouds
27974,107,1553094000,34,6,40,Clouds
27975,108,1553094000,39,1,40,Clouds
27976,109,1553094000,28,1,29,Clouds
27977,110,1553094000,39,1,40,Clouds
27978,111,1553094000,39,1,40,Clouds
27979,112,1553094000,23,7,30,Clouds
27980,113,1553094000,14,25,39,Clouds
27981,114,1553094000,2,38,40,Clouds
27982,115,1553094000,25,5,30,Clouds
27983,2,1553097600,20,0,20,Clouds
27984,3,1553097600,15,5,20,Clouds
27985,4,1553097600,13,7,20,Clouds
27986,5,1553097600,30,10,40,Clouds
27987,6,1553097600,15,5,20,Clouds
27988,7,1553097600,16,13,29,Clouds
27989,8,1553097600,10,20,30,Clouds
27990,9,1553097600,7,17,24,Clouds
27991,10,1553097600,12,4,16,Clouds
27992,11,1553097600,13,17,30,Clouds
27993,12,1553097600,18,2,20,Clouds
27994,13,1553097600,11,19,30,Clouds
27995,14,1553097600,6,23,29,Clouds
27996,15,1553097600,16,0,16,Clouds
27997,16,1553097600,7,13,20,Clouds
27998,17,1553097600,15,5,20,Clouds
27999,18,1553097600,28,1,29,Clouds
28000,19,1553097600,16,14,30,Clouds
28001,21,1553097600,17,13,30,Clouds
28002,22,1553097600,15,5,20,Clouds
28003,23,1553097600,15,15,30,Clouds
28004,24,1553097600,15,5,20,Clouds
28005,25,1553097600,1,29,30,Clouds
28006,26,1553097600,6,14,20,Clouds
28007,27,1553097600,9,11,20,Clouds
28008,28,1553097600,30,0,30,Clouds
28009,29,1553097600,29,0,29,Clouds
28010,30,1553097600,15,5,20,Clouds
28011,31,1553097600,20,0,20,Clouds
28012,32,1553097600,23,7,30,Clouds
28013,33,1553097600,14,9,23,Clouds
28014,34,1553097600,27,3,30,Clouds
28015,35,1553097600,27,3,30,Clouds
28016,36,1553097600,0,39,39,Clouds
28017,37,1553097600,25,5,30,Clouds
28018,38,1553097600,37,2,39,Clouds
28019,39,1553097600,0,20,20,Clouds
28020,40,1553097600,15,6,21,Clouds
28021,41,1553097600,17,3,20,Clouds
28022,42,1553097600,28,2,30,Clouds
28023,43,1553097600,28,2,30,Clouds
28024,44,1553097600,28,2,30,Clouds
28025,45,1553097600,30,0,30,Clouds
28026,46,1553097600,20,0,20,Clouds
28027,47,1553097600,1,39,40,Clouds
28028,48,1553097600,0,40,40,Clouds
28029,49,1553097600,7,33,40,Clouds
28030,50,1553097600,34,6,40,Clouds
28031,51,1553097600,32,8,40,Clouds
28032,52,1553097600,3,29,32,Clouds
28033,53,1553097600,3,37,40,Clouds
28034,54,1553097600,8,25,33,Clouds
28035,55,1553097600,16,20,36,Clouds
28036,56,1553097600,27,13,40,Clouds
28037,57,1553097600,0,23,23,Clouds
28038,58,1553097600,17,22,39,Clouds
28039,59,1553097600,20,0,20,Clouds
28040,60,1553097600,25,5,30,Clouds
28041,61,1553097600,23,2,25,Clouds
28042,62,1553097600,5,35,40,Clouds
28043,63,1553097600,4,31,35,Clouds
28044,64,1553097600,12,28,40,Clouds
28045,65,1553097600,3,37,40,Clouds
28046,66,1553097600,4,35,39,Clouds
28047,67,1553097600,22,18,40,Clouds
28048,68,1553097600,4,36,40,Clouds
28049,69,1553097600,2,38,40,Clouds
28050,70,1553097600,2,26,28,Clouds
28051,71,1553097600,36,4,40,Clouds
28052,72,1553097600,31,0,31,Clouds
28053,73,1553097600,30,0,30,Clouds
28054,74,1553097600,26,4,30,Clouds
28055,75,1553097600,40,0,40,Clouds
28056,76,1553097600,38,0,38,Clouds
28057,77,1553097600,26,3,29,Clouds
28058,78,1553097600,40,0,40,Clouds
28059,79,1553097600,27,0,27,Clouds
28060,80,1553097600,37,3,40,Clouds
28061,81,1553097600,40,0,40,Clouds
28062,82,1553097600,21,1,22,Clouds
28063,83,1553097600,33,7,40,Clouds
28064,84,1553097600,30,0,30,Clouds
28065,85,1553097600,33,2,35,Clouds
28066,86,1553097600,36,2,38,Clouds
28067,87,1553097600,38,0,38,Clouds
28068,88,1553097600,28,2,30,Clouds
28069,89,1553097600,16,24,40,Clouds
28070,90,1553097600,5,35,40,Clouds
28071,91,1553097600,11,19,30,Clouds
28072,92,1553097600,38,2,40,Clouds
28073,93,1553097600,39,1,40,Clouds
28074,94,1553097600,39,1,40,Clouds
28075,95,1553097600,37,3,40,Clouds
28076,96,1553097600,27,3,30,Clouds
28077,97,1553097600,31,9,40,Clouds
28078,98,1553097600,13,27,40,Clouds
28079,99,1553097600,2,28,30,Clouds
28080,100,1553097600,25,0,25,Clouds
28081,101,1553097600,29,1,30,Clouds
28082,102,1553097600,40,0,40,Clouds
28083,103,1553097600,38,2,40,Clouds
28084,104,1553097600,40,0,40,Clouds
28085,105,1553097600,36,0,36,Clouds
28086,106,1553097600,38,2,40,Clouds
28087,107,1553097600,36,4,40,Clouds
28088,108,1553097600,40,0,40,Clouds
28089,109,1553097600,29,0,29,Clouds
28090,110,1553097600,40,0,40,Clouds
28091,111,1553097600,39,1,40,Clouds
28092,112,1553097600,23,7,30,Clouds
28093,113,1553097600,11,28,39,Clouds
28094,114,1553097600,3,37,40,Clouds
28095,115,1553097600,24,6,30,Clouds
28096,2,1553101200,19,1,20,Rain
28097,3,1553101200,20,0,20,Rain
28098,4,1553101200,19,1,20,Rain
28099,5,1553101200,25,15,40,Rain
28100,6,1553101200,14,6,20,Rain
28101,7,1553101200,13,16,29,Rain
28102,8,1553101200,11,19,30,Rain
28103,9,1553101200,17,7,24,Rain
28104,10,1553101200,14,2,16,Rain
28105,11,1553101200,18,12,30,Rain
28106,12,1553101200,20,0,20,Rain
28107,13,1553101200,8,22,30,Rain
28108,14,1553101200,12,18,30,Rain
28109,15,1553101200,16,0,16,Rain
28110,16,1553101200,8,12,20,Rain
28111,17,1553101200,18,2,20,Rain
28112,18,1553101200,30,0,30,Rain
28113,19,1553101200,21,9,30,Rain
28114,21,1553101200,18,12,30,Rain
28115,22,1553101200,15,5,20,Rain
28116,23,1553101200,28,2,30,Rain
28117,24,1553101200,16,4,20,Rain
28118,25,1553101200,10,20,30,Rain
28119,26,1553101200,1,19,20,Rain
28120,27,1553101200,10,10,20,Rain
28121,28,1553101200,30,0,30,Rain
28122,29,1553101200,28,1,29,Rain
28123,30,1553101200,16,4,20,Rain
28124,31,1553101200,16,4,20,Rain
28125,32,1553101200,26,4,30,Rain
28126,33,1553101200,12,11,23,Rain
28127,34,1553101200,20,10,30,Rain
28128,35,1553101200,26,4,30,Rain
28129,36,1553101200,1,38,39,Rain
28130,37,1553101200,25,5,30,Rain
28131,38,1553101200,32,8,40,Rain
28132,39,1553101200,4,16,20,Rain
28133,40,1553101200,12,9,21,Rain
28134,41,1553101200,14,6,20,Rain
28135,42,1553101200,26,4,30,Rain
28136,43,1553101200,26,4,30,Rain
28137,44,1553101200,26,4,30,Rain
28138,45,1553101200,21,9,30,Rain
28139,46,1553101200,16,4,20,Rain
28140,47,1553101200,0,40,40,Rain
28141,48,1553101200,1,39,40,Rain
28142,49,1553101200,2,38,40,Rain
28143,50,1553101200,31,9,40,Rain
28144,51,1553101200,34,6,40,Rain
28145,52,1553101200,3,29,32,Rain
28146,53,1553101200,13,27,40,Rain
28147,54,1553101200,13,20,33,Rain
28148,55,1553101200,22,14,36,Rain
28149,56,1553101200,12,28,40,Rain
28150,57,1553101200,1,22,23,Rain
28151,58,1553101200,21,19,40,Rain
28152,59,1553101200,20,0,20,Rain
28153,60,1553101200,18,12,30,Rain
28154,61,1553101200,25,0,25,Rain
28155,62,1553101200,5,35,40,Rain
28156,63,1553101200,2,33,35,Rain
28157,64,1553101200,12,28,40,Rain
28158,65,1553101200,6,34,40,Rain
28159,66,1553101200,11,29,40,Rain
28160,67,1553101200,15,25,40,Rain
28161,68,1553101200,8,32,40,Rain
28162,69,1553101200,9,31,40,Rain
28163,70,1553101200,11,17,28,Rain
28164,71,1553101200,37,3,40,Rain
28165,72,1553101200,29,2,31,Rain
28166,73,1553101200,30,0,30,Rain
28167,74,1553101200,23,7,30,Rain
28168,75,1553101200,38,2,40,Rain
28169,76,1553101200,37,1,38,Rain
28170,77,1553101200,27,2,29,Rain
28171,78,1553101200,38,2,40,Rain
28172,79,1553101200,27,0,27,Rain
28173,80,1553101200,40,0,40,Rain
28174,81,1553101200,40,0,40,Rain
28175,82,1553101200,22,0,22,Rain
28176,83,1553101200,34,6,40,Rain
28177,84,1553101200,29,1,30,Rain
28178,85,1553101200,33,2,35,Rain
28179,86,1553101200,34,4,38,Rain
28180,87,1553101200,38,0,38,Rain
28181,88,1553101200,25,5,30,Rain
28182,89,1553101200,19,21,40,Rain
28183,90,1553101200,13,27,40,Rain
28184,91,1553101200,10,20,30,Rain
28185,92,1553101200,39,0,39,Rain
28186,93,1553101200,39,1,40,Rain
28187,94,1553101200,38,2,40,Rain
28188,95,1553101200,35,5,40,Rain
28189,96,1553101200,28,2,30,Rain
28190,97,1553101200,31,9,40,Rain
28191,98,1553101200,18,22,40,Rain
28192,99,1553101200,5,25,30,Rain
28193,100,1553101200,12,13,25,Rain
28194,101,1553101200,28,2,30,Rain
28195,102,1553101200,40,0,40,Rain
28196,103,1553101200,38,2,40,Rain
28197,104,1553101200,40,0,40,Rain
28198,105,1553101200,36,0,36,Rain
28199,106,1553101200,37,3,40,Rain
28200,107,1553101200,37,3,40,Rain
28201,108,1553101200,39,1,40,Rain
28202,109,1553101200,26,3,29,Rain
28203,110,1553101200,39,1,40,Rain
28204,111,1553101200,38,2,40,Rain
28205,112,1553101200,22,8,30,Rain
28206,113,1553101200,11,28,39,Rain
28207,114,1553101200,3,37,40,Rain
28208,115,1553101200,26,4,30,Rain
28209,2,1553104800,18,2,20,Rain
28210,3,1553104800,19,1,20,Rain
28211,4,1553104800,20,0,20,Rain
28212,5,1553104800,6,34,40,Rain
28213,6,1553104800,19,1,20,Rain
28214,7,1553104800,17,12,29,Rain
28215,8,1553104800,2,28,30,Rain
28216,9,1553104800,23,1,24,Rain
28217,10,1553104800,15,1,16,Rain
28218,11,1553104800,30,0,30,Rain
28219,12,1553104800,19,1,20,Rain
28220,13,1553104800,17,13,30,Rain
28221,14,1553104800,1,29,30,Rain
28222,15,1553104800,16,0,16,Rain
28223,16,1553104800,5,15,20,Rain
28224,17,1553104800,18,2,20,Rain
28225,18,1553104800,30,0,30,Rain
28226,19,1553104800,29,1,30,Rain
28227,21,1553104800,13,17,30,Rain
28228,22,1553104800,20,0,20,Rain
28229,23,1553104800,8,22,30,Rain
28230,24,1553104800,16,4,20,Rain
28231,25,1553104800,28,2,30,Rain
28232,26,1553104800,0,20,20,Rain
28233,27,1553104800,9,11,20,Rain
28234,28,1553104800,29,1,30,Rain
28235,29,1553104800,28,1,29,Rain
28236,30,1553104800,20,0,20,Rain
28237,31,1553104800,20,0,20,Rain
28238,32,1553104800,8,22,30,Rain
28239,33,1553104800,12,11,23,Rain
28240,34,1553104800,1,29,30,Rain
28241,35,1553104800,30,0,30,Rain
28242,36,1553104800,19,20,39,Rain
28243,37,1553104800,29,1,30,Rain
28244,38,1553104800,24,16,40,Rain
28245,39,1553104800,10,10,20,Rain
28246,40,1553104800,19,2,21,Rain
28247,41,1553104800,19,1,20,Rain
28248,42,1553104800,24,6,30,Rain
28249,43,1553104800,18,12,30,Rain
28250,44,1553104800,26,4,30,Rain
28251,45,1553104800,21,9,30,Rain
28252,46,1553104800,15,5,20,Rain
28253,47,1553104800,16,24,40,Rain
28254,48,1553104800,2,38,40,Rain
28255,49,1553104800,6,34,40,Rain
28256,50,1553104800,34,6,40,Rain
28257,51,1553104800,38,2,40,Rain
28258,52,1553104800,2,30,32,Rain
28259,53,1553104800,24,16,40,Rain
28260,54,1553104800,25,8,33,Rain
28261,55,1553104800,35,1,36,Rain
28262,56,1553104800,34,6,40,Rain
28263,57,1553104800,13,10,23,Rain
28264,58,1553104800,32,8,40,Rain
28265,59,1553104800,20,0,20,Rain
28266,60,1553104800,20,10,30,Rain
28267,61,1553104800,25,0,25,Rain
28268,62,1553104800,9,31,40,Rain
28269,63,1553104800,6,29,35,Rain
28270,64,1553104800,19,21,40,Rain
28271,65,1553104800,8,32,40,Rain
28272,66,1553104800,40,0,40,Rain
28273,67,1553104800,15,25,40,Rain
28274,68,1553104800,27,13,40,Rain
28275,69,1553104800,15,25,40,Rain
28276,70,1553104800,7,21,28,Rain
28277,71,1553104800,40,0,40,Rain
28278,72,1553104800,28,3,31,Rain
28279,73,1553104800,27,3,30,Rain
28280,74,1553104800,9,21,30,Rain
28281,75,1553104800,39,1,40,Rain
28282,76,1553104800,37,1,38,Rain
28283,77,1553104800,27,2,29,Rain
28284,78,1553104800,37,3,40,Rain
28285,79,1553104800,27,0,27,Rain
28286,80,1553104800,27,13,40,Rain
28287,81,1553104800,40,0,40,Rain
28288,82,1553104800,22,0,22,Rain
28289,83,1553104800,33,7,40,Rain
28290,84,1553104800,24,6,30,Rain
28291,85,1553104800,29,6,35,Rain
28292,86,1553104800,26,12,38,Rain
28293,87,1553104800,37,1,38,Rain
28294,88,1553104800,21,9,30,Rain
28295,89,1553104800,30,10,40,Rain
28296,90,1553104800,16,24,40,Rain
28297,91,1553104800,14,16,30,Rain
28298,92,1553104800,30,9,39,Rain
28299,93,1553104800,12,28,40,Rain
28300,94,1553104800,37,3,40,Rain
28301,95,1553104800,31,9,40,Rain
28302,96,1553104800,28,2,30,Rain
28303,97,1553104800,31,9,40,Rain
28304,98,1553104800,20,20,40,Rain
28305,99,1553104800,5,25,30,Rain
28306,100,1553104800,0,25,25,Rain
28307,101,1553104800,24,6,30,Rain
28308,102,1553104800,35,5,40,Rain
28309,103,1553104800,40,0,40,Rain
28310,104,1553104800,40,0,40,Rain
28311,105,1553104800,36,0,36,Rain
28312,106,1553104800,37,3,40,Rain
28313,107,1553104800,33,7,40,Rain
28314,108,1553104800,38,2,40,Rain
28315,109,1553104800,25,4,29,Rain
28316,110,1553104800,37,3,40,Rain
28317,111,1553104800,35,5,40,Rain
28318,112,1553104800,27,3,30,Rain
28319,113,1553104800,11,29,40,Rain
28320,114,1553104800,40,0,40,Rain
28321,115,1553104800,24,6,30,Rain
28322,2,1553108400,14,6,20,Clouds
28323,3,1553108400,14,6,20,Clouds
28324,4,1553108400,20,0,20,Clouds
28325,5,1553108400,11,29,40,Clouds
28326,6,1553108400,14,6,20,Clouds
28327,7,1553108400,24,5,29,Clouds
28328,8,1553108400,13,17,30,Clouds
28329,9,1553108400,13,11,24,Clouds
28330,10,1553108400,10,6,16,Clouds
28331,11,1553108400,30,0,30,Clouds
28332,12,1553108400,15,5,20,Clouds
28333,13,1553108400,30,0,30,Clouds
28334,14,1553108400,1,29,30,Clouds
28335,15,1553108400,15,1,16,Clouds
28336,16,1553108400,0,20,20,Clouds
28337,17,1553108400,20,0,20,Clouds
28338,18,1553108400,30,0,30,Clouds
28339,19,1553108400,21,9,30,Clouds
28340,21,1553108400,0,30,30,Clouds
28341,22,1553108400,5,15,20,Clouds
28342,23,1553108400,2,28,30,Clouds
28343,24,1553108400,16,4,20,Clouds
28344,25,1553108400,30,0,30,Clouds
28345,26,1553108400,1,19,20,Clouds
28346,27,1553108400,19,1,20,Clouds
28347,28,1553108400,24,6,30,Clouds
28348,29,1553108400,27,2,29,Clouds
28349,30,1553108400,20,0,20,Clouds
28350,31,1553108400,12,8,20,Clouds
28351,32,1553108400,1,29,30,Clouds
28352,33,1553108400,3,20,23,Clouds
28353,34,1553108400,5,25,30,Clouds
28354,35,1553108400,21,9,30,Clouds
28355,36,1553108400,40,0,40,Clouds
28356,37,1553108400,30,0,30,Clouds
28357,38,1553108400,25,15,40,Clouds
28358,39,1553108400,20,0,20,Clouds
28359,40,1553108400,18,3,21,Clouds
28360,41,1553108400,20,0,20,Clouds
28361,42,1553108400,19,11,30,Clouds
28362,43,1553108400,0,30,30,Clouds
28363,44,1553108400,21,9,30,Clouds
28364,45,1553108400,19,11,30,Clouds
28365,46,1553108400,7,13,20,Clouds
28366,47,1553108400,40,0,40,Clouds
28367,48,1553108400,4,36,40,Clouds
28368,49,1553108400,34,6,40,Clouds
28369,50,1553108400,27,13,40,Clouds
28370,51,1553108400,37,3,40,Clouds
28371,52,1553108400,31,1,32,Clouds
28372,53,1553108400,40,0,40,Clouds
28373,54,1553108400,33,0,33,Clouds
28374,55,1553108400,36,0,36,Clouds
28375,56,1553108400,40,0,40,Clouds
28376,57,1553108400,23,0,23,Clouds
28377,58,1553108400,37,3,40,Clouds
28378,59,1553108400,15,5,20,Clouds
28379,60,1553108400,8,22,30,Clouds
28380,61,1553108400,25,0,25,Clouds
28381,62,1553108400,40,0,40,Clouds
28382,63,1553108400,31,4,35,Clouds
28383,64,1553108400,16,24,40,Clouds
28384,65,1553108400,40,0,40,Clouds
28385,66,1553108400,40,0,40,Clouds
28386,67,1553108400,23,17,40,Clouds
28387,68,1553108400,40,0,40,Clouds
28388,69,1553108400,35,5,40,Clouds
28389,70,1553108400,9,19,28,Clouds
28390,71,1553108400,39,1,40,Clouds
28391,72,1553108400,19,12,31,Clouds
28392,73,1553108400,30,0,30,Clouds
28393,74,1553108400,9,21,30,Clouds
28394,75,1553108400,30,10,40,Clouds
28395,76,1553108400,36,2,38,Clouds
28396,77,1553108400,26,3,29,Clouds
28397,78,1553108400,31,9,40,Clouds
28398,79,1553108400,25,2,27,Clouds
28399,80,1553108400,30,10,40,Clouds
28400,81,1553108400,40,0,40,Clouds
28401,82,1553108400,21,1,22,Clouds
28402,83,1553108400,26,14,40,Clouds
28403,84,1553108400,23,7,30,Clouds
28404,85,1553108400,20,15,35,Clouds
28405,86,1553108400,10,28,38,Clouds
28406,87,1553108400,34,4,38,Clouds
28407,88,1553108400,19,11,30,Clouds
28408,89,1553108400,39,1,40,Clouds
28409,90,1553108400,39,1,40,Clouds
28410,91,1553108400,8,22,30,Clouds
28411,92,1553108400,15,24,39,Clouds
28412,93,1553108400,0,40,40,Clouds
28413,94,1553108400,1,39,40,Clouds
28414,95,1553108400,18,22,40,Clouds
28415,96,1553108400,25,5,30,Clouds
28416,97,1553108400,20,20,40,Clouds
28417,98,1553108400,33,7,40,Clouds
28418,99,1553108400,19,11,30,Clouds
28419,100,1553108400,1,24,25,Clouds
28420,101,1553108400,19,11,30,Clouds
28421,102,1553108400,32,8,40,Clouds
28422,103,1553108400,38,2,40,Clouds
28423,104,1553108400,40,0,40,Clouds
28424,105,1553108400,36,0,36,Clouds
28425,106,1553108400,35,5,40,Clouds
28426,107,1553108400,23,17,40,Clouds
28427,108,1553108400,30,10,40,Clouds
28428,109,1553108400,26,3,29,Clouds
28429,110,1553108400,35,5,40,Clouds
28430,111,1553108400,38,2,40,Clouds
28431,112,1553108400,23,7,30,Clouds
28432,113,1553108400,34,6,40,Clouds
28433,114,1553108400,40,0,40,Clouds
28434,115,1553108400,17,13,30,Clouds
28435,2,1553112000,14,6,20,Clouds
28436,3,1553112000,20,0,20,Clouds
28437,4,1553112000,18,2,20,Clouds
28438,5,1553112000,0,40,40,Clouds
28439,6,1553112000,19,1,20,Clouds
28440,7,1553112000,19,10,29,Clouds
28441,8,1553112000,27,3,30,Clouds
28442,9,1553112000,18,6,24,Clouds
28443,10,1553112000,7,9,16,Clouds
28444,11,1553112000,30,0,30,Clouds
28445,12,1553112000,13,7,20,Clouds
28446,13,1553112000,30,0,30,Clouds
28447,14,1553112000,0,30,30,Clouds
28448,15,1553112000,13,3,16,Clouds
28449,16,1553112000,5,15,20,Clouds
28450,17,1553112000,20,0,20,Clouds
28451,18,1553112000,29,1,30,Clouds
28452,19,1553112000,30,0,30,Clouds
28453,21,1553112000,11,19,30,Clouds
28454,22,1553112000,7,13,20,Clouds
28455,23,1553112000,0,30,30,Clouds
28456,24,1553112000,20,0,20,Clouds
28457,25,1553112000,30,0,30,Clouds
28458,26,1553112000,8,12,20,Clouds
28459,27,1553112000,17,3,20,Clouds
28460,28,1553112000,30,0,30,Clouds
28461,29,1553112000,29,0,29,Clouds
28462,30,1553112000,20,0,20,Clouds
28463,31,1553112000,16,4,20,Clouds
28464,32,1553112000,3,27,30,Clouds
28465,33,1553112000,4,19,23,Clouds
28466,34,1553112000,7,23,30,Clouds
28467,35,1553112000,21,9,30,Clouds
28468,36,1553112000,40,0,40,Clouds
28469,37,1553112000,30,0,30,Clouds
28470,38,1553112000,22,18,40,Clouds
28471,39,1553112000,19,1,20,Clouds
28472,40,1553112000,17,4,21,Clouds
28473,41,1553112000,20,0,20,Clouds
28474,42,1553112000,5,25,30,Clouds
28475,43,1553112000,4,26,30,Clouds
28476,44,1553112000,11,19,30,Clouds
28477,45,1553112000,17,13,30,Clouds
28478,46,1553112000,19,1,20,Clouds
28479,47,1553112000,40,0,40,Clouds
28480,48,1553112000,9,31,40,Clouds
28481,49,1553112000,40,0,40,Clouds
28482,50,1553112000,23,17,40,Clouds
28483,51,1553112000,38,2,40,Clouds
28484,52,1553112000,31,1,32,Clouds
28485,53,1553112000,40,0,40,Clouds
28486,54,1553112000,33,0,33,Clouds
28487,55,1553112000,34,2,36,Clouds
28488,56,1553112000,38,2,40,Clouds
28489,57,1553112000,20,3,23,Clouds
28490,58,1553112000,26,14,40,Clouds
28491,59,1553112000,12,8,20,Clouds
28492,60,1553112000,2,28,30,Clouds
28493,61,1553112000,22,3,25,Clouds
28494,62,1553112000,40,0,40,Clouds
28495,63,1553112000,34,1,35,Clouds
28496,64,1553112000,19,21,40,Clouds
28497,65,1553112000,40,0,40,Clouds
28498,66,1553112000,38,2,40,Clouds
28499,67,1553112000,20,20,40,Clouds
28500,68,1553112000,40,0,40,Clouds
28501,69,1553112000,40,0,40,Clouds
28502,70,1553112000,27,1,28,Clouds
28503,71,1553112000,40,0,40,Clouds
28504,72,1553112000,18,13,31,Clouds
28505,73,1553112000,4,26,30,Clouds
28506,74,1553112000,12,18,30,Clouds
28507,75,1553112000,21,19,40,Clouds
28508,76,1553112000,29,9,38,Clouds
28509,77,1553112000,27,2,29,Clouds
28510,78,1553112000,21,19,40,Clouds
28511,79,1553112000,25,2,27,Clouds
28512,80,1553112000,32,8,40,Clouds
28513,81,1553112000,40,0,40,Clouds
28514,82,1553112000,18,4,22,Clouds
28515,83,1553112000,20,20,40,Clouds
28516,84,1553112000,14,16,30,Clouds
28517,85,1553112000,7,28,35,Clouds
28518,86,1553112000,3,35,38,Clouds
28519,87,1553112000,25,13,38,Clouds
28520,88,1553112000,14,16,30,Clouds
28521,89,1553112000,38,2,40,Clouds
28522,90,1553112000,40,0,40,Clouds
28523,91,1553112000,8,22,30,Clouds
28524,92,1553112000,0,39,39,Clouds
28525,93,1553112000,0,40,40,Clouds
28526,94,1553112000,0,40,40,Clouds
28527,95,1553112000,11,29,40,Clouds
28528,96,1553112000,23,7,30,Clouds
28529,97,1553112000,17,23,40,Clouds
28530,98,1553112000,40,0,40,Clouds
28531,99,1553112000,29,1,30,Clouds
28532,100,1553112000,1,24,25,Clouds
28533,101,1553112000,14,16,30,Clouds
28534,102,1553112000,31,9,40,Clouds
28535,103,1553112000,40,0,40,Clouds
28536,104,1553112000,40,0,40,Clouds
28537,105,1553112000,36,0,36,Clouds
28538,106,1553112000,35,5,40,Clouds
28539,107,1553112000,24,16,40,Clouds
28540,108,1553112000,28,12,40,Clouds
28541,109,1553112000,23,6,29,Clouds
28542,110,1553112000,33,7,40,Clouds
28543,111,1553112000,35,5,40,Clouds
28544,112,1553112000,12,18,30,Clouds
28545,113,1553112000,40,0,40,Clouds
28546,114,1553112000,40,0,40,Clouds
28547,115,1553112000,6,24,30,Clouds
28548,2,1553115600,15,5,20,Rain
28549,3,1553115600,16,4,20,Rain
28550,4,1553115600,13,7,20,Rain
28551,5,1553115600,6,34,40,Rain
28552,6,1553115600,14,6,20,Rain
28553,7,1553115600,20,9,29,Rain
28554,8,1553115600,30,0,30,Rain
28555,9,1553115600,21,3,24,Rain
28556,10,1553115600,11,5,16,Rain
28557,11,1553115600,30,0,30,Rain
28558,12,1553115600,14,6,20,Rain
28559,13,1553115600,30,0,30,Rain
28560,14,1553115600,5,25,30,Rain
28561,15,1553115600,11,5,16,Rain
28562,16,1553115600,7,13,20,Rain
28563,17,1553115600,19,1,20,Rain
28564,18,1553115600,22,8,30,Rain
28565,19,1553115600,13,17,30,Rain
28566,21,1553115600,15,15,30,Rain
28567,22,1553115600,13,7,20,Rain
28568,23,1553115600,6,24,30,Rain
28569,24,1553115600,17,3,20,Rain
28570,25,1553115600,29,1,30,Rain
28571,26,1553115600,15,5,20,Rain
28572,27,1553115600,20,0,20,Rain
28573,28,1553115600,27,3,30,Rain
28574,29,1553115600,26,3,29,Rain
28575,30,1553115600,20,0,20,Rain
28576,31,1553115600,18,2,20,Rain
28577,32,1553115600,7,23,30,Rain
28578,33,1553115600,6,17,23,Rain
28579,34,1553115600,1,29,30,Rain
28580,35,1553115600,10,20,30,Rain
28581,36,1553115600,26,14,40,Rain
28582,37,1553115600,30,0,30,Rain
28583,38,1553115600,17,23,40,Rain
28584,39,1553115600,19,1,20,Rain
28585,40,1553115600,20,1,21,Rain
28586,41,1553115600,20,0,20,Rain
28587,42,1553115600,0,30,30,Rain
28588,43,1553115600,0,30,30,Rain
28589,44,1553115600,3,27,30,Rain
28590,45,1553115600,17,13,30,Rain
28591,46,1553115600,15,5,20,Rain
28592,47,1553115600,39,1,40,Rain
28593,48,1553115600,15,25,40,Rain
28594,49,1553115600,40,0,40,Rain
28595,50,1553115600,19,21,40,Rain
28596,51,1553115600,38,2,40,Rain
28597,52,1553115600,31,1,32,Rain
28598,53,1553115600,40,0,40,Rain
28599,54,1553115600,32,1,33,Rain
28600,55,1553115600,35,1,36,Rain
28601,56,1553115600,38,2,40,Rain
28602,57,1553115600,21,2,23,Rain
28603,58,1553115600,38,2,40,Rain
28604,59,1553115600,17,3,20,Rain
28605,60,1553115600,0,29,29,Rain
28606,61,1553115600,24,1,25,Rain
28607,62,1553115600,40,0,40,Rain
28608,63,1553115600,34,1,35,Rain
28609,64,1553115600,25,15,40,Rain
28610,65,1553115600,40,0,40,Rain
28611,66,1553115600,33,7,40,Rain
28612,67,1553115600,21,19,40,Rain
28613,68,1553115600,40,0,40,Rain
28614,69,1553115600,40,0,40,Rain
28615,70,1553115600,23,5,28,Rain
28616,71,1553115600,36,4,40,Rain
28617,72,1553115600,15,16,31,Rain
28618,73,1553115600,5,25,30,Rain
28619,74,1553115600,11,19,30,Rain
28620,75,1553115600,21,19,40,Rain
28621,76,1553115600,29,9,38,Rain
28622,77,1553115600,29,0,29,Rain
28623,78,1553115600,16,24,40,Rain
28624,79,1553115600,27,0,27,Rain
28625,80,1553115600,34,6,40,Rain
28626,81,1553115600,40,0,40,Rain
28627,82,1553115600,16,6,22,Rain
28628,83,1553115600,12,28,40,Rain
28629,84,1553115600,12,18,30,Rain
28630,85,1553115600,7,28,35,Rain
28631,86,1553115600,0,38,38,Rain
28632,87,1553115600,20,18,38,Rain
28633,88,1553115600,9,21,30,Rain
28634,89,1553115600,39,1,40,Rain
28635,90,1553115600,40,0,40,Rain
28636,91,1553115600,0,30,30,Rain
28637,92,1553115600,0,39,39,Rain
28638,93,1553115600,0,40,40,Rain
28639,94,1553115600,0,40,40,Rain
28640,95,1553115600,9,31,40,Rain
28641,96,1553115600,22,8,30,Rain
28642,97,1553115600,12,28,40,Rain
28643,98,1553115600,40,0,40,Rain
28644,99,1553115600,30,0,30,Rain
28645,100,1553115600,0,25,25,Rain
28646,101,1553115600,14,16,30,Rain
28647,102,1553115600,31,9,40,Rain
28648,103,1553115600,38,2,40,Rain
28649,104,1553115600,40,0,40,Rain
28650,105,1553115600,36,0,36,Rain
28651,106,1553115600,35,5,40,Rain
28652,107,1553115600,23,17,40,Rain
28653,108,1553115600,25,15,40,Rain
28654,109,1553115600,23,6,29,Rain
28655,110,1553115600,31,9,40,Rain
28656,111,1553115600,35,5,40,Rain
28657,112,1553115600,4,26,30,Rain
28658,113,1553115600,40,0,40,Rain
28659,114,1553115600,40,0,40,Rain
28660,115,1553115600,19,11,30,Rain
28661,2,1553119200,14,6,20,Clouds
28662,3,1553119200,15,5,20,Clouds
28663,4,1553119200,15,5,20,Clouds
28664,5,1553119200,11,29,40,Clouds
28665,6,1553119200,18,2,20,Clouds
28666,7,1553119200,20,9,29,Clouds
28667,8,1553119200,28,2,30,Clouds
28668,9,1553119200,22,2,24,Clouds
28669,10,1553119200,11,5,16,Clouds
28670,11,1553119200,28,2,30,Clouds
28671,12,1553119200,19,1,20,Clouds
28672,13,1553119200,29,1,30,Clouds
28673,14,1553119200,6,24,30,Clouds
28674,15,1553119200,11,5,16,Clouds
28675,16,1553119200,16,4,20,Clouds
28676,17,1553119200,20,0,20,Clouds
28677,18,1553119200,16,14,30,Clouds
28678,19,1553119200,19,11,30,Clouds
28679,21,1553119200,30,0,30,Clouds
28680,22,1553119200,15,5,20,Clouds
28681,23,1553119200,17,13,30,Clouds
28682,24,1553119200,15,5,20,Clouds
28683,25,1553119200,30,0,30,Clouds
28684,26,1553119200,13,7,20,Clouds
28685,27,1553119200,20,0,20,Clouds
28686,28,1553119200,22,8,30,Clouds
28687,29,1553119200,29,0,29,Clouds
28688,30,1553119200,19,1,20,Clouds
28689,31,1553119200,11,9,20,Clouds
28690,32,1553119200,10,20,30,Clouds
28691,33,1553119200,11,12,23,Clouds
28692,34,1553119200,1,29,30,Clouds
28693,35,1553119200,3,27,30,Clouds
28694,36,1553119200,33,7,40,Clouds
28695,37,1553119200,30,0,30,Clouds
28696,38,1553119200,20,20,40,Clouds
28697,39,1553119200,14,6,20,Clouds
28698,40,1553119200,18,3,21,Clouds
28699,41,1553119200,20,0,20,Clouds
28700,42,1553119200,5,25,30,Clouds
28701,43,1553119200,1,29,30,Clouds
28702,44,1553119200,1,29,30,Clouds
28703,45,1553119200,18,12,30,Clouds
28704,46,1553119200,15,5,20,Clouds
28705,47,1553119200,39,1,40,Clouds
28706,48,1553119200,27,13,40,Clouds
28707,49,1553119200,38,2,40,Clouds
28708,50,1553119200,15,25,40,Clouds
28709,51,1553119200,40,0,40,Clouds
28710,52,1553119200,32,0,32,Clouds
28711,53,1553119200,40,0,40,Clouds
28712,54,1553119200,32,1,33,Clouds
28713,55,1553119200,35,1,36,Clouds
28714,56,1553119200,37,3,40,Clouds
28715,57,1553119200,22,1,23,Clouds
28716,58,1553119200,36,4,40,Clouds
28717,59,1553119200,20,0,20,Clouds
28718,60,1553119200,1,29,30,Clouds
28719,61,1553119200,23,2,25,Clouds
28720,62,1553119200,39,1,40,Clouds
28721,63,1553119200,32,3,35,Clouds
28722,64,1553119200,30,10,40,Clouds
28723,65,1553119200,39,1,40,Clouds
28724,66,1553119200,31,9,40,Clouds
28725,67,1553119200,16,24,40,Clouds
28726,68,1553119200,25,15,40,Clouds
28727,69,1553119200,35,5,40,Clouds
28728,70,1553119200,22,6,28,Clouds
28729,71,1553119200,40,0,40,Clouds
28730,72,1553119200,14,17,31,Clouds
28731,73,1553119200,10,20,30,Clouds
28732,74,1553119200,14,16,30,Clouds
28733,75,1553119200,17,23,40,Clouds
28734,76,1553119200,26,12,38,Clouds
28735,77,1553119200,26,3,29,Clouds
28736,78,1553119200,19,21,40,Clouds
28737,79,1553119200,27,0,27,Clouds
28738,80,1553119200,36,4,40,Clouds
28739,81,1553119200,39,1,40,Clouds
28740,82,1553119200,9,13,22,Clouds
28741,83,1553119200,1,39,40,Clouds
28742,84,1553119200,8,22,30,Clouds
28743,85,1553119200,2,33,35,Clouds
28744,86,1553119200,0,38,38,Clouds
28745,87,1553119200,14,24,38,Clouds
28746,88,1553119200,7,23,30,Clouds
28747,89,1553119200,39,1,40,Clouds
28748,90,1553119200,37,3,40,Clouds
28749,91,1553119200,2,28,30,Clouds
28750,92,1553119200,0,39,39,Clouds
28751,93,1553119200,0,40,40,Clouds
28752,94,1553119200,0,40,40,Clouds
28753,95,1553119200,5,35,40,Clouds
28754,96,1553119200,20,10,30,Clouds
28755,97,1553119200,6,34,40,Clouds
28756,98,1553119200,40,0,40,Clouds
28757,99,1553119200,30,0,30,Clouds
28758,100,1553119200,0,25,25,Clouds
28759,101,1553119200,9,21,30,Clouds
28760,102,1553119200,30,10,40,Clouds
28761,103,1553119200,39,1,40,Clouds
28762,104,1553119200,40,0,40,Clouds
28763,105,1553119200,36,0,36,Clouds
28764,106,1553119200,37,3,40,Clouds
28765,107,1553119200,21,19,40,Clouds
28766,108,1553119200,24,16,40,Clouds
28767,109,1553119200,24,5,29,Clouds
28768,110,1553119200,28,12,40,Clouds
28769,111,1553119200,31,9,40,Clouds
28770,112,1553119200,2,28,30,Clouds
28771,113,1553119200,40,0,40,Clouds
28772,114,1553119200,40,0,40,Clouds
28773,115,1553119200,13,17,30,Clouds
28774,2,1553122800,9,11,20,Clouds
28775,3,1553122800,17,3,20,Clouds
28776,4,1553122800,15,5,20,Clouds
28777,5,1553122800,2,38,40,Clouds
28778,6,1553122800,19,1,20,Clouds
28779,7,1553122800,21,8,29,Clouds
28780,8,1553122800,30,0,30,Clouds
28781,9,1553122800,12,12,24,Clouds
28782,10,1553122800,14,2,16,Clouds
28783,11,1553122800,29,1,30,Clouds
28784,12,1553122800,19,1,20,Clouds
28785,13,1553122800,30,0,30,Clouds
28786,14,1553122800,16,14,30,Clouds
28787,15,1553122800,9,7,16,Clouds
28788,16,1553122800,20,0,20,Clouds
28789,17,1553122800,20,0,20,Clouds
28790,18,1553122800,19,11,30,Clouds
28791,19,1553122800,23,7,30,Clouds
28792,21,1553122800,30,0,30,Clouds
28793,22,1553122800,20,0,20,Clouds
28794,23,1553122800,24,6,30,Clouds
28795,24,1553122800,14,6,20,Clouds
28796,25,1553122800,30,0,30,Clouds
28797,26,1553122800,14,6,20,Clouds
28798,27,1553122800,20,0,20,Clouds
28799,28,1553122800,19,11,30,Clouds
28800,29,1553122800,27,2,29,Clouds
28801,30,1553122800,19,1,20,Clouds
28802,31,1553122800,9,11,20,Clouds
28803,32,1553122800,12,18,30,Clouds
28804,33,1553122800,18,5,23,Clouds
28805,34,1553122800,10,20,30,Clouds
28806,35,1553122800,4,26,30,Clouds
28807,36,1553122800,34,6,40,Clouds
28808,37,1553122800,30,0,30,Clouds
28809,38,1553122800,25,15,40,Clouds
28810,39,1553122800,18,2,20,Clouds
28811,40,1553122800,19,2,21,Clouds
28812,41,1553122800,20,0,20,Clouds
28813,42,1553122800,3,27,30,Clouds
28814,43,1553122800,11,19,30,Clouds
28815,44,1553122800,0,30,30,Clouds
28816,45,1553122800,16,14,30,Clouds
28817,46,1553122800,20,0,20,Clouds
28818,47,1553122800,40,0,40,Clouds
28819,48,1553122800,31,9,40,Clouds
28820,49,1553122800,37,3,40,Clouds
28821,50,1553122800,9,31,40,Clouds
28822,51,1553122800,40,0,40,Clouds
28823,52,1553122800,32,0,32,Clouds
28824,53,1553122800,39,1,40,Clouds
28825,54,1553122800,31,2,33,Clouds
28826,55,1553122800,36,0,36,Clouds
28827,56,1553122800,34,6,40,Clouds
28828,57,1553122800,21,2,23,Clouds
28829,58,1553122800,36,4,40,Clouds
28830,59,1553122800,20,0,20,Clouds
28831,60,1553122800,0,30,30,Clouds
28832,61,1553122800,25,0,25,Clouds
28833,62,1553122800,40,0,40,Clouds
28834,63,1553122800,30,5,35,Clouds
28835,64,1553122800,30,10,40,Clouds
28836,65,1553122800,40,0,40,Clouds
28837,66,1553122800,31,9,40,Clouds
28838,67,1553122800,18,22,40,Clouds
28839,68,1553122800,29,11,40,Clouds
28840,69,1553122800,31,9,40,Clouds
28841,70,1553122800,15,13,28,Clouds
28842,71,1553122800,40,0,40,Clouds
28843,72,1553122800,16,15,31,Clouds
28844,73,1553122800,9,21,30,Clouds
28845,74,1553122800,11,19,30,Clouds
28846,75,1553122800,16,24,40,Clouds
28847,76,1553122800,25,13,38,Clouds
28848,77,1553122800,25,4,29,Clouds
28849,78,1553122800,18,22,40,Clouds
28850,79,1553122800,19,8,27,Clouds
28851,80,1553122800,37,3,40,Clouds
28852,81,1553122800,38,2,40,Clouds
28853,82,1553122800,8,14,22,Clouds
28854,83,1553122800,1,39,40,Clouds
28855,84,1553122800,3,27,30,Clouds
28856,85,1553122800,0,35,35,Clouds
28857,86,1553122800,1,37,38,Clouds
28858,87,1553122800,10,28,38,Clouds
28859,88,1553122800,5,25,30,Clouds
28860,89,1553122800,39,1,40,Clouds
28861,90,1553122800,36,4,40,Clouds
28862,91,1553122800,3,27,30,Clouds
28863,92,1553122800,15,25,40,Clouds
28864,93,1553122800,0,40,40,Clouds
28865,94,1553122800,0,40,40,Clouds
28866,95,1553122800,3,37,40,Clouds
28867,96,1553122800,19,11,30,Clouds
28868,97,1553122800,0,40,40,Clouds
28869,98,1553122800,40,0,40,Clouds
28870,99,1553122800,30,0,30,Clouds
28871,100,1553122800,3,22,25,Clouds
28872,101,1553122800,6,24,30,Clouds
28873,102,1553122800,29,11,40,Clouds
28874,103,1553122800,33,7,40,Clouds
28875,104,1553122800,40,0,40,Clouds
28876,105,1553122800,36,0,36,Clouds
28877,106,1553122800,24,16,40,Clouds
28878,107,1553122800,18,22,40,Clouds
28879,108,1553122800,23,17,40,Clouds
28880,109,1553122800,21,8,29,Clouds
28881,110,1553122800,29,11,40,Clouds
28882,111,1553122800,24,16,40,Clouds
28883,112,1553122800,0,30,30,Clouds
28884,113,1553122800,40,0,40,Clouds
28885,114,1553122800,39,1,40,Clouds
28886,115,1553122800,8,22,30,Clouds
28887,2,1553126400,8,12,20,Clouds
28888,3,1553126400,20,0,20,Clouds
28889,4,1553126400,16,4,20,Clouds
28890,5,1553126400,2,38,40,Clouds
28891,6,1553126400,20,0,20,Clouds
28892,7,1553126400,16,13,29,Clouds
28893,8,1553126400,27,3,30,Clouds
28894,9,1553126400,21,3,24,Clouds
28895,10,1553126400,16,0,16,Clouds
28896,11,1553126400,28,2,30,Clouds
28897,12,1553126400,17,3,20,Clouds
28898,13,1553126400,30,0,30,Clouds
28899,14,1553126400,26,4,30,Clouds
28900,15,1553126400,7,9,16,Clouds
28901,16,1553126400,20,0,20,Clouds
28902,17,1553126400,15,5,20,Clouds
28903,18,1553126400,25,5,30,Clouds
28904,19,1553126400,22,8,30,Clouds
28905,21,1553126400,30,0,30,Clouds
28906,22,1553126400,20,0,20,Clouds
28907,23,1553126400,27,3,30,Clouds
28908,24,1553126400,15,5,20,Clouds
28909,25,1553126400,30,0,30,Clouds
28910,26,1553126400,20,0,20,Clouds
28911,27,1553126400,20,0,20,Clouds
28912,28,1553126400,7,23,30,Clouds
28913,29,1553126400,29,0,29,Clouds
28914,30,1553126400,19,1,20,Clouds
28915,31,1553126400,8,12,20,Clouds
28916,32,1553126400,13,17,30,Clouds
28917,33,1553126400,17,6,23,Clouds
28918,34,1553126400,15,15,30,Clouds
28919,35,1553126400,7,23,30,Clouds
28920,36,1553126400,38,2,40,Clouds
28921,37,1553126400,30,0,30,Clouds
28922,38,1553126400,21,19,40,Clouds
28923,39,1553126400,18,2,20,Clouds
28924,40,1553126400,20,1,21,Clouds
28925,41,1553126400,20,0,20,Clouds
28926,42,1553126400,1,29,30,Clouds
28927,43,1553126400,8,22,30,Clouds
28928,44,1553126400,8,22,30,Clouds
28929,45,1553126400,16,14,30,Clouds
28930,46,1553126400,20,0,20,Clouds
28931,47,1553126400,40,0,40,Clouds
28932,48,1553126400,29,11,40,Clouds
28933,49,1553126400,37,3,40,Clouds
28934,50,1553126400,9,31,40,Clouds
28935,51,1553126400,39,1,40,Clouds
28936,52,1553126400,31,1,32,Clouds
28937,53,1553126400,40,0,40,Clouds
28938,54,1553126400,32,1,33,Clouds
28939,55,1553126400,36,0,36,Clouds
28940,56,1553126400,31,9,40,Clouds
28941,57,1553126400,22,1,23,Clouds
28942,58,1553126400,38,2,40,Clouds
28943,59,1553126400,19,1,20,Clouds
28944,60,1553126400,1,29,30,Clouds
28945,61,1553126400,17,8,25,Clouds
28946,62,1553126400,38,2,40,Clouds
28947,63,1553126400,31,4,35,Clouds
28948,64,1553126400,24,16,40,Clouds
28949,65,1553126400,40,0,40,Clouds
28950,66,1553126400,30,10,40,Clouds
28951,67,1553126400,17,23,40,Clouds
28952,68,1553126400,30,10,40,Clouds
28953,69,1553126400,30,10,40,Clouds
28954,70,1553126400,14,14,28,Clouds
28955,71,1553126400,37,3,40,Clouds
28956,72,1553126400,16,15,31,Clouds
28957,73,1553126400,8,22,30,Clouds
28958,74,1553126400,11,19,30,Clouds
28959,75,1553126400,13,27,40,Clouds
28960,76,1553126400,21,17,38,Clouds
28961,77,1553126400,25,4,29,Clouds
28962,78,1553126400,15,25,40,Clouds
28963,79,1553126400,20,7,27,Clouds
28964,80,1553126400,37,3,40,Clouds
28965,81,1553126400,40,0,40,Clouds
28966,82,1553126400,6,16,22,Clouds
28967,83,1553126400,6,34,40,Clouds
28968,84,1553126400,1,29,30,Clouds
28969,85,1553126400,7,28,35,Clouds
28970,86,1553126400,1,37,38,Clouds
28971,87,1553126400,13,25,38,Clouds
28972,88,1553126400,3,27,30,Clouds
28973,89,1553126400,38,2,40,Clouds
28974,90,1553126400,35,5,40,Clouds
28975,91,1553126400,1,29,30,Clouds
28976,92,1553126400,14,26,40,Clouds
28977,93,1553126400,0,40,40,Clouds
28978,94,1553126400,0,40,40,Clouds
28979,95,1553126400,0,40,40,Clouds
28980,96,1553126400,16,14,30,Clouds
28981,97,1553126400,4,36,40,Clouds
28982,98,1553126400,40,0,40,Clouds
28983,99,1553126400,30,0,30,Clouds
28984,100,1553126400,3,22,25,Clouds
28985,101,1553126400,6,24,30,Clouds
28986,102,1553126400,27,13,40,Clouds
28987,103,1553126400,33,7,40,Clouds
28988,104,1553126400,40,0,40,Clouds
28989,105,1553126400,36,0,36,Clouds
28990,106,1553126400,24,16,40,Clouds
28991,107,1553126400,19,21,40,Clouds
28992,108,1553126400,23,17,40,Clouds
28993,109,1553126400,20,9,29,Clouds
28994,110,1553126400,24,16,40,Clouds
28995,111,1553126400,21,19,40,Clouds
28996,112,1553126400,0,30,30,Clouds
28997,113,1553126400,40,0,40,Clouds
28998,114,1553126400,39,1,40,Clouds
28999,115,1553126400,8,22,30,Clouds
29000,2,1553130000,5,15,20,Clouds
29001,3,1553130000,19,1,20,Clouds
29002,4,1553130000,17,3,20,Clouds
29003,5,1553130000,1,39,40,Clouds
29004,6,1553130000,20,0,20,Clouds
29005,7,1553130000,18,11,29,Clouds
29006,8,1553130000,29,1,30,Clouds
29007,9,1553130000,24,0,24,Clouds
29008,10,1553130000,16,0,16,Clouds
29009,11,1553130000,30,0,30,Clouds
29010,12,1553130000,20,0,20,Clouds
29011,13,1553130000,30,0,30,Clouds
29012,14,1553130000,29,1,30,Clouds
29013,15,1553130000,7,9,16,Clouds
29014,16,1553130000,20,0,20,Clouds
29015,17,1553130000,15,5,20,Clouds
29016,18,1553130000,23,7,30,Clouds
29017,19,1553130000,24,6,30,Clouds
29018,21,1553130000,30,0,30,Clouds
29019,22,1553130000,20,0,20,Clouds
29020,23,1553130000,30,0,30,Clouds
29021,24,1553130000,18,2,20,Clouds
29022,25,1553130000,30,0,30,Clouds
29023,26,1553130000,20,0,20,Clouds
29024,27,1553130000,20,0,20,Clouds
29025,28,1553130000,7,23,30,Clouds
29026,29,1553130000,28,1,29,Clouds
29027,30,1553130000,20,0,20,Clouds
29028,31,1553130000,12,8,20,Clouds
29029,32,1553130000,16,14,30,Clouds
29030,33,1553130000,23,0,23,Clouds
29031,34,1553130000,18,12,30,Clouds
29032,35,1553130000,4,26,30,Clouds
29033,36,1553130000,40,0,40,Clouds
29034,37,1553130000,30,0,30,Clouds
29035,38,1553130000,16,24,40,Clouds
29036,39,1553130000,18,2,20,Clouds
29037,40,1553130000,21,0,21,Clouds
29038,41,1553130000,20,0,20,Clouds
29039,42,1553130000,0,30,30,Clouds
29040,43,1553130000,8,22,30,Clouds
29041,44,1553130000,2,28,30,Clouds
29042,45,1553130000,14,16,30,Clouds
29043,46,1553130000,20,0,20,Clouds
29044,47,1553130000,40,0,40,Clouds
29045,48,1553130000,29,11,40,Clouds
29046,49,1553130000,35,5,40,Clouds
29047,50,1553130000,6,34,40,Clouds
29048,51,1553130000,40,0,40,Clouds
29049,52,1553130000,30,2,32,Clouds
29050,53,1553130000,40,0,40,Clouds
29051,54,1553130000,32,1,33,Clouds
29052,55,1553130000,36,0,36,Clouds
29053,56,1553130000,30,10,40,Clouds
29054,57,1553130000,22,1,23,Clouds
29055,58,1553130000,39,1,40,Clouds
29056,59,1553130000,20,0,20,Clouds
29057,60,1553130000,5,25,30,Clouds
29058,61,1553130000,16,9,25,Clouds
29059,62,1553130000,40,0,40,Clouds
29060,63,1553130000,30,5,35,Clouds
29061,64,1553130000,24,16,40,Clouds
29062,65,1553130000,40,0,40,Clouds
29063,66,1553130000,27,13,40,Clouds
29064,67,1553130000,16,24,40,Clouds
29065,68,1553130000,32,8,40,Clouds
29066,69,1553130000,31,9,40,Clouds
29067,70,1553130000,9,19,28,Clouds
29068,71,1553130000,40,0,40,Clouds
29069,72,1553130000,21,10,31,Clouds
29070,73,1553130000,4,26,30,Clouds
29071,74,1553130000,11,19,30,Clouds
29072,75,1553130000,13,27,40,Clouds
29073,76,1553130000,21,17,38,Clouds
29074,77,1553130000,24,5,29,Clouds
29075,78,1553130000,13,27,40,Clouds
29076,79,1553130000,19,8,27,Clouds
29077,80,1553130000,31,9,40,Clouds
29078,81,1553130000,40,0,40,Clouds
29079,82,1553130000,5,17,22,Clouds
29080,83,1553130000,5,35,40,Clouds
29081,84,1553130000,1,29,30,Clouds
29082,85,1553130000,5,30,35,Clouds
29083,86,1553130000,0,38,38,Clouds
29084,87,1553130000,12,26,38,Clouds
29085,88,1553130000,2,28,30,Clouds
29086,89,1553130000,39,1,40,Clouds
29087,90,1553130000,34,6,40,Clouds
29088,91,1553130000,0,30,30,Clouds
29089,92,1553130000,14,26,40,Clouds
29090,93,1553130000,0,40,40,Clouds
29091,94,1553130000,0,40,40,Clouds
29092,95,1553130000,0,40,40,Clouds
29093,96,1553130000,15,15,30,Clouds
29094,97,1553130000,1,39,40,Clouds
29095,98,1553130000,39,1,40,Clouds
29096,99,1553130000,30,0,30,Clouds
29097,100,1553130000,4,21,25,Clouds
29098,101,1553130000,5,25,30,Clouds
29099,102,1553130000,26,14,40,Clouds
29100,103,1553130000,34,6,40,Clouds
29101,104,1553130000,40,0,40,Clouds
29102,105,1553130000,36,0,36,Clouds
29103,106,1553130000,23,17,40,Clouds
29104,107,1553130000,18,22,40,Clouds
29105,108,1553130000,23,17,40,Clouds
29106,109,1553130000,19,10,29,Clouds
29107,110,1553130000,25,15,40,Clouds
29108,111,1553130000,14,26,40,Clouds
29109,112,1553130000,5,25,30,Clouds
29110,113,1553130000,40,0,40,Clouds
29111,114,1553130000,40,0,40,Clouds
29112,115,1553130000,4,26,30,Clouds
29113,2,1553133600,5,15,20,Clouds
29114,3,1553133600,19,1,20,Clouds
29115,4,1553133600,18,2,20,Clouds
29116,5,1553133600,0,40,40,Clouds
29117,6,1553133600,20,0,20,Clouds
29118,7,1553133600,20,9,29,Clouds
29119,8,1553133600,30,0,30,Clouds
29120,9,1553133600,24,0,24,Clouds
29121,10,1553133600,15,1,16,Clouds
29122,11,1553133600,30,0,30,Clouds
29123,12,1553133600,20,0,20,Clouds
29124,13,1553133600,30,0,30,Clouds
29125,14,1553133600,30,0,30,Clouds
29126,15,1553133600,5,11,16,Clouds
29127,16,1553133600,20,0,20,Clouds
29128,17,1553133600,15,5,20,Clouds
29129,18,1553133600,23,7,30,Clouds
29130,19,1553133600,25,5,30,Clouds
29131,21,1553133600,30,0,30,Clouds
29132,22,1553133600,20,0,20,Clouds
29133,23,1553133600,30,0,30,Clouds
29134,24,1553133600,20,0,20,Clouds
29135,25,1553133600,30,0,30,Clouds
29136,26,1553133600,20,0,20,Clouds
29137,27,1553133600,20,0,20,Clouds
29138,28,1553133600,7,23,30,Clouds
29139,29,1553133600,28,1,29,Clouds
29140,30,1553133600,19,1,20,Clouds
29141,31,1553133600,15,5,20,Clouds
29142,32,1553133600,17,13,30,Clouds
29143,33,1553133600,22,1,23,Clouds
29144,34,1553133600,19,11,30,Clouds
29145,35,1553133600,4,26,30,Clouds
29146,36,1553133600,40,0,40,Clouds
29147,37,1553133600,30,0,30,Clouds
29148,38,1553133600,20,20,40,Clouds
29149,39,1553133600,18,2,20,Clouds
29150,40,1553133600,21,0,21,Clouds
29151,41,1553133600,19,1,20,Clouds
29152,42,1553133600,0,30,30,Clouds
29153,43,1553133600,7,23,30,Clouds
29154,44,1553133600,2,28,30,Clouds
29155,45,1553133600,15,15,30,Clouds
29156,46,1553133600,20,0,20,Clouds
29157,47,1553133600,40,0,40,Clouds
29158,48,1553133600,29,11,40,Clouds
29159,49,1553133600,37,3,40,Clouds
29160,50,1553133600,6,34,40,Clouds
29161,51,1553133600,40,0,40,Clouds
29162,52,1553133600,30,2,32,Clouds
29163,53,1553133600,40,0,40,Clouds
29164,54,1553133600,32,1,33,Clouds
29165,55,1553133600,36,0,36,Clouds
29166,56,1553133600,30,10,40,Clouds
29167,57,1553133600,22,1,23,Clouds
29168,58,1553133600,39,1,40,Clouds
29169,59,1553133600,19,1,20,Clouds
29170,60,1553133600,4,26,30,Clouds
29171,61,1553133600,16,9,25,Clouds
29172,62,1553133600,40,0,40,Clouds
29173,63,1553133600,30,5,35,Clouds
29174,64,1553133600,25,15,40,Clouds
29175,65,1553133600,40,0,40,Clouds
29176,66,1553133600,27,13,40,Clouds
29177,67,1553133600,16,24,40,Clouds
29178,68,1553133600,32,8,40,Clouds
29179,69,1553133600,30,10,40,Clouds
29180,70,1553133600,5,23,28,Clouds
29181,71,1553133600,40,0,40,Clouds
29182,72,1553133600,20,11,31,Clouds
29183,73,1553133600,5,25,30,Clouds
29184,74,1553133600,11,19,30,Clouds
29185,75,1553133600,12,28,40,Clouds
29186,76,1553133600,21,17,38,Clouds
29187,77,1553133600,24,5,29,Clouds
29188,78,1553133600,14,26,40,Clouds
29189,79,1553133600,19,8,27,Clouds
29190,80,1553133600,30,10,40,Clouds
29191,81,1553133600,37,3,40,Clouds
29192,82,1553133600,5,17,22,Clouds
29193,83,1553133600,5,35,40,Clouds
29194,84,1553133600,0,30,30,Clouds
29195,85,1553133600,3,32,35,Clouds
29196,86,1553133600,0,38,38,Clouds
29197,87,1553133600,12,26,38,Clouds
29198,88,1553133600,3,27,30,Clouds
29199,89,1553133600,39,1,40,Clouds
29200,90,1553133600,34,6,40,Clouds
29201,91,1553133600,0,30,30,Clouds
29202,92,1553133600,14,26,40,Clouds
29203,93,1553133600,0,40,40,Clouds
29204,94,1553133600,0,40,40,Clouds
29205,95,1553133600,1,39,40,Clouds
29206,96,1553133600,15,15,30,Clouds
29207,97,1553133600,0,40,40,Clouds
29208,98,1553133600,40,0,40,Clouds
29209,99,1553133600,30,0,30,Clouds
29210,100,1553133600,4,21,25,Clouds
29211,101,1553133600,5,25,30,Clouds
29212,102,1553133600,26,14,40,Clouds
29213,103,1553133600,34,6,40,Clouds
29214,104,1553133600,40,0,40,Clouds
29215,105,1553133600,36,0,36,Clouds
29216,106,1553133600,23,17,40,Clouds
29217,107,1553133600,18,22,40,Clouds
29218,108,1553133600,23,17,40,Clouds
29219,109,1553133600,19,10,29,Clouds
29220,110,1553133600,25,15,40,Clouds
29221,111,1553133600,12,28,40,Clouds
29222,112,1553133600,1,29,30,Clouds
29223,113,1553133600,40,0,40,Clouds
29224,114,1553133600,40,0,40,Clouds
29225,115,1553133600,3,27,30,Clouds
29226,2,1553137200,5,15,20,Clouds
29227,3,1553137200,19,1,20,Clouds
29228,4,1553137200,18,2,20,Clouds
29229,5,1553137200,0,40,40,Clouds
29230,6,1553137200,20,0,20,Clouds
29231,7,1553137200,20,9,29,Clouds
29232,8,1553137200,30,0,30,Clouds
29233,9,1553137200,24,0,24,Clouds
29234,10,1553137200,15,1,16,Clouds
29235,11,1553137200,30,0,30,Clouds
29236,12,1553137200,20,0,20,Clouds
29237,13,1553137200,30,0,30,Clouds
29238,14,1553137200,30,0,30,Clouds
29239,15,1553137200,5,11,16,Clouds
29240,16,1553137200,20,0,20,Clouds
29241,17,1553137200,15,5,20,Clouds
29242,18,1553137200,23,7,30,Clouds
29243,19,1553137200,25,5,30,Clouds
29244,21,1553137200,30,0,30,Clouds
29245,22,1553137200,20,0,20,Clouds
29246,23,1553137200,30,0,30,Clouds
29247,24,1553137200,20,0,20,Clouds
29248,25,1553137200,30,0,30,Clouds
29249,26,1553137200,20,0,20,Clouds
29250,27,1553137200,20,0,20,Clouds
29251,28,1553137200,6,24,30,Clouds
29252,29,1553137200,28,1,29,Clouds
29253,30,1553137200,19,1,20,Clouds
29254,31,1553137200,15,5,20,Clouds
29255,32,1553137200,17,13,30,Clouds
29256,33,1553137200,22,1,23,Clouds
29257,34,1553137200,19,11,30,Clouds
29258,35,1553137200,4,26,30,Clouds
29259,36,1553137200,40,0,40,Clouds
29260,37,1553137200,30,0,30,Clouds
29261,38,1553137200,20,20,40,Clouds
29262,39,1553137200,18,2,20,Clouds
29263,40,1553137200,21,0,21,Clouds
29264,41,1553137200,19,1,20,Clouds
29265,42,1553137200,0,30,30,Clouds
29266,43,1553137200,7,23,30,Clouds
29267,44,1553137200,1,29,30,Clouds
29268,45,1553137200,15,15,30,Clouds
29269,46,1553137200,20,0,20,Clouds
29270,47,1553137200,40,0,40,Clouds
29271,48,1553137200,29,11,40,Clouds
29272,49,1553137200,37,3,40,Clouds
29273,50,1553137200,6,34,40,Clouds
29274,51,1553137200,40,0,40,Clouds
29275,52,1553137200,30,2,32,Clouds
29276,53,1553137200,40,0,40,Clouds
29277,54,1553137200,32,1,33,Clouds
29278,55,1553137200,36,0,36,Clouds
29279,56,1553137200,30,10,40,Clouds
29280,57,1553137200,22,1,23,Clouds
29281,58,1553137200,39,1,40,Clouds
29282,59,1553137200,19,1,20,Clouds
29283,60,1553137200,4,26,30,Clouds
29284,61,1553137200,16,9,25,Clouds
29285,62,1553137200,40,0,40,Clouds
29286,63,1553137200,30,5,35,Clouds
29287,64,1553137200,25,15,40,Clouds
29288,65,1553137200,40,0,40,Clouds
29289,66,1553137200,27,13,40,Clouds
29290,67,1553137200,16,24,40,Clouds
29291,68,1553137200,32,8,40,Clouds
29292,69,1553137200,30,10,40,Clouds
29293,70,1553137200,5,23,28,Clouds
29294,71,1553137200,40,0,40,Clouds
29295,72,1553137200,20,11,31,Clouds
29296,73,1553137200,5,25,30,Clouds
29297,74,1553137200,10,20,30,Clouds
29298,75,1553137200,12,28,40,Clouds
29299,76,1553137200,21,17,38,Clouds
29300,77,1553137200,24,5,29,Clouds
29301,78,1553137200,14,26,40,Clouds
29302,79,1553137200,19,8,27,Clouds
29303,80,1553137200,30,10,40,Clouds
29304,81,1553137200,37,3,40,Clouds
29305,82,1553137200,5,17,22,Clouds
29306,83,1553137200,5,35,40,Clouds
29307,84,1553137200,0,30,30,Clouds
29308,85,1553137200,3,32,35,Clouds
29309,86,1553137200,0,38,38,Clouds
29310,87,1553137200,12,26,38,Clouds
29311,88,1553137200,3,27,30,Clouds
29312,89,1553137200,39,1,40,Clouds
29313,90,1553137200,34,6,40,Clouds
29314,91,1553137200,0,30,30,Clouds
29315,92,1553137200,14,26,40,Clouds
29316,93,1553137200,0,40,40,Clouds
29317,94,1553137200,0,40,40,Clouds
29318,95,1553137200,1,39,40,Clouds
29319,96,1553137200,15,15,30,Clouds
29320,97,1553137200,0,40,40,Clouds
29321,98,1553137200,40,0,40,Clouds
29322,99,1553137200,30,0,30,Clouds
29323,100,1553137200,4,21,25,Clouds
29324,101,1553137200,5,25,30,Clouds
29325,102,1553137200,26,14,40,Clouds
29326,103,1553137200,34,6,40,Clouds
29327,104,1553137200,40,0,40,Clouds
29328,105,1553137200,36,0,36,Clouds
29329,106,1553137200,23,17,40,Clouds
29330,107,1553137200,18,22,40,Clouds
29331,108,1553137200,23,17,40,Clouds
29332,109,1553137200,19,10,29,Clouds
29333,110,1553137200,25,15,40,Clouds
29334,111,1553137200,12,28,40,Clouds
29335,112,1553137200,1,29,30,Clouds
29336,113,1553137200,40,0,40,Clouds
29337,114,1553137200,40,0,40,Clouds
29338,115,1553137200,3,27,30,Clouds
29339,2,1553140800,5,15,20,Clouds
29340,3,1553140800,19,1,20,Clouds
29341,4,1553140800,18,2,20,Clouds
29342,5,1553140800,0,40,40,Clouds
29343,6,1553140800,20,0,20,Clouds
29344,7,1553140800,20,9,29,Clouds
29345,8,1553140800,30,0,30,Clouds
29346,9,1553140800,24,0,24,Clouds
29347,10,1553140800,15,1,16,Clouds
29348,11,1553140800,30,0,30,Clouds
29349,12,1553140800,20,0,20,Clouds
29350,13,1553140800,30,0,30,Clouds
29351,14,1553140800,30,0,30,Clouds
29352,15,1553140800,5,11,16,Clouds
29353,16,1553140800,20,0,20,Clouds
29354,17,1553140800,15,5,20,Clouds
29355,18,1553140800,23,7,30,Clouds
29356,19,1553140800,25,5,30,Clouds
29357,21,1553140800,30,0,30,Clouds
29358,22,1553140800,20,0,20,Clouds
29359,23,1553140800,30,0,30,Clouds
29360,24,1553140800,20,0,20,Clouds
29361,25,1553140800,30,0,30,Clouds
29362,26,1553140800,20,0,20,Clouds
29363,27,1553140800,20,0,20,Clouds
29364,28,1553140800,6,24,30,Clouds
29365,29,1553140800,28,1,29,Clouds
29366,30,1553140800,19,1,20,Clouds
29367,31,1553140800,15,5,20,Clouds
29368,32,1553140800,17,13,30,Clouds
29369,33,1553140800,22,1,23,Clouds
29370,34,1553140800,19,11,30,Clouds
29371,35,1553140800,4,26,30,Clouds
29372,36,1553140800,40,0,40,Clouds
29373,37,1553140800,30,0,30,Clouds
29374,38,1553140800,20,20,40,Clouds
29375,39,1553140800,18,2,20,Clouds
29376,40,1553140800,21,0,21,Clouds
29377,41,1553140800,19,1,20,Clouds
29378,42,1553140800,0,30,30,Clouds
29379,43,1553140800,7,23,30,Clouds
29380,44,1553140800,1,29,30,Clouds
29381,45,1553140800,15,15,30,Clouds
29382,46,1553140800,20,0,20,Clouds
29383,47,1553140800,40,0,40,Clouds
29384,48,1553140800,29,11,40,Clouds
29385,49,1553140800,37,3,40,Clouds
29386,50,1553140800,6,34,40,Clouds
29387,51,1553140800,40,0,40,Clouds
29388,52,1553140800,30,2,32,Clouds
29389,53,1553140800,40,0,40,Clouds
29390,54,1553140800,32,1,33,Clouds
29391,55,1553140800,36,0,36,Clouds
29392,56,1553140800,30,10,40,Clouds
29393,57,1553140800,22,1,23,Clouds
29394,58,1553140800,39,1,40,Clouds
29395,59,1553140800,19,1,20,Clouds
29396,60,1553140800,4,26,30,Clouds
29397,61,1553140800,16,9,25,Clouds
29398,62,1553140800,40,0,40,Clouds
29399,63,1553140800,30,5,35,Clouds
29400,64,1553140800,25,15,40,Clouds
29401,65,1553140800,40,0,40,Clouds
29402,66,1553140800,27,13,40,Clouds
29403,67,1553140800,16,24,40,Clouds
29404,68,1553140800,32,8,40,Clouds
29405,69,1553140800,30,10,40,Clouds
29406,70,1553140800,5,23,28,Clouds
29407,71,1553140800,40,0,40,Clouds
29408,72,1553140800,20,11,31,Clouds
29409,73,1553140800,5,25,30,Clouds
29410,74,1553140800,10,20,30,Clouds
29411,75,1553140800,12,28,40,Clouds
29412,76,1553140800,21,17,38,Clouds
29413,77,1553140800,24,5,29,Clouds
29414,78,1553140800,14,26,40,Clouds
29415,79,1553140800,19,8,27,Clouds
29416,80,1553140800,30,10,40,Clouds
29417,81,1553140800,37,3,40,Clouds
29418,82,1553140800,5,17,22,Clouds
29419,83,1553140800,5,35,40,Clouds
29420,84,1553140800,0,30,30,Clouds
29421,85,1553140800,3,32,35,Clouds
29422,86,1553140800,0,38,38,Clouds
29423,87,1553140800,12,26,38,Clouds
29424,88,1553140800,3,27,30,Clouds
29425,89,1553140800,39,1,40,Clouds
29426,90,1553140800,34,6,40,Clouds
29427,91,1553140800,0,30,30,Clouds
29428,92,1553140800,14,26,40,Clouds
29429,93,1553140800,0,40,40,Clouds
29430,94,1553140800,0,40,40,Clouds
29431,95,1553140800,1,39,40,Clouds
29432,96,1553140800,15,15,30,Clouds
29433,97,1553140800,0,40,40,Clouds
29434,98,1553140800,40,0,40,Clouds
29435,99,1553140800,30,0,30,Clouds
29436,100,1553140800,4,21,25,Clouds
29437,101,1553140800,5,25,30,Clouds
29438,102,1553140800,26,14,40,Clouds
29439,103,1553140800,34,6,40,Clouds
29440,104,1553140800,40,0,40,Clouds
29441,105,1553140800,36,0,36,Clouds
29442,106,1553140800,23,17,40,Clouds
29443,107,1553140800,18,22,40,Clouds
29444,108,1553140800,23,17,40,Clouds
29445,109,1553140800,19,10,29,Clouds
29446,110,1553140800,25,15,40,Clouds
29447,111,1553140800,12,28,40,Clouds
29448,112,1553140800,1,29,30,Clouds
29449,113,1553140800,40,0,40,Clouds
29450,114,1553140800,40,0,40,Clouds
29451,115,1553140800,3,27,30,Clouds
29452,2,1553144400,5,15,20,Drizzle
29453,3,1553144400,19,1,20,Drizzle
29454,4,1553144400,18,2,20,Drizzle
29455,5,1553144400,0,40,40,Drizzle
29456,6,1553144400,20,0,20,Drizzle
29457,7,1553144400,20,9,29,Drizzle
29458,8,1553144400,30,0,30,Drizzle
29459,9,1553144400,24,0,24,Drizzle
29460,10,1553144400,15,1,16,Drizzle
29461,11,1553144400,30,0,30,Drizzle
29462,12,1553144400,20,0,20,Drizzle
29463,13,1553144400,30,0,30,Drizzle
29464,14,1553144400,30,0,30,Drizzle
29465,15,1553144400,5,11,16,Drizzle
29466,16,1553144400,20,0,20,Drizzle
29467,17,1553144400,15,5,20,Drizzle
29468,18,1553144400,23,7,30,Drizzle
29469,19,1553144400,25,5,30,Drizzle
29470,21,1553144400,30,0,30,Drizzle
29471,22,1553144400,20,0,20,Drizzle
29472,23,1553144400,30,0,30,Drizzle
29473,24,1553144400,20,0,20,Drizzle
29474,25,1553144400,30,0,30,Drizzle
29475,26,1553144400,20,0,20,Drizzle
29476,27,1553144400,20,0,20,Drizzle
29477,28,1553144400,6,24,30,Drizzle
29478,29,1553144400,28,1,29,Drizzle
29479,30,1553144400,19,1,20,Drizzle
29480,31,1553144400,15,5,20,Drizzle
29481,32,1553144400,17,13,30,Drizzle
29482,33,1553144400,22,1,23,Drizzle
29483,34,1553144400,19,11,30,Drizzle
29484,35,1553144400,4,26,30,Drizzle
29485,36,1553144400,40,0,40,Drizzle
29486,37,1553144400,30,0,30,Drizzle
29487,38,1553144400,20,20,40,Drizzle
29488,39,1553144400,18,2,20,Drizzle
29489,40,1553144400,21,0,21,Drizzle
29490,41,1553144400,19,1,20,Drizzle
29491,42,1553144400,0,30,30,Drizzle
29492,43,1553144400,7,23,30,Drizzle
29493,44,1553144400,1,29,30,Drizzle
29494,45,1553144400,15,15,30,Drizzle
29495,46,1553144400,20,0,20,Drizzle
29496,47,1553144400,40,0,40,Drizzle
29497,48,1553144400,29,11,40,Drizzle
29498,49,1553144400,37,3,40,Drizzle
29499,50,1553144400,6,34,40,Drizzle
29500,51,1553144400,40,0,40,Drizzle
29501,52,1553144400,30,2,32,Drizzle
29502,53,1553144400,40,0,40,Drizzle
29503,54,1553144400,32,1,33,Drizzle
29504,55,1553144400,36,0,36,Drizzle
29505,56,1553144400,30,10,40,Drizzle
29506,57,1553144400,22,1,23,Drizzle
29507,58,1553144400,39,1,40,Drizzle
29508,59,1553144400,19,1,20,Drizzle
29509,60,1553144400,4,26,30,Drizzle
29510,61,1553144400,16,9,25,Drizzle
29511,62,1553144400,40,0,40,Drizzle
29512,63,1553144400,30,5,35,Drizzle
29513,64,1553144400,25,15,40,Drizzle
29514,65,1553144400,40,0,40,Drizzle
29515,66,1553144400,27,13,40,Drizzle
29516,67,1553144400,16,24,40,Drizzle
29517,68,1553144400,32,8,40,Drizzle
29518,69,1553144400,30,10,40,Drizzle
29519,70,1553144400,5,23,28,Drizzle
29520,72,1553144400,20,11,31,Drizzle
29521,73,1553144400,5,25,30,Drizzle
29522,74,1553144400,10,20,30,Drizzle
29523,75,1553144400,12,28,40,Drizzle
29524,76,1553144400,21,17,38,Drizzle
29525,77,1553144400,24,5,29,Drizzle
29526,78,1553144400,14,26,40,Drizzle
29527,79,1553144400,19,8,27,Drizzle
29528,80,1553144400,30,10,40,Drizzle
29529,81,1553144400,37,3,40,Drizzle
29530,82,1553144400,5,17,22,Drizzle
29531,83,1553144400,5,35,40,Drizzle
29532,84,1553144400,0,30,30,Drizzle
29533,85,1553144400,3,32,35,Drizzle
29534,86,1553144400,0,38,38,Drizzle
29535,87,1553144400,12,26,38,Drizzle
29536,88,1553144400,3,27,30,Drizzle
29537,89,1553144400,39,1,40,Drizzle
29538,90,1553144400,34,6,40,Drizzle
29539,91,1553144400,0,30,30,Drizzle
29540,92,1553144400,14,26,40,Drizzle
29541,93,1553144400,0,40,40,Drizzle
29542,94,1553144400,0,40,40,Drizzle
29543,95,1553144400,1,39,40,Drizzle
29544,96,1553144400,15,15,30,Drizzle
29545,97,1553144400,0,40,40,Drizzle
29546,98,1553144400,40,0,40,Drizzle
29547,99,1553144400,30,0,30,Drizzle
29548,100,1553144400,4,21,25,Drizzle
29549,101,1553144400,5,25,30,Drizzle
29550,102,1553144400,26,14,40,Drizzle
29551,103,1553144400,34,6,40,Drizzle
29552,104,1553144400,40,0,40,Drizzle
29553,105,1553144400,36,0,36,Drizzle
29554,106,1553144400,23,17,40,Drizzle
29555,107,1553144400,18,22,40,Drizzle
29556,108,1553144400,23,17,40,Drizzle
29557,109,1553144400,19,10,29,Drizzle
29558,110,1553144400,25,15,40,Drizzle
29559,111,1553144400,12,28,40,Drizzle
29560,112,1553144400,1,29,30,Drizzle
29561,113,1553144400,40,0,40,Drizzle
29562,114,1553144400,40,0,40,Drizzle
29563,115,1553144400,3,27,30,Drizzle
29564,2,1553148000,5,15,20,Clouds
29565,3,1553148000,19,1,20,Clouds
29566,4,1553148000,18,2,20,Clouds
29567,5,1553148000,0,40,40,Clouds
29568,6,1553148000,20,0,20,Clouds
29569,7,1553148000,20,9,29,Clouds
29570,8,1553148000,30,0,30,Clouds
29571,9,1553148000,24,0,24,Clouds
29572,10,1553148000,15,1,16,Clouds
29573,11,1553148000,30,0,30,Clouds
29574,12,1553148000,20,0,20,Clouds
29575,13,1553148000,30,0,30,Clouds
29576,14,1553148000,30,0,30,Clouds
29577,15,1553148000,5,11,16,Clouds
29578,16,1553148000,20,0,20,Clouds
29579,17,1553148000,15,5,20,Clouds
29580,18,1553148000,23,7,30,Clouds
29581,19,1553148000,25,5,30,Clouds
29582,21,1553148000,30,0,30,Clouds
29583,22,1553148000,20,0,20,Clouds
29584,23,1553148000,30,0,30,Clouds
29585,24,1553148000,20,0,20,Clouds
29586,25,1553148000,30,0,30,Clouds
29587,26,1553148000,20,0,20,Clouds
29588,27,1553148000,20,0,20,Clouds
29589,28,1553148000,6,24,30,Clouds
29590,29,1553148000,28,1,29,Clouds
29591,30,1553148000,19,1,20,Clouds
29592,31,1553148000,15,5,20,Clouds
29593,32,1553148000,17,13,30,Clouds
29594,33,1553148000,19,4,23,Clouds
29595,34,1553148000,19,11,30,Clouds
29596,35,1553148000,4,26,30,Clouds
29597,36,1553148000,40,0,40,Clouds
29598,37,1553148000,30,0,30,Clouds
29599,38,1553148000,20,20,40,Clouds
29600,39,1553148000,18,2,20,Clouds
29601,40,1553148000,21,0,21,Clouds
29602,41,1553148000,19,1,20,Clouds
29603,42,1553148000,0,30,30,Clouds
29604,43,1553148000,7,23,30,Clouds
29605,44,1553148000,1,29,30,Clouds
29606,45,1553148000,15,15,30,Clouds
29607,46,1553148000,20,0,20,Clouds
29608,47,1553148000,40,0,40,Clouds
29609,48,1553148000,29,11,40,Clouds
29610,49,1553148000,37,3,40,Clouds
29611,50,1553148000,6,34,40,Clouds
29612,51,1553148000,40,0,40,Clouds
29613,52,1553148000,30,2,32,Clouds
29614,53,1553148000,40,0,40,Clouds
29615,54,1553148000,32,1,33,Clouds
29616,55,1553148000,36,0,36,Clouds
29617,56,1553148000,30,10,40,Clouds
29618,57,1553148000,22,1,23,Clouds
29619,58,1553148000,39,1,40,Clouds
29620,59,1553148000,19,1,20,Clouds
29621,60,1553148000,4,26,30,Clouds
29622,61,1553148000,16,9,25,Clouds
29623,62,1553148000,40,0,40,Clouds
29624,63,1553148000,30,5,35,Clouds
29625,64,1553148000,25,15,40,Clouds
29626,65,1553148000,40,0,40,Clouds
29627,66,1553148000,27,13,40,Clouds
29628,67,1553148000,16,24,40,Clouds
29629,68,1553148000,32,8,40,Clouds
29630,69,1553148000,30,10,40,Clouds
29631,70,1553148000,5,23,28,Clouds
29632,72,1553148000,20,11,31,Clouds
29633,73,1553148000,5,25,30,Clouds
29634,74,1553148000,10,20,30,Clouds
29635,75,1553148000,12,28,40,Clouds
29636,76,1553148000,21,17,38,Clouds
29637,77,1553148000,24,5,29,Clouds
29638,78,1553148000,14,26,40,Clouds
29639,79,1553148000,19,8,27,Clouds
29640,80,1553148000,31,9,40,Clouds
29641,81,1553148000,37,3,40,Clouds
29642,82,1553148000,5,17,22,Clouds
29643,83,1553148000,5,35,40,Clouds
29644,84,1553148000,0,30,30,Clouds
29645,85,1553148000,3,32,35,Clouds
29646,86,1553148000,0,38,38,Clouds
29647,87,1553148000,12,26,38,Clouds
29648,88,1553148000,3,27,30,Clouds
29649,89,1553148000,39,1,40,Clouds
29650,90,1553148000,34,6,40,Clouds
29651,91,1553148000,0,30,30,Clouds
29652,92,1553148000,14,26,40,Clouds
29653,93,1553148000,0,40,40,Clouds
29654,94,1553148000,0,40,40,Clouds
29655,95,1553148000,1,39,40,Clouds
29656,96,1553148000,15,15,30,Clouds
29657,97,1553148000,0,40,40,Clouds
29658,99,1553148000,30,0,30,Clouds
29659,100,1553148000,4,21,25,Clouds
29660,101,1553148000,5,25,30,Clouds
29661,102,1553148000,26,14,40,Clouds
29662,103,1553148000,34,6,40,Clouds
29663,104,1553148000,40,0,40,Clouds
29664,105,1553148000,36,0,36,Clouds
29665,106,1553148000,23,17,40,Clouds
29666,107,1553148000,18,22,40,Clouds
29667,108,1553148000,23,17,40,Clouds
29668,109,1553148000,19,10,29,Clouds
29669,110,1553148000,25,15,40,Clouds
29670,111,1553148000,12,28,40,Clouds
29671,112,1553148000,1,29,30,Clouds
29672,113,1553148000,40,0,40,Clouds
29673,114,1553148000,40,0,40,Clouds
29674,115,1553148000,3,27,30,Clouds
29675,2,1553151600,6,14,20,Drizzle
29676,3,1553151600,19,1,20,Drizzle
29677,4,1553151600,18,2,20,Drizzle
29678,5,1553151600,2,38,40,Drizzle
29679,6,1553151600,20,0,20,Drizzle
29680,7,1553151600,22,7,29,Drizzle
29681,8,1553151600,28,2,30,Drizzle
29682,9,1553151600,21,3,24,Drizzle
29683,10,1553151600,16,0,16,Drizzle
29684,11,1553151600,30,0,30,Drizzle
29685,12,1553151600,4,16,20,Drizzle
29686,13,1553151600,30,0,30,Drizzle
29687,14,1553151600,24,6,30,Drizzle
29688,15,1553151600,5,11,16,Drizzle
29689,16,1553151600,20,0,20,Drizzle
29690,17,1553151600,17,3,20,Drizzle
29691,18,1553151600,24,6,30,Drizzle
29692,19,1553151600,24,6,30,Drizzle
29693,21,1553151600,27,3,30,Drizzle
29694,22,1553151600,20,0,20,Drizzle
29695,23,1553151600,30,0,30,Drizzle
29696,24,1553151600,14,6,20,Drizzle
29697,25,1553151600,30,0,30,Drizzle
29698,26,1553151600,20,0,20,Drizzle
29699,27,1553151600,20,0,20,Drizzle
29700,28,1553151600,8,22,30,Drizzle
29701,29,1553151600,27,2,29,Drizzle
29702,30,1553151600,19,1,20,Drizzle
29703,31,1553151600,17,3,20,Drizzle
29704,32,1553151600,26,4,30,Drizzle
29705,33,1553151600,12,11,23,Drizzle
29706,34,1553151600,4,26,30,Drizzle
29707,35,1553151600,8,22,30,Drizzle
29708,36,1553151600,39,1,40,Drizzle
29709,37,1553151600,30,0,30,Drizzle
29710,38,1553151600,22,18,40,Drizzle
29711,39,1553151600,18,2,20,Drizzle
29712,40,1553151600,20,1,21,Drizzle
29713,41,1553151600,19,1,20,Drizzle
29714,42,1553151600,1,29,30,Drizzle
29715,43,1553151600,13,17,30,Drizzle
29716,44,1553151600,6,24,30,Drizzle
29717,45,1553151600,16,14,30,Drizzle
29718,46,1553151600,20,0,20,Drizzle
29719,47,1553151600,40,0,40,Drizzle
29720,48,1553151600,27,13,40,Drizzle
29721,49,1553151600,31,9,40,Drizzle
29722,50,1553151600,10,30,40,Drizzle
29723,51,1553151600,39,1,40,Drizzle
29724,52,1553151600,22,10,32,Drizzle
29725,53,1553151600,39,1,40,Drizzle
29726,54,1553151600,32,1,33,Drizzle
29727,55,1553151600,35,1,36,Drizzle
29728,56,1553151600,32,8,40,Drizzle
29729,57,1553151600,21,2,23,Drizzle
29730,58,1553151600,38,2,40,Drizzle
29731,59,1553151600,19,1,20,Drizzle
29732,60,1553151600,8,22,30,Drizzle
29733,61,1553151600,17,8,25,Drizzle
29734,62,1553151600,38,2,40,Drizzle
29735,63,1553151600,29,6,35,Drizzle
29736,64,1553151600,31,9,40,Drizzle
29737,65,1553151600,40,0,40,Drizzle
29738,66,1553151600,24,16,40,Drizzle
29739,67,1553151600,33,7,40,Drizzle
29740,68,1553151600,30,10,40,Drizzle
29741,69,1553151600,24,16,40,Drizzle
29742,70,1553151600,3,25,28,Drizzle
29743,72,1553151600,20,11,31,Drizzle
29744,73,1553151600,5,25,30,Drizzle
29745,74,1553151600,11,19,30,Drizzle
29746,75,1553151600,13,27,40,Drizzle
29747,76,1553151600,23,15,38,Drizzle
29748,77,1553151600,23,6,29,Drizzle
29749,78,1553151600,16,24,40,Drizzle
29750,79,1553151600,18,9,27,Drizzle
29751,80,1553151600,33,7,40,Drizzle
29752,81,1553151600,37,3,40,Drizzle
29753,82,1553151600,6,16,22,Drizzle
29754,83,1553151600,7,33,40,Drizzle
29755,84,1553151600,6,24,30,Drizzle
29756,85,1553151600,3,32,35,Drizzle
29757,86,1553151600,1,37,38,Drizzle
29758,87,1553151600,12,26,38,Drizzle
29759,88,1553151600,4,26,30,Drizzle
29760,89,1553151600,39,1,40,Drizzle
29761,90,1553151600,34,6,40,Drizzle
29762,91,1553151600,18,12,30,Drizzle
29763,92,1553151600,17,23,40,Drizzle
29764,93,1553151600,0,40,40,Drizzle
29765,94,1553151600,0,40,40,Drizzle
29766,95,1553151600,2,38,40,Drizzle
29767,96,1553151600,15,15,30,Drizzle
29768,97,1553151600,2,38,40,Drizzle
29769,99,1553151600,29,1,30,Drizzle
29770,100,1553151600,4,21,25,Drizzle
29771,101,1553151600,9,21,30,Drizzle
29772,102,1553151600,26,14,40,Drizzle
29773,103,1553151600,35,5,40,Drizzle
29774,104,1553151600,40,0,40,Drizzle
29775,105,1553151600,36,0,36,Drizzle
29776,106,1553151600,23,17,40,Drizzle
29777,107,1553151600,24,16,40,Drizzle
29778,108,1553151600,25,15,40,Drizzle
29779,109,1553151600,24,5,29,Drizzle
29780,110,1553151600,25,15,40,Drizzle
29781,111,1553151600,11,29,40,Drizzle
29782,112,1553151600,4,26,30,Drizzle
29783,113,1553151600,40,0,40,Drizzle
29784,114,1553151600,40,0,40,Drizzle
29785,115,1553151600,5,25,30,Drizzle
29786,2,1553155200,16,4,20,Clouds
29787,3,1553155200,20,0,20,Clouds
29788,4,1553155200,16,4,20,Clouds
29789,5,1553155200,18,22,40,Clouds
29790,6,1553155200,20,0,20,Clouds
29791,7,1553155200,23,6,29,Clouds
29792,8,1553155200,25,5,30,Clouds
29793,9,1553155200,9,15,24,Clouds
29794,10,1553155200,16,0,16,Clouds
29795,11,1553155200,26,4,30,Clouds
29796,12,1553155200,15,5,20,Clouds
29797,13,1553155200,28,2,30,Clouds
29798,14,1553155200,23,7,30,Clouds
29799,15,1553155200,7,9,16,Clouds
29800,16,1553155200,20,0,20,Clouds
29801,17,1553155200,17,3,20,Clouds
29802,18,1553155200,3,27,30,Clouds
29803,19,1553155200,15,15,30,Clouds
29804,21,1553155200,25,5,30,Clouds
29805,22,1553155200,17,3,20,Clouds
29806,23,1553155200,22,8,30,Clouds
29807,24,1553155200,15,5,20,Clouds
29808,25,1553155200,23,7,30,Clouds
29809,26,1553155200,16,4,20,Clouds
29810,27,1553155200,11,9,20,Clouds
29811,28,1553155200,15,15,30,Clouds
29812,29,1553155200,26,3,29,Clouds
29813,30,1553155200,16,4,20,Clouds
29814,31,1553155200,16,4,20,Clouds
29815,32,1553155200,24,6,30,Clouds
29816,33,1553155200,10,13,23,Clouds
29817,34,1553155200,28,2,30,Clouds
29818,35,1553155200,22,8,30,Clouds
29819,36,1553155200,38,2,40,Clouds
29820,37,1553155200,29,1,30,Clouds
29821,38,1553155200,15,25,40,Clouds
29822,39,1553155200,19,1,20,Clouds
29823,40,1553155200,17,4,21,Clouds
29824,41,1553155200,20,0,20,Clouds
29825,42,1553155200,9,21,30,Clouds
29826,43,1553155200,26,4,30,Clouds
29827,44,1553155200,19,11,30,Clouds
29828,45,1553155200,21,9,30,Clouds
29829,46,1553155200,18,2,20,Clouds
29830,47,1553155200,37,3,40,Clouds
29831,48,1553155200,29,11,40,Clouds
29832,49,1553155200,28,12,40,Clouds
29833,50,1553155200,12,28,40,Clouds
29834,51,1553155200,35,5,40,Clouds
29835,52,1553155200,29,3,32,Clouds
29836,53,1553155200,40,0,40,Clouds
29837,54,1553155200,29,4,33,Clouds
29838,55,1553155200,33,3,36,Clouds
29839,56,1553155200,37,3,40,Clouds
29840,57,1553155200,23,0,23,Clouds
29841,58,1553155200,38,2,40,Clouds
29842,59,1553155200,20,0,20,Clouds
29843,60,1553155200,21,9,30,Clouds
29844,61,1553155200,21,4,25,Clouds
29845,62,1553155200,34,6,40,Clouds
29846,63,1553155200,27,8,35,Clouds
29847,64,1553155200,27,13,40,Clouds
29848,65,1553155200,33,7,40,Clouds
29849,66,1553155200,28,12,40,Clouds
29850,67,1553155200,30,10,40,Clouds
29851,68,1553155200,16,24,40,Clouds
29852,69,1553155200,14,26,40,Clouds
29853,70,1553155200,9,19,28,Clouds
29854,72,1553155200,28,3,31,Clouds
29855,73,1553155200,14,16,30,Clouds
29856,74,1553155200,16,14,30,Clouds
29857,75,1553155200,12,28,40,Clouds
29858,76,1553155200,30,8,38,Clouds
29859,77,1553155200,23,6,29,Clouds
29860,78,1553155200,3,37,40,Clouds
29861,79,1553155200,19,8,27,Clouds
29862,80,1553155200,35,5,40,Clouds
29863,81,1553155200,37,3,40,Clouds
29864,82,1553155200,7,15,22,Clouds
29865,83,1553155200,12,28,40,Clouds
29866,84,1553155200,8,22,30,Clouds
29867,85,1553155200,6,29,35,Clouds
29868,86,1553155200,4,34,38,Clouds
29869,87,1553155200,12,26,38,Clouds
29870,88,1553155200,8,22,30,Clouds
29871,89,1553155200,37,3,40,Clouds
29872,90,1553155200,17,23,40,Clouds
29873,91,1553155200,22,8,30,Clouds
29874,92,1553155200,2,38,40,Clouds
29875,93,1553155200,13,27,40,Clouds
29876,94,1553155200,1,39,40,Clouds
29877,95,1553155200,4,36,40,Clouds
29878,96,1553155200,17,13,30,Clouds
29879,97,1553155200,12,28,40,Clouds
29880,99,1553155200,26,4,30,Clouds
29881,100,1553155200,10,15,25,Clouds
29882,101,1553155200,20,10,30,Clouds
29883,102,1553155200,28,12,40,Clouds
29884,103,1553155200,35,5,40,Clouds
29885,104,1553155200,40,0,40,Clouds
29886,105,1553155200,33,3,36,Clouds
29887,106,1553155200,26,14,40,Clouds
29888,107,1553155200,31,9,40,Clouds
29889,108,1553155200,29,11,40,Clouds
29890,109,1553155200,11,18,29,Clouds
29891,110,1553155200,26,14,40,Clouds
29892,111,1553155200,15,25,40,Clouds
29893,112,1553155200,18,12,30,Clouds
29894,113,1553155200,38,2,40,Clouds
29895,114,1553155200,33,7,40,Clouds
29896,115,1553155200,10,20,30,Clouds
29897,2,1553158800,20,0,20,Clouds
29898,3,1553158800,17,3,20,Clouds
29899,4,1553158800,15,5,20,Clouds
29900,5,1553158800,40,0,40,Clouds
29901,6,1553158800,20,0,20,Clouds
29902,7,1553158800,29,0,29,Clouds
29903,8,1553158800,29,1,30,Clouds
29904,9,1553158800,20,4,24,Clouds
29905,10,1553158800,11,5,16,Clouds
29906,11,1553158800,16,14,30,Clouds
29907,12,1553158800,18,2,20,Clouds
29908,13,1553158800,19,11,30,Clouds
29909,14,1553158800,26,4,30,Clouds
29910,15,1553158800,12,3,15,Clouds
29911,16,1553158800,15,5,20,Clouds
29912,17,1553158800,15,5,20,Clouds
29913,18,1553158800,4,26,30,Clouds
29914,19,1553158800,23,6,29,Clouds
29915,21,1553158800,21,9,30,Clouds
29916,22,1553158800,18,2,20,Clouds
29917,23,1553158800,27,3,30,Clouds
29918,24,1553158800,16,4,20,Clouds
29919,25,1553158800,16,14,30,Clouds
29920,26,1553158800,12,8,20,Clouds
29921,27,1553158800,2,18,20,Clouds
29922,28,1553158800,17,13,30,Clouds
29923,29,1553158800,24,5,29,Clouds
29924,30,1553158800,16,4,20,Clouds
29925,31,1553158800,14,6,20,Clouds
29926,32,1553158800,20,10,30,Clouds
29927,33,1553158800,7,16,23,Clouds
29928,34,1553158800,30,0,30,Clouds
29929,35,1553158800,26,4,30,Clouds
29930,36,1553158800,22,18,40,Clouds
29931,37,1553158800,28,2,30,Clouds
29932,38,1553158800,22,18,40,Clouds
29933,39,1553158800,17,3,20,Clouds
29934,40,1553158800,0,21,21,Clouds
29935,41,1553158800,20,0,20,Clouds
29936,42,1553158800,21,9,30,Clouds
29937,43,1553158800,30,0,30,Clouds
29938,44,1553158800,17,13,30,Clouds
29939,45,1553158800,21,9,30,Clouds
29940,46,1553158800,17,3,20,Clouds
29941,47,1553158800,37,3,40,Clouds
29942,48,1553158800,16,24,40,Clouds
29943,49,1553158800,34,6,40,Clouds
29944,50,1553158800,32,8,40,Clouds
29945,51,1553158800,27,13,40,Clouds
29946,52,1553158800,17,15,32,Clouds
29947,53,1553158800,34,6,40,Clouds
29948,54,1553158800,23,10,33,Clouds
29949,55,1553158800,29,7,36,Clouds
29950,56,1553158800,23,17,40,Clouds
29951,57,1553158800,21,2,23,Clouds
29952,58,1553158800,18,22,40,Clouds
29953,59,1553158800,19,1,20,Clouds
29954,60,1553158800,30,0,30,Clouds
29955,61,1553158800,23,2,25,Clouds
29956,62,1553158800,31,9,40,Clouds
29957,63,1553158800,17,18,35,Clouds
29958,64,1553158800,20,20,40,Clouds
29959,65,1553158800,28,12,40,Clouds
29960,66,1553158800,4,36,40,Clouds
29961,67,1553158800,22,18,40,Clouds
29962,68,1553158800,0,38,38,Clouds
29963,69,1553158800,1,39,40,Clouds
29964,70,1553158800,0,28,28,Clouds
29965,72,1553158800,29,2,31,Clouds
29966,73,1553158800,23,7,30,Clouds
29967,74,1553158800,24,6,30,Clouds
29968,75,1553158800,30,10,40,Clouds
29969,76,1553158800,37,1,38,Clouds
29970,77,1553158800,26,3,29,Clouds
29971,78,1553158800,9,31,40,Clouds
29972,79,1553158800,20,7,27,Clouds
29973,80,1553158800,40,0,40,Clouds
29974,81,1553158800,37,3,40,Clouds
29975,82,1553158800,11,11,22,Clouds
29976,83,1553158800,21,19,40,Clouds
29977,84,1553158800,19,11,30,Clouds
29978,85,1553158800,23,12,35,Clouds
29979,86,1553158800,22,16,38,Clouds
29980,87,1553158800,22,16,38,Clouds
29981,88,1553158800,23,7,30,Clouds
29982,89,1553158800,33,7,40,Clouds
29983,90,1553158800,15,25,40,Clouds
29984,91,1553158800,23,7,30,Clouds
29985,92,1553158800,21,19,40,Clouds
29986,93,1553158800,35,5,40,Clouds
29987,94,1553158800,4,36,40,Clouds
29988,95,1553158800,20,20,40,Clouds
29989,96,1553158800,22,8,30,Clouds
29990,97,1553158800,31,9,40,Clouds
29991,98,1553158800,39,1,40,Clouds
29992,99,1553158800,24,6,30,Clouds
29993,100,1553158800,25,0,25,Clouds
29994,101,1553158800,25,5,30,Clouds
29995,102,1553158800,38,2,40,Clouds
29996,103,1553158800,32,8,40,Clouds
29997,104,1553158800,39,1,40,Clouds
29998,105,1553158800,33,3,36,Clouds
29999,106,1553158800,30,10,40,Clouds
30000,107,1553158800,40,0,40,Clouds
30001,108,1553158800,34,6,40,Clouds
30002,109,1553158800,14,15,29,Clouds
30003,110,1553158800,30,10,40,Clouds
30004,111,1553158800,28,12,40,Clouds
30005,112,1553158800,30,0,30,Clouds
30006,113,1553158800,35,5,40,Clouds
30007,114,1553158800,31,9,40,Clouds
30008,115,1553158800,28,1,29,Clouds
30009,2,1553162400,20,0,20,Drizzle
30010,3,1553162400,20,0,20,Drizzle
30011,4,1553162400,18,2,20,Drizzle
30012,5,1553162400,40,0,40,Drizzle
30013,6,1553162400,19,1,20,Drizzle
30014,7,1553162400,29,0,29,Drizzle
30015,8,1553162400,23,7,30,Drizzle
30016,9,1553162400,18,6,24,Drizzle
30017,10,1553162400,9,7,16,Drizzle
30018,11,1553162400,1,29,30,Drizzle
30019,12,1553162400,20,0,20,Drizzle
30020,13,1553162400,6,24,30,Drizzle
30021,14,1553162400,20,10,30,Drizzle
30022,15,1553162400,14,1,15,Drizzle
30023,16,1553162400,16,4,20,Drizzle
30024,17,1553162400,18,2,20,Drizzle
30025,18,1553162400,28,2,30,Drizzle
30026,19,1553162400,0,29,29,Drizzle
30027,21,1553162400,17,13,30,Drizzle
30028,22,1553162400,20,0,20,Drizzle
30029,23,1553162400,12,17,29,Drizzle
30030,24,1553162400,18,2,20,Drizzle
30031,25,1553162400,1,29,30,Drizzle
30032,26,1553162400,2,18,20,Drizzle
30033,27,1553162400,4,16,20,Drizzle
30034,28,1553162400,23,7,30,Drizzle
30035,29,1553162400,25,4,29,Drizzle
30036,30,1553162400,20,0,20,Drizzle
30037,31,1553162400,15,5,20,Drizzle
30038,32,1553162400,18,12,30,Drizzle
30039,33,1553162400,5,18,23,Drizzle
30040,34,1553162400,30,0,30,Drizzle
30041,35,1553162400,28,2,30,Drizzle
30042,36,1553162400,1,39,40,Drizzle
30043,37,1553162400,30,0,30,Drizzle
30044,38,1553162400,37,3,40,Drizzle
30045,39,1553162400,20,0,20,Drizzle
30046,40,1553162400,8,13,21,Drizzle
30047,41,1553162400,17,3,20,Drizzle
30048,42,1553162400,30,0,30,Drizzle
30049,43,1553162400,29,1,30,Drizzle
30050,44,1553162400,30,0,30,Drizzle
30051,45,1553162400,29,1,30,Drizzle
30052,46,1553162400,18,2,20,Drizzle
30053,47,1553162400,11,29,40,Drizzle
30054,48,1553162400,11,29,40,Drizzle
30055,49,1553162400,3,37,40,Drizzle
30056,50,1553162400,40,0,40,Drizzle
30057,51,1553162400,33,7,40,Drizzle
30058,52,1553162400,6,26,32,Drizzle
30059,53,1553162400,33,7,40,Drizzle
30060,54,1553162400,24,9,33,Drizzle
30061,55,1553162400,21,15,36,Drizzle
30062,56,1553162400,18,22,40,Drizzle
30063,57,1553162400,2,20,22,Drizzle
30064,58,1553162400,3,37,40,Drizzle
30065,59,1553162400,19,1,20,Drizzle
30066,60,1553162400,30,0,30,Drizzle
30067,61,1553162400,25,0,25,Drizzle
30068,62,1553162400,6,34,40,Drizzle
30069,63,1553162400,6,29,35,Drizzle
30070,64,1553162400,2,38,40,Drizzle
30071,65,1553162400,25,15,40,Drizzle
30072,66,1553162400,0,40,40,Drizzle
30073,67,1553162400,11,28,39,Drizzle
30074,68,1553162400,0,38,38,Drizzle
30075,69,1553162400,0,40,40,Drizzle
30076,70,1553162400,3,25,28,Drizzle
30077,71,1553162400,40,0,40,Drizzle
30078,72,1553162400,31,0,31,Drizzle
30079,73,1553162400,30,0,30,Drizzle
30080,74,1553162400,30,0,30,Drizzle
30081,75,1553162400,40,0,40,Drizzle
30082,76,1553162400,38,0,38,Drizzle
30083,77,1553162400,26,3,29,Drizzle
30084,78,1553162400,40,0,40,Drizzle
30085,79,1553162400,26,1,27,Drizzle
30086,80,1553162400,40,0,40,Drizzle
30087,81,1553162400,39,1,40,Drizzle
30088,82,1553162400,22,0,22,Drizzle
30089,83,1553162400,40,0,40,Drizzle
30090,84,1553162400,30,0,30,Drizzle
30091,85,1553162400,35,0,35,Drizzle
30092,86,1553162400,38,0,38,Drizzle
30093,87,1553162400,37,1,38,Drizzle
30094,88,1553162400,30,0,30,Drizzle
30095,89,1553162400,28,12,40,Drizzle
30096,90,1553162400,0,40,40,Drizzle
30097,91,1553162400,30,0,30,Drizzle
30098,92,1553162400,40,0,40,Drizzle
30099,93,1553162400,40,0,40,Drizzle
30100,94,1553162400,40,0,40,Drizzle
30101,95,1553162400,40,0,40,Drizzle
30102,96,1553162400,30,0,30,Drizzle
30103,97,1553162400,39,1,40,Drizzle
30104,98,1553162400,35,5,40,Drizzle
30105,99,1553162400,10,20,30,Drizzle
30106,100,1553162400,25,0,25,Drizzle
30107,101,1553162400,30,0,30,Drizzle
30108,102,1553162400,40,0,40,Drizzle
30109,103,1553162400,40,0,40,Drizzle
30110,104,1553162400,40,0,40,Drizzle
30111,105,1553162400,36,0,36,Drizzle
30112,106,1553162400,40,0,40,Drizzle
30113,107,1553162400,40,0,40,Drizzle
30114,108,1553162400,40,0,40,Drizzle
30115,109,1553162400,29,0,29,Drizzle
30116,110,1553162400,40,0,40,Drizzle
30117,111,1553162400,38,2,40,Drizzle
30118,112,1553162400,29,1,30,Drizzle
30119,113,1553162400,26,14,40,Drizzle
30120,114,1553162400,20,20,40,Drizzle
30121,115,1553162400,28,1,29,Drizzle
30122,2,1553166000,20,0,20,Clouds
30123,3,1553166000,19,1,20,Clouds
30124,4,1553166000,20,0,20,Clouds
30125,5,1553166000,38,2,40,Clouds
30126,6,1553166000,20,0,20,Clouds
30127,7,1553166000,29,0,29,Clouds
30128,8,1553166000,21,9,30,Clouds
30129,9,1553166000,21,3,24,Clouds
30130,10,1553166000,7,8,15,Clouds
30131,11,1553166000,1,29,30,Clouds
30132,12,1553166000,20,0,20,Clouds
30133,13,1553166000,0,30,30,Clouds
30134,14,1553166000,14,16,30,Clouds
30135,15,1553166000,15,0,15,Clouds
30136,16,1553166000,15,5,20,Clouds
30137,17,1553166000,19,1,20,Clouds
30138,18,1553166000,29,1,30,Clouds
30139,19,1553166000,11,18,29,Clouds
30140,21,1553166000,12,18,30,Clouds
30141,22,1553166000,16,4,20,Clouds
30142,23,1553166000,14,15,29,Clouds
30143,24,1553166000,19,1,20,Clouds
30144,25,1553166000,1,29,30,Clouds
30145,26,1553166000,0,20,20,Clouds
30146,27,1553166000,1,19,20,Clouds
30147,28,1553166000,30,0,30,Clouds
30148,29,1553166000,29,0,29,Clouds
30149,30,1553166000,20,0,20,Clouds
30150,31,1553166000,18,2,20,Clouds
30151,32,1553166000,10,20,30,Clouds
30152,33,1553166000,11,12,23,Clouds
30153,34,1553166000,30,0,30,Clouds
30154,35,1553166000,28,2,30,Clouds
30155,36,1553166000,0,40,40,Clouds
30156,37,1553166000,28,2,30,Clouds
30157,38,1553166000,39,1,40,Clouds
30158,39,1553166000,18,2,20,Clouds
30159,40,1553166000,14,7,21,Clouds
30160,41,1553166000,9,11,20,Clouds
30161,42,1553166000,30,0,30,Clouds
30162,43,1553166000,30,0,30,Clouds
30163,44,1553166000,30,0,30,Clouds
30164,45,1553166000,30,0,30,Clouds
30165,46,1553166000,19,1,20,Clouds
30166,47,1553166000,5,35,40,Clouds
30167,48,1553166000,6,34,40,Clouds
30168,49,1553166000,0,40,40,Clouds
30169,50,1553166000,37,3,40,Clouds
30170,51,1553166000,27,13,40,Clouds
30171,52,1553166000,20,12,32,Clouds
30172,53,1553166000,26,14,40,Clouds
30173,54,1553166000,17,16,33,Clouds
30174,55,1553166000,12,24,36,Clouds
30175,56,1553166000,0,40,40,Clouds
30176,57,1553166000,0,22,22,Clouds
30177,58,1553166000,0,40,40,Clouds
30178,59,1553166000,20,0,20,Clouds
30179,60,1553166000,29,1,30,Clouds
30180,61,1553166000,25,0,25,Clouds
30181,62,1553166000,1,39,40,Clouds
30182,63,1553166000,4,31,35,Clouds
30183,64,1553166000,0,40,40,Clouds
30184,65,1553166000,2,38,40,Clouds
30185,66,1553166000,3,37,40,Clouds
30186,67,1553166000,1,38,39,Clouds
30187,68,1553166000,0,38,38,Clouds
30188,69,1553166000,0,40,40,Clouds
30189,70,1553166000,0,28,28,Clouds
30190,71,1553166000,2,38,40,Clouds
30191,72,1553166000,31,0,31,Clouds
30192,73,1553166000,29,1,30,Clouds
30193,74,1553166000,29,1,30,Clouds
30194,75,1553166000,40,0,40,Clouds
30195,76,1553166000,38,0,38,Clouds
30196,77,1553166000,28,1,29,Clouds
30197,78,1553166000,24,16,40,Clouds
30198,79,1553166000,27,0,27,Clouds
30199,80,1553166000,37,3,40,Clouds
30200,81,1553166000,40,0,40,Clouds
30201,82,1553166000,22,0,22,Clouds
30202,83,1553166000,40,0,40,Clouds
30203,84,1553166000,30,0,30,Clouds
30204,85,1553166000,35,0,35,Clouds
30205,86,1553166000,38,0,38,Clouds
30206,87,1553166000,37,1,38,Clouds
30207,88,1553166000,29,1,30,Clouds
30208,89,1553166000,17,23,40,Clouds
30209,90,1553166000,1,39,40,Clouds
30210,91,1553166000,13,17,30,Clouds
30211,92,1553166000,40,0,40,Clouds
30212,93,1553166000,40,0,40,Clouds
30213,94,1553166000,40,0,40,Clouds
30214,95,1553166000,40,0,40,Clouds
30215,96,1553166000,30,0,30,Clouds
30216,97,1553166000,40,0,40,Clouds
30217,98,1553166000,34,6,40,Clouds
30218,99,1553166000,1,29,30,Clouds
30219,100,1553166000,25,0,25,Clouds
30220,101,1553166000,30,0,30,Clouds
30221,102,1553166000,40,0,40,Clouds
30222,103,1553166000,36,4,40,Clouds
30223,104,1553166000,40,0,40,Clouds
30224,105,1553166000,36,0,36,Clouds
30225,106,1553166000,40,0,40,Clouds
30226,107,1553166000,40,0,40,Clouds
30227,108,1553166000,40,0,40,Clouds
30228,109,1553166000,29,0,29,Clouds
30229,110,1553166000,40,0,40,Clouds
30230,111,1553166000,40,0,40,Clouds
30231,112,1553166000,30,0,30,Clouds
30232,113,1553166000,4,36,40,Clouds
30233,114,1553166000,4,36,40,Clouds
30234,115,1553166000,29,0,29,Clouds
30235,2,1553169600,20,0,20,Clouds
30236,3,1553169600,18,2,20,Clouds
30237,4,1553169600,19,1,20,Clouds
30238,5,1553169600,26,14,40,Clouds
30239,6,1553169600,18,2,20,Clouds
30240,7,1553169600,29,0,29,Clouds
30241,8,1553169600,15,15,30,Clouds
30242,9,1553169600,15,9,24,Clouds
30243,10,1553169600,8,8,16,Clouds
30244,11,1553169600,2,28,30,Clouds
30245,12,1553169600,20,0,20,Clouds
30246,13,1553169600,0,30,30,Clouds
30247,14,1553169600,15,15,30,Clouds
30248,15,1553169600,14,1,15,Clouds
30249,16,1553169600,13,7,20,Clouds
30250,17,1553169600,17,3,20,Clouds
30251,18,1553169600,30,0,30,Clouds
30252,19,1553169600,19,10,29,Clouds
30253,21,1553169600,6,24,30,Clouds
30254,22,1553169600,20,0,20,Clouds
30255,23,1553169600,13,16,29,Clouds
30256,24,1553169600,17,3,20,Clouds
30257,25,1553169600,13,17,30,Clouds
30258,26,1553169600,2,18,20,Clouds
30259,27,1553169600,1,19,20,Clouds
30260,28,1553169600,30,0,30,Clouds
30261,29,1553169600,26,3,29,Clouds
30262,30,1553169600,20,0,20,Clouds
30263,31,1553169600,19,1,20,Clouds
30264,32,1553169600,8,22,30,Clouds
30265,33,1553169600,13,10,23,Clouds
30266,34,1553169600,30,0,30,Clouds
30267,35,1553169600,30,0,30,Clouds
30268,36,1553169600,3,37,40,Clouds
30269,37,1553169600,28,2,30,Clouds
30270,38,1553169600,39,1,40,Clouds
30271,39,1553169600,18,2,20,Clouds
30272,40,1553169600,19,2,21,Clouds
30273,41,1553169600,5,15,20,Clouds
30274,42,1553169600,29,1,30,Clouds
30275,43,1553169600,30,0,30,Clouds
30276,44,1553169600,28,2,30,Clouds
30277,45,1553169600,30,0,30,Clouds
30278,46,1553169600,19,1,20,Clouds
30279,47,1553169600,2,38,40,Clouds
30280,48,1553169600,0,40,40,Clouds
30281,49,1553169600,0,40,40,Clouds
30282,50,1553169600,39,1,40,Clouds
30283,51,1553169600,30,10,40,Clouds
30284,52,1553169600,19,13,32,Clouds
30285,53,1553169600,23,17,40,Clouds
30286,54,1553169600,17,16,33,Clouds
30287,55,1553169600,11,25,36,Clouds
30288,56,1553169600,3,37,40,Clouds
30289,57,1553169600,0,22,22,Clouds
30290,58,1553169600,5,35,40,Clouds
30291,59,1553169600,18,2,20,Clouds
30292,60,1553169600,30,0,30,Clouds
30293,61,1553169600,25,0,25,Clouds
30294,62,1553169600,0,40,40,Clouds
30295,63,1553169600,1,34,35,Clouds
30296,64,1553169600,0,40,40,Clouds
30297,65,1553169600,0,40,40,Clouds
30298,66,1553169600,12,28,40,Clouds
30299,67,1553169600,8,31,39,Clouds
30300,68,1553169600,1,37,38,Clouds
30301,69,1553169600,0,40,40,Clouds
30302,70,1553169600,1,27,28,Clouds
30303,71,1553169600,6,34,40,Clouds
30304,72,1553169600,31,0,31,Clouds
30305,73,1553169600,28,2,30,Clouds
30306,74,1553169600,30,0,30,Clouds
30307,75,1553169600,39,1,40,Clouds
30308,76,1553169600,37,1,38,Clouds
30309,77,1553169600,29,0,29,Clouds
30310,78,1553169600,32,8,40,Clouds
30311,79,1553169600,19,8,27,Clouds
30312,80,1553169600,38,2,40,Clouds
30313,81,1553169600,40,0,40,Clouds
30314,82,1553169600,22,0,22,Clouds
30315,83,1553169600,40,0,40,Clouds
30316,84,1553169600,30,0,30,Clouds
30317,85,1553169600,35,0,35,Clouds
30318,86,1553169600,38,0,38,Clouds
30319,87,1553169600,37,1,38,Clouds
30320,88,1553169600,30,0,30,Clouds
30321,89,1553169600,2,38,40,Clouds
30322,90,1553169600,10,30,40,Clouds
30323,91,1553169600,10,20,30,Clouds
30324,92,1553169600,40,0,40,Clouds
30325,93,1553169600,40,0,40,Clouds
30326,94,1553169600,40,0,40,Clouds
30327,95,1553169600,40,0,40,Clouds
30328,96,1553169600,30,0,30,Clouds
30329,97,1553169600,40,0,40,Clouds
30330,98,1553169600,34,6,40,Clouds
30331,99,1553169600,0,30,30,Clouds
30332,100,1553169600,25,0,25,Clouds
30333,101,1553169600,28,2,30,Clouds
30334,102,1553169600,33,7,40,Clouds
30335,103,1553169600,37,3,40,Clouds
30336,104,1553169600,40,0,40,Clouds
30337,105,1553169600,36,0,36,Clouds
30338,106,1553169600,40,0,40,Clouds
30339,107,1553169600,40,0,40,Clouds
30340,108,1553169600,40,0,40,Clouds
30341,109,1553169600,29,0,29,Clouds
30342,110,1553169600,40,0,40,Clouds
30343,111,1553169600,23,17,40,Clouds
30344,112,1553169600,30,0,30,Clouds
30345,113,1553169600,4,36,40,Clouds
30346,114,1553169600,3,37,40,Clouds
30347,115,1553169600,28,1,29,Clouds
30348,2,1553173200,20,0,20,Clouds
30349,3,1553173200,18,2,20,Clouds
30350,4,1553173200,18,2,20,Clouds
30351,5,1553173200,34,6,40,Clouds
30352,6,1553173200,19,1,20,Clouds
30353,7,1553173200,29,0,29,Clouds
30354,8,1553173200,16,14,30,Clouds
30355,9,1553173200,4,20,24,Clouds
30356,10,1553173200,8,8,16,Clouds
30357,11,1553173200,2,28,30,Clouds
30358,12,1553173200,19,1,20,Clouds
30359,13,1553173200,0,30,30,Clouds
30360,14,1553173200,6,24,30,Clouds
30361,15,1553173200,15,0,15,Clouds
30362,16,1553173200,13,7,20,Clouds
30363,17,1553173200,18,2,20,Clouds
30364,18,1553173200,28,2,30,Clouds
30365,19,1553173200,15,14,29,Clouds
30366,21,1553173200,2,28,30,Clouds
30367,22,1553173200,17,3,20,Clouds
30368,23,1553173200,17,12,29,Clouds
30369,24,1553173200,18,2,20,Clouds
30370,25,1553173200,5,25,30,Clouds
30371,26,1553173200,2,18,20,Clouds
30372,27,1553173200,2,18,20,Clouds
30373,28,1553173200,30,0,30,Clouds
30374,29,1553173200,29,0,29,Clouds
30375,30,1553173200,20,0,20,Clouds
30376,31,1553173200,18,2,20,Clouds
30377,32,1553173200,6,24,30,Clouds
30378,33,1553173200,12,11,23,Clouds
30379,34,1553173200,29,1,30,Clouds
30380,35,1553173200,29,1,30,Clouds
30381,36,1553173200,11,29,40,Clouds
30382,37,1553173200,29,1,30,Clouds
30383,38,1553173200,38,2,40,Clouds
30384,39,1553173200,15,5,20,Clouds
30385,40,1553173200,18,3,21,Clouds
30386,41,1553173200,5,15,20,Clouds
30387,42,1553173200,30,0,30,Clouds
30388,43,1553173200,30,0,30,Clouds
30389,44,1553173200,30,0,30,Clouds
30390,45,1553173200,27,3,30,Clouds
30391,46,1553173200,19,1,20,Clouds
30392,47,1553173200,5,34,39,Clouds
30393,48,1553173200,4,36,40,Clouds
30394,49,1553173200,2,38,40,Clouds
30395,50,1553173200,40,0,40,Clouds
30396,51,1553173200,29,11,40,Clouds
30397,52,1553173200,17,15,32,Clouds
30398,53,1553173200,22,18,40,Clouds
30399,54,1553173200,19,14,33,Clouds
30400,55,1553173200,14,22,36,Clouds
30401,56,1553173200,7,32,39,Clouds
30402,57,1553173200,0,22,22,Clouds
30403,58,1553173200,6,33,39,Clouds
30404,59,1553173200,20,0,20,Clouds
30405,60,1553173200,29,1,30,Clouds
30406,61,1553173200,25,0,25,Clouds
30407,62,1553173200,9,31,40,Clouds
30408,63,1553173200,0,35,35,Clouds
30409,64,1553173200,9,31,40,Clouds
30410,65,1553173200,10,30,40,Clouds
30411,66,1553173200,11,29,40,Clouds
30412,67,1553173200,8,31,39,Clouds
30413,68,1553173200,1,37,38,Clouds
30414,69,1553173200,1,39,40,Clouds
30415,70,1553173200,2,26,28,Clouds
30416,71,1553173200,9,31,40,Clouds
30417,72,1553173200,30,1,31,Clouds
30418,73,1553173200,29,1,30,Clouds
30419,74,1553173200,28,2,30,Clouds
30420,75,1553173200,38,2,40,Clouds
30421,76,1553173200,35,3,38,Clouds
30422,77,1553173200,27,2,29,Clouds
30423,78,1553173200,36,4,40,Clouds
30424,79,1553173200,23,4,27,Clouds
30425,80,1553173200,34,6,40,Clouds
30426,81,1553173200,40,0,40,Clouds
30427,82,1553173200,22,0,22,Clouds
30428,83,1553173200,40,0,40,Clouds
30429,84,1553173200,30,0,30,Clouds
30430,85,1553173200,35,0,35,Clouds
30431,86,1553173200,38,0,38,Clouds
30432,87,1553173200,38,0,38,Clouds
30433,88,1553173200,29,1,30,Clouds
30434,89,1553173200,0,40,40,Clouds
30435,90,1553173200,10,30,40,Clouds
30436,91,1553173200,8,22,30,Clouds
30437,92,1553173200,40,0,40,Clouds
30438,93,1553173200,40,0,40,Clouds
30439,94,1553173200,40,0,40,Clouds
30440,95,1553173200,40,0,40,Clouds
30441,96,1553173200,30,0,30,Clouds
30442,97,1553173200,40,0,40,Clouds
30443,98,1553173200,30,10,40,Clouds
30444,99,1553173200,1,29,30,Clouds
30445,100,1553173200,24,1,25,Clouds
30446,101,1553173200,28,2,30,Clouds
30447,102,1553173200,36,4,40,Clouds
30448,103,1553173200,40,0,40,Clouds
30449,104,1553173200,40,0,40,Clouds
30450,105,1553173200,36,0,36,Clouds
30451,106,1553173200,40,0,40,Clouds
30452,107,1553173200,40,0,40,Clouds
30453,108,1553173200,40,0,40,Clouds
30454,109,1553173200,29,0,29,Clouds
30455,110,1553173200,40,0,40,Clouds
30456,111,1553173200,33,7,40,Clouds
30457,112,1553173200,30,0,30,Clouds
30458,113,1553173200,3,37,40,Clouds
30459,114,1553173200,1,39,40,Clouds
30460,115,1553173200,28,1,29,Clouds
30461,2,1553176800,20,0,20,Clouds
30462,3,1553176800,18,2,20,Clouds
30463,4,1553176800,18,2,20,Clouds
30464,5,1553176800,29,11,40,Clouds
30465,6,1553176800,20,0,20,Clouds
30466,7,1553176800,29,0,29,Clouds
30467,8,1553176800,25,5,30,Clouds
30468,9,1553176800,3,21,24,Clouds
30469,10,1553176800,11,5,16,Clouds
30470,11,1553176800,14,16,30,Clouds
30471,12,1553176800,18,2,20,Clouds
30472,13,1553176800,5,25,30,Clouds
30473,14,1553176800,3,27,30,Clouds
30474,15,1553176800,16,0,16,Clouds
30475,16,1553176800,19,1,20,Clouds
30476,17,1553176800,20,0,20,Clouds
30477,18,1553176800,26,4,30,Clouds
30478,19,1553176800,20,8,28,Clouds
30479,21,1553176800,1,29,30,Clouds
30480,22,1553176800,13,7,20,Clouds
30481,23,1553176800,26,3,29,Clouds
30482,24,1553176800,13,7,20,Clouds
30483,25,1553176800,2,28,30,Clouds
30484,26,1553176800,0,20,20,Clouds
30485,27,1553176800,5,15,20,Clouds
30486,28,1553176800,30,0,30,Clouds
30487,29,1553176800,26,3,29,Clouds
30488,30,1553176800,18,2,20,Clouds
30489,31,1553176800,19,1,20,Clouds
30490,32,1553176800,15,15,30,Clouds
30491,33,1553176800,21,2,23,Clouds
30492,34,1553176800,25,5,30,Clouds
30493,35,1553176800,29,1,30,Clouds
30494,36,1553176800,6,34,40,Clouds
30495,37,1553176800,30,0,30,Clouds
30496,38,1553176800,38,2,40,Clouds
30497,39,1553176800,12,8,20,Clouds
30498,40,1553176800,21,0,21,Clouds
30499,41,1553176800,8,12,20,Clouds
30500,42,1553176800,29,1,30,Clouds
30501,43,1553176800,29,1,30,Clouds
30502,44,1553176800,29,1,30,Clouds
30503,45,1553176800,26,4,30,Clouds
30504,46,1553176800,20,0,20,Clouds
30505,47,1553176800,2,37,39,Clouds
30506,48,1553176800,5,35,40,Clouds
30507,49,1553176800,7,33,40,Clouds
30508,50,1553176800,39,1,40,Clouds
30509,51,1553176800,30,10,40,Clouds
30510,52,1553176800,10,22,32,Clouds
30511,53,1553176800,25,15,40,Clouds
30512,54,1553176800,15,18,33,Clouds
30513,55,1553176800,18,18,36,Clouds
30514,56,1553176800,8,31,39,Clouds
30515,57,1553176800,2,20,22,Clouds
30516,58,1553176800,15,24,39,Clouds
30517,59,1553176800,19,1,20,Clouds
30518,60,1553176800,29,1,30,Clouds
30519,61,1553176800,25,0,25,Clouds
30520,62,1553176800,12,28,40,Clouds
30521,63,1553176800,5,30,35,Clouds
30522,64,1553176800,12,28,40,Clouds
30523,65,1553176800,14,26,40,Clouds
30524,66,1553176800,17,23,40,Clouds
30525,67,1553176800,16,23,39,Clouds
30526,68,1553176800,2,36,38,Clouds
30527,69,1553176800,10,30,40,Clouds
30528,70,1553176800,2,26,28,Clouds
30529,71,1553176800,11,29,40,Clouds
30530,72,1553176800,31,0,31,Clouds
30531,73,1553176800,27,3,30,Clouds
30532,74,1553176800,26,4,30,Clouds
30533,75,1553176800,39,1,40,Clouds
30534,76,1553176800,38,0,38,Clouds
30535,77,1553176800,28,1,29,Clouds
30536,78,1553176800,39,1,40,Clouds
30537,79,1553176800,25,2,27,Clouds
30538,80,1553176800,31,9,40,Clouds
30539,81,1553176800,39,1,40,Clouds
30540,82,1553176800,22,0,22,Clouds
30541,83,1553176800,40,0,40,Clouds
30542,84,1553176800,30,0,30,Clouds
30543,85,1553176800,35,0,35,Clouds
30544,86,1553176800,38,0,38,Clouds
30545,87,1553176800,38,0,38,Clouds
30546,88,1553176800,29,1,30,Clouds
30547,89,1553176800,4,36,40,Clouds
30548,90,1553176800,18,22,40,Clouds
30549,91,1553176800,8,22,30,Clouds
30550,92,1553176800,40,0,40,Clouds
30551,93,1553176800,40,0,40,Clouds
30552,94,1553176800,40,0,40,Clouds
30553,95,1553176800,40,0,40,Clouds
30554,96,1553176800,30,0,30,Clouds
30555,97,1553176800,40,0,40,Clouds
30556,98,1553176800,22,18,40,Clouds
30557,99,1553176800,1,29,30,Clouds
30558,100,1553176800,23,2,25,Clouds
30559,101,1553176800,28,2,30,Clouds
30560,102,1553176800,39,1,40,Clouds
30561,103,1553176800,40,0,40,Clouds
30562,104,1553176800,40,0,40,Clouds
30563,105,1553176800,36,0,36,Clouds
30564,106,1553176800,40,0,40,Clouds
30565,107,1553176800,40,0,40,Clouds
30566,108,1553176800,39,1,40,Clouds
30567,109,1553176800,29,0,29,Clouds
30568,110,1553176800,40,0,40,Clouds
30569,111,1553176800,38,2,40,Clouds
30570,112,1553176800,29,1,30,Clouds
30571,113,1553176800,1,39,40,Clouds
30572,114,1553176800,0,40,40,Clouds
30573,115,1553176800,29,1,30,Clouds
30574,2,1553180400,20,0,20,Clouds
30575,3,1553180400,16,4,20,Clouds
30576,4,1553180400,19,1,20,Clouds
30577,5,1553180400,25,15,40,Clouds
30578,6,1553180400,19,1,20,Clouds
30579,7,1553180400,29,0,29,Clouds
30580,8,1553180400,17,13,30,Clouds
30581,9,1553180400,8,16,24,Clouds
30582,10,1553180400,16,0,16,Clouds
30583,11,1553180400,12,18,30,Clouds
30584,12,1553180400,18,2,20,Clouds
30585,13,1553180400,1,29,30,Clouds
30586,14,1553180400,2,28,30,Clouds
30587,15,1553180400,12,4,16,Clouds
30588,16,1553180400,16,4,20,Clouds
30589,17,1553180400,18,2,20,Clouds
30590,18,1553180400,26,4,30,Clouds
30591,19,1553180400,19,11,30,Clouds
30592,21,1553180400,0,30,30,Clouds
30593,22,1553180400,16,4,20,Clouds
30594,23,1553180400,19,10,29,Clouds
30595,24,1553180400,15,5,20,Clouds
30596,25,1553180400,8,22,30,Clouds
30597,26,1553180400,8,12,20,Clouds
30598,27,1553180400,7,13,20,Clouds
30599,28,1553180400,23,7,30,Clouds
30600,29,1553180400,29,0,29,Clouds
30601,30,1553180400,18,2,20,Clouds
30602,31,1553180400,20,0,20,Clouds
30603,32,1553180400,17,13,30,Clouds
30604,33,1553180400,21,2,23,Clouds
30605,34,1553180400,28,2,30,Clouds
30606,35,1553180400,29,1,30,Clouds
30607,36,1553180400,25,15,40,Clouds
30608,37,1553180400,12,18,30,Clouds
30609,38,1553180400,40,0,40,Clouds
30610,39,1553180400,18,2,20,Clouds
30611,40,1553180400,19,2,21,Clouds
30612,41,1553180400,7,13,20,Clouds
30613,42,1553180400,30,0,30,Clouds
30614,43,1553180400,24,6,30,Clouds
30615,44,1553180400,29,1,30,Clouds
30616,45,1553180400,30,0,30,Clouds
30617,46,1553180400,15,5,20,Clouds
30618,47,1553180400,5,35,40,Clouds
30619,48,1553180400,0,40,40,Clouds
30620,49,1553180400,9,31,40,Clouds
30621,50,1553180400,36,4,40,Clouds
30622,51,1553180400,39,1,40,Clouds
30623,52,1553180400,7,25,32,Clouds
30624,53,1553180400,26,14,40,Clouds
30625,54,1553180400,13,20,33,Clouds
30626,55,1553180400,16,20,36,Clouds
30627,56,1553180400,2,37,39,Clouds
30628,57,1553180400,5,17,22,Clouds
30629,58,1553180400,20,19,39,Clouds
30630,59,1553180400,18,2,20,Clouds
30631,60,1553180400,27,3,30,Clouds
30632,61,1553180400,17,8,25,Clouds
30633,62,1553180400,10,30,40,Clouds
30634,63,1553180400,5,30,35,Clouds
30635,64,1553180400,1,39,40,Clouds
30636,65,1553180400,16,24,40,Clouds
30637,66,1553180400,7,33,40,Clouds
30638,67,1553180400,12,27,39,Clouds
30639,68,1553180400,13,25,38,Clouds
30640,69,1553180400,3,37,40,Clouds
30641,70,1553180400,0,28,28,Clouds
30642,71,1553180400,8,32,40,Clouds
30643,72,1553180400,31,0,31,Clouds
30644,73,1553180400,29,1,30,Clouds
30645,74,1553180400,23,7,30,Clouds
30646,75,1553180400,40,0,40,Clouds
30647,76,1553180400,37,1,38,Clouds
30648,77,1553180400,15,14,29,Clouds
30649,78,1553180400,39,1,40,Clouds
30650,79,1553180400,27,0,27,Clouds
30651,80,1553180400,39,1,40,Clouds
30652,81,1553180400,40,0,40,Clouds
30653,82,1553180400,22,0,22,Clouds
30654,83,1553180400,40,0,40,Clouds
30655,84,1553180400,29,1,30,Clouds
30656,85,1553180400,35,0,35,Clouds
30657,86,1553180400,37,1,38,Clouds
30658,87,1553180400,38,0,38,Clouds
30659,88,1553180400,27,3,30,Clouds
30660,89,1553180400,4,36,40,Clouds
30661,90,1553180400,13,27,40,Clouds
30662,91,1553180400,5,25,30,Clouds
30663,92,1553180400,36,4,40,Clouds
30664,93,1553180400,40,0,40,Clouds
30665,94,1553180400,39,1,40,Clouds
30666,95,1553180400,36,4,40,Clouds
30667,96,1553180400,30,0,30,Clouds
30668,97,1553180400,40,0,40,Clouds
30669,98,1553180400,27,13,40,Clouds
30670,99,1553180400,1,29,30,Clouds
30671,100,1553180400,25,0,25,Clouds
30672,101,1553180400,30,0,30,Clouds
30673,102,1553180400,40,0,40,Clouds
30674,103,1553180400,40,0,40,Clouds
30675,104,1553180400,40,0,40,Clouds
30676,105,1553180400,36,0,36,Clouds
30677,106,1553180400,40,0,40,Clouds
30678,107,1553180400,40,0,40,Clouds
30679,108,1553180400,39,1,40,Clouds
30680,109,1553180400,27,2,29,Clouds
30681,110,1553180400,39,1,40,Clouds
30682,111,1553180400,40,0,40,Clouds
30683,112,1553180400,25,5,30,Clouds
30684,113,1553180400,8,32,40,Clouds
30685,114,1553180400,5,35,40,Clouds
30686,115,1553180400,25,5,30,Clouds
30687,2,1553184000,20,0,20,Clouds
30688,3,1553184000,18,2,20,Clouds
30689,4,1553184000,19,1,20,Clouds
30690,5,1553184000,17,23,40,Clouds
30691,6,1553184000,19,1,20,Clouds
30692,7,1553184000,29,0,29,Clouds
30693,8,1553184000,16,14,30,Clouds
30694,9,1553184000,8,16,24,Clouds
30695,10,1553184000,15,1,16,Clouds
30696,11,1553184000,11,19,30,Clouds
30697,12,1553184000,20,0,20,Clouds
30698,13,1553184000,5,25,30,Clouds
30699,14,1553184000,6,24,30,Clouds
30700,15,1553184000,13,3,16,Clouds
30701,16,1553184000,8,12,20,Clouds
30702,17,1553184000,20,0,20,Clouds
30703,18,1553184000,23,7,30,Clouds
30704,19,1553184000,13,17,30,Clouds
30705,21,1553184000,10,20,30,Clouds
30706,22,1553184000,17,3,20,Clouds
30707,23,1553184000,25,5,30,Clouds
30708,24,1553184000,20,0,20,Clouds
30709,25,1553184000,8,22,30,Clouds
30710,26,1553184000,4,16,20,Clouds
30711,27,1553184000,20,0,20,Clouds
30712,28,1553184000,21,9,30,Clouds
30713,29,1553184000,23,6,29,Clouds
30714,30,1553184000,12,8,20,Clouds
30715,31,1553184000,16,4,20,Clouds
30716,32,1553184000,11,19,30,Clouds
30717,33,1553184000,20,3,23,Clouds
30718,34,1553184000,27,3,30,Clouds
30719,35,1553184000,28,2,30,Clouds
30720,36,1553184000,22,18,40,Clouds
30721,37,1553184000,10,20,30,Clouds
30722,38,1553184000,33,7,40,Clouds
30723,39,1553184000,18,2,20,Clouds
30724,40,1553184000,17,4,21,Clouds
30725,41,1553184000,3,17,20,Clouds
30726,42,1553184000,27,3,30,Clouds
30727,43,1553184000,25,5,30,Clouds
30728,44,1553184000,28,2,30,Clouds
30729,45,1553184000,30,0,30,Clouds
30730,46,1553184000,11,9,20,Clouds
30731,47,1553184000,2,38,40,Clouds
30732,48,1553184000,1,39,40,Clouds
30733,49,1553184000,6,34,40,Clouds
30734,50,1553184000,34,6,40,Clouds
30735,51,1553184000,38,2,40,Clouds
30736,52,1553184000,12,20,32,Clouds
30737,53,1553184000,27,13,40,Clouds
30738,54,1553184000,14,19,33,Clouds
30739,55,1553184000,16,20,36,Clouds
30740,56,1553184000,3,37,40,Clouds
30741,57,1553184000,4,19,23,Clouds
30742,58,1553184000,19,21,40,Clouds
30743,59,1553184000,20,0,20,Clouds
30744,60,1553184000,28,2,30,Clouds
30745,61,1553184000,18,7,25,Clouds
30746,62,1553184000,5,35,40,Clouds
30747,63,1553184000,8,27,35,Clouds
30748,64,1553184000,23,17,40,Clouds
30749,65,1553184000,2,38,40,Clouds
30750,66,1553184000,8,32,40,Clouds
30751,67,1553184000,0,40,40,Clouds
30752,68,1553184000,1,39,40,Clouds
30753,69,1553184000,5,35,40,Clouds
30754,70,1553184000,0,28,28,Clouds
30755,71,1553184000,6,34,40,Clouds
30756,72,1553184000,18,13,31,Clouds
30757,73,1553184000,27,3,30,Clouds
30758,74,1553184000,26,4,30,Clouds
30759,75,1553184000,40,0,40,Clouds
30760,76,1553184000,36,2,38,Clouds
30761,77,1553184000,17,12,29,Clouds
30762,78,1553184000,36,4,40,Clouds
30763,79,1553184000,25,2,27,Clouds
30764,80,1553184000,38,2,40,Clouds
30765,81,1553184000,40,0,40,Clouds
30766,82,1553184000,20,2,22,Clouds
30767,83,1553184000,39,1,40,Clouds
30768,84,1553184000,29,1,30,Clouds
30769,85,1553184000,35,0,35,Clouds
30770,86,1553184000,32,6,38,Clouds
30771,87,1553184000,37,1,38,Clouds
30772,88,1553184000,23,7,30,Clouds
30773,89,1553184000,1,39,40,Clouds
30774,90,1553184000,16,24,40,Clouds
30775,91,1553184000,0,30,30,Clouds
30776,92,1553184000,35,5,40,Clouds
30777,93,1553184000,39,1,40,Clouds
30778,94,1553184000,39,1,40,Clouds
30779,95,1553184000,34,6,40,Clouds
30780,96,1553184000,30,0,30,Clouds
30781,97,1553184000,38,2,40,Clouds
30782,98,1553184000,29,11,40,Clouds
30783,99,1553184000,1,29,30,Clouds
30784,100,1553184000,21,4,25,Clouds
30785,101,1553184000,30,0,30,Clouds
30786,102,1553184000,38,2,40,Clouds
30787,103,1553184000,40,0,40,Clouds
30788,104,1553184000,40,0,40,Clouds
30789,105,1553184000,36,0,36,Clouds
30790,106,1553184000,38,2,40,Clouds
30791,107,1553184000,40,0,40,Clouds
30792,108,1553184000,40,0,40,Clouds
30793,109,1553184000,26,3,29,Clouds
30794,110,1553184000,40,0,40,Clouds
30795,111,1553184000,29,11,40,Clouds
30796,112,1553184000,26,4,30,Clouds
30797,113,1553184000,7,33,40,Clouds
30798,114,1553184000,15,25,40,Clouds
30799,115,1553184000,26,4,30,Clouds
30800,2,1553187600,19,1,20,Clouds
30801,3,1553187600,20,0,20,Clouds
30802,4,1553187600,20,0,20,Clouds
30803,5,1553187600,34,6,40,Clouds
30804,6,1553187600,20,0,20,Clouds
30805,7,1553187600,28,1,29,Clouds
30806,8,1553187600,6,24,30,Clouds
30807,9,1553187600,15,9,24,Clouds
30808,10,1553187600,14,2,16,Clouds
30809,11,1553187600,20,10,30,Clouds
30810,12,1553187600,20,0,20,Clouds
30811,13,1553187600,6,24,30,Clouds
30812,14,1553187600,17,13,30,Clouds
30813,15,1553187600,15,1,16,Clouds
30814,16,1553187600,14,6,20,Clouds
30815,17,1553187600,20,0,20,Clouds
30816,18,1553187600,23,7,30,Clouds
30817,19,1553187600,23,7,30,Clouds
30818,21,1553187600,4,26,30,Clouds
30819,22,1553187600,8,12,20,Clouds
30820,23,1553187600,19,11,30,Clouds
30821,24,1553187600,17,3,20,Clouds
30822,25,1553187600,10,20,30,Clouds
30823,26,1553187600,8,12,20,Clouds
30824,27,1553187600,18,2,20,Clouds
30825,28,1553187600,27,3,30,Clouds
30826,29,1553187600,27,2,29,Clouds
30827,30,1553187600,16,4,20,Clouds
30828,31,1553187600,14,6,20,Clouds
30829,32,1553187600,20,10,30,Clouds
30830,33,1553187600,9,14,23,Clouds
30831,34,1553187600,23,7,30,Clouds
30832,35,1553187600,25,5,30,Clouds
30833,36,1553187600,26,14,40,Clouds
30834,37,1553187600,10,20,30,Clouds
30835,38,1553187600,29,11,40,Clouds
30836,39,1553187600,19,1,20,Clouds
30837,40,1553187600,13,8,21,Clouds
30838,41,1553187600,0,20,20,Clouds
30839,42,1553187600,30,0,30,Clouds
30840,43,1553187600,22,8,30,Clouds
30841,44,1553187600,28,2,30,Clouds
30842,45,1553187600,24,6,30,Clouds
30843,46,1553187600,7,13,20,Clouds
30844,47,1553187600,9,31,40,Clouds
30845,48,1553187600,1,39,40,Clouds
30846,49,1553187600,1,39,40,Clouds
30847,50,1553187600,34,6,40,Clouds
30848,51,1553187600,37,3,40,Clouds
30849,52,1553187600,18,14,32,Clouds
30850,53,1553187600,8,32,40,Clouds
30851,54,1553187600,18,15,33,Clouds
30852,55,1553187600,23,13,36,Clouds
30853,56,1553187600,0,40,40,Clouds
30854,57,1553187600,4,19,23,Clouds
30855,58,1553187600,13,27,40,Clouds
30856,59,1553187600,18,2,20,Clouds
30857,60,1553187600,23,7,30,Clouds
30858,61,1553187600,21,4,25,Clouds
30859,62,1553187600,9,31,40,Clouds
30860,63,1553187600,3,32,35,Clouds
30861,64,1553187600,19,21,40,Clouds
30862,65,1553187600,4,36,40,Clouds
30863,66,1553187600,6,34,40,Clouds
30864,67,1553187600,0,40,40,Clouds
30865,68,1553187600,8,32,40,Clouds
30866,69,1553187600,8,32,40,Clouds
30867,70,1553187600,6,22,28,Clouds
30868,71,1553187600,11,29,40,Clouds
30869,72,1553187600,9,22,31,Clouds
30870,73,1553187600,28,2,30,Clouds
30871,74,1553187600,23,7,30,Clouds
30872,75,1553187600,38,2,40,Clouds
30873,76,1553187600,36,2,38,Clouds
30874,77,1553187600,17,12,29,Clouds
30875,78,1553187600,39,1,40,Clouds
30876,79,1553187600,27,0,27,Clouds
30877,80,1553187600,27,13,40,Clouds
30878,81,1553187600,40,0,40,Clouds
30879,82,1553187600,22,0,22,Clouds
30880,83,1553187600,40,0,40,Clouds
30881,84,1553187600,29,1,30,Clouds
30882,85,1553187600,33,2,35,Clouds
30883,86,1553187600,34,4,38,Clouds
30884,87,1553187600,36,2,38,Clouds
30885,88,1553187600,26,4,30,Clouds
30886,89,1553187600,3,37,40,Clouds
30887,90,1553187600,25,15,40,Clouds
30888,91,1553187600,1,29,30,Clouds
30889,92,1553187600,37,3,40,Clouds
30890,93,1553187600,39,1,40,Clouds
30891,94,1553187600,38,2,40,Clouds
30892,95,1553187600,33,7,40,Clouds
30893,96,1553187600,29,1,30,Clouds
30894,97,1553187600,40,0,40,Clouds
30895,98,1553187600,34,6,40,Clouds
30896,99,1553187600,4,26,30,Clouds
30897,100,1553187600,9,16,25,Clouds
30898,101,1553187600,30,0,30,Clouds
30899,102,1553187600,40,0,40,Clouds
30900,103,1553187600,40,0,40,Clouds
30901,104,1553187600,40,0,40,Clouds
30902,105,1553187600,36,0,36,Clouds
30903,106,1553187600,40,0,40,Clouds
30904,107,1553187600,39,1,40,Clouds
30905,108,1553187600,40,0,40,Clouds
30906,109,1553187600,22,7,29,Clouds
30907,110,1553187600,38,2,40,Clouds
30908,111,1553187600,33,7,40,Clouds
30909,112,1553187600,26,4,30,Clouds
30910,113,1553187600,6,34,40,Clouds
30911,114,1553187600,23,17,40,Clouds
30912,115,1553187600,30,0,30,Clouds
30913,2,1553191200,18,2,20,Clouds
30914,3,1553191200,19,1,20,Clouds
30915,4,1553191200,20,0,20,Clouds
30916,5,1553191200,23,17,40,Clouds
30917,6,1553191200,19,1,20,Clouds
30918,7,1553191200,29,0,29,Clouds
30919,8,1553191200,6,24,30,Clouds
30920,9,1553191200,13,11,24,Clouds
30921,10,1553191200,13,3,16,Clouds
30922,11,1553191200,30,0,30,Clouds
30923,12,1553191200,20,0,20,Clouds
30924,13,1553191200,15,15,30,Clouds
30925,14,1553191200,10,20,30,Clouds
30926,15,1553191200,16,0,16,Clouds
30927,16,1553191200,8,12,20,Clouds
30928,17,1553191200,20,0,20,Clouds
30929,18,1553191200,30,0,30,Clouds
30930,19,1553191200,30,0,30,Clouds
30931,21,1553191200,12,18,30,Clouds
30932,22,1553191200,14,6,20,Clouds
30933,23,1553191200,8,22,30,Clouds
30934,24,1553191200,20,0,20,Clouds
30935,25,1553191200,25,5,30,Clouds
30936,26,1553191200,8,12,20,Clouds
30937,27,1553191200,8,12,20,Clouds
30938,28,1553191200,30,0,30,Clouds
30939,29,1553191200,26,3,29,Clouds
30940,30,1553191200,20,0,20,Clouds
30941,31,1553191200,20,0,20,Clouds
30942,32,1553191200,15,15,30,Clouds
30943,33,1553191200,6,17,23,Clouds
30944,34,1553191200,12,18,30,Clouds
30945,35,1553191200,29,1,30,Clouds
30946,36,1553191200,39,1,40,Clouds
30947,37,1553191200,15,15,30,Clouds
30948,38,1553191200,20,20,40,Clouds
30949,39,1553191200,20,0,20,Clouds
30950,40,1553191200,20,1,21,Clouds
30951,41,1553191200,0,20,20,Clouds
30952,42,1553191200,30,0,30,Clouds
30953,43,1553191200,25,5,30,Clouds
30954,44,1553191200,25,5,30,Clouds
30955,45,1553191200,23,7,30,Clouds
30956,46,1553191200,9,11,20,Clouds
30957,47,1553191200,40,0,40,Clouds
30958,48,1553191200,1,39,40,Clouds
30959,49,1553191200,6,34,40,Clouds
30960,50,1553191200,39,1,40,Clouds
30961,51,1553191200,39,1,40,Clouds
30962,52,1553191200,25,7,32,Clouds
30963,53,1553191200,16,24,40,Clouds
30964,54,1553191200,22,11,33,Clouds
30965,55,1553191200,34,2,36,Clouds
30966,56,1553191200,28,12,40,Clouds
30967,57,1553191200,13,10,23,Clouds
30968,58,1553191200,8,32,40,Clouds
30969,59,1553191200,20,0,20,Clouds
30970,60,1553191200,18,12,30,Clouds
30971,61,1553191200,25,0,25,Clouds
30972,62,1553191200,23,17,40,Clouds
30973,63,1553191200,0,35,35,Clouds
30974,64,1553191200,16,24,40,Clouds
30975,65,1553191200,4,36,40,Clouds
30976,66,1553191200,33,7,40,Clouds
30977,67,1553191200,1,39,40,Clouds
30978,68,1553191200,16,24,40,Clouds
30979,69,1553191200,20,20,40,Clouds
30980,70,1553191200,6,22,28,Clouds
30981,71,1553191200,20,20,40,Clouds
30982,72,1553191200,15,16,31,Clouds
30983,73,1553191200,27,3,30,Clouds
30984,74,1553191200,4,26,30,Clouds
30985,75,1553191200,38,2,40,Clouds
30986,76,1553191200,14,24,38,Clouds
30987,77,1553191200,27,2,29,Clouds
30988,78,1553191200,39,1,40,Clouds
30989,79,1553191200,27,0,27,Clouds
30990,80,1553191200,37,3,40,Clouds
30991,81,1553191200,40,0,40,Clouds
30992,82,1553191200,22,0,22,Clouds
30993,83,1553191200,38,2,40,Clouds
30994,84,1553191200,24,6,30,Clouds
30995,85,1553191200,32,3,35,Clouds
30996,86,1553191200,25,13,38,Clouds
30997,87,1553191200,38,0,38,Clouds
30998,88,1553191200,22,8,30,Clouds
30999,89,1553191200,11,29,40,Clouds
31000,90,1553191200,30,10,40,Clouds
31001,91,1553191200,5,25,30,Clouds
31002,92,1553191200,30,10,40,Clouds
31003,93,1553191200,24,16,40,Clouds
31004,94,1553191200,38,2,40,Clouds
31005,95,1553191200,28,12,40,Clouds
31006,96,1553191200,30,0,30,Clouds
31007,97,1553191200,37,3,40,Clouds
31008,98,1553191200,36,4,40,Clouds
31009,99,1553191200,0,30,30,Clouds
31010,100,1553191200,1,24,25,Clouds
31011,101,1553191200,25,5,30,Clouds
31012,102,1553191200,39,1,40,Clouds
31013,103,1553191200,40,0,40,Clouds
31014,104,1553191200,40,0,40,Clouds
31015,105,1553191200,35,1,36,Clouds
31016,106,1553191200,40,0,40,Clouds
31017,107,1553191200,40,0,40,Clouds
31018,108,1553191200,38,2,40,Clouds
31019,109,1553191200,28,1,29,Clouds
31020,110,1553191200,38,2,40,Clouds
31021,111,1553191200,37,3,40,Clouds
31022,112,1553191200,24,6,30,Clouds
31023,113,1553191200,5,35,40,Clouds
31024,114,1553191200,40,0,40,Clouds
31025,115,1553191200,24,6,30,Clouds
31026,2,1553194800,17,3,20,Clouds
31027,3,1553194800,18,2,20,Clouds
31028,4,1553194800,20,0,20,Clouds
31029,5,1553194800,10,30,40,Clouds
31030,6,1553194800,15,5,20,Clouds
31031,7,1553194800,28,1,29,Clouds
31032,8,1553194800,5,24,29,Clouds
31033,9,1553194800,17,7,24,Clouds
31034,10,1553194800,1,15,16,Clouds
31035,11,1553194800,30,0,30,Clouds
31036,12,1553194800,15,5,20,Clouds
31037,13,1553194800,29,1,30,Clouds
31038,14,1553194800,8,22,30,Clouds
31039,15,1553194800,15,1,16,Clouds
31040,16,1553194800,5,15,20,Clouds
31041,17,1553194800,18,2,20,Clouds
31042,18,1553194800,26,4,30,Clouds
31043,19,1553194800,30,0,30,Clouds
31044,21,1553194800,0,30,30,Clouds
31045,22,1553194800,7,13,20,Clouds
31046,23,1553194800,11,19,30,Clouds
31047,24,1553194800,16,4,20,Clouds
31048,25,1553194800,30,0,30,Clouds
31049,26,1553194800,14,6,20,Clouds
31050,27,1553194800,10,10,20,Clouds
31051,28,1553194800,30,0,30,Clouds
31052,29,1553194800,25,4,29,Clouds
31053,30,1553194800,19,1,20,Clouds
31054,31,1553194800,15,5,20,Clouds
31055,32,1553194800,5,25,30,Clouds
31056,33,1553194800,0,23,23,Clouds
31057,34,1553194800,0,30,30,Clouds
31058,35,1553194800,28,2,30,Clouds
31059,36,1553194800,40,0,40,Clouds
31060,37,1553194800,30,0,30,Clouds
31061,38,1553194800,25,15,40,Clouds
31062,39,1553194800,16,4,20,Clouds
31063,40,1553194800,16,5,21,Clouds
31064,41,1553194800,18,2,20,Clouds
31065,42,1553194800,23,7,30,Clouds
31066,43,1553194800,2,28,30,Clouds
31067,44,1553194800,16,14,30,Clouds
31068,45,1553194800,17,13,30,Clouds
31069,46,1553194800,5,15,20,Clouds
31070,47,1553194800,40,0,40,Clouds
31071,48,1553194800,5,35,40,Clouds
31072,49,1553194800,37,3,40,Clouds
31073,50,1553194800,28,12,40,Clouds
31074,51,1553194800,31,9,40,Clouds
31075,52,1553194800,30,2,32,Clouds
31076,53,1553194800,36,4,40,Clouds
31077,54,1553194800,33,0,33,Clouds
31078,55,1553194800,35,1,36,Clouds
31079,56,1553194800,40,0,40,Clouds
31080,57,1553194800,21,2,23,Clouds
31081,58,1553194800,40,0,40,Clouds
31082,59,1553194800,19,1,20,Clouds
31083,60,1553194800,4,26,30,Clouds
31084,61,1553194800,23,2,25,Clouds
31085,62,1553194800,40,0,40,Clouds
31086,63,1553194800,18,17,35,Clouds
31087,64,1553194800,12,28,40,Clouds
31088,65,1553194800,40,0,40,Clouds
31089,66,1553194800,40,0,40,Clouds
31090,67,1553194800,7,33,40,Clouds
31091,68,1553194800,40,0,40,Clouds
31092,69,1553194800,38,2,40,Clouds
31093,70,1553194800,20,8,28,Clouds
31094,71,1553194800,30,10,40,Clouds
31095,72,1553194800,28,3,31,Clouds
31096,73,1553194800,28,2,30,Clouds
31097,74,1553194800,9,21,30,Clouds
31098,75,1553194800,27,13,40,Clouds
31099,76,1553194800,11,27,38,Clouds
31100,77,1553194800,29,0,29,Clouds
31101,78,1553194800,26,14,40,Clouds
31102,79,1553194800,27,0,27,Clouds
31103,80,1553194800,23,17,40,Clouds
31104,81,1553194800,40,0,40,Clouds
31105,82,1553194800,20,2,22,Clouds
31106,83,1553194800,28,12,40,Clouds
31107,84,1553194800,25,5,30,Clouds
31108,85,1553194800,29,6,35,Clouds
31109,86,1553194800,20,18,38,Clouds
31110,87,1553194800,37,1,38,Clouds
31111,88,1553194800,16,14,30,Clouds
31112,89,1553194800,40,0,40,Clouds
31113,90,1553194800,40,0,40,Clouds
31114,91,1553194800,19,11,30,Clouds
31115,92,1553194800,0,40,40,Clouds
31116,93,1553194800,0,40,40,Clouds
31117,94,1553194800,9,31,40,Clouds
31118,95,1553194800,21,19,40,Clouds
31119,96,1553194800,27,3,30,Clouds
31120,97,1553194800,36,3,39,Clouds
31121,98,1553194800,38,2,40,Clouds
31122,99,1553194800,13,17,30,Clouds
31123,100,1553194800,10,15,25,Clouds
31124,101,1553194800,25,5,30,Clouds
31125,102,1553194800,39,1,40,Clouds
31126,103,1553194800,37,3,40,Clouds
31127,104,1553194800,40,0,40,Clouds
31128,105,1553194800,36,0,36,Clouds
31129,106,1553194800,36,4,40,Clouds
31130,107,1553194800,37,3,40,Clouds
31131,108,1553194800,36,4,40,Clouds
31132,109,1553194800,25,4,29,Clouds
31133,110,1553194800,35,5,40,Clouds
31134,111,1553194800,38,2,40,Clouds
31135,112,1553194800,30,0,30,Clouds
31136,113,1553194800,33,7,40,Clouds
31137,114,1553194800,40,0,40,Clouds
31138,115,1553194800,5,25,30,Clouds
31139,2,1553198400,14,6,20,Clouds
31140,3,1553198400,17,3,20,Clouds
31141,4,1553198400,20,0,20,Clouds
31142,5,1553198400,15,25,40,Clouds
31143,6,1553198400,5,15,20,Clouds
31144,7,1553198400,27,2,29,Clouds
31145,8,1553198400,16,13,29,Clouds
31146,9,1553198400,21,3,24,Clouds
31147,10,1553198400,2,14,16,Clouds
31148,11,1553198400,29,1,30,Clouds
31149,12,1553198400,16,4,20,Clouds
31150,13,1553198400,30,0,30,Clouds
31151,14,1553198400,8,22,30,Clouds
31152,15,1553198400,9,7,16,Clouds
31153,16,1553198400,7,13,20,Clouds
31154,17,1553198400,15,5,20,Clouds
31155,18,1553198400,13,17,30,Clouds
31156,19,1553198400,29,1,30,Clouds
31157,21,1553198400,1,29,30,Clouds
31158,22,1553198400,8,12,20,Clouds
31159,23,1553198400,8,22,30,Clouds
31160,24,1553198400,12,8,20,Clouds
31161,25,1553198400,28,2,30,Clouds
31162,26,1553198400,20,0,20,Clouds
31163,27,1553198400,11,9,20,Clouds
31164,28,1553198400,28,2,30,Clouds
31165,29,1553198400,29,0,29,Clouds
31166,30,1553198400,20,0,20,Clouds
31167,31,1553198400,7,13,20,Clouds
31168,32,1553198400,10,20,30,Clouds
31169,33,1553198400,4,19,23,Clouds
31170,34,1553198400,5,25,30,Clouds
31171,35,1553198400,17,13,30,Clouds
31172,36,1553198400,38,2,40,Clouds
31173,37,1553198400,30,0,30,Clouds
31174,38,1553198400,29,11,40,Clouds
31175,39,1553198400,20,0,20,Clouds
31176,40,1553198400,19,2,21,Clouds
31177,41,1553198400,19,1,20,Clouds
31178,42,1553198400,11,19,30,Clouds
31179,43,1553198400,11,19,30,Clouds
31180,44,1553198400,8,22,30,Clouds
31181,45,1553198400,19,11,30,Clouds
31182,46,1553198400,1,19,20,Clouds
31183,47,1553198400,40,0,40,Clouds
31184,48,1553198400,23,17,40,Clouds
31185,49,1553198400,39,1,40,Clouds
31186,50,1553198400,21,19,40,Clouds
31187,51,1553198400,29,11,40,Clouds
31188,52,1553198400,32,0,32,Clouds
31189,53,1553198400,39,1,40,Clouds
31190,54,1553198400,33,0,33,Clouds
31191,55,1553198400,36,0,36,Clouds
31192,56,1553198400,32,8,40,Clouds
31193,57,1553198400,20,3,23,Clouds
31194,58,1553198400,39,1,40,Clouds
31195,59,1553198400,20,0,20,Clouds
31196,60,1553198400,1,29,30,Clouds
31197,61,1553198400,25,0,25,Clouds
31198,62,1553198400,40,0,40,Clouds
31199,63,1553198400,29,6,35,Clouds
31200,64,1553198400,26,14,40,Clouds
31201,65,1553198400,40,0,40,Clouds
31202,66,1553198400,33,7,40,Clouds
31203,67,1553198400,9,31,40,Clouds
31204,68,1553198400,38,2,40,Clouds
31205,69,1553198400,38,2,40,Clouds
31206,70,1553198400,27,1,28,Clouds
31207,71,1553198400,26,14,40,Clouds
31208,72,1553198400,26,5,31,Clouds
31209,73,1553198400,23,7,30,Clouds
31210,74,1553198400,4,26,30,Clouds
31211,75,1553198400,23,17,40,Clouds
31212,76,1553198400,7,31,38,Clouds
31213,77,1553198400,28,1,29,Clouds
31214,78,1553198400,18,22,40,Clouds
31215,79,1553198400,26,1,27,Clouds
31216,80,1553198400,28,12,40,Clouds
31217,81,1553198400,24,16,40,Clouds
31218,82,1553198400,16,6,22,Clouds
31219,83,1553198400,23,17,40,Clouds
31220,84,1553198400,17,13,30,Clouds
31221,85,1553198400,19,16,35,Clouds
31222,86,1553198400,0,38,38,Clouds
31223,87,1553198400,27,11,38,Clouds
31224,88,1553198400,13,17,30,Clouds
31225,89,1553198400,39,1,40,Clouds
31226,90,1553198400,40,0,40,Clouds
31227,91,1553198400,17,13,30,Clouds
31228,92,1553198400,0,40,40,Clouds
31229,93,1553198400,0,40,40,Clouds
31230,94,1553198400,3,37,40,Clouds
31231,95,1553198400,10,30,40,Clouds
31232,96,1553198400,26,4,30,Clouds
31233,97,1553198400,26,13,39,Clouds
31234,98,1553198400,36,4,40,Clouds
31235,99,1553198400,27,3,30,Clouds
31236,100,1553198400,11,14,25,Clouds
31237,101,1553198400,20,10,30,Clouds
31238,102,1553198400,32,8,40,Clouds
31239,103,1553198400,40,0,40,Clouds
31240,104,1553198400,40,0,40,Clouds
31241,105,1553198400,34,2,36,Clouds
31242,106,1553198400,32,8,40,Clouds
31243,107,1553198400,32,8,40,Clouds
31244,108,1553198400,31,9,40,Clouds
31245,109,1553198400,23,6,29,Clouds
31246,110,1553198400,31,9,40,Clouds
31247,111,1553198400,36,4,40,Clouds
31248,112,1553198400,27,3,30,Clouds
31249,113,1553198400,26,14,40,Clouds
31250,114,1553198400,40,0,40,Clouds
31251,115,1553198400,2,28,30,Clouds
31252,2,1553202000,11,9,20,Clouds
31253,3,1553202000,17,3,20,Clouds
31254,4,1553202000,18,2,20,Clouds
31255,5,1553202000,33,7,40,Clouds
31256,6,1553202000,7,13,20,Clouds
31257,7,1553202000,24,5,29,Clouds
31258,8,1553202000,23,6,29,Clouds
31259,9,1553202000,22,2,24,Clouds
31260,10,1553202000,7,9,16,Clouds
31261,11,1553202000,30,0,30,Clouds
31262,12,1553202000,17,3,20,Clouds
31263,13,1553202000,28,2,30,Clouds
31264,14,1553202000,4,26,30,Clouds
31265,15,1553202000,8,8,16,Clouds
31266,16,1553202000,12,8,20,Clouds
31267,17,1553202000,18,2,20,Clouds
31268,18,1553202000,10,20,30,Clouds
31269,19,1553202000,22,8,30,Clouds
31270,21,1553202000,4,26,30,Clouds
31271,22,1553202000,1,19,20,Clouds
31272,23,1553202000,9,21,30,Clouds
31273,24,1553202000,9,11,20,Clouds
31274,25,1553202000,30,0,30,Clouds
31275,26,1553202000,10,10,20,Clouds
31276,27,1553202000,19,1,20,Clouds
31277,28,1553202000,27,3,30,Clouds
31278,29,1553202000,27,2,29,Clouds
31279,30,1553202000,20,0,20,Clouds
31280,31,1553202000,8,12,20,Clouds
31281,32,1553202000,12,18,30,Clouds
31282,33,1553202000,2,21,23,Clouds
31283,34,1553202000,4,26,30,Clouds
31284,35,1553202000,13,17,30,Clouds
31285,36,1553202000,30,10,40,Clouds
31286,37,1553202000,28,2,30,Clouds
31287,38,1553202000,28,12,40,Clouds
31288,39,1553202000,19,1,20,Clouds
31289,40,1553202000,21,0,21,Clouds
31290,41,1553202000,20,0,20,Clouds
31291,42,1553202000,13,17,30,Clouds
31292,43,1553202000,16,14,30,Clouds
31293,44,1553202000,1,29,30,Clouds
31294,45,1553202000,17,13,30,Clouds
31295,46,1553202000,6,14,20,Clouds
31296,47,1553202000,40,0,40,Clouds
31297,48,1553202000,29,11,40,Clouds
31298,49,1553202000,39,1,40,Clouds
31299,50,1553202000,21,19,40,Clouds
31300,51,1553202000,37,3,40,Clouds
31301,52,1553202000,30,2,32,Clouds
31302,53,1553202000,40,0,40,Clouds
31303,54,1553202000,33,0,33,Clouds
31304,55,1553202000,36,0,36,Clouds
31305,56,1553202000,39,1,40,Clouds
31306,57,1553202000,21,2,23,Clouds
31307,58,1553202000,36,4,40,Clouds
31308,59,1553202000,18,2,20,Clouds
31309,60,1553202000,0,30,30,Clouds
31310,61,1553202000,24,1,25,Clouds
31311,62,1553202000,40,0,40,Clouds
31312,63,1553202000,32,3,35,Clouds
31313,64,1553202000,30,10,40,Clouds
31314,65,1553202000,39,1,40,Clouds
31315,66,1553202000,36,4,40,Clouds
31316,67,1553202000,7,33,40,Clouds
31317,68,1553202000,33,7,40,Clouds
31318,69,1553202000,38,2,40,Clouds
31319,70,1553202000,27,1,28,Clouds
31320,71,1553202000,25,15,40,Clouds
31321,72,1553202000,25,6,31,Clouds
31322,73,1553202000,20,10,30,Clouds
31323,74,1553202000,8,22,30,Clouds
31324,75,1553202000,18,22,40,Clouds
31325,76,1553202000,4,34,38,Clouds
31326,77,1553202000,27,2,29,Clouds
31327,78,1553202000,18,22,40,Clouds
31328,79,1553202000,26,1,27,Clouds
31329,80,1553202000,25,15,40,Clouds
31330,81,1553202000,24,16,40,Clouds
31331,82,1553202000,17,5,22,Clouds
31332,83,1553202000,14,26,40,Clouds
31333,84,1553202000,9,21,30,Clouds
31334,85,1553202000,12,23,35,Clouds
31335,86,1553202000,0,38,38,Clouds
31336,87,1553202000,23,15,38,Clouds
31337,88,1553202000,7,23,30,Clouds
31338,89,1553202000,39,1,40,Clouds
31339,90,1553202000,40,0,40,Clouds
31340,91,1553202000,10,20,30,Clouds
31341,92,1553202000,1,39,40,Clouds
31342,93,1553202000,0,40,40,Clouds
31343,94,1553202000,3,37,40,Clouds
31344,95,1553202000,11,29,40,Clouds
31345,96,1553202000,26,4,30,Clouds
31346,97,1553202000,20,20,40,Clouds
31347,98,1553202000,39,1,40,Clouds
31348,99,1553202000,28,2,30,Clouds
31349,100,1553202000,2,23,25,Clouds
31350,101,1553202000,16,14,30,Clouds
31351,102,1553202000,30,10,40,Clouds
31352,103,1553202000,39,1,40,Clouds
31353,104,1553202000,40,0,40,Clouds
31354,105,1553202000,34,2,36,Clouds
31355,106,1553202000,31,9,40,Clouds
31356,107,1553202000,28,12,40,Clouds
31357,108,1553202000,28,12,40,Clouds
31358,109,1553202000,16,13,29,Clouds
31359,110,1553202000,29,11,40,Clouds
31360,111,1553202000,38,2,40,Clouds
31361,112,1553202000,24,6,30,Clouds
31362,113,1553202000,33,7,40,Clouds
31363,114,1553202000,39,1,40,Clouds
31364,115,1553202000,2,28,30,Clouds
31365,2,1553205600,9,11,20,Clouds
31366,3,1553205600,18,2,20,Clouds
31367,4,1553205600,20,0,20,Clouds
31368,5,1553205600,31,9,40,Clouds
31369,6,1553205600,7,13,20,Clouds
31370,7,1553205600,26,3,29,Clouds
31371,8,1553205600,27,3,30,Clouds
31372,9,1553205600,21,3,24,Clouds
31373,10,1553205600,16,0,16,Clouds
31374,11,1553205600,30,0,30,Clouds
31375,12,1553205600,18,2,20,Clouds
31376,13,1553205600,30,0,30,Clouds
31377,14,1553205600,3,27,30,Clouds
31378,15,1553205600,12,4,16,Clouds
31379,16,1553205600,14,6,20,Clouds
31380,17,1553205600,17,3,20,Clouds
31381,18,1553205600,7,23,30,Clouds
31382,19,1553205600,30,0,30,Clouds
31383,21,1553205600,24,6,30,Clouds
31384,22,1553205600,8,12,20,Clouds
31385,23,1553205600,7,23,30,Clouds
31386,24,1553205600,9,11,20,Clouds
31387,25,1553205600,30,0,30,Clouds
31388,26,1553205600,11,9,20,Clouds
31389,27,1553205600,20,0,20,Clouds
31390,28,1553205600,26,4,30,Clouds
31391,29,1553205600,25,4,29,Clouds
31392,30,1553205600,19,1,20,Clouds
31393,31,1553205600,12,8,20,Clouds
31394,32,1553205600,20,10,30,Clouds
31395,33,1553205600,4,19,23,Clouds
31396,34,1553205600,2,28,30,Clouds
31397,35,1553205600,6,24,30,Clouds
31398,36,1553205600,37,3,40,Clouds
31399,37,1553205600,30,0,30,Clouds
31400,38,1553205600,30,10,40,Clouds
31401,39,1553205600,17,3,20,Clouds
31402,40,1553205600,20,1,21,Clouds
31403,41,1553205600,20,0,20,Clouds
31404,42,1553205600,10,20,30,Clouds
31405,43,1553205600,10,20,30,Clouds
31406,44,1553205600,0,30,30,Clouds
31407,45,1553205600,14,16,30,Clouds
31408,46,1553205600,8,12,20,Clouds
31409,47,1553205600,40,0,40,Clouds
31410,48,1553205600,33,7,40,Clouds
31411,49,1553205600,37,3,40,Clouds
31412,50,1553205600,17,23,40,Clouds
31413,51,1553205600,40,0,40,Clouds
31414,52,1553205600,32,0,32,Clouds
31415,53,1553205600,40,0,40,Clouds
31416,54,1553205600,33,0,33,Clouds
31417,55,1553205600,36,0,36,Clouds
31418,56,1553205600,38,2,40,Clouds
31419,57,1553205600,22,1,23,Clouds
31420,58,1553205600,35,5,40,Clouds
31421,59,1553205600,20,0,20,Clouds
31422,60,1553205600,0,30,30,Clouds
31423,61,1553205600,25,0,25,Clouds
31424,62,1553205600,40,0,40,Clouds
31425,63,1553205600,33,2,35,Clouds
31426,64,1553205600,34,6,40,Clouds
31427,65,1553205600,37,3,40,Clouds
31428,66,1553205600,37,3,40,Clouds
31429,67,1553205600,2,37,39,Clouds
31430,68,1553205600,23,17,40,Clouds
31431,69,1553205600,39,1,40,Clouds
31432,70,1553205600,17,11,28,Clouds
31433,71,1553205600,28,12,40,Clouds
31434,72,1553205600,22,9,31,Clouds
31435,73,1553205600,17,13,30,Clouds
31436,74,1553205600,3,27,30,Clouds
31437,75,1553205600,18,22,40,Clouds
31438,76,1553205600,4,34,38,Clouds
31439,77,1553205600,25,4,29,Clouds
31440,78,1553205600,9,31,40,Clouds
31441,79,1553205600,26,1,27,Clouds
31442,80,1553205600,22,18,40,Clouds
31443,81,1553205600,26,14,40,Clouds
31444,82,1553205600,18,4,22,Clouds
31445,83,1553205600,13,27,40,Clouds
31446,84,1553205600,6,24,30,Clouds
31447,85,1553205600,11,24,35,Clouds
31448,86,1553205600,0,38,38,Clouds
31449,87,1553205600,22,16,38,Clouds
31450,88,1553205600,0,30,30,Clouds
31451,89,1553205600,40,0,40,Clouds
31452,90,1553205600,40,0,40,Clouds
31453,91,1553205600,12,18,30,Clouds
31454,92,1553205600,0,40,40,Clouds
31455,93,1553205600,0,40,40,Clouds
31456,94,1553205600,1,39,40,Clouds
31457,95,1553205600,10,30,40,Clouds
31458,96,1553205600,24,6,30,Clouds
31459,97,1553205600,13,27,40,Clouds
31460,98,1553205600,38,2,40,Clouds
31461,99,1553205600,30,0,30,Clouds
31462,100,1553205600,0,25,25,Clouds
31463,101,1553205600,8,22,30,Clouds
31464,102,1553205600,31,9,40,Clouds
31465,103,1553205600,38,2,40,Clouds
31466,104,1553205600,40,0,40,Clouds
31467,105,1553205600,34,2,36,Clouds
31468,106,1553205600,29,11,40,Clouds
31469,107,1553205600,27,13,40,Clouds
31470,108,1553205600,27,13,40,Clouds
31471,109,1553205600,14,15,29,Clouds
31472,110,1553205600,33,7,40,Clouds
31473,111,1553205600,33,7,40,Clouds
31474,112,1553205600,17,13,30,Clouds
31475,113,1553205600,32,8,40,Clouds
31476,114,1553205600,40,0,40,Clouds
31477,115,1553205600,1,29,30,Clouds
31478,2,1553209200,3,17,20,Clouds
31479,3,1553209200,16,4,20,Clouds
31480,4,1553209200,20,0,20,Clouds
31481,5,1553209200,36,4,40,Clouds
31482,6,1553209200,9,11,20,Clouds
31483,7,1553209200,25,4,29,Clouds
31484,8,1553209200,28,2,30,Clouds
31485,9,1553209200,12,12,24,Clouds
31486,10,1553209200,15,1,16,Clouds
31487,11,1553209200,30,0,30,Clouds
31488,12,1553209200,16,4,20,Clouds
31489,13,1553209200,28,2,30,Clouds
31490,14,1553209200,9,21,30,Clouds
31491,15,1553209200,12,4,16,Clouds
31492,16,1553209200,19,1,20,Clouds
31493,17,1553209200,17,3,20,Clouds
31494,18,1553209200,21,9,30,Clouds
31495,19,1553209200,29,1,30,Clouds
31496,21,1553209200,29,1,30,Clouds
31497,22,1553209200,10,10,20,Clouds
31498,23,1553209200,1,29,30,Clouds
31499,24,1553209200,10,10,20,Clouds
31500,25,1553209200,30,0,30,Clouds
31501,26,1553209200,12,8,20,Clouds
31502,27,1553209200,20,0,20,Clouds
31503,28,1553209200,17,13,30,Clouds
31504,29,1553209200,23,6,29,Clouds
31505,30,1553209200,20,0,20,Clouds
31506,31,1553209200,16,4,20,Clouds
31507,32,1553209200,24,6,30,Clouds
31508,33,1553209200,10,13,23,Clouds
31509,34,1553209200,19,11,30,Clouds
31510,35,1553209200,1,29,30,Clouds
31511,36,1553209200,31,9,40,Clouds
31512,37,1553209200,30,0,30,Clouds
31513,38,1553209200,30,10,40,Clouds
31514,39,1553209200,18,2,20,Clouds
31515,40,1553209200,21,0,21,Clouds
31516,41,1553209200,20,0,20,Clouds
31517,42,1553209200,4,26,30,Clouds
31518,43,1553209200,2,28,30,Clouds
31519,44,1553209200,2,28,30,Clouds
31520,45,1553209200,13,17,30,Clouds
31521,46,1553209200,10,10,20,Clouds
31522,47,1553209200,39,1,40,Clouds
31523,48,1553209200,40,0,40,Clouds
31524,49,1553209200,36,4,40,Clouds
31525,50,1553209200,12,28,40,Clouds
31526,51,1553209200,40,0,40,Clouds
31527,52,1553209200,32,0,32,Clouds
31528,53,1553209200,39,1,40,Clouds
31529,54,1553209200,32,1,33,Clouds
31530,55,1553209200,36,0,36,Clouds
31531,56,1553209200,37,3,40,Clouds
31532,57,1553209200,22,1,23,Clouds
31533,58,1553209200,38,2,40,Clouds
31534,59,1553209200,19,1,20,Clouds
31535,60,1553209200,10,20,30,Clouds
31536,61,1553209200,10,15,25,Clouds
31537,62,1553209200,39,0,39,Clouds
31538,63,1553209200,33,2,35,Clouds
31539,64,1553209200,37,3,40,Clouds
31540,65,1553209200,38,2,40,Clouds
31541,66,1553209200,37,3,40,Clouds
31542,67,1553209200,1,39,40,Clouds
31543,68,1553209200,27,13,40,Clouds
31544,69,1553209200,36,4,40,Clouds
31545,70,1553209200,15,13,28,Clouds
31546,71,1553209200,38,2,40,Clouds
31547,72,1553209200,18,13,31,Clouds
31548,73,1553209200,13,17,30,Clouds
31549,74,1553209200,0,30,30,Clouds
31550,75,1553209200,17,23,40,Clouds
31551,76,1553209200,3,35,38,Clouds
31552,77,1553209200,28,1,29,Clouds
31553,78,1553209200,4,36,40,Clouds
31554,79,1553209200,26,1,27,Clouds
31555,80,1553209200,24,16,40,Clouds
31556,81,1553209200,25,15,40,Clouds
31557,82,1553209200,15,7,22,Clouds
31558,83,1553209200,19,21,40,Clouds
31559,84,1553209200,3,27,30,Clouds
31560,85,1553209200,8,27,35,Clouds
31561,86,1553209200,10,28,38,Clouds
31562,87,1553209200,15,23,38,Clouds
31563,88,1553209200,1,29,30,Clouds
31564,89,1553209200,40,0,40,Clouds
31565,90,1553209200,40,0,40,Clouds
31566,91,1553209200,8,22,30,Clouds
31567,92,1553209200,9,31,40,Clouds
31568,93,1553209200,0,40,40,Clouds
31569,94,1553209200,1,39,40,Clouds
31570,95,1553209200,9,31,40,Clouds
31571,96,1553209200,23,7,30,Clouds
31572,97,1553209200,11,29,40,Clouds
31573,98,1553209200,40,0,40,Clouds
31574,99,1553209200,30,0,30,Clouds
31575,100,1553209200,1,24,25,Clouds
31576,101,1553209200,5,25,30,Clouds
31577,102,1553209200,31,9,40,Clouds
31578,103,1553209200,40,0,40,Clouds
31579,104,1553209200,40,0,40,Clouds
31580,105,1553209200,35,1,36,Clouds
31581,106,1553209200,27,13,40,Clouds
31582,107,1553209200,26,14,40,Clouds
31583,108,1553209200,25,15,40,Clouds
31584,109,1553209200,4,25,29,Clouds
31585,110,1553209200,31,9,40,Clouds
31586,111,1553209200,31,9,40,Clouds
31587,112,1553209200,9,21,30,Clouds
31588,113,1553209200,33,7,40,Clouds
31589,114,1553209200,40,0,40,Clouds
31590,115,1553209200,9,21,30,Clouds
31591,2,1553212800,0,20,20,Clouds
31592,3,1553212800,9,11,20,Clouds
31593,4,1553212800,19,1,20,Clouds
31594,5,1553212800,33,7,40,Clouds
31595,6,1553212800,14,6,20,Clouds
31596,7,1553212800,24,5,29,Clouds
31597,8,1553212800,28,2,30,Clouds
31598,9,1553212800,22,2,24,Clouds
31599,10,1553212800,16,0,16,Clouds
31600,11,1553212800,30,0,30,Clouds
31601,12,1553212800,14,6,20,Clouds
31602,13,1553212800,28,2,30,Clouds
31603,14,1553212800,18,12,30,Clouds
31604,15,1553212800,7,9,16,Clouds
31605,16,1553212800,20,0,20,Clouds
31606,17,1553212800,20,0,20,Clouds
31607,18,1553212800,28,2,30,Clouds
31608,19,1553212800,28,2,30,Clouds
31609,21,1553212800,30,0,30,Clouds
31610,22,1553212800,15,5,20,Clouds
31611,23,1553212800,13,17,30,Clouds
31612,24,1553212800,5,15,20,Clouds
31613,25,1553212800,30,0,30,Clouds
31614,26,1553212800,14,6,20,Clouds
31615,27,1553212800,20,0,20,Clouds
31616,28,1553212800,7,23,30,Clouds
31617,29,1553212800,29,0,29,Clouds
31618,30,1553212800,20,0,20,Clouds
31619,31,1553212800,18,2,20,Clouds
31620,32,1553212800,21,9,30,Clouds
31621,33,1553212800,8,15,23,Clouds
31622,34,1553212800,21,9,30,Clouds
31623,35,1553212800,5,25,30,Clouds
31624,36,1553212800,31,9,40,Clouds
31625,37,1553212800,22,8,30,Clouds
31626,38,1553212800,30,10,40,Clouds
31627,39,1553212800,13,7,20,Clouds
31628,40,1553212800,21,0,21,Clouds
31629,41,1553212800,19,1,20,Clouds
31630,42,1553212800,4,26,30,Clouds
31631,43,1553212800,0,30,30,Clouds
31632,44,1553212800,4,26,30,Clouds
31633,45,1553212800,10,20,30,Clouds
31634,46,1553212800,11,9,20,Clouds
31635,47,1553212800,38,2,40,Clouds
31636,48,1553212800,39,1,40,Clouds
31637,49,1553212800,38,2,40,Clouds
31638,50,1553212800,11,29,40,Clouds
31639,51,1553212800,38,2,40,Clouds
31640,52,1553212800,30,2,32,Clouds
31641,53,1553212800,40,0,40,Clouds
31642,54,1553212800,33,0,33,Clouds
31643,55,1553212800,36,0,36,Clouds
31644,56,1553212800,35,5,40,Clouds
31645,57,1553212800,22,1,23,Clouds
31646,58,1553212800,37,3,40,Clouds
31647,59,1553212800,19,1,20,Clouds
31648,60,1553212800,10,20,30,Clouds
31649,61,1553212800,13,12,25,Clouds
31650,62,1553212800,32,7,39,Clouds
31651,63,1553212800,33,2,35,Clouds
31652,64,1553212800,35,5,40,Clouds
31653,65,1553212800,38,2,40,Clouds
31654,66,1553212800,33,7,40,Clouds
31655,67,1553212800,1,39,40,Clouds
31656,68,1553212800,35,5,40,Clouds
31657,69,1553212800,38,2,40,Clouds
31658,70,1553212800,14,14,28,Clouds
31659,71,1553212800,35,5,40,Clouds
31660,72,1553212800,18,13,31,Clouds
31661,73,1553212800,15,15,30,Clouds
31662,74,1553212800,0,30,30,Clouds
31663,75,1553212800,13,27,40,Clouds
31664,76,1553212800,3,35,38,Clouds
31665,77,1553212800,28,1,29,Clouds
31666,78,1553212800,7,33,40,Clouds
31667,79,1553212800,26,1,27,Clouds
31668,80,1553212800,23,17,40,Clouds
31669,81,1553212800,25,15,40,Clouds
31670,82,1553212800,14,8,22,Clouds
31671,83,1553212800,17,23,40,Clouds
31672,84,1553212800,1,29,30,Clouds
31673,85,1553212800,14,21,35,Clouds
31674,86,1553212800,7,31,38,Clouds
31675,87,1553212800,15,23,38,Clouds
31676,88,1553212800,1,29,30,Clouds
31677,89,1553212800,40,0,40,Clouds
31678,90,1553212800,40,0,40,Clouds
31679,91,1553212800,9,21,30,Clouds
31680,92,1553212800,6,34,40,Clouds
31681,93,1553212800,0,40,40,Clouds
31682,94,1553212800,1,39,40,Clouds
31683,95,1553212800,6,34,40,Clouds
31684,96,1553212800,23,7,30,Clouds
31685,97,1553212800,9,31,40,Clouds
31686,98,1553212800,40,0,40,Clouds
31687,99,1553212800,30,0,30,Clouds
31688,100,1553212800,1,24,25,Clouds
31689,101,1553212800,4,26,30,Clouds
31690,102,1553212800,27,13,40,Clouds
31691,103,1553212800,33,7,40,Clouds
31692,104,1553212800,33,7,40,Clouds
31693,105,1553212800,30,6,36,Clouds
31694,106,1553212800,26,14,40,Clouds
31695,107,1553212800,24,16,40,Clouds
31696,108,1553212800,24,16,40,Clouds
31697,109,1553212800,1,28,29,Clouds
31698,110,1553212800,31,9,40,Clouds
31699,111,1553212800,29,11,40,Clouds
31700,112,1553212800,7,23,30,Clouds
31701,113,1553212800,33,7,40,Clouds
31702,114,1553212800,34,6,40,Clouds
31703,115,1553212800,5,25,30,Clouds
31704,2,1553216400,1,19,20,Clouds
31705,3,1553216400,10,10,20,Clouds
31706,4,1553216400,19,1,20,Clouds
31707,5,1553216400,30,10,40,Clouds
31708,6,1553216400,20,0,20,Clouds
31709,7,1553216400,27,2,29,Clouds
31710,8,1553216400,29,1,30,Clouds
31711,9,1553216400,24,0,24,Clouds
31712,10,1553216400,16,0,16,Clouds
31713,11,1553216400,30,0,30,Clouds
31714,12,1553216400,14,6,20,Clouds
31715,13,1553216400,27,3,30,Clouds
31716,14,1553216400,29,1,30,Clouds
31717,15,1553216400,5,11,16,Clouds
31718,16,1553216400,20,0,20,Clouds
31719,17,1553216400,19,1,20,Clouds
31720,18,1553216400,29,1,30,Clouds
31721,19,1553216400,25,5,30,Clouds
31722,21,1553216400,30,0,30,Clouds
31723,22,1553216400,14,6,20,Clouds
31724,23,1553216400,16,14,30,Clouds
31725,24,1553216400,8,12,20,Clouds
31726,25,1553216400,30,0,30,Clouds
31727,26,1553216400,15,5,20,Clouds
31728,27,1553216400,20,0,20,Clouds
31729,28,1553216400,5,25,30,Clouds
31730,29,1553216400,29,0,29,Clouds
31731,30,1553216400,19,1,20,Clouds
31732,31,1553216400,19,1,20,Clouds
31733,32,1553216400,25,5,30,Clouds
31734,33,1553216400,11,12,23,Clouds
31735,34,1553216400,20,10,30,Clouds
31736,35,1553216400,6,24,30,Clouds
31737,36,1553216400,34,6,40,Clouds
31738,37,1553216400,25,5,30,Clouds
31739,38,1553216400,30,10,40,Clouds
31740,39,1553216400,9,11,20,Clouds
31741,40,1553216400,19,2,21,Clouds
31742,41,1553216400,19,1,20,Clouds
31743,42,1553216400,5,25,30,Clouds
31744,43,1553216400,0,30,30,Clouds
31745,44,1553216400,2,28,30,Clouds
31746,45,1553216400,7,23,30,Clouds
31747,46,1553216400,17,3,20,Clouds
31748,47,1553216400,38,2,40,Clouds
31749,48,1553216400,38,2,40,Clouds
31750,49,1553216400,35,5,40,Clouds
31751,50,1553216400,8,32,40,Clouds
31752,51,1553216400,37,3,40,Clouds
31753,52,1553216400,28,4,32,Clouds
31754,53,1553216400,40,0,40,Clouds
31755,54,1553216400,33,0,33,Clouds
31756,55,1553216400,36,0,36,Clouds
31757,56,1553216400,38,2,40,Clouds
31758,57,1553216400,23,0,23,Clouds
31759,58,1553216400,37,3,40,Clouds
31760,59,1553216400,19,1,20,Clouds
31761,60,1553216400,4,26,30,Clouds
31762,61,1553216400,14,11,25,Clouds
31763,62,1553216400,37,3,40,Clouds
31764,63,1553216400,35,0,35,Clouds
31765,64,1553216400,40,0,40,Clouds
31766,65,1553216400,40,0,40,Clouds
31767,66,1553216400,24,16,40,Clouds
31768,67,1553216400,15,25,40,Clouds
31769,68,1553216400,39,1,40,Clouds
31770,69,1553216400,39,1,40,Clouds
31771,70,1553216400,17,11,28,Clouds
31772,71,1553216400,35,5,40,Clouds
31773,72,1553216400,15,16,31,Clouds
31774,73,1553216400,14,16,30,Clouds
31775,74,1553216400,0,30,30,Clouds
31776,75,1553216400,12,28,40,Clouds
31777,76,1553216400,4,34,38,Clouds
31778,77,1553216400,25,4,29,Clouds
31779,78,1553216400,6,34,40,Clouds
31780,79,1553216400,25,2,27,Clouds
31781,80,1553216400,22,18,40,Clouds
31782,81,1553216400,25,15,40,Clouds
31783,82,1553216400,12,10,22,Clouds
31784,83,1553216400,15,25,40,Clouds
31785,84,1553216400,1,29,30,Clouds
31786,85,1553216400,10,25,35,Clouds
31787,86,1553216400,8,30,38,Clouds
31788,87,1553216400,14,24,38,Clouds
31789,88,1553216400,4,26,30,Clouds
31790,89,1553216400,40,0,40,Clouds
31791,90,1553216400,37,3,40,Clouds
31792,91,1553216400,12,18,30,Clouds
31793,92,1553216400,5,35,40,Clouds
31794,93,1553216400,0,40,40,Clouds
31795,94,1553216400,1,39,40,Clouds
31796,95,1553216400,4,36,40,Clouds
31797,96,1553216400,23,7,30,Clouds
31798,97,1553216400,9,31,40,Clouds
31799,98,1553216400,38,2,40,Clouds
31800,99,1553216400,30,0,30,Clouds
31801,100,1553216400,1,24,25,Clouds
31802,101,1553216400,3,27,30,Clouds
31803,102,1553216400,26,14,40,Clouds
31804,103,1553216400,34,6,40,Clouds
31805,104,1553216400,33,7,40,Clouds
31806,105,1553216400,30,6,36,Clouds
31807,106,1553216400,23,17,40,Clouds
31808,107,1553216400,22,18,40,Clouds
31809,108,1553216400,20,20,40,Clouds
31810,109,1553216400,6,23,29,Clouds
31811,110,1553216400,31,9,40,Clouds
31812,111,1553216400,25,15,40,Clouds
31813,112,1553216400,1,29,30,Clouds
31814,113,1553216400,34,6,40,Clouds
31815,114,1553216400,36,4,40,Clouds
31816,115,1553216400,0,30,30,Clouds
31817,2,1553220000,0,20,20,Clouds
31818,3,1553220000,11,9,20,Clouds
31819,4,1553220000,19,1,20,Clouds
31820,5,1553220000,31,9,40,Clouds
31821,6,1553220000,20,0,20,Clouds
31822,7,1553220000,28,1,29,Clouds
31823,8,1553220000,30,0,30,Clouds
31824,9,1553220000,24,0,24,Clouds
31825,10,1553220000,15,1,16,Clouds
31826,11,1553220000,30,0,30,Clouds
31827,12,1553220000,14,6,20,Clouds
31828,13,1553220000,27,3,30,Clouds
31829,14,1553220000,29,1,30,Clouds
31830,15,1553220000,4,12,16,Clouds
31831,16,1553220000,20,0,20,Clouds
31832,17,1553220000,20,0,20,Clouds
31833,18,1553220000,26,4,30,Clouds
31834,19,1553220000,23,7,30,Clouds
31835,21,1553220000,30,0,30,Clouds
31836,22,1553220000,14,6,20,Clouds
31837,23,1553220000,19,11,30,Clouds
31838,24,1553220000,6,14,20,Clouds
31839,25,1553220000,30,0,30,Clouds
31840,26,1553220000,17,3,20,Clouds
31841,27,1553220000,20,0,20,Clouds
31842,28,1553220000,5,25,30,Clouds
31843,29,1553220000,29,0,29,Clouds
31844,30,1553220000,19,1,20,Clouds
31845,31,1553220000,19,1,20,Clouds
31846,32,1553220000,26,4,30,Clouds
31847,33,1553220000,12,11,23,Clouds
31848,34,1553220000,21,9,30,Clouds
31849,35,1553220000,7,23,30,Clouds
31850,36,1553220000,35,5,40,Clouds
31851,37,1553220000,26,4,30,Clouds
31852,38,1553220000,33,7,40,Clouds
31853,39,1553220000,7,13,20,Clouds
31854,40,1553220000,20,1,21,Clouds
31855,41,1553220000,19,1,20,Clouds
31856,42,1553220000,6,24,30,Clouds
31857,43,1553220000,0,30,30,Clouds
31858,44,1553220000,1,29,30,Clouds
31859,45,1553220000,8,22,30,Clouds
31860,46,1553220000,20,0,20,Clouds
31861,47,1553220000,37,3,40,Clouds
31862,48,1553220000,40,0,40,Clouds
31863,49,1553220000,37,3,40,Clouds
31864,50,1553220000,5,35,40,Clouds
31865,51,1553220000,39,1,40,Clouds
31866,52,1553220000,30,2,32,Clouds
31867,53,1553220000,40,0,40,Clouds
31868,54,1553220000,33,0,33,Clouds
31869,55,1553220000,36,0,36,Clouds
31870,56,1553220000,36,4,40,Clouds
31871,57,1553220000,22,1,23,Clouds
31872,58,1553220000,39,1,40,Clouds
31873,59,1553220000,20,0,20,Clouds
31874,60,1553220000,1,29,30,Clouds
31875,61,1553220000,13,12,25,Clouds
31876,62,1553220000,37,3,40,Clouds
31877,63,1553220000,35,0,35,Clouds
31878,64,1553220000,40,0,40,Clouds
31879,65,1553220000,40,0,40,Clouds
31880,66,1553220000,23,17,40,Clouds
31881,67,1553220000,13,27,40,Clouds
31882,68,1553220000,40,0,40,Clouds
31883,69,1553220000,39,1,40,Clouds
31884,70,1553220000,16,12,28,Clouds
31885,71,1553220000,34,6,40,Clouds
31886,72,1553220000,15,16,31,Clouds
31887,73,1553220000,13,17,30,Clouds
31888,74,1553220000,0,30,30,Clouds
31889,75,1553220000,12,28,40,Clouds
31890,76,1553220000,4,34,38,Clouds
31891,77,1553220000,26,3,29,Clouds
31892,78,1553220000,4,36,40,Clouds
31893,79,1553220000,25,2,27,Clouds
31894,80,1553220000,21,19,40,Clouds
31895,81,1553220000,25,15,40,Clouds
31896,82,1553220000,11,11,22,Clouds
31897,83,1553220000,13,27,40,Clouds
31898,84,1553220000,0,30,30,Clouds
31899,85,1553220000,10,25,35,Clouds
31900,86,1553220000,9,29,38,Clouds
31901,87,1553220000,15,23,38,Clouds
31902,88,1553220000,3,27,30,Clouds
31903,89,1553220000,40,0,40,Clouds
31904,90,1553220000,36,4,40,Clouds
31905,91,1553220000,11,19,30,Clouds
31906,92,1553220000,5,35,40,Clouds
31907,93,1553220000,0,40,40,Clouds
31908,94,1553220000,1,39,40,Clouds
31909,95,1553220000,1,39,40,Clouds
31910,96,1553220000,23,7,30,Clouds
31911,97,1553220000,8,32,40,Clouds
31912,98,1553220000,40,0,40,Clouds
31913,99,1553220000,30,0,30,Clouds
31914,100,1553220000,1,24,25,Clouds
31915,101,1553220000,1,29,30,Clouds
31916,102,1553220000,24,16,40,Clouds
31917,103,1553220000,34,6,40,Clouds
31918,104,1553220000,33,7,40,Clouds
31919,105,1553220000,29,7,36,Clouds
31920,106,1553220000,24,16,40,Clouds
31921,107,1553220000,20,20,40,Clouds
31922,108,1553220000,20,20,40,Clouds
31923,109,1553220000,6,23,29,Clouds
31924,110,1553220000,32,8,40,Clouds
31925,111,1553220000,19,21,40,Clouds
31926,112,1553220000,0,30,30,Clouds
31927,113,1553220000,34,6,40,Clouds
31928,114,1553220000,34,6,40,Clouds
31929,115,1553220000,1,29,30,Clouds
31930,2,1553223600,0,20,20,Clouds
31931,3,1553223600,11,9,20,Clouds
31932,4,1553223600,19,1,20,Clouds
31933,5,1553223600,31,9,40,Clouds
31934,6,1553223600,19,1,20,Clouds
31935,7,1553223600,28,1,29,Clouds
31936,8,1553223600,30,0,30,Clouds
31937,9,1553223600,24,0,24,Clouds
31938,10,1553223600,15,1,16,Clouds
31939,11,1553223600,30,0,30,Clouds
31940,12,1553223600,14,6,20,Clouds
31941,13,1553223600,27,3,30,Clouds
31942,14,1553223600,29,1,30,Clouds
31943,15,1553223600,4,12,16,Clouds
31944,16,1553223600,20,0,20,Clouds
31945,17,1553223600,20,0,20,Clouds
31946,18,1553223600,26,4,30,Clouds
31947,19,1553223600,23,7,30,Clouds
31948,21,1553223600,30,0,30,Clouds
31949,22,1553223600,14,6,20,Clouds
31950,23,1553223600,19,11,30,Clouds
31951,24,1553223600,6,14,20,Clouds
31952,25,1553223600,30,0,30,Clouds
31953,26,1553223600,17,3,20,Clouds
31954,27,1553223600,20,0,20,Clouds
31955,28,1553223600,5,25,30,Clouds
31956,29,1553223600,29,0,29,Clouds
31957,30,1553223600,19,1,20,Clouds
31958,31,1553223600,19,1,20,Clouds
31959,32,1553223600,26,4,30,Clouds
31960,33,1553223600,12,11,23,Clouds
31961,34,1553223600,21,9,30,Clouds
31962,35,1553223600,7,23,30,Clouds
31963,36,1553223600,35,5,40,Clouds
31964,37,1553223600,26,4,30,Clouds
31965,38,1553223600,33,7,40,Clouds
31966,39,1553223600,7,13,20,Clouds
31967,40,1553223600,20,1,21,Clouds
31968,41,1553223600,19,1,20,Clouds
31969,42,1553223600,6,24,30,Clouds
31970,43,1553223600,0,30,30,Clouds
31971,44,1553223600,1,29,30,Clouds
31972,45,1553223600,8,22,30,Clouds
31973,46,1553223600,20,0,20,Clouds
31974,47,1553223600,37,3,40,Clouds
31975,48,1553223600,40,0,40,Clouds
31976,49,1553223600,37,3,40,Clouds
31977,50,1553223600,5,35,40,Clouds
31978,51,1553223600,39,1,40,Clouds
31979,52,1553223600,30,2,32,Clouds
31980,53,1553223600,40,0,40,Clouds
31981,54,1553223600,33,0,33,Clouds
31982,55,1553223600,36,0,36,Clouds
31983,56,1553223600,36,4,40,Clouds
31984,57,1553223600,22,1,23,Clouds
31985,58,1553223600,39,1,40,Clouds
31986,59,1553223600,19,1,20,Clouds
31987,60,1553223600,1,29,30,Clouds
31988,61,1553223600,13,12,25,Clouds
31989,62,1553223600,37,3,40,Clouds
31990,63,1553223600,35,0,35,Clouds
31991,64,1553223600,40,0,40,Clouds
31992,65,1553223600,40,0,40,Clouds
31993,66,1553223600,22,18,40,Clouds
31994,67,1553223600,13,27,40,Clouds
31995,68,1553223600,40,0,40,Clouds
31996,69,1553223600,39,1,40,Clouds
31997,70,1553223600,16,12,28,Clouds
31998,71,1553223600,34,6,40,Clouds
31999,72,1553223600,15,16,31,Clouds
32000,73,1553223600,13,17,30,Clouds
32001,74,1553223600,0,30,30,Clouds
32002,75,1553223600,12,28,40,Clouds
32003,76,1553223600,4,34,38,Clouds
32004,77,1553223600,26,3,29,Clouds
32005,78,1553223600,4,36,40,Clouds
32006,79,1553223600,25,2,27,Clouds
32007,80,1553223600,21,19,40,Clouds
32008,81,1553223600,25,15,40,Clouds
32009,82,1553223600,11,11,22,Clouds
32010,83,1553223600,13,27,40,Clouds
32011,84,1553223600,0,30,30,Clouds
32012,85,1553223600,9,26,35,Clouds
32013,86,1553223600,9,29,38,Clouds
32014,87,1553223600,15,23,38,Clouds
32015,88,1553223600,3,27,30,Clouds
32016,89,1553223600,40,0,40,Clouds
32017,90,1553223600,36,4,40,Clouds
32018,91,1553223600,11,19,30,Clouds
32019,92,1553223600,5,35,40,Clouds
32020,93,1553223600,0,40,40,Clouds
32021,94,1553223600,1,39,40,Clouds
32022,95,1553223600,1,39,40,Clouds
32023,96,1553223600,23,7,30,Clouds
32024,97,1553223600,8,32,40,Clouds
32025,98,1553223600,40,0,40,Clouds
32026,99,1553223600,30,0,30,Clouds
32027,100,1553223600,1,24,25,Clouds
32028,101,1553223600,1,29,30,Clouds
32029,102,1553223600,24,16,40,Clouds
32030,103,1553223600,34,6,40,Clouds
32031,104,1553223600,33,7,40,Clouds
32032,105,1553223600,29,7,36,Clouds
32033,106,1553223600,24,16,40,Clouds
32034,107,1553223600,20,20,40,Clouds
32035,108,1553223600,20,20,40,Clouds
32036,109,1553223600,6,23,29,Clouds
32037,110,1553223600,32,8,40,Clouds
32038,111,1553223600,19,21,40,Clouds
32039,112,1553223600,0,30,30,Clouds
32040,113,1553223600,34,6,40,Clouds
32041,114,1553223600,34,6,40,Clouds
32042,115,1553223600,1,29,30,Clouds
32043,2,1553227200,0,20,20,Clouds
32044,3,1553227200,11,9,20,Clouds
32045,4,1553227200,19,1,20,Clouds
32046,5,1553227200,31,9,40,Clouds
32047,6,1553227200,19,1,20,Clouds
32048,7,1553227200,28,1,29,Clouds
32049,8,1553227200,30,0,30,Clouds
32050,9,1553227200,24,0,24,Clouds
32051,10,1553227200,15,1,16,Clouds
32052,11,1553227200,30,0,30,Clouds
32053,12,1553227200,14,6,20,Clouds
32054,13,1553227200,27,3,30,Clouds
32055,14,1553227200,29,1,30,Clouds
32056,15,1553227200,4,12,16,Clouds
32057,16,1553227200,20,0,20,Clouds
32058,17,1553227200,20,0,20,Clouds
32059,18,1553227200,26,4,30,Clouds
32060,19,1553227200,23,7,30,Clouds
32061,21,1553227200,30,0,30,Clouds
32062,22,1553227200,14,6,20,Clouds
32063,23,1553227200,19,11,30,Clouds
32064,24,1553227200,6,14,20,Clouds
32065,25,1553227200,30,0,30,Clouds
32066,26,1553227200,17,3,20,Clouds
32067,27,1553227200,20,0,20,Clouds
32068,28,1553227200,5,25,30,Clouds
32069,29,1553227200,29,0,29,Clouds
32070,30,1553227200,19,1,20,Clouds
32071,31,1553227200,19,1,20,Clouds
32072,32,1553227200,26,4,30,Clouds
32073,33,1553227200,12,11,23,Clouds
32074,34,1553227200,21,9,30,Clouds
32075,35,1553227200,7,23,30,Clouds
32076,36,1553227200,35,5,40,Clouds
32077,37,1553227200,26,4,30,Clouds
32078,38,1553227200,33,7,40,Clouds
32079,39,1553227200,7,13,20,Clouds
32080,40,1553227200,20,1,21,Clouds
32081,41,1553227200,19,1,20,Clouds
32082,42,1553227200,6,24,30,Clouds
32083,43,1553227200,0,30,30,Clouds
32084,44,1553227200,1,29,30,Clouds
32085,45,1553227200,8,22,30,Clouds
32086,46,1553227200,20,0,20,Clouds
32087,47,1553227200,37,3,40,Clouds
32088,48,1553227200,40,0,40,Clouds
32089,49,1553227200,37,3,40,Clouds
32090,50,1553227200,5,35,40,Clouds
32091,51,1553227200,39,1,40,Clouds
32092,52,1553227200,30,2,32,Clouds
32093,53,1553227200,40,0,40,Clouds
32094,54,1553227200,33,0,33,Clouds
32095,55,1553227200,36,0,36,Clouds
32096,56,1553227200,36,4,40,Clouds
32097,57,1553227200,22,1,23,Clouds
32098,58,1553227200,39,1,40,Clouds
32099,59,1553227200,19,1,20,Clouds
32100,60,1553227200,1,29,30,Clouds
32101,61,1553227200,13,12,25,Clouds
32102,62,1553227200,37,3,40,Clouds
32103,63,1553227200,35,0,35,Clouds
32104,64,1553227200,40,0,40,Clouds
32105,65,1553227200,40,0,40,Clouds
32106,66,1553227200,22,18,40,Clouds
32107,67,1553227200,13,27,40,Clouds
32108,68,1553227200,40,0,40,Clouds
32109,69,1553227200,39,1,40,Clouds
32110,70,1553227200,16,12,28,Clouds
32111,71,1553227200,34,6,40,Clouds
32112,72,1553227200,15,16,31,Clouds
32113,73,1553227200,13,17,30,Clouds
32114,74,1553227200,0,30,30,Clouds
32115,75,1553227200,12,28,40,Clouds
32116,76,1553227200,4,34,38,Clouds
32117,77,1553227200,26,3,29,Clouds
32118,78,1553227200,4,36,40,Clouds
32119,79,1553227200,25,2,27,Clouds
32120,80,1553227200,21,19,40,Clouds
32121,81,1553227200,25,15,40,Clouds
32122,82,1553227200,11,11,22,Clouds
32123,83,1553227200,13,27,40,Clouds
32124,84,1553227200,0,30,30,Clouds
32125,85,1553227200,9,26,35,Clouds
32126,86,1553227200,9,29,38,Clouds
32127,87,1553227200,15,23,38,Clouds
32128,88,1553227200,3,27,30,Clouds
32129,89,1553227200,40,0,40,Clouds
32130,90,1553227200,36,4,40,Clouds
32131,91,1553227200,11,19,30,Clouds
32132,92,1553227200,5,35,40,Clouds
32133,93,1553227200,0,40,40,Clouds
32134,94,1553227200,1,39,40,Clouds
32135,95,1553227200,1,39,40,Clouds
32136,96,1553227200,23,7,30,Clouds
32137,97,1553227200,8,32,40,Clouds
32138,98,1553227200,40,0,40,Clouds
32139,99,1553227200,30,0,30,Clouds
32140,100,1553227200,1,24,25,Clouds
32141,101,1553227200,1,29,30,Clouds
32142,102,1553227200,24,16,40,Clouds
32143,103,1553227200,34,6,40,Clouds
32144,104,1553227200,33,7,40,Clouds
32145,105,1553227200,29,7,36,Clouds
32146,106,1553227200,24,16,40,Clouds
32147,107,1553227200,20,20,40,Clouds
32148,108,1553227200,20,20,40,Clouds
32149,109,1553227200,6,23,29,Clouds
32150,110,1553227200,32,8,40,Clouds
32151,111,1553227200,19,21,40,Clouds
32152,112,1553227200,0,30,30,Clouds
32153,113,1553227200,34,6,40,Clouds
32154,114,1553227200,34,6,40,Clouds
32155,115,1553227200,1,29,30,Clouds
32156,2,1553230800,0,20,20,Clouds
32157,3,1553230800,11,9,20,Clouds
32158,4,1553230800,19,1,20,Clouds
32159,5,1553230800,31,9,40,Clouds
32160,6,1553230800,19,1,20,Clouds
32161,7,1553230800,28,1,29,Clouds
32162,8,1553230800,30,0,30,Clouds
32163,9,1553230800,24,0,24,Clouds
32164,10,1553230800,15,1,16,Clouds
32165,11,1553230800,30,0,30,Clouds
32166,12,1553230800,14,6,20,Clouds
32167,13,1553230800,27,3,30,Clouds
32168,14,1553230800,28,2,30,Clouds
32169,15,1553230800,4,12,16,Clouds
32170,16,1553230800,20,0,20,Clouds
32171,17,1553230800,20,0,20,Clouds
32172,18,1553230800,26,4,30,Clouds
32173,19,1553230800,23,7,30,Clouds
32174,21,1553230800,30,0,30,Clouds
32175,22,1553230800,14,6,20,Clouds
32176,23,1553230800,19,11,30,Clouds
32177,24,1553230800,6,14,20,Clouds
32178,25,1553230800,30,0,30,Clouds
32179,26,1553230800,17,3,20,Clouds
32180,27,1553230800,20,0,20,Clouds
32181,28,1553230800,5,25,30,Clouds
32182,29,1553230800,29,0,29,Clouds
32183,30,1553230800,19,1,20,Clouds
32184,31,1553230800,19,1,20,Clouds
32185,32,1553230800,26,4,30,Clouds
32186,33,1553230800,12,11,23,Clouds
32187,34,1553230800,21,9,30,Clouds
32188,35,1553230800,7,23,30,Clouds
32189,36,1553230800,35,5,40,Clouds
32190,37,1553230800,26,4,30,Clouds
32191,38,1553230800,33,7,40,Clouds
32192,39,1553230800,7,13,20,Clouds
32193,40,1553230800,20,1,21,Clouds
32194,41,1553230800,19,1,20,Clouds
32195,42,1553230800,6,24,30,Clouds
32196,43,1553230800,0,30,30,Clouds
32197,44,1553230800,1,29,30,Clouds
32198,45,1553230800,8,22,30,Clouds
32199,46,1553230800,20,0,20,Clouds
32200,47,1553230800,37,3,40,Clouds
32201,48,1553230800,40,0,40,Clouds
32202,49,1553230800,37,3,40,Clouds
32203,50,1553230800,5,35,40,Clouds
32204,51,1553230800,39,1,40,Clouds
32205,52,1553230800,30,2,32,Clouds
32206,53,1553230800,40,0,40,Clouds
32207,54,1553230800,33,0,33,Clouds
32208,55,1553230800,36,0,36,Clouds
32209,56,1553230800,36,4,40,Clouds
32210,57,1553230800,22,1,23,Clouds
32211,58,1553230800,39,1,40,Clouds
32212,59,1553230800,19,1,20,Clouds
32213,60,1553230800,1,29,30,Clouds
32214,61,1553230800,13,12,25,Clouds
32215,62,1553230800,37,3,40,Clouds
32216,63,1553230800,35,0,35,Clouds
32217,64,1553230800,40,0,40,Clouds
32218,65,1553230800,40,0,40,Clouds
32219,66,1553230800,22,18,40,Clouds
32220,67,1553230800,13,27,40,Clouds
32221,68,1553230800,40,0,40,Clouds
32222,69,1553230800,39,1,40,Clouds
32223,70,1553230800,16,12,28,Clouds
32224,71,1553230800,34,6,40,Clouds
32225,72,1553230800,15,16,31,Clouds
32226,73,1553230800,13,17,30,Clouds
32227,74,1553230800,0,30,30,Clouds
32228,75,1553230800,12,28,40,Clouds
32229,76,1553230800,4,34,38,Clouds
32230,77,1553230800,26,3,29,Clouds
32231,78,1553230800,4,36,40,Clouds
32232,79,1553230800,25,2,27,Clouds
32233,80,1553230800,21,19,40,Clouds
32234,81,1553230800,25,15,40,Clouds
32235,82,1553230800,11,11,22,Clouds
32236,83,1553230800,13,27,40,Clouds
32237,84,1553230800,0,30,30,Clouds
32238,85,1553230800,9,26,35,Clouds
32239,86,1553230800,9,29,38,Clouds
32240,87,1553230800,15,23,38,Clouds
32241,88,1553230800,3,27,30,Clouds
32242,89,1553230800,40,0,40,Clouds
32243,90,1553230800,36,4,40,Clouds
32244,91,1553230800,11,19,30,Clouds
32245,92,1553230800,5,35,40,Clouds
32246,93,1553230800,0,40,40,Clouds
32247,94,1553230800,1,39,40,Clouds
32248,95,1553230800,1,39,40,Clouds
32249,96,1553230800,23,7,30,Clouds
32250,97,1553230800,8,32,40,Clouds
32251,98,1553230800,40,0,40,Clouds
32252,99,1553230800,30,0,30,Clouds
32253,100,1553230800,1,24,25,Clouds
32254,101,1553230800,1,29,30,Clouds
32255,102,1553230800,24,16,40,Clouds
32256,103,1553230800,34,6,40,Clouds
32257,104,1553230800,33,7,40,Clouds
32258,105,1553230800,29,7,36,Clouds
32259,106,1553230800,24,16,40,Clouds
32260,107,1553230800,20,20,40,Clouds
32261,108,1553230800,20,20,40,Clouds
32262,109,1553230800,6,23,29,Clouds
32263,110,1553230800,32,8,40,Clouds
32264,111,1553230800,19,21,40,Clouds
32265,112,1553230800,0,30,30,Clouds
32266,113,1553230800,34,6,40,Clouds
32267,114,1553230800,34,6,40,Clouds
32268,115,1553230800,1,29,30,Clouds
32269,2,1553234400,0,20,20,Clouds
32270,3,1553234400,11,9,20,Clouds
32271,4,1553234400,19,1,20,Clouds
32272,5,1553234400,31,9,40,Clouds
32273,6,1553234400,19,1,20,Clouds
32274,7,1553234400,28,1,29,Clouds
32275,8,1553234400,30,0,30,Clouds
32276,9,1553234400,24,0,24,Clouds
32277,10,1553234400,15,1,16,Clouds
32278,11,1553234400,30,0,30,Clouds
32279,12,1553234400,14,6,20,Clouds
32280,13,1553234400,27,3,30,Clouds
32281,14,1553234400,28,2,30,Clouds
32282,15,1553234400,4,12,16,Clouds
32283,16,1553234400,20,0,20,Clouds
32284,17,1553234400,20,0,20,Clouds
32285,18,1553234400,26,4,30,Clouds
32286,19,1553234400,23,7,30,Clouds
32287,21,1553234400,30,0,30,Clouds
32288,22,1553234400,14,6,20,Clouds
32289,23,1553234400,19,11,30,Clouds
32290,24,1553234400,6,14,20,Clouds
32291,25,1553234400,30,0,30,Clouds
32292,26,1553234400,17,3,20,Clouds
32293,27,1553234400,20,0,20,Clouds
32294,28,1553234400,5,25,30,Clouds
32295,29,1553234400,29,0,29,Clouds
32296,30,1553234400,19,1,20,Clouds
32297,31,1553234400,19,1,20,Clouds
32298,32,1553234400,26,4,30,Clouds
32299,33,1553234400,12,11,23,Clouds
32300,34,1553234400,21,9,30,Clouds
32301,35,1553234400,7,23,30,Clouds
32302,36,1553234400,35,5,40,Clouds
32303,37,1553234400,26,4,30,Clouds
32304,38,1553234400,33,7,40,Clouds
32305,39,1553234400,7,13,20,Clouds
32306,40,1553234400,20,1,21,Clouds
32307,41,1553234400,19,1,20,Clouds
32308,42,1553234400,6,24,30,Clouds
32309,43,1553234400,1,28,29,Clouds
32310,44,1553234400,1,29,30,Clouds
32311,45,1553234400,8,22,30,Clouds
32312,46,1553234400,20,0,20,Clouds
32313,47,1553234400,37,3,40,Clouds
32314,48,1553234400,40,0,40,Clouds
32315,49,1553234400,37,3,40,Clouds
32316,50,1553234400,5,35,40,Clouds
32317,51,1553234400,39,1,40,Clouds
32318,52,1553234400,30,2,32,Clouds
32319,53,1553234400,40,0,40,Clouds
32320,54,1553234400,33,0,33,Clouds
32321,55,1553234400,36,0,36,Clouds
32322,56,1553234400,36,4,40,Clouds
32323,57,1553234400,22,1,23,Clouds
32324,58,1553234400,39,1,40,Clouds
32325,59,1553234400,19,1,20,Clouds
32326,60,1553234400,2,28,30,Clouds
32327,61,1553234400,13,12,25,Clouds
32328,62,1553234400,37,3,40,Clouds
32329,63,1553234400,35,0,35,Clouds
32330,64,1553234400,40,0,40,Clouds
32331,65,1553234400,40,0,40,Clouds
32332,66,1553234400,22,18,40,Clouds
32333,67,1553234400,13,27,40,Clouds
32334,68,1553234400,40,0,40,Clouds
32335,69,1553234400,39,1,40,Clouds
32336,70,1553234400,16,12,28,Clouds
32337,71,1553234400,34,6,40,Clouds
32338,72,1553234400,15,16,31,Clouds
32339,73,1553234400,13,17,30,Clouds
32340,74,1553234400,0,30,30,Clouds
32341,75,1553234400,12,28,40,Clouds
32342,76,1553234400,4,34,38,Clouds
32343,77,1553234400,26,3,29,Clouds
32344,78,1553234400,4,36,40,Clouds
32345,79,1553234400,25,2,27,Clouds
32346,80,1553234400,23,17,40,Clouds
32347,81,1553234400,25,15,40,Clouds
32348,82,1553234400,11,11,22,Clouds
32349,83,1553234400,13,27,40,Clouds
32350,84,1553234400,0,30,30,Clouds
32351,85,1553234400,9,26,35,Clouds
32352,86,1553234400,9,29,38,Clouds
32353,87,1553234400,15,23,38,Clouds
32354,88,1553234400,3,27,30,Clouds
32355,89,1553234400,40,0,40,Clouds
32356,90,1553234400,36,4,40,Clouds
32357,91,1553234400,11,19,30,Clouds
32358,92,1553234400,5,35,40,Clouds
32359,93,1553234400,0,40,40,Clouds
32360,94,1553234400,1,39,40,Clouds
32361,95,1553234400,1,39,40,Clouds
32362,96,1553234400,23,7,30,Clouds
32363,97,1553234400,8,32,40,Clouds
32364,99,1553234400,30,0,30,Clouds
32365,100,1553234400,1,24,25,Clouds
32366,101,1553234400,1,29,30,Clouds
32367,102,1553234400,24,16,40,Clouds
32368,103,1553234400,34,6,40,Clouds
32369,104,1553234400,33,7,40,Clouds
32370,105,1553234400,29,7,36,Clouds
32371,106,1553234400,24,16,40,Clouds
32372,107,1553234400,20,20,40,Clouds
32373,108,1553234400,20,20,40,Clouds
32374,109,1553234400,6,23,29,Clouds
32375,110,1553234400,32,8,40,Clouds
32376,111,1553234400,19,21,40,Clouds
32377,112,1553234400,0,30,30,Clouds
32378,113,1553234400,34,6,40,Clouds
32379,114,1553234400,34,6,40,Clouds
32380,115,1553234400,1,29,30,Clouds
32381,2,1553241600,14,6,20,Clouds
32382,3,1553241600,15,5,20,Clouds
32383,4,1553241600,19,1,20,Clouds
32384,5,1553241600,29,11,40,Clouds
32385,6,1553241600,20,0,20,Clouds
32386,7,1553241600,29,0,29,Clouds
32387,8,1553241600,27,3,30,Clouds
32388,9,1553241600,4,20,24,Clouds
32389,10,1553241600,15,1,16,Clouds
32390,11,1553241600,26,4,30,Clouds
32391,12,1553241600,20,0,20,Clouds
32392,13,1553241600,25,5,30,Clouds
32393,14,1553241600,23,7,30,Clouds
32394,15,1553241600,9,7,16,Clouds
32395,16,1553241600,18,2,20,Clouds
32396,17,1553241600,19,1,20,Clouds
32397,18,1553241600,26,4,30,Clouds
32398,19,1553241600,14,16,30,Clouds
32399,21,1553241600,24,6,30,Clouds
32400,22,1553241600,13,7,20,Clouds
32401,23,1553241600,28,2,30,Clouds
32402,24,1553241600,0,20,20,Clouds
32403,25,1553241600,24,6,30,Clouds
32404,26,1553241600,9,11,20,Clouds
32405,27,1553241600,14,6,20,Clouds
32406,28,1553241600,12,18,30,Clouds
32407,29,1553241600,26,3,29,Clouds
32408,30,1553241600,1,19,20,Clouds
32409,31,1553241600,18,2,20,Clouds
32410,32,1553241600,20,10,30,Clouds
32411,33,1553241600,1,22,23,Clouds
32412,34,1553241600,12,18,30,Clouds
32413,35,1553241600,14,16,30,Clouds
32414,36,1553241600,28,12,40,Clouds
32415,37,1553241600,26,4,30,Clouds
32416,38,1553241600,30,10,40,Clouds
32417,39,1553241600,6,14,20,Clouds
32418,40,1553241600,12,9,21,Clouds
32419,41,1553241600,19,1,20,Clouds
32420,42,1553241600,12,18,30,Clouds
32421,43,1553241600,22,8,30,Clouds
32422,44,1553241600,20,10,30,Clouds
32423,45,1553241600,13,17,30,Clouds
32424,46,1553241600,18,2,20,Clouds
32425,47,1553241600,36,4,40,Clouds
32426,48,1553241600,39,1,40,Clouds
32427,49,1553241600,40,0,40,Clouds
32428,50,1553241600,13,27,40,Clouds
32429,51,1553241600,34,6,40,Clouds
32430,52,1553241600,23,9,32,Clouds
32431,53,1553241600,39,1,40,Clouds
32432,54,1553241600,30,3,33,Clouds
32433,55,1553241600,33,3,36,Clouds
32434,56,1553241600,38,2,40,Clouds
32435,57,1553241600,23,0,23,Clouds
32436,58,1553241600,32,8,40,Clouds
32437,59,1553241600,20,0,20,Clouds
32438,60,1553241600,20,10,30,Clouds
32439,61,1553241600,20,5,25,Clouds
32440,62,1553241600,29,11,40,Clouds
32441,63,1553241600,34,1,35,Clouds
32442,64,1553241600,39,1,40,Clouds
32443,65,1553241600,34,6,40,Clouds
32444,66,1553241600,31,9,40,Clouds
32445,67,1553241600,34,6,40,Clouds
32446,68,1553241600,32,8,40,Clouds
32447,69,1553241600,30,10,40,Clouds
32448,70,1553241600,12,16,28,Clouds
32449,71,1553241600,36,4,40,Clouds
32450,72,1553241600,23,8,31,Clouds
32451,73,1553241600,23,7,30,Clouds
32452,74,1553241600,2,28,30,Clouds
32453,75,1553241600,8,32,40,Clouds
32454,76,1553241600,14,24,38,Clouds
32455,77,1553241600,25,4,29,Clouds
32456,78,1553241600,9,31,40,Clouds
32457,79,1553241600,8,19,27,Clouds
32458,80,1553241600,25,15,40,Clouds
32459,81,1553241600,25,15,40,Clouds
32460,82,1553241600,14,8,22,Clouds
32461,83,1553241600,15,25,40,Clouds
32462,84,1553241600,6,24,30,Clouds
32463,85,1553241600,14,21,35,Clouds
32464,86,1553241600,16,22,38,Clouds
32465,87,1553241600,18,20,38,Clouds
32466,88,1553241600,5,25,30,Clouds
32467,89,1553241600,38,2,40,Clouds
32468,90,1553241600,21,19,40,Clouds
32469,91,1553241600,29,1,30,Clouds
32470,92,1553241600,12,28,40,Clouds
32471,93,1553241600,0,40,40,Clouds
32472,94,1553241600,1,39,40,Clouds
32473,95,1553241600,5,35,40,Clouds
32474,96,1553241600,25,5,30,Clouds
32475,97,1553241600,18,22,40,Clouds
32476,99,1553241600,28,2,30,Clouds
32477,100,1553241600,6,19,25,Clouds
32478,101,1553241600,10,20,30,Clouds
32479,102,1553241600,27,13,40,Clouds
32480,103,1553241600,33,7,40,Clouds
32481,104,1553241600,33,7,40,Clouds
32482,105,1553241600,28,8,36,Clouds
32483,106,1553241600,25,15,40,Clouds
32484,107,1553241600,29,11,40,Clouds
32485,108,1553241600,29,11,40,Clouds
32486,109,1553241600,21,8,29,Clouds
32487,110,1553241600,33,7,40,Clouds
32488,111,1553241600,7,33,40,Clouds
32489,112,1553241600,16,14,30,Clouds
32490,113,1553241600,32,8,40,Clouds
32491,114,1553241600,30,10,40,Clouds
32492,115,1553241600,4,26,30,Clouds
32493,2,1553245200,18,2,20,Clouds
32494,3,1553245200,16,4,20,Clouds
32495,4,1553245200,16,4,20,Clouds
32496,5,1553245200,40,0,40,Clouds
32497,6,1553245200,20,0,20,Clouds
32498,7,1553245200,29,0,29,Clouds
32499,8,1553245200,28,2,30,Clouds
32500,9,1553245200,19,5,24,Clouds
32501,10,1553245200,13,3,16,Clouds
32502,11,1553245200,19,10,29,Clouds
32503,12,1553245200,20,0,20,Clouds
32504,13,1553245200,19,11,30,Clouds
32505,14,1553245200,17,13,30,Clouds
32506,15,1553245200,11,5,16,Clouds
32507,16,1553245200,16,4,20,Clouds
32508,17,1553245200,18,2,20,Clouds
32509,18,1553245200,27,3,30,Clouds
32510,19,1553245200,7,23,30,Clouds
32511,21,1553245200,26,4,30,Clouds
32512,22,1553245200,5,15,20,Clouds
32513,23,1553245200,28,2,30,Clouds
32514,24,1553245200,0,20,20,Clouds
32515,25,1553245200,12,18,30,Clouds
32516,26,1553245200,14,6,20,Clouds
32517,27,1553245200,5,14,19,Clouds
32518,28,1553245200,23,7,30,Clouds
32519,29,1553245200,24,5,29,Clouds
32520,30,1553245200,1,19,20,Clouds
32521,31,1553245200,15,5,20,Clouds
32522,32,1553245200,15,15,30,Clouds
32523,33,1553245200,1,22,23,Clouds
32524,34,1553245200,30,0,30,Clouds
32525,35,1553245200,18,12,30,Clouds
32526,36,1553245200,16,24,40,Clouds
32527,37,1553245200,29,1,30,Clouds
32528,38,1553245200,35,5,40,Clouds
32529,39,1553245200,19,1,20,Clouds
32530,40,1553245200,9,12,21,Clouds
32531,41,1553245200,18,2,20,Clouds
32532,42,1553245200,25,5,30,Clouds
32533,43,1553245200,30,0,30,Clouds
32534,44,1553245200,19,11,30,Clouds
32535,45,1553245200,16,14,30,Clouds
32536,46,1553245200,19,1,20,Clouds
32537,47,1553245200,31,9,40,Clouds
32538,48,1553245200,35,5,40,Clouds
32539,49,1553245200,33,7,40,Clouds
32540,50,1553245200,36,4,40,Clouds
32541,51,1553245200,30,10,40,Clouds
32542,52,1553245200,12,20,32,Clouds
32543,53,1553245200,33,7,40,Clouds
32544,54,1553245200,28,5,33,Clouds
32545,55,1553245200,24,11,35,Clouds
32546,56,1553245200,13,27,40,Clouds
32547,57,1553245200,21,2,23,Clouds
32548,58,1553245200,27,12,39,Clouds
32549,59,1553245200,16,4,20,Clouds
32550,60,1553245200,28,2,30,Clouds
32551,61,1553245200,16,9,25,Clouds
32552,62,1553245200,27,13,40,Clouds
32553,63,1553245200,28,7,35,Clouds
32554,64,1553245200,30,10,40,Clouds
32555,65,1553245200,32,8,40,Clouds
32556,66,1553245200,11,29,40,Clouds
32557,67,1553245200,26,13,39,Clouds
32558,68,1553245200,15,24,39,Clouds
32559,69,1553245200,16,24,40,Clouds
32560,70,1553245200,0,28,28,Clouds
32561,71,1553245200,38,2,40,Clouds
32562,72,1553245200,28,3,31,Clouds
32563,73,1553245200,29,1,30,Clouds
32564,74,1553245200,12,18,30,Clouds
32565,75,1553245200,16,24,40,Clouds
32566,76,1553245200,24,14,38,Clouds
32567,77,1553245200,26,3,29,Clouds
32568,78,1553245200,11,29,40,Clouds
32569,79,1553245200,7,20,27,Clouds
32570,80,1553245200,24,16,40,Clouds
32571,81,1553245200,21,19,40,Clouds
32572,82,1553245200,14,8,22,Clouds
32573,83,1553245200,25,15,40,Clouds
32574,84,1553245200,16,14,30,Clouds
32575,85,1553245200,31,4,35,Clouds
32576,86,1553245200,29,9,38,Clouds
32577,87,1553245200,24,14,38,Clouds
32578,88,1553245200,17,13,30,Clouds
32579,89,1553245200,33,7,40,Clouds
32580,90,1553245200,14,25,39,Clouds
32581,91,1553245200,24,6,30,Clouds
32582,92,1553245200,22,18,40,Clouds
32583,93,1553245200,18,22,40,Clouds
32584,94,1553245200,7,33,40,Clouds
32585,95,1553245200,21,19,40,Clouds
32586,96,1553245200,30,0,30,Clouds
32587,97,1553245200,40,0,40,Clouds
32588,99,1553245200,27,3,30,Clouds
32589,100,1553245200,24,1,25,Clouds
32590,101,1553245200,25,5,30,Clouds
32591,102,1553245200,38,2,40,Clouds
32592,103,1553245200,34,6,40,Clouds
32593,104,1553245200,33,7,40,Clouds
32594,105,1553245200,27,9,36,Clouds
32595,106,1553245200,30,10,40,Clouds
32596,107,1553245200,40,0,40,Clouds
32597,108,1553245200,34,6,40,Clouds
32598,109,1553245200,13,16,29,Clouds
32599,110,1553245200,37,3,40,Clouds
32600,111,1553245200,18,21,39,Clouds
32601,112,1553245200,30,0,30,Clouds
32602,113,1553245200,30,10,40,Clouds
32603,114,1553245200,30,10,40,Clouds
32604,115,1553245200,18,12,30,Clouds
32605,2,1553252400,20,0,20,Clouds
32606,3,1553252400,20,0,20,Clouds
32607,4,1553252400,18,2,20,Clouds
32608,5,1553252400,40,0,40,Clouds
32609,6,1553252400,20,0,20,Clouds
32610,7,1553252400,29,0,29,Clouds
32611,8,1553252400,12,18,30,Clouds
32612,9,1553252400,1,23,24,Clouds
32613,10,1553252400,14,2,16,Clouds
32614,11,1553252400,0,29,29,Clouds
32615,12,1553252400,20,0,20,Clouds
32616,13,1553252400,6,24,30,Clouds
32617,14,1553252400,8,22,30,Clouds
32618,15,1553252400,16,0,16,Clouds
32619,16,1553252400,11,9,20,Clouds
32620,17,1553252400,20,0,20,Clouds
32621,18,1553252400,27,3,30,Clouds
32622,19,1553252400,0,30,30,Clouds
32623,21,1553252400,0,30,30,Clouds
32624,22,1553252400,8,12,20,Clouds
32625,23,1553252400,18,12,30,Clouds
32626,24,1553252400,17,3,20,Clouds
32627,25,1553252400,1,29,30,Clouds
32628,26,1553252400,0,20,20,Clouds
32629,27,1553252400,1,19,20,Clouds
32630,28,1553252400,30,0,30,Clouds
32631,29,1553252400,26,3,29,Clouds
32632,30,1553252400,15,5,20,Clouds
32633,31,1553252400,9,11,20,Clouds
32634,32,1553252400,17,13,30,Clouds
32635,33,1553252400,3,20,23,Clouds
32636,34,1553252400,25,5,30,Clouds
32637,35,1553252400,27,3,30,Clouds
32638,36,1553252400,0,40,40,Clouds
32639,37,1553252400,23,7,30,Clouds
32640,38,1553252400,37,3,40,Clouds
32641,39,1553252400,13,7,20,Clouds
32642,40,1553252400,4,17,21,Clouds
32643,41,1553252400,18,2,20,Clouds
32644,42,1553252400,29,1,30,Clouds
32645,43,1553252400,25,5,30,Clouds
32646,44,1553252400,30,0,30,Clouds
32647,45,1553252400,30,0,30,Clouds
32648,46,1553252400,15,5,20,Clouds
32649,47,1553252400,0,40,40,Clouds
32650,48,1553252400,11,29,40,Clouds
32651,49,1553252400,1,39,40,Clouds
32652,50,1553252400,40,0,40,Clouds
32653,51,1553252400,26,14,40,Clouds
32654,52,1553252400,11,21,32,Clouds
32655,53,1553252400,19,21,40,Clouds
32656,54,1553252400,16,17,33,Clouds
32657,55,1553252400,14,22,36,Clouds
32658,56,1553252400,2,38,40,Clouds
32659,57,1553252400,0,23,23,Clouds
32660,58,1553252400,10,30,40,Clouds
32661,59,1553252400,20,0,20,Clouds
32662,60,1553252400,30,0,30,Clouds
32663,61,1553252400,25,0,25,Clouds
32664,62,1553252400,1,39,40,Clouds
32665,63,1553252400,2,33,35,Clouds
32666,64,1553252400,0,40,40,Clouds
32667,65,1553252400,1,37,38,Clouds
32668,66,1553252400,13,26,39,Clouds
32669,67,1553252400,23,15,38,Clouds
32670,68,1553252400,0,38,38,Clouds
32671,69,1553252400,0,40,40,Clouds
32672,70,1553252400,1,27,28,Clouds
32673,71,1553252400,39,1,40,Clouds
32674,72,1553252400,31,0,31,Clouds
32675,73,1553252400,30,0,30,Clouds
32676,74,1553252400,30,0,30,Clouds
32677,75,1553252400,40,0,40,Clouds
32678,76,1553252400,37,1,38,Clouds
32679,77,1553252400,29,0,29,Clouds
32680,78,1553252400,24,16,40,Clouds
32681,79,1553252400,27,0,27,Clouds
32682,80,1553252400,39,1,40,Clouds
32683,81,1553252400,40,0,40,Clouds
32684,82,1553252400,22,0,22,Clouds
32685,83,1553252400,40,0,40,Clouds
32686,84,1553252400,30,0,30,Clouds
32687,85,1553252400,34,1,35,Clouds
32688,86,1553252400,36,2,38,Clouds
32689,87,1553252400,38,0,38,Clouds
32690,88,1553252400,29,1,30,Clouds
32691,89,1553252400,28,12,40,Clouds
32692,90,1553252400,0,39,39,Clouds
32693,91,1553252400,20,10,30,Clouds
32694,92,1553252400,39,1,40,Clouds
32695,93,1553252400,40,0,40,Clouds
32696,94,1553252400,40,0,40,Clouds
32697,95,1553252400,38,2,40,Clouds
32698,96,1553252400,30,0,30,Clouds
32699,97,1553252400,40,0,40,Clouds
32700,98,1553252400,28,12,40,Clouds
32701,99,1553252400,9,21,30,Clouds
32702,100,1553252400,19,6,25,Clouds
32703,101,1553252400,30,0,30,Clouds
32704,102,1553252400,40,0,40,Clouds
32705,103,1553252400,37,3,40,Clouds
32706,104,1553252400,40,0,40,Clouds
32707,105,1553252400,36,0,36,Clouds
32708,106,1553252400,40,0,40,Clouds
32709,107,1553252400,40,0,40,Clouds
32710,108,1553252400,39,1,40,Clouds
32711,109,1553252400,28,1,29,Clouds
32712,110,1553252400,40,0,40,Clouds
32713,111,1553252400,39,0,39,Clouds
32714,112,1553252400,30,0,30,Clouds
32715,113,1553252400,3,37,40,Clouds
32716,114,1553252400,0,40,40,Clouds
32717,115,1553252400,29,1,30,Clouds
32718,2,1553256000,4,16,20,Rain
32719,3,1553256000,19,1,20,Rain
32720,4,1553256000,20,0,20,Rain
32721,5,1553256000,40,0,40,Rain
32722,6,1553256000,18,2,20,Rain
32723,7,1553256000,29,0,29,Rain
32724,8,1553256000,14,16,30,Rain
32725,9,1553256000,0,24,24,Rain
32726,10,1553256000,10,6,16,Rain
32727,11,1553256000,0,29,29,Rain
32728,12,1553256000,20,0,20,Rain
32729,13,1553256000,4,26,30,Rain
32730,14,1553256000,7,23,30,Rain
32731,15,1553256000,13,3,16,Rain
32732,16,1553256000,10,10,20,Rain
32733,17,1553256000,19,1,20,Rain
32734,18,1553256000,30,0,30,Rain
32735,19,1553256000,2,28,30,Rain
32736,21,1553256000,0,30,30,Rain
32737,22,1553256000,9,11,20,Rain
32738,23,1553256000,16,14,30,Rain
32739,24,1553256000,14,6,20,Rain
32740,25,1553256000,1,29,30,Rain
32741,26,1553256000,1,19,20,Rain
32742,27,1553256000,1,19,20,Rain
32743,28,1553256000,18,12,30,Rain
32744,29,1553256000,24,5,29,Rain
32745,30,1553256000,19,1,20,Rain
32746,31,1553256000,14,6,20,Rain
32747,32,1553256000,7,23,30,Rain
32748,33,1553256000,2,21,23,Rain
32749,34,1553256000,30,0,30,Rain
32750,35,1553256000,30,0,30,Rain
32751,36,1553256000,0,40,40,Rain
32752,37,1553256000,24,6,30,Rain
32753,38,1553256000,40,0,40,Rain
32754,39,1553256000,9,11,20,Rain
32755,40,1553256000,1,20,21,Rain
32756,41,1553256000,17,3,20,Rain
32757,42,1553256000,30,0,30,Rain
32758,43,1553256000,29,1,30,Rain
32759,44,1553256000,30,0,30,Rain
32760,45,1553256000,30,0,30,Rain
32761,46,1553256000,17,3,20,Rain
32762,47,1553256000,4,36,40,Rain
32763,48,1553256000,6,34,40,Rain
32764,49,1553256000,3,37,40,Rain
32765,50,1553256000,40,0,40,Rain
32766,51,1553256000,18,22,40,Rain
32767,52,1553256000,11,21,32,Rain
32768,53,1553256000,17,23,40,Rain
32769,54,1553256000,18,15,33,Rain
32770,55,1553256000,13,23,36,Rain
32771,56,1553256000,7,33,40,Rain
32772,57,1553256000,1,22,23,Rain
32773,58,1553256000,6,34,40,Rain
32774,59,1553256000,19,1,20,Rain
32775,60,1553256000,28,2,30,Rain
32776,61,1553256000,25,0,25,Rain
32777,62,1553256000,1,39,40,Rain
32778,63,1553256000,0,35,35,Rain
32779,64,1553256000,0,40,40,Rain
32780,65,1553256000,7,33,40,Rain
32781,66,1553256000,12,28,40,Rain
32782,67,1553256000,33,7,40,Rain
32783,68,1553256000,7,33,40,Rain
32784,69,1553256000,2,38,40,Rain
32785,70,1553256000,0,27,27,Rain
32786,71,1553256000,36,4,40,Rain
32787,72,1553256000,30,1,31,Rain
32788,73,1553256000,30,0,30,Rain
32789,74,1553256000,30,0,30,Rain
32790,75,1553256000,39,1,40,Rain
32791,76,1553256000,38,0,38,Rain
32792,77,1553256000,29,0,29,Rain
32793,78,1553256000,33,7,40,Rain
32794,79,1553256000,27,0,27,Rain
32795,80,1553256000,37,3,40,Rain
32796,81,1553256000,40,0,40,Rain
32797,82,1553256000,22,0,22,Rain
32798,83,1553256000,40,0,40,Rain
32799,84,1553256000,27,3,30,Rain
32800,85,1553256000,34,1,35,Rain
32801,86,1553256000,38,0,38,Rain
32802,87,1553256000,38,0,38,Rain
32803,88,1553256000,30,0,30,Rain
32804,89,1553256000,31,9,40,Rain
32805,90,1553256000,2,38,40,Rain
32806,91,1553256000,20,10,30,Rain
32807,92,1553256000,40,0,40,Rain
32808,93,1553256000,40,0,40,Rain
32809,94,1553256000,40,0,40,Rain
32810,95,1553256000,37,3,40,Rain
32811,96,1553256000,30,0,30,Rain
32812,97,1553256000,40,0,40,Rain
32813,98,1553256000,24,16,40,Rain
32814,99,1553256000,3,27,30,Rain
32815,100,1553256000,25,0,25,Rain
32816,101,1553256000,30,0,30,Rain
32817,102,1553256000,39,1,40,Rain
32818,103,1553256000,37,3,40,Rain
32819,104,1553256000,40,0,40,Rain
32820,105,1553256000,36,0,36,Rain
32821,106,1553256000,40,0,40,Rain
32822,107,1553256000,40,0,40,Rain
32823,108,1553256000,40,0,40,Rain
32824,109,1553256000,29,0,29,Rain
32825,110,1553256000,40,0,40,Rain
32826,111,1553256000,40,0,40,Rain
32827,112,1553256000,30,0,30,Rain
32828,113,1553256000,1,39,40,Rain
32829,114,1553256000,0,40,40,Rain
32830,115,1553256000,30,0,30,Rain
32831,2,1553259600,14,6,20,Rain
32832,3,1553259600,20,0,20,Rain
32833,4,1553259600,19,1,20,Rain
32834,5,1553259600,37,3,40,Rain
32835,6,1553259600,17,3,20,Rain
32836,7,1553259600,29,0,29,Rain
32837,8,1553259600,21,8,29,Rain
32838,9,1553259600,1,23,24,Rain
32839,10,1553259600,8,8,16,Rain
32840,11,1553259600,0,29,29,Rain
32841,12,1553259600,20,0,20,Rain
32842,13,1553259600,7,23,30,Rain
32843,14,1553259600,2,28,30,Rain
32844,15,1553259600,16,0,16,Rain
32845,16,1553259600,10,10,20,Rain
32846,17,1553259600,17,3,20,Rain
32847,18,1553259600,27,3,30,Rain
32848,19,1553259600,0,29,29,Rain
32849,21,1553259600,0,30,30,Rain
32850,22,1553259600,6,14,20,Rain
32851,23,1553259600,17,13,30,Rain
32852,24,1553259600,16,4,20,Rain
32853,25,1553259600,2,28,30,Rain
32854,26,1553259600,1,19,20,Rain
32855,27,1553259600,0,20,20,Rain
32856,28,1553259600,26,4,30,Rain
32857,29,1553259600,24,5,29,Rain
32858,30,1553259600,20,0,20,Rain
32859,31,1553259600,18,2,20,Rain
32860,32,1553259600,1,29,30,Rain
32861,33,1553259600,1,22,23,Rain
32862,34,1553259600,28,2,30,Rain
32863,35,1553259600,30,0,30,Rain
32864,36,1553259600,2,38,40,Rain
32865,37,1553259600,25,5,30,Rain
32866,38,1553259600,37,3,40,Rain
32867,39,1553259600,12,8,20,Rain
32868,40,1553259600,9,12,21,Rain
32869,41,1553259600,19,1,20,Rain
32870,42,1553259600,27,3,30,Rain
32871,43,1553259600,27,3,30,Rain
32872,44,1553259600,30,0,30,Rain
32873,45,1553259600,28,2,30,Rain
32874,46,1553259600,14,6,20,Rain
32875,47,1553259600,1,39,40,Rain
32876,48,1553259600,4,36,40,Rain
32877,49,1553259600,5,35,40,Rain
32878,50,1553259600,40,0,40,Rain
32879,51,1553259600,16,24,40,Rain
32880,52,1553259600,9,23,32,Rain
32881,53,1553259600,11,29,40,Rain
32882,54,1553259600,19,14,33,Rain
32883,55,1553259600,18,18,36,Rain
32884,56,1553259600,7,33,40,Rain
32885,57,1553259600,1,22,23,Rain
32886,58,1553259600,4,36,40,Rain
32887,59,1553259600,20,0,20,Rain
32888,60,1553259600,30,0,30,Rain
32889,61,1553259600,25,0,25,Rain
32890,62,1553259600,2,38,40,Rain
32891,63,1553259600,1,34,35,Rain
32892,64,1553259600,1,39,40,Rain
32893,65,1553259600,5,35,40,Rain
32894,66,1553259600,16,24,40,Rain
32895,67,1553259600,34,6,40,Rain
32896,68,1553259600,0,40,40,Rain
32897,69,1553259600,0,40,40,Rain
32898,70,1553259600,0,27,27,Rain
32899,71,1553259600,40,0,40,Rain
32900,72,1553259600,31,0,31,Rain
32901,73,1553259600,30,0,30,Rain
32902,74,1553259600,25,5,30,Rain
32903,75,1553259600,39,1,40,Rain
32904,76,1553259600,38,0,38,Rain
32905,77,1553259600,29,0,29,Rain
32906,78,1553259600,40,0,40,Rain
32907,79,1553259600,27,0,27,Rain
32908,80,1553259600,38,2,40,Rain
32909,81,1553259600,40,0,40,Rain
32910,82,1553259600,22,0,22,Rain
32911,83,1553259600,40,0,40,Rain
32912,84,1553259600,28,2,30,Rain
32913,85,1553259600,33,2,35,Rain
32914,86,1553259600,36,2,38,Rain
32915,87,1553259600,38,0,38,Rain
32916,88,1553259600,29,1,30,Rain
32917,89,1553259600,32,8,40,Rain
32918,90,1553259600,3,37,40,Rain
32919,91,1553259600,18,12,30,Rain
32920,92,1553259600,39,1,40,Rain
32921,93,1553259600,40,0,40,Rain
32922,94,1553259600,40,0,40,Rain
32923,95,1553259600,40,0,40,Rain
32924,96,1553259600,30,0,30,Rain
32925,97,1553259600,40,0,40,Rain
32926,98,1553259600,18,22,40,Rain
32927,99,1553259600,5,25,30,Rain
32928,100,1553259600,25,0,25,Rain
32929,101,1553259600,30,0,30,Rain
32930,102,1553259600,39,1,40,Rain
32931,103,1553259600,40,0,40,Rain
32932,104,1553259600,40,0,40,Rain
32933,105,1553259600,36,0,36,Rain
32934,106,1553259600,40,0,40,Rain
32935,107,1553259600,40,0,40,Rain
32936,108,1553259600,40,0,40,Rain
32937,109,1553259600,29,0,29,Rain
32938,110,1553259600,40,0,40,Rain
32939,111,1553259600,39,1,40,Rain
32940,112,1553259600,27,3,30,Rain
32941,113,1553259600,0,40,40,Rain
32942,114,1553259600,3,37,40,Rain
32943,115,1553259600,29,1,30,Rain
32944,2,1553263200,19,1,20,Rain
32945,3,1553263200,17,3,20,Rain
32946,4,1553263200,19,1,20,Rain
32947,5,1553263200,33,7,40,Rain
32948,6,1553263200,20,0,20,Rain
32949,7,1553263200,29,0,29,Rain
32950,8,1553263200,14,16,30,Rain
32951,9,1553263200,7,17,24,Rain
32952,10,1553263200,7,9,16,Rain
32953,11,1553263200,6,23,29,Rain
32954,12,1553263200,19,1,20,Rain
32955,13,1553263200,11,19,30,Rain
32956,14,1553263200,1,29,30,Rain
32957,15,1553263200,14,2,16,Rain
32958,16,1553263200,15,5,20,Rain
32959,17,1553263200,18,2,20,Rain
32960,18,1553263200,28,2,30,Rain
32961,19,1553263200,0,30,30,Rain
32962,21,1553263200,1,29,30,Rain
32963,22,1553263200,0,20,20,Rain
32964,23,1553263200,16,14,30,Rain
32965,24,1553263200,19,1,20,Rain
32966,25,1553263200,1,29,30,Rain
32967,26,1553263200,3,17,20,Rain
32968,27,1553263200,0,20,20,Rain
32969,28,1553263200,30,0,30,Rain
32970,29,1553263200,29,0,29,Rain
32971,30,1553263200,17,3,20,Rain
32972,31,1553263200,18,2,20,Rain
32973,32,1553263200,19,11,30,Rain
32974,33,1553263200,3,20,23,Rain
32975,34,1553263200,21,9,30,Rain
32976,35,1553263200,30,0,30,Rain
32977,36,1553263200,1,39,40,Rain
32978,37,1553263200,26,4,30,Rain
32979,38,1553263200,35,5,40,Rain
32980,39,1553263200,11,9,20,Rain
32981,40,1553263200,8,13,21,Rain
32982,41,1553263200,20,0,20,Rain
32983,42,1553263200,28,2,30,Rain
32984,43,1553263200,28,2,30,Rain
32985,44,1553263200,30,0,30,Rain
32986,45,1553263200,30,0,30,Rain
32987,46,1553263200,14,6,20,Rain
32988,47,1553263200,1,39,40,Rain
32989,48,1553263200,5,35,40,Rain
32990,49,1553263200,7,33,40,Rain
32991,50,1553263200,39,1,40,Rain
32992,51,1553263200,19,21,40,Rain
32993,52,1553263200,7,25,32,Rain
32994,53,1553263200,11,29,40,Rain
32995,54,1553263200,15,18,33,Rain
32996,55,1553263200,16,20,36,Rain
32997,56,1553263200,10,30,40,Rain
32998,57,1553263200,2,21,23,Rain
32999,58,1553263200,28,12,40,Rain
33000,59,1553263200,20,0,20,Rain
33001,60,1553263200,30,0,30,Rain
33002,61,1553263200,25,0,25,Rain
33003,62,1553263200,10,30,40,Rain
33004,63,1553263200,10,25,35,Rain
33005,64,1553263200,7,33,40,Rain
33006,65,1553263200,20,20,40,Rain
33007,66,1553263200,17,23,40,Rain
33008,67,1553263200,32,8,40,Rain
33009,68,1553263200,2,38,40,Rain
33010,69,1553263200,9,31,40,Rain
33011,70,1553263200,3,24,27,Rain
33012,71,1553263200,37,3,40,Rain
33013,72,1553263200,28,3,31,Rain
33014,73,1553263200,30,0,30,Rain
33015,74,1553263200,25,5,30,Rain
33016,75,1553263200,40,0,40,Rain
33017,76,1553263200,37,1,38,Rain
33018,77,1553263200,11,18,29,Rain
33019,78,1553263200,40,0,40,Rain
33020,79,1553263200,27,0,27,Rain
33021,80,1553263200,23,17,40,Rain
33022,81,1553263200,39,1,40,Rain
33023,82,1553263200,22,0,22,Rain
33024,83,1553263200,40,0,40,Rain
33025,84,1553263200,30,0,30,Rain
33026,85,1553263200,33,2,35,Rain
33027,86,1553263200,37,1,38,Rain
33028,87,1553263200,37,1,38,Rain
33029,88,1553263200,29,1,30,Rain
33030,89,1553263200,31,9,40,Rain
33031,90,1553263200,7,33,40,Rain
33032,91,1553263200,19,11,30,Rain
33033,92,1553263200,39,1,40,Rain
33034,93,1553263200,40,0,40,Rain
33035,94,1553263200,40,0,40,Rain
33036,95,1553263200,35,5,40,Rain
33037,96,1553263200,29,1,30,Rain
33038,97,1553263200,39,1,40,Rain
33039,98,1553263200,18,22,40,Rain
33040,99,1553263200,3,27,30,Rain
33041,100,1553263200,22,3,25,Rain
33042,101,1553263200,30,0,30,Rain
33043,102,1553263200,39,1,40,Rain
33044,103,1553263200,40,0,40,Rain
33045,104,1553263200,40,0,40,Rain
33046,105,1553263200,36,0,36,Rain
33047,106,1553263200,40,0,40,Rain
33048,107,1553263200,40,0,40,Rain
33049,108,1553263200,40,0,40,Rain
33050,109,1553263200,28,1,29,Rain
33051,110,1553263200,39,1,40,Rain
33052,111,1553263200,40,0,40,Rain
33053,112,1553263200,27,3,30,Rain
33054,113,1553263200,2,38,40,Rain
33055,114,1553263200,5,35,40,Rain
33056,115,1553263200,30,0,30,Rain
33057,2,1553266800,19,1,20,Rain
33058,3,1553266800,17,2,19,Rain
33059,4,1553266800,13,7,20,Rain
33060,5,1553266800,30,10,40,Rain
33061,6,1553266800,19,1,20,Rain
33062,7,1553266800,29,0,29,Rain
33063,8,1553266800,10,20,30,Rain
33064,9,1553266800,12,12,24,Rain
33065,10,1553266800,7,9,16,Rain
33066,11,1553266800,9,20,29,Rain
33067,12,1553266800,20,0,20,Rain
33068,13,1553266800,12,18,30,Rain
33069,14,1553266800,4,26,30,Rain
33070,15,1553266800,11,5,16,Rain
33071,16,1553266800,15,5,20,Rain
33072,17,1553266800,20,0,20,Rain
33073,18,1553266800,29,1,30,Rain
33074,19,1553266800,0,30,30,Rain
33075,21,1553266800,1,29,30,Rain
33076,22,1553266800,1,19,20,Rain
33077,23,1553266800,15,15,30,Rain
33078,24,1553266800,20,0,20,Rain
33079,25,1553266800,2,28,30,Rain
33080,26,1553266800,3,17,20,Rain
33081,27,1553266800,9,11,20,Rain
33082,28,1553266800,17,13,30,Rain
33083,29,1553266800,26,3,29,Rain
33084,30,1553266800,17,3,20,Rain
33085,31,1553266800,19,1,20,Rain
33086,32,1553266800,17,13,30,Rain
33087,33,1553266800,0,23,23,Rain
33088,34,1553266800,30,0,30,Rain
33089,35,1553266800,30,0,30,Rain
33090,36,1553266800,1,39,40,Rain
33091,37,1553266800,26,4,30,Rain
33092,38,1553266800,34,6,40,Rain
33093,39,1553266800,16,4,20,Rain
33094,40,1553266800,10,11,21,Rain
33095,41,1553266800,16,4,20,Rain
33096,42,1553266800,26,4,30,Rain
33097,43,1553266800,29,1,30,Rain
33098,44,1553266800,30,0,30,Rain
33099,45,1553266800,30,0,30,Rain
33100,46,1553266800,16,4,20,Rain
33101,47,1553266800,0,40,40,Rain
33102,48,1553266800,2,38,40,Rain
33103,49,1553266800,0,40,40,Rain
33104,50,1553266800,37,3,40,Rain
33105,51,1553266800,18,22,40,Rain
33106,52,1553266800,11,21,32,Rain
33107,53,1553266800,11,29,40,Rain
33108,54,1553266800,18,15,33,Rain
33109,55,1553266800,16,20,36,Rain
33110,56,1553266800,10,30,40,Rain
33111,57,1553266800,2,21,23,Rain
33112,58,1553266800,16,24,40,Rain
33113,59,1553266800,20,0,20,Rain
33114,60,1553266800,30,0,30,Rain
33115,61,1553266800,17,8,25,Rain
33116,62,1553266800,9,31,40,Rain
33117,63,1553266800,5,30,35,Rain
33118,64,1553266800,6,34,40,Rain
33119,65,1553266800,20,20,40,Rain
33120,66,1553266800,16,24,40,Rain
33121,67,1553266800,25,15,40,Rain
33122,68,1553266800,2,38,40,Rain
33123,69,1553266800,3,37,40,Rain
33124,70,1553266800,4,23,27,Rain
33125,71,1553266800,35,5,40,Rain
33126,72,1553266800,31,0,31,Rain
33127,73,1553266800,22,8,30,Rain
33128,74,1553266800,25,5,30,Rain
33129,75,1553266800,39,1,40,Rain
33130,76,1553266800,37,1,38,Rain
33131,77,1553266800,13,16,29,Rain
33132,78,1553266800,40,0,40,Rain
33133,79,1553266800,27,0,27,Rain
33134,80,1553266800,32,8,40,Rain
33135,81,1553266800,39,1,40,Rain
33136,82,1553266800,22,0,22,Rain
33137,83,1553266800,40,0,40,Rain
33138,84,1553266800,30,0,30,Rain
33139,85,1553266800,35,0,35,Rain
33140,86,1553266800,34,4,38,Rain
33141,87,1553266800,35,3,38,Rain
33142,88,1553266800,30,0,30,Rain
33143,89,1553266800,31,9,40,Rain
33144,90,1553266800,8,32,40,Rain
33145,91,1553266800,25,5,30,Rain
33146,92,1553266800,40,0,40,Rain
33147,93,1553266800,40,0,40,Rain
33148,94,1553266800,40,0,40,Rain
33149,95,1553266800,32,8,40,Rain
33150,96,1553266800,30,0,30,Rain
33151,97,1553266800,39,1,40,Rain
33152,98,1553266800,14,26,40,Rain
33153,99,1553266800,3,27,30,Rain
33154,100,1553266800,18,7,25,Rain
33155,101,1553266800,27,3,30,Rain
33156,102,1553266800,40,0,40,Rain
33157,103,1553266800,40,0,40,Rain
33158,104,1553266800,40,0,40,Rain
33159,105,1553266800,36,0,36,Rain
33160,106,1553266800,40,0,40,Rain
33161,107,1553266800,37,3,40,Rain
33162,108,1553266800,38,2,40,Rain
33163,109,1553266800,27,2,29,Rain
33164,110,1553266800,39,1,40,Rain
33165,111,1553266800,38,2,40,Rain
33166,112,1553266800,30,0,30,Rain
33167,113,1553266800,2,38,40,Rain
33168,114,1553266800,0,40,40,Rain
33169,115,1553266800,29,1,30,Rain
33170,2,1553270400,20,0,20,Clouds
33171,3,1553270400,20,0,20,Clouds
33172,4,1553270400,15,5,20,Clouds
33173,5,1553270400,28,12,40,Clouds
33174,6,1553270400,16,4,20,Clouds
33175,7,1553270400,29,0,29,Clouds
33176,8,1553270400,0,30,30,Clouds
33177,9,1553270400,8,16,24,Clouds
33178,10,1553270400,7,9,16,Clouds
33179,11,1553270400,11,18,29,Clouds
33180,12,1553270400,18,2,20,Clouds
33181,13,1553270400,9,21,30,Clouds
33182,14,1553270400,19,11,30,Clouds
33183,15,1553270400,12,4,16,Clouds
33184,16,1553270400,16,4,20,Clouds
33185,17,1553270400,20,0,20,Clouds
33186,18,1553270400,30,0,30,Clouds
33187,19,1553270400,2,28,30,Clouds
33188,21,1553270400,1,29,30,Clouds
33189,22,1553270400,0,20,20,Clouds
33190,23,1553270400,12,18,30,Clouds
33191,24,1553270400,15,5,20,Clouds
33192,25,1553270400,7,23,30,Clouds
33193,26,1553270400,1,19,20,Clouds
33194,27,1553270400,12,8,20,Clouds
33195,28,1553270400,16,14,30,Clouds
33196,29,1553270400,28,1,29,Clouds
33197,30,1553270400,20,0,20,Clouds
33198,31,1553270400,17,3,20,Clouds
33199,32,1553270400,22,8,30,Clouds
33200,33,1553270400,0,23,23,Clouds
33201,34,1553270400,28,2,30,Clouds
33202,35,1553270400,27,3,30,Clouds
33203,36,1553270400,4,36,40,Clouds
33204,37,1553270400,27,3,30,Clouds
33205,38,1553270400,37,3,40,Clouds
33206,39,1553270400,11,9,20,Clouds
33207,40,1553270400,7,14,21,Clouds
33208,41,1553270400,16,4,20,Clouds
33209,42,1553270400,25,5,30,Clouds
33210,43,1553270400,27,3,30,Clouds
33211,44,1553270400,30,0,30,Clouds
33212,45,1553270400,30,0,30,Clouds
33213,46,1553270400,15,5,20,Clouds
33214,47,1553270400,0,40,40,Clouds
33215,48,1553270400,4,36,40,Clouds
33216,49,1553270400,4,36,40,Clouds
33217,50,1553270400,39,1,40,Clouds
33218,51,1553270400,22,18,40,Clouds
33219,52,1553270400,13,19,32,Clouds
33220,53,1553270400,10,30,40,Clouds
33221,54,1553270400,18,15,33,Clouds
33222,55,1553270400,17,19,36,Clouds
33223,56,1553270400,1,39,40,Clouds
33224,57,1553270400,3,20,23,Clouds
33225,58,1553270400,0,40,40,Clouds
33226,59,1553270400,20,0,20,Clouds
33227,60,1553270400,28,2,30,Clouds
33228,61,1553270400,22,3,25,Clouds
33229,62,1553270400,6,34,40,Clouds
33230,63,1553270400,2,33,35,Clouds
33231,64,1553270400,19,21,40,Clouds
33232,65,1553270400,15,25,40,Clouds
33233,66,1553270400,16,24,40,Clouds
33234,67,1553270400,23,17,40,Clouds
33235,68,1553270400,7,33,40,Clouds
33236,69,1553270400,9,31,40,Clouds
33237,70,1553270400,7,21,28,Clouds
33238,71,1553270400,37,3,40,Clouds
33239,72,1553270400,31,0,31,Clouds
33240,73,1553270400,25,5,30,Clouds
33241,74,1553270400,26,4,30,Clouds
33242,75,1553270400,38,2,40,Clouds
33243,76,1553270400,36,2,38,Clouds
33244,77,1553270400,16,13,29,Clouds
33245,78,1553270400,38,2,40,Clouds
33246,79,1553270400,26,1,27,Clouds
33247,80,1553270400,33,7,40,Clouds
33248,81,1553270400,40,0,40,Clouds
33249,82,1553270400,22,0,22,Clouds
33250,83,1553270400,40,0,40,Clouds
33251,84,1553270400,29,1,30,Clouds
33252,85,1553270400,35,0,35,Clouds
33253,86,1553270400,28,10,38,Clouds
33254,87,1553270400,33,5,38,Clouds
33255,88,1553270400,30,0,30,Clouds
33256,89,1553270400,25,15,40,Clouds
33257,90,1553270400,10,30,40,Clouds
33258,91,1553270400,26,4,30,Clouds
33259,92,1553270400,38,2,40,Clouds
33260,93,1553270400,40,0,40,Clouds
33261,94,1553270400,40,0,40,Clouds
33262,95,1553270400,35,5,40,Clouds
33263,96,1553270400,30,0,30,Clouds
33264,97,1553270400,39,1,40,Clouds
33265,98,1553270400,15,25,40,Clouds
33266,99,1553270400,2,28,30,Clouds
33267,100,1553270400,12,13,25,Clouds
33268,101,1553270400,28,2,30,Clouds
33269,102,1553270400,40,0,40,Clouds
33270,103,1553270400,30,10,40,Clouds
33271,104,1553270400,32,8,40,Clouds
33272,105,1553270400,24,12,36,Clouds
33273,106,1553270400,25,15,40,Clouds
33274,107,1553270400,29,11,40,Clouds
33275,108,1553270400,37,3,40,Clouds
33276,109,1553270400,26,3,29,Clouds
33277,110,1553270400,40,0,40,Clouds
33278,111,1553270400,37,3,40,Clouds
33279,112,1553270400,30,0,30,Clouds
33280,113,1553270400,3,37,40,Clouds
33281,114,1553270400,1,39,40,Clouds
33282,115,1553270400,28,2,30,Clouds
33283,2,1553274000,19,1,20,Clouds
33284,3,1553274000,19,1,20,Clouds
33285,4,1553274000,14,6,20,Clouds
33286,5,1553274000,26,14,40,Clouds
33287,6,1553274000,14,6,20,Clouds
33288,7,1553274000,29,0,29,Clouds
33289,8,1553274000,0,30,30,Clouds
33290,9,1553274000,9,15,24,Clouds
33291,10,1553274000,9,7,16,Clouds
33292,11,1553274000,22,7,29,Clouds
33293,12,1553274000,20,0,20,Clouds
33294,13,1553274000,9,21,30,Clouds
33295,14,1553274000,24,6,30,Clouds
33296,15,1553274000,16,0,16,Clouds
33297,16,1553274000,13,7,20,Clouds
33298,17,1553274000,20,0,20,Clouds
33299,18,1553274000,28,2,30,Clouds
33300,19,1553274000,15,15,30,Clouds
33301,21,1553274000,1,29,30,Clouds
33302,22,1553274000,2,18,20,Clouds
33303,23,1553274000,22,8,30,Clouds
33304,24,1553274000,11,9,20,Clouds
33305,25,1553274000,9,21,30,Clouds
33306,26,1553274000,0,19,19,Clouds
33307,27,1553274000,16,4,20,Clouds
33308,28,1553274000,24,6,30,Clouds
33309,29,1553274000,24,5,29,Clouds
33310,30,1553274000,18,2,20,Clouds
33311,31,1553274000,18,2,20,Clouds
33312,32,1553274000,18,12,30,Clouds
33313,33,1553274000,1,22,23,Clouds
33314,34,1553274000,23,7,30,Clouds
33315,35,1553274000,22,8,30,Clouds
33316,36,1553274000,11,29,40,Clouds
33317,37,1553274000,17,13,30,Clouds
33318,38,1553274000,36,4,40,Clouds
33319,39,1553274000,12,8,20,Clouds
33320,40,1553274000,4,17,21,Clouds
33321,41,1553274000,17,3,20,Clouds
33322,42,1553274000,27,3,30,Clouds
33323,43,1553274000,29,1,30,Clouds
33324,44,1553274000,26,4,30,Clouds
33325,45,1553274000,25,5,30,Clouds
33326,46,1553274000,14,6,20,Clouds
33327,47,1553274000,6,34,40,Clouds
33328,48,1553274000,1,39,40,Clouds
33329,49,1553274000,2,38,40,Clouds
33330,50,1553274000,40,0,40,Clouds
33331,51,1553274000,21,19,40,Clouds
33332,52,1553274000,15,17,32,Clouds
33333,53,1553274000,24,16,40,Clouds
33334,54,1553274000,21,12,33,Clouds
33335,55,1553274000,5,31,36,Clouds
33336,56,1553274000,11,29,40,Clouds
33337,57,1553274000,4,19,23,Clouds
33338,58,1553274000,3,37,40,Clouds
33339,59,1553274000,20,0,20,Clouds
33340,60,1553274000,27,3,30,Clouds
33341,61,1553274000,24,1,25,Clouds
33342,62,1553274000,9,31,40,Clouds
33343,63,1553274000,6,29,35,Clouds
33344,64,1553274000,24,16,40,Clouds
33345,65,1553274000,15,25,40,Clouds
33346,66,1553274000,29,11,40,Clouds
33347,67,1553274000,15,25,40,Clouds
33348,68,1553274000,8,32,40,Clouds
33349,69,1553274000,20,20,40,Clouds
33350,70,1553274000,14,14,28,Clouds
33351,71,1553274000,40,0,40,Clouds
33352,72,1553274000,27,4,31,Clouds
33353,73,1553274000,29,1,30,Clouds
33354,74,1553274000,26,4,30,Clouds
33355,75,1553274000,37,3,40,Clouds
33356,76,1553274000,34,4,38,Clouds
33357,77,1553274000,16,13,29,Clouds
33358,78,1553274000,40,0,40,Clouds
33359,79,1553274000,27,0,27,Clouds
33360,80,1553274000,21,19,40,Clouds
33361,81,1553274000,40,0,40,Clouds
33362,82,1553274000,22,0,22,Clouds
33363,83,1553274000,40,0,40,Clouds
33364,84,1553274000,30,0,30,Clouds
33365,85,1553274000,34,1,35,Clouds
33366,86,1553274000,27,11,38,Clouds
33367,87,1553274000,36,2,38,Clouds
33368,88,1553274000,30,0,30,Clouds
33369,89,1553274000,8,32,40,Clouds
33370,90,1553274000,16,24,40,Clouds
33371,91,1553274000,28,2,30,Clouds
33372,92,1553274000,37,3,40,Clouds
33373,93,1553274000,40,0,40,Clouds
33374,94,1553274000,40,0,40,Clouds
33375,95,1553274000,33,7,40,Clouds
33376,96,1553274000,30,0,30,Clouds
33377,97,1553274000,40,0,40,Clouds
33378,98,1553274000,13,27,40,Clouds
33379,99,1553274000,4,26,30,Clouds
33380,100,1553274000,15,10,25,Clouds
33381,101,1553274000,26,4,30,Clouds
33382,102,1553274000,40,0,40,Clouds
33383,103,1553274000,34,6,40,Clouds
33384,104,1553274000,32,8,40,Clouds
33385,105,1553274000,24,12,36,Clouds
33386,106,1553274000,28,12,40,Clouds
33387,107,1553274000,32,8,40,Clouds
33388,108,1553274000,36,4,40,Clouds
33389,109,1553274000,27,2,29,Clouds
33390,110,1553274000,40,0,40,Clouds
33391,111,1553274000,38,2,40,Clouds
33392,112,1553274000,27,3,30,Clouds
33393,113,1553274000,4,36,40,Clouds
33394,114,1553274000,6,34,40,Clouds
33395,115,1553274000,26,4,30,Clouds
33396,2,1553277600,19,1,20,Clouds
33397,3,1553277600,20,0,20,Clouds
33398,4,1553277600,18,2,20,Clouds
33399,5,1553277600,36,4,40,Clouds
33400,6,1553277600,18,2,20,Clouds
33401,7,1553277600,29,0,29,Clouds
33402,8,1553277600,1,28,29,Clouds
33403,9,1553277600,5,19,24,Clouds
33404,10,1553277600,6,10,16,Clouds
33405,11,1553277600,20,10,30,Clouds
33406,12,1553277600,20,0,20,Clouds
33407,13,1553277600,19,11,30,Clouds
33408,14,1553277600,24,6,30,Clouds
33409,15,1553277600,16,0,16,Clouds
33410,16,1553277600,3,17,20,Clouds
33411,17,1553277600,20,0,20,Clouds
33412,18,1553277600,30,0,30,Clouds
33413,19,1553277600,25,5,30,Clouds
33414,21,1553277600,5,25,30,Clouds
33415,22,1553277600,0,20,20,Clouds
33416,23,1553277600,1,29,30,Clouds
33417,24,1553277600,18,1,19,Clouds
33418,25,1553277600,14,16,30,Clouds
33419,26,1553277600,0,19,19,Clouds
33420,27,1553277600,14,6,20,Clouds
33421,28,1553277600,30,0,30,Clouds
33422,29,1553277600,24,5,29,Clouds
33423,30,1553277600,20,0,20,Clouds
33424,31,1553277600,19,1,20,Clouds
33425,32,1553277600,1,29,30,Clouds
33426,33,1553277600,0,23,23,Clouds
33427,34,1553277600,25,5,30,Clouds
33428,35,1553277600,30,0,30,Clouds
33429,36,1553277600,11,29,40,Clouds
33430,37,1553277600,16,14,30,Clouds
33431,38,1553277600,20,20,40,Clouds
33432,39,1553277600,20,0,20,Clouds
33433,40,1553277600,4,17,21,Clouds
33434,41,1553277600,19,1,20,Clouds
33435,42,1553277600,24,6,30,Clouds
33436,43,1553277600,22,8,30,Clouds
33437,44,1553277600,26,4,30,Clouds
33438,45,1553277600,20,10,30,Clouds
33439,46,1553277600,14,6,20,Clouds
33440,47,1553277600,10,30,40,Clouds
33441,48,1553277600,4,36,40,Clouds
33442,49,1553277600,0,40,40,Clouds
33443,50,1553277600,39,1,40,Clouds
33444,51,1553277600,26,14,40,Clouds
33445,52,1553277600,16,16,32,Clouds
33446,53,1553277600,34,6,40,Clouds
33447,54,1553277600,21,12,33,Clouds
33448,55,1553277600,30,6,36,Clouds
33449,56,1553277600,31,9,40,Clouds
33450,57,1553277600,8,15,23,Clouds
33451,58,1553277600,29,11,40,Clouds
33452,59,1553277600,20,0,20,Clouds
33453,60,1553277600,22,8,30,Clouds
33454,61,1553277600,24,1,25,Clouds
33455,62,1553277600,17,23,40,Clouds
33456,63,1553277600,0,35,35,Clouds
33457,64,1553277600,24,16,40,Clouds
33458,65,1553277600,19,21,40,Clouds
33459,66,1553277600,39,1,40,Clouds
33460,67,1553277600,10,30,40,Clouds
33461,68,1553277600,17,23,40,Clouds
33462,69,1553277600,31,9,40,Clouds
33463,70,1553277600,9,19,28,Clouds
33464,71,1553277600,40,0,40,Clouds
33465,72,1553277600,20,11,31,Clouds
33466,73,1553277600,30,0,30,Clouds
33467,74,1553277600,19,11,30,Clouds
33468,75,1553277600,33,7,40,Clouds
33469,76,1553277600,33,5,38,Clouds
33470,77,1553277600,25,4,29,Clouds
33471,78,1553277600,40,0,40,Clouds
33472,79,1553277600,27,0,27,Clouds
33473,80,1553277600,28,12,40,Clouds
33474,81,1553277600,38,2,40,Clouds
33475,82,1553277600,21,1,22,Clouds
33476,83,1553277600,34,6,40,Clouds
33477,84,1553277600,26,4,30,Clouds
33478,85,1553277600,32,3,35,Clouds
33479,86,1553277600,26,12,38,Clouds
33480,87,1553277600,36,2,38,Clouds
33481,88,1553277600,30,0,30,Clouds
33482,89,1553277600,17,23,40,Clouds
33483,90,1553277600,33,7,40,Clouds
33484,91,1553277600,24,6,30,Clouds
33485,92,1553277600,24,16,40,Clouds
33486,93,1553277600,22,18,40,Clouds
33487,94,1553277600,40,0,40,Clouds
33488,95,1553277600,36,4,40,Clouds
33489,96,1553277600,29,1,30,Clouds
33490,97,1553277600,37,3,40,Clouds
33491,98,1553277600,14,26,40,Clouds
33492,99,1553277600,5,25,30,Clouds
33493,100,1553277600,0,25,25,Clouds
33494,101,1553277600,30,0,30,Clouds
33495,102,1553277600,39,1,40,Clouds
33496,103,1553277600,35,5,40,Clouds
33497,104,1553277600,31,9,40,Clouds
33498,105,1553277600,23,13,36,Clouds
33499,106,1553277600,28,12,40,Clouds
33500,107,1553277600,31,9,40,Clouds
33501,108,1553277600,37,3,40,Clouds
33502,109,1553277600,22,7,29,Clouds
33503,110,1553277600,39,1,40,Clouds
33504,111,1553277600,35,5,40,Clouds
33505,112,1553277600,22,8,30,Clouds
33506,113,1553277600,12,28,40,Clouds
33507,114,1553277600,37,3,40,Clouds
33508,115,1553277600,26,4,30,Clouds
33509,2,1553281200,15,5,20,Clouds
33510,3,1553281200,20,0,20,Clouds
33511,4,1553281200,20,0,20,Clouds
33512,5,1553281200,29,11,40,Clouds
33513,6,1553281200,16,4,20,Clouds
33514,7,1553281200,28,1,29,Clouds
33515,8,1553281200,2,27,29,Clouds
33516,9,1553281200,10,14,24,Clouds
33517,10,1553281200,10,6,16,Clouds
33518,11,1553281200,30,0,30,Clouds
33519,12,1553281200,15,5,20,Clouds
33520,13,1553281200,30,0,30,Clouds
33521,14,1553281200,7,23,30,Clouds
33522,15,1553281200,14,2,16,Clouds
33523,16,1553281200,0,20,20,Clouds
33524,17,1553281200,20,0,20,Clouds
33525,18,1553281200,26,4,30,Clouds
33526,19,1553281200,28,1,29,Clouds
33527,21,1553281200,3,27,30,Clouds
33528,22,1553281200,1,19,20,Clouds
33529,23,1553281200,1,29,30,Clouds
33530,24,1553281200,12,8,20,Clouds
33531,25,1553281200,18,12,30,Clouds
33532,26,1553281200,1,18,19,Clouds
33533,27,1553281200,17,3,20,Clouds
33534,28,1553281200,30,0,30,Clouds
33535,29,1553281200,23,6,29,Clouds
33536,30,1553281200,17,3,20,Clouds
33537,31,1553281200,16,4,20,Clouds
33538,32,1553281200,5,25,30,Clouds
33539,33,1553281200,0,23,23,Clouds
33540,34,1553281200,22,8,30,Clouds
33541,35,1553281200,21,9,30,Clouds
33542,36,1553281200,28,12,40,Clouds
33543,37,1553281200,27,3,30,Clouds
33544,38,1553281200,14,26,40,Clouds
33545,39,1553281200,18,2,20,Clouds
33546,40,1553281200,4,17,21,Clouds
33547,41,1553281200,20,0,20,Clouds
33548,42,1553281200,22,8,30,Clouds
33549,43,1553281200,27,3,30,Clouds
33550,44,1553281200,12,18,30,Clouds
33551,45,1553281200,20,10,30,Clouds
33552,46,1553281200,12,8,20,Clouds
33553,47,1553281200,39,1,40,Clouds
33554,48,1553281200,0,40,40,Clouds
33555,49,1553281200,10,30,40,Clouds
33556,50,1553281200,28,12,40,Clouds
33557,51,1553281200,25,15,40,Clouds
33558,52,1553281200,26,6,32,Clouds
33559,53,1553281200,40,0,40,Clouds
33560,54,1553281200,32,1,33,Clouds
33561,55,1553281200,36,0,36,Clouds
33562,56,1553281200,26,14,40,Clouds
33563,57,1553281200,22,1,23,Clouds
33564,58,1553281200,40,0,40,Clouds
33565,59,1553281200,17,3,20,Clouds
33566,60,1553281200,17,13,30,Clouds
33567,61,1553281200,23,2,25,Clouds
33568,62,1553281200,40,0,40,Clouds
33569,63,1553281200,9,26,35,Clouds
33570,64,1553281200,26,14,40,Clouds
33571,65,1553281200,30,10,40,Clouds
33572,66,1553281200,39,1,40,Clouds
33573,67,1553281200,13,27,40,Clouds
33574,68,1553281200,40,0,40,Clouds
33575,69,1553281200,40,0,40,Clouds
33576,70,1553281200,11,17,28,Clouds
33577,71,1553281200,32,8,40,Clouds
33578,72,1553281200,23,8,31,Clouds
33579,73,1553281200,17,13,30,Clouds
33580,74,1553281200,24,6,30,Clouds
33581,75,1553281200,22,18,40,Clouds
33582,76,1553281200,34,4,38,Clouds
33583,77,1553281200,29,0,29,Clouds
33584,78,1553281200,33,7,40,Clouds
33585,79,1553281200,27,0,27,Clouds
33586,80,1553281200,29,11,40,Clouds
33587,81,1553281200,40,0,40,Clouds
33588,82,1553281200,19,3,22,Clouds
33589,83,1553281200,31,9,40,Clouds
33590,84,1553281200,20,10,30,Clouds
33591,85,1553281200,31,4,35,Clouds
33592,86,1553281200,7,31,38,Clouds
33593,87,1553281200,33,5,38,Clouds
33594,88,1553281200,24,6,30,Clouds
33595,89,1553281200,37,3,40,Clouds
33596,90,1553281200,39,1,40,Clouds
33597,91,1553281200,19,11,30,Clouds
33598,92,1553281200,2,38,40,Clouds
33599,93,1553281200,0,40,40,Clouds
33600,94,1553281200,34,6,40,Clouds
33601,95,1553281200,22,18,40,Clouds
33602,96,1553281200,26,4,30,Clouds
33603,97,1553281200,31,9,40,Clouds
33604,98,1553281200,23,17,40,Clouds
33605,99,1553281200,19,11,30,Clouds
33606,100,1553281200,8,17,25,Clouds
33607,101,1553281200,28,2,30,Clouds
33608,102,1553281200,37,3,40,Clouds
33609,103,1553281200,38,2,40,Clouds
33610,104,1553281200,31,9,40,Clouds
33611,105,1553281200,25,11,36,Clouds
33612,106,1553281200,26,14,40,Clouds
33613,107,1553281200,25,15,40,Clouds
33614,108,1553281200,33,7,40,Clouds
33615,109,1553281200,19,10,29,Clouds
33616,110,1553281200,37,3,40,Clouds
33617,111,1553281200,36,4,40,Clouds
33618,112,1553281200,18,12,30,Clouds
33619,113,1553281200,21,19,40,Clouds
33620,114,1553281200,40,0,40,Clouds
33621,115,1553281200,15,15,30,Clouds
33622,2,1553284800,15,5,20,Clouds
33623,3,1553284800,15,5,20,Clouds
33624,4,1553284800,16,4,20,Clouds
33625,5,1553284800,28,12,40,Clouds
33626,6,1553284800,17,3,20,Clouds
33627,7,1553284800,23,6,29,Clouds
33628,8,1553284800,4,25,29,Clouds
33629,9,1553284800,7,17,24,Clouds
33630,10,1553284800,0,16,16,Clouds
33631,11,1553284800,20,10,30,Clouds
33632,12,1553284800,16,4,20,Clouds
33633,13,1553284800,30,0,30,Clouds
33634,14,1553284800,2,28,30,Clouds
33635,15,1553284800,11,5,16,Clouds
33636,16,1553284800,1,19,20,Clouds
33637,17,1553284800,20,0,20,Clouds
33638,18,1553284800,27,3,30,Clouds
33639,19,1553284800,25,4,29,Clouds
33640,21,1553284800,2,28,30,Clouds
33641,22,1553284800,2,18,20,Clouds
33642,23,1553284800,1,29,30,Clouds
33643,24,1553284800,5,15,20,Clouds
33644,25,1553284800,21,9,30,Clouds
33645,26,1553284800,9,11,20,Clouds
33646,27,1553284800,19,1,20,Clouds
33647,28,1553284800,22,8,30,Clouds
33648,29,1553284800,27,2,29,Clouds
33649,30,1553284800,17,3,20,Clouds
33650,31,1553284800,10,10,20,Clouds
33651,32,1553284800,14,16,30,Clouds
33652,33,1553284800,1,22,23,Clouds
33653,34,1553284800,21,9,30,Clouds
33654,35,1553284800,17,13,30,Clouds
33655,36,1553284800,33,7,40,Clouds
33656,37,1553284800,30,0,30,Clouds
33657,38,1553284800,19,21,40,Clouds
33658,39,1553284800,13,7,20,Clouds
33659,40,1553284800,11,10,21,Clouds
33660,41,1553284800,17,3,20,Clouds
33661,42,1553284800,19,11,30,Clouds
33662,43,1553284800,30,0,30,Clouds
33663,44,1553284800,10,20,30,Clouds
33664,45,1553284800,15,15,30,Clouds
33665,46,1553284800,5,15,20,Clouds
33666,47,1553284800,38,2,40,Clouds
33667,48,1553284800,4,36,40,Clouds
33668,49,1553284800,12,28,40,Clouds
33669,50,1553284800,27,13,40,Clouds
33670,51,1553284800,24,16,40,Clouds
33671,52,1553284800,26,6,32,Clouds
33672,53,1553284800,26,14,40,Clouds
33673,54,1553284800,33,0,33,Clouds
33674,55,1553284800,36,0,36,Clouds
33675,56,1553284800,28,12,40,Clouds
33676,57,1553284800,20,3,23,Clouds
33677,58,1553284800,27,13,40,Clouds
33678,59,1553284800,20,0,20,Clouds
33679,60,1553284800,10,20,30,Clouds
33680,61,1553284800,24,1,25,Clouds
33681,62,1553284800,40,0,40,Clouds
33682,63,1553284800,9,26,35,Clouds
33683,64,1553284800,31,9,40,Clouds
33684,65,1553284800,40,0,40,Clouds
33685,66,1553284800,37,3,40,Clouds
33686,67,1553284800,19,21,40,Clouds
33687,68,1553284800,38,2,40,Clouds
33688,69,1553284800,34,6,40,Clouds
33689,70,1553284800,24,4,28,Clouds
33690,71,1553284800,30,10,40,Clouds
33691,72,1553284800,26,5,31,Clouds
33692,73,1553284800,12,18,30,Clouds
33693,74,1553284800,22,8,30,Clouds
33694,75,1553284800,21,19,40,Clouds
33695,76,1553284800,36,2,38,Clouds
33696,77,1553284800,21,8,29,Clouds
33697,78,1553284800,32,8,40,Clouds
33698,79,1553284800,27,0,27,Clouds
33699,80,1553284800,33,7,40,Clouds
33700,81,1553284800,40,0,40,Clouds
33701,82,1553284800,17,5,22,Clouds
33702,83,1553284800,19,21,40,Clouds
33703,84,1553284800,8,22,30,Clouds
33704,85,1553284800,30,5,35,Clouds
33705,86,1553284800,3,35,38,Clouds
33706,87,1553284800,30,8,38,Clouds
33707,88,1553284800,23,7,30,Clouds
33708,89,1553284800,40,0,40,Clouds
33709,90,1553284800,39,1,40,Clouds
33710,91,1553284800,9,21,30,Clouds
33711,92,1553284800,12,28,40,Clouds
33712,93,1553284800,0,40,40,Clouds
33713,94,1553284800,29,11,40,Clouds
33714,95,1553284800,11,29,40,Clouds
33715,96,1553284800,27,3,30,Clouds
33716,97,1553284800,26,14,40,Clouds
33717,98,1553284800,33,7,40,Clouds
33718,99,1553284800,27,3,30,Clouds
33719,100,1553284800,0,25,25,Clouds
33720,101,1553284800,25,5,30,Clouds
33721,102,1553284800,38,2,40,Clouds
33722,103,1553284800,39,1,40,Clouds
33723,104,1553284800,32,8,40,Clouds
33724,105,1553284800,25,11,36,Clouds
33725,106,1553284800,24,16,40,Clouds
33726,107,1553284800,32,8,40,Clouds
33727,108,1553284800,31,9,40,Clouds
33728,109,1553284800,23,6,29,Clouds
33729,110,1553284800,37,3,40,Clouds
33730,111,1553284800,36,4,40,Clouds
33731,112,1553284800,9,21,30,Clouds
33732,113,1553284800,26,14,40,Clouds
33733,114,1553284800,38,2,40,Clouds
33734,115,1553284800,5,25,30,Clouds
33735,2,1553288400,13,7,20,Clouds
33736,3,1553288400,18,2,20,Clouds
33737,4,1553288400,20,0,20,Clouds
33738,5,1553288400,17,23,40,Clouds
33739,6,1553288400,14,6,20,Clouds
33740,7,1553288400,23,6,29,Clouds
33741,8,1553288400,10,19,29,Clouds
33742,9,1553288400,4,20,24,Clouds
33743,10,1553288400,0,16,16,Clouds
33744,11,1553288400,23,7,30,Clouds
33745,12,1553288400,14,6,20,Clouds
33746,13,1553288400,30,0,30,Clouds
33747,14,1553288400,1,29,30,Clouds
33748,15,1553288400,14,2,16,Clouds
33749,16,1553288400,3,17,20,Clouds
33750,17,1553288400,19,1,20,Clouds
33751,18,1553288400,22,8,30,Clouds
33752,19,1553288400,29,0,29,Clouds
33753,21,1553288400,0,30,30,Clouds
33754,22,1553288400,7,13,20,Clouds
33755,23,1553288400,1,29,30,Clouds
33756,24,1553288400,1,19,20,Clouds
33757,25,1553288400,21,9,30,Clouds
33758,26,1553288400,7,13,20,Clouds
33759,27,1553288400,19,1,20,Clouds
33760,28,1553288400,21,9,30,Clouds
33761,29,1553288400,22,7,29,Clouds
33762,30,1553288400,17,3,20,Clouds
33763,31,1553288400,17,3,20,Clouds
33764,32,1553288400,17,13,30,Clouds
33765,33,1553288400,0,23,23,Clouds
33766,34,1553288400,22,8,30,Clouds
33767,35,1553288400,16,14,30,Clouds
33768,36,1553288400,27,13,40,Clouds
33769,37,1553288400,23,7,30,Clouds
33770,38,1553288400,21,19,40,Clouds
33771,39,1553288400,17,3,20,Clouds
33772,40,1553288400,2,19,21,Clouds
33773,41,1553288400,20,0,20,Clouds
33774,42,1553288400,23,7,30,Clouds
33775,43,1553288400,25,5,30,Clouds
33776,44,1553288400,10,20,30,Clouds
33777,45,1553288400,12,18,30,Clouds
33778,46,1553288400,1,19,20,Clouds
33779,47,1553288400,39,1,40,Clouds
33780,48,1553288400,8,32,40,Clouds
33781,49,1553288400,16,24,40,Clouds
33782,50,1553288400,27,13,40,Clouds
33783,51,1553288400,28,12,40,Clouds
33784,52,1553288400,26,6,32,Clouds
33785,53,1553288400,26,14,40,Clouds
33786,54,1553288400,31,2,33,Clouds
33787,55,1553288400,36,0,36,Clouds
33788,56,1553288400,37,3,40,Clouds
33789,57,1553288400,18,5,23,Clouds
33790,58,1553288400,36,4,40,Clouds
33791,59,1553288400,20,0,20,Clouds
33792,60,1553288400,5,25,30,Clouds
33793,61,1553288400,25,0,25,Clouds
33794,62,1553288400,38,2,40,Clouds
33795,63,1553288400,12,23,35,Clouds
33796,64,1553288400,29,11,40,Clouds
33797,65,1553288400,36,4,40,Clouds
33798,66,1553288400,33,7,40,Clouds
33799,67,1553288400,13,27,40,Clouds
33800,68,1553288400,28,12,40,Clouds
33801,69,1553288400,32,8,40,Clouds
33802,70,1553288400,24,4,28,Clouds
33803,71,1553288400,30,10,40,Clouds
33804,72,1553288400,12,19,31,Clouds
33805,73,1553288400,11,19,30,Clouds
33806,74,1553288400,27,3,30,Clouds
33807,75,1553288400,26,14,40,Clouds
33808,76,1553288400,38,0,38,Clouds
33809,77,1553288400,24,5,29,Clouds
33810,78,1553288400,28,12,40,Clouds
33811,79,1553288400,27,0,27,Clouds
33812,80,1553288400,35,5,40,Clouds
33813,81,1553288400,40,0,40,Clouds
33814,82,1553288400,18,4,22,Clouds
33815,83,1553288400,14,26,40,Clouds
33816,84,1553288400,9,21,30,Clouds
33817,85,1553288400,28,7,35,Clouds
33818,86,1553288400,2,36,38,Clouds
33819,87,1553288400,25,13,38,Clouds
33820,88,1553288400,19,11,30,Clouds
33821,89,1553288400,40,0,40,Clouds
33822,90,1553288400,37,3,40,Clouds
33823,91,1553288400,6,24,30,Clouds
33824,92,1553288400,9,31,40,Clouds
33825,93,1553288400,0,40,40,Clouds
33826,94,1553288400,28,12,40,Clouds
33827,95,1553288400,13,27,40,Clouds
33828,96,1553288400,27,3,30,Clouds
33829,97,1553288400,28,12,40,Clouds
33830,98,1553288400,32,8,40,Clouds
33831,99,1553288400,30,0,30,Clouds
33832,100,1553288400,0,25,25,Clouds
33833,101,1553288400,25,5,30,Clouds
33834,102,1553288400,32,8,40,Clouds
33835,103,1553288400,38,2,40,Clouds
33836,104,1553288400,32,8,40,Clouds
33837,105,1553288400,27,9,36,Clouds
33838,106,1553288400,24,16,40,Clouds
33839,107,1553288400,32,8,40,Clouds
33840,108,1553288400,33,7,40,Clouds
33841,109,1553288400,19,10,29,Clouds
33842,110,1553288400,36,4,40,Clouds
33843,111,1553288400,37,3,40,Clouds
33844,112,1553288400,3,27,30,Clouds
33845,113,1553288400,25,15,40,Clouds
33846,114,1553288400,40,0,40,Clouds
33847,115,1553288400,0,30,30,Clouds
33848,2,1553292000,9,11,20,Clouds
33849,3,1553292000,20,0,20,Clouds
33850,4,1553292000,16,4,20,Clouds
33851,5,1553292000,13,27,40,Clouds
33852,6,1553292000,17,3,20,Clouds
33853,7,1553292000,27,2,29,Clouds
33854,8,1553292000,12,18,30,Clouds
33855,9,1553292000,10,14,24,Clouds
33856,10,1553292000,7,9,16,Clouds
33857,11,1553292000,27,3,30,Clouds
33858,12,1553292000,14,6,20,Clouds
33859,13,1553292000,30,0,30,Clouds
33860,14,1553292000,0,30,30,Clouds
33861,15,1553292000,16,0,16,Clouds
33862,16,1553292000,2,18,20,Clouds
33863,17,1553292000,15,5,20,Clouds
33864,18,1553292000,18,12,30,Clouds
33865,19,1553292000,28,1,29,Clouds
33866,21,1553292000,22,8,30,Clouds
33867,22,1553292000,10,10,20,Clouds
33868,23,1553292000,1,29,30,Clouds
33869,24,1553292000,0,20,20,Clouds
33870,25,1553292000,23,7,30,Clouds
33871,26,1553292000,8,12,20,Clouds
33872,27,1553292000,20,0,20,Clouds
33873,28,1553292000,20,10,30,Clouds
33874,29,1553292000,18,11,29,Clouds
33875,30,1553292000,20,0,20,Clouds
33876,31,1553292000,14,6,20,Clouds
33877,32,1553292000,18,12,30,Clouds
33878,33,1553292000,1,22,23,Clouds
33879,34,1553292000,16,14,30,Clouds
33880,35,1553292000,8,22,30,Clouds
33881,36,1553292000,27,13,40,Clouds
33882,37,1553292000,24,6,30,Clouds
33883,38,1553292000,25,15,40,Clouds
33884,39,1553292000,17,3,20,Clouds
33885,40,1553292000,1,20,21,Clouds
33886,41,1553292000,20,0,20,Clouds
33887,42,1553292000,26,4,30,Clouds
33888,43,1553292000,20,10,30,Clouds
33889,44,1553292000,5,25,30,Clouds
33890,45,1553292000,10,20,30,Clouds
33891,46,1553292000,2,18,20,Clouds
33892,47,1553292000,40,0,40,Clouds
33893,48,1553292000,26,14,40,Clouds
33894,49,1553292000,18,22,40,Clouds
33895,50,1553292000,26,14,40,Clouds
33896,51,1553292000,27,13,40,Clouds
33897,52,1553292000,27,5,32,Clouds
33898,53,1553292000,26,14,40,Clouds
33899,54,1553292000,33,0,33,Clouds
33900,55,1553292000,36,0,36,Clouds
33901,56,1553292000,36,4,40,Clouds
33902,57,1553292000,20,3,23,Clouds
33903,58,1553292000,31,9,40,Clouds
33904,59,1553292000,20,0,20,Clouds
33905,60,1553292000,1,29,30,Clouds
33906,61,1553292000,24,1,25,Clouds
33907,62,1553292000,34,6,40,Clouds
33908,63,1553292000,15,20,35,Clouds
33909,64,1553292000,29,11,40,Clouds
33910,65,1553292000,37,3,40,Clouds
33911,66,1553292000,34,6,40,Clouds
33912,67,1553292000,8,32,40,Clouds
33913,68,1553292000,39,1,40,Clouds
33914,69,1553292000,37,3,40,Clouds
33915,70,1553292000,23,5,28,Clouds
33916,71,1553292000,26,14,40,Clouds
33917,72,1553292000,10,21,31,Clouds
33918,73,1553292000,7,23,30,Clouds
33919,74,1553292000,21,9,30,Clouds
33920,75,1553292000,31,9,40,Clouds
33921,76,1553292000,37,1,38,Clouds
33922,77,1553292000,20,9,29,Clouds
33923,78,1553292000,27,13,40,Clouds
33924,79,1553292000,25,2,27,Clouds
33925,80,1553292000,38,2,40,Clouds
33926,81,1553292000,40,0,40,Clouds
33927,82,1553292000,17,5,22,Clouds
33928,83,1553292000,11,29,40,Clouds
33929,84,1553292000,9,21,30,Clouds
33930,85,1553292000,29,6,35,Clouds
33931,86,1553292000,0,38,38,Clouds
33932,87,1553292000,23,15,38,Clouds
33933,88,1553292000,13,17,30,Clouds
33934,89,1553292000,40,0,40,Clouds
33935,90,1553292000,37,3,40,Clouds
33936,91,1553292000,9,21,30,Clouds
33937,92,1553292000,3,37,40,Clouds
33938,93,1553292000,0,40,40,Clouds
33939,94,1553292000,28,12,40,Clouds
33940,95,1553292000,13,27,40,Clouds
33941,96,1553292000,25,5,30,Clouds
33942,97,1553292000,31,9,40,Clouds
33943,98,1553292000,35,5,40,Clouds
33944,99,1553292000,30,0,30,Clouds
33945,100,1553292000,0,25,25,Clouds
33946,101,1553292000,23,7,30,Clouds
33947,102,1553292000,35,5,40,Clouds
33948,103,1553292000,38,2,40,Clouds
33949,104,1553292000,32,8,40,Clouds
33950,105,1553292000,26,10,36,Clouds
33951,106,1553292000,24,16,40,Clouds
33952,107,1553292000,31,9,40,Clouds
33953,108,1553292000,32,8,40,Clouds
33954,109,1553292000,16,13,29,Clouds
33955,110,1553292000,34,6,40,Clouds
33956,111,1553292000,26,14,40,Clouds
33957,112,1553292000,18,12,30,Clouds
33958,113,1553292000,25,15,40,Clouds
33959,114,1553292000,40,0,40,Clouds
33960,115,1553292000,1,29,30,Clouds
33961,2,1553295600,4,16,20,Clouds
33962,3,1553295600,17,3,20,Clouds
33963,4,1553295600,16,4,20,Clouds
33964,5,1553295600,6,34,40,Clouds
33965,6,1553295600,19,1,20,Clouds
33966,7,1553295600,29,0,29,Clouds
33967,8,1553295600,15,15,30,Clouds
33968,9,1553295600,15,9,24,Clouds
33969,10,1553295600,0,16,16,Clouds
33970,11,1553295600,29,1,30,Clouds
33971,12,1553295600,17,3,20,Clouds
33972,13,1553295600,29,1,30,Clouds
33973,14,1553295600,0,30,30,Clouds
33974,15,1553295600,12,4,16,Clouds
33975,16,1553295600,1,19,20,Clouds
33976,17,1553295600,17,3,20,Clouds
33977,18,1553295600,12,18,30,Clouds
33978,19,1553295600,28,2,30,Clouds
33979,21,1553295600,26,4,30,Clouds
33980,22,1553295600,16,4,20,Clouds
33981,23,1553295600,18,12,30,Clouds
33982,24,1553295600,0,20,20,Clouds
33983,25,1553295600,21,9,30,Clouds
33984,26,1553295600,5,15,20,Clouds
33985,27,1553295600,20,0,20,Clouds
33986,28,1553295600,15,15,30,Clouds
33987,29,1553295600,13,16,29,Clouds
33988,30,1553295600,20,0,20,Clouds
33989,31,1553295600,8,12,20,Clouds
33990,32,1553295600,14,16,30,Clouds
33991,33,1553295600,0,23,23,Clouds
33992,34,1553295600,14,16,30,Clouds
33993,35,1553295600,10,20,30,Clouds
33994,36,1553295600,28,12,40,Clouds
33995,37,1553295600,27,3,30,Clouds
33996,38,1553295600,20,20,40,Clouds
33997,39,1553295600,19,1,20,Clouds
33998,40,1553295600,8,13,21,Clouds
33999,41,1553295600,20,0,20,Clouds
34000,42,1553295600,21,9,30,Clouds
34001,43,1553295600,19,11,30,Clouds
34002,44,1553295600,3,27,30,Clouds
34003,45,1553295600,11,19,30,Clouds
34004,46,1553295600,2,18,20,Clouds
34005,47,1553295600,40,0,40,Clouds
34006,48,1553295600,32,8,40,Clouds
34007,49,1553295600,23,17,40,Clouds
34008,50,1553295600,26,14,40,Clouds
34009,51,1553295600,32,8,40,Clouds
34010,52,1553295600,30,2,32,Clouds
34011,53,1553295600,26,14,40,Clouds
34012,54,1553295600,32,1,33,Clouds
34013,55,1553295600,35,0,35,Clouds
34014,56,1553295600,38,2,40,Clouds
34015,57,1553295600,20,3,23,Clouds
34016,58,1553295600,32,8,40,Clouds
34017,59,1553295600,10,10,20,Clouds
34018,60,1553295600,0,30,30,Clouds
34019,61,1553295600,12,13,25,Clouds
34020,62,1553295600,38,2,40,Clouds
34021,63,1553295600,14,21,35,Clouds
34022,64,1553295600,28,12,40,Clouds
34023,65,1553295600,40,0,40,Clouds
34024,66,1553295600,38,2,40,Clouds
34025,67,1553295600,11,29,40,Clouds
34026,68,1553295600,40,0,40,Clouds
34027,69,1553295600,35,5,40,Clouds
34028,70,1553295600,25,3,28,Clouds
34029,71,1553295600,25,15,40,Clouds
34030,72,1553295600,11,20,31,Clouds
34031,73,1553295600,4,26,30,Clouds
34032,74,1553295600,21,9,30,Clouds
34033,75,1553295600,31,9,40,Clouds
34034,76,1553295600,18,20,38,Clouds
34035,77,1553295600,16,13,29,Clouds
34036,78,1553295600,24,16,40,Clouds
34037,79,1553295600,20,7,27,Clouds
34038,80,1553295600,37,3,40,Clouds
34039,81,1553295600,22,18,40,Clouds
34040,82,1553295600,17,5,22,Clouds
34041,83,1553295600,9,31,40,Clouds
34042,84,1553295600,6,24,30,Clouds
34043,85,1553295600,27,8,35,Clouds
34044,86,1553295600,11,27,38,Clouds
34045,87,1553295600,20,18,38,Clouds
34046,88,1553295600,12,18,30,Clouds
34047,89,1553295600,36,4,40,Clouds
34048,90,1553295600,39,1,40,Clouds
34049,91,1553295600,10,20,30,Clouds
34050,92,1553295600,11,29,40,Clouds
34051,93,1553295600,0,40,40,Clouds
34052,94,1553295600,28,12,40,Clouds
34053,95,1553295600,11,29,40,Clouds
34054,96,1553295600,24,6,30,Clouds
34055,97,1553295600,28,12,40,Clouds
34056,98,1553295600,38,2,40,Clouds
34057,99,1553295600,30,0,30,Clouds
34058,100,1553295600,17,8,25,Clouds
34059,101,1553295600,24,6,30,Clouds
34060,102,1553295600,35,5,40,Clouds
34061,103,1553295600,37,3,40,Clouds
34062,104,1553295600,35,5,40,Clouds
34063,105,1553295600,26,10,36,Clouds
34064,106,1553295600,23,17,40,Clouds
34065,107,1553295600,19,21,40,Clouds
34066,108,1553295600,21,19,40,Clouds
34067,109,1553295600,16,13,29,Clouds
34068,110,1553295600,36,4,40,Clouds
34069,111,1553295600,22,18,40,Clouds
34070,112,1553295600,15,15,30,Clouds
34071,113,1553295600,25,15,40,Clouds
34072,114,1553295600,37,3,40,Clouds
34073,115,1553295600,0,30,30,Clouds
34074,2,1553299200,3,17,20,Clouds
34075,3,1553299200,13,7,20,Clouds
34076,4,1553299200,14,6,20,Clouds
34077,5,1553299200,5,35,40,Clouds
34078,6,1553299200,20,0,20,Clouds
34079,7,1553299200,19,10,29,Clouds
34080,8,1553299200,18,12,30,Clouds
34081,9,1553299200,15,9,24,Clouds
34082,10,1553299200,1,15,16,Clouds
34083,11,1553299200,30,0,30,Clouds
34084,12,1553299200,17,3,20,Clouds
34085,13,1553299200,28,2,30,Clouds
34086,14,1553299200,3,27,30,Clouds
34087,15,1553299200,15,1,16,Clouds
34088,16,1553299200,2,18,20,Clouds
34089,17,1553299200,20,0,20,Clouds
34090,18,1553299200,10,20,30,Clouds
34091,19,1553299200,28,1,29,Clouds
34092,21,1553299200,27,3,30,Clouds
34093,22,1553299200,16,4,20,Clouds
34094,23,1553299200,15,15,30,Clouds
34095,24,1553299200,4,16,20,Clouds
34096,25,1553299200,21,9,30,Clouds
34097,26,1553299200,5,15,20,Clouds
34098,27,1553299200,20,0,20,Clouds
34099,28,1553299200,11,19,30,Clouds
34100,29,1553299200,14,15,29,Clouds
34101,30,1553299200,18,2,20,Clouds
34102,31,1553299200,12,8,20,Clouds
34103,32,1553299200,16,14,30,Clouds
34104,33,1553299200,5,18,23,Clouds
34105,34,1553299200,9,21,30,Clouds
34106,35,1553299200,12,18,30,Clouds
34107,36,1553299200,31,9,40,Clouds
34108,37,1553299200,27,3,30,Clouds
34109,38,1553299200,19,21,40,Clouds
34110,39,1553299200,17,3,20,Clouds
34111,40,1553299200,7,14,21,Clouds
34112,41,1553299200,19,1,20,Clouds
34113,42,1553299200,19,11,30,Clouds
34114,43,1553299200,17,13,30,Clouds
34115,44,1553299200,4,26,30,Clouds
34116,45,1553299200,11,19,30,Clouds
34117,46,1553299200,3,17,20,Clouds
34118,47,1553299200,40,0,40,Clouds
34119,48,1553299200,28,12,40,Clouds
34120,49,1553299200,24,16,40,Clouds
34121,50,1553299200,31,9,40,Clouds
34122,51,1553299200,32,8,40,Clouds
34123,52,1553299200,29,3,32,Clouds
34124,53,1553299200,28,12,40,Clouds
34125,54,1553299200,32,1,33,Clouds
34126,55,1553299200,35,0,35,Clouds
34127,56,1553299200,37,3,40,Clouds
34128,57,1553299200,20,3,23,Clouds
34129,58,1553299200,37,3,40,Clouds
34130,59,1553299200,9,11,20,Clouds
34131,60,1553299200,12,18,30,Clouds
34132,61,1553299200,14,11,25,Clouds
34133,62,1553299200,37,3,40,Clouds
34134,63,1553299200,17,18,35,Clouds
34135,64,1553299200,25,15,40,Clouds
34136,65,1553299200,40,0,40,Clouds
34137,66,1553299200,29,11,40,Clouds
34138,67,1553299200,21,19,40,Clouds
34139,68,1553299200,40,0,40,Clouds
34140,69,1553299200,33,7,40,Clouds
34141,70,1553299200,25,3,28,Clouds
34142,71,1553299200,25,15,40,Clouds
34143,72,1553299200,16,15,31,Clouds
34144,73,1553299200,4,26,30,Clouds
34145,74,1553299200,19,11,30,Clouds
34146,75,1553299200,29,11,40,Clouds
34147,76,1553299200,20,18,38,Clouds
34148,77,1553299200,17,12,29,Clouds
34149,78,1553299200,23,17,40,Clouds
34150,79,1553299200,20,7,27,Clouds
34151,80,1553299200,34,6,40,Clouds
34152,81,1553299200,22,18,40,Clouds
34153,82,1553299200,18,4,22,Clouds
34154,83,1553299200,16,24,40,Clouds
34155,84,1553299200,7,23,30,Clouds
34156,85,1553299200,25,10,35,Clouds
34157,86,1553299200,11,27,38,Clouds
34158,87,1553299200,20,18,38,Clouds
34159,88,1553299200,13,17,30,Clouds
34160,89,1553299200,36,4,40,Clouds
34161,90,1553299200,38,2,40,Clouds
34162,91,1553299200,13,17,30,Clouds
34163,92,1553299200,10,30,40,Clouds
34164,93,1553299200,0,40,40,Clouds
34165,94,1553299200,28,12,40,Clouds
34166,95,1553299200,11,29,40,Clouds
34167,96,1553299200,22,8,30,Clouds
34168,97,1553299200,25,15,40,Clouds
34169,98,1553299200,40,0,40,Clouds
34170,99,1553299200,29,1,30,Clouds
34171,100,1553299200,16,9,25,Clouds
34172,101,1553299200,23,7,30,Clouds
34173,102,1553299200,34,6,40,Clouds
34174,103,1553299200,37,3,40,Clouds
34175,104,1553299200,35,5,40,Clouds
34176,105,1553299200,25,11,36,Clouds
34177,106,1553299200,23,17,40,Clouds
34178,107,1553299200,18,22,40,Clouds
34179,108,1553299200,25,15,40,Clouds
34180,109,1553299200,12,17,29,Clouds
34181,110,1553299200,26,14,40,Clouds
34182,111,1553299200,22,18,40,Clouds
34183,112,1553299200,12,18,30,Clouds
34184,113,1553299200,25,15,40,Clouds
34185,114,1553299200,37,3,40,Clouds
34186,115,1553299200,0,30,30,Clouds
34187,2,1553302800,4,16,20,Clouds
34188,3,1553302800,15,5,20,Clouds
34189,4,1553302800,15,5,20,Clouds
34190,5,1553302800,7,33,40,Clouds
34191,6,1553302800,20,0,20,Clouds
34192,7,1553302800,20,9,29,Clouds
34193,8,1553302800,25,5,30,Clouds
34194,9,1553302800,22,2,24,Clouds
34195,10,1553302800,3,13,16,Clouds
34196,11,1553302800,30,0,30,Clouds
34197,12,1553302800,15,5,20,Clouds
34198,13,1553302800,29,1,30,Clouds
34199,14,1553302800,6,24,30,Clouds
34200,15,1553302800,14,2,16,Clouds
34201,16,1553302800,0,20,20,Clouds
34202,17,1553302800,20,0,20,Clouds
34203,18,1553302800,16,14,30,Clouds
34204,19,1553302800,29,1,30,Clouds
34205,21,1553302800,30,0,30,Clouds
34206,22,1553302800,15,5,20,Clouds
34207,23,1553302800,15,15,30,Clouds
34208,24,1553302800,7,13,20,Clouds
34209,25,1553302800,24,6,30,Clouds
34210,26,1553302800,6,14,20,Clouds
34211,27,1553302800,19,1,20,Clouds
34212,28,1553302800,9,21,30,Clouds
34213,29,1553302800,19,10,29,Clouds
34214,30,1553302800,20,0,20,Clouds
34215,31,1553302800,14,6,20,Clouds
34216,32,1553302800,16,14,30,Clouds
34217,33,1553302800,8,15,23,Clouds
34218,34,1553302800,2,28,30,Clouds
34219,35,1553302800,8,22,30,Clouds
34220,36,1553302800,30,10,40,Clouds
34221,37,1553302800,27,3,30,Clouds
34222,38,1553302800,22,18,40,Clouds
34223,39,1553302800,19,1,20,Clouds
34224,40,1553302800,4,17,21,Clouds
34225,41,1553302800,19,1,20,Clouds
34226,42,1553302800,18,12,30,Clouds
34227,43,1553302800,12,18,30,Clouds
34228,44,1553302800,3,27,30,Clouds
34229,45,1553302800,12,18,30,Clouds
34230,46,1553302800,4,16,20,Clouds
34231,47,1553302800,39,1,40,Clouds
34232,48,1553302800,35,5,40,Clouds
34233,49,1553302800,23,17,40,Clouds
34234,50,1553302800,28,12,40,Clouds
34235,51,1553302800,30,10,40,Clouds
34236,52,1553302800,31,1,32,Clouds
34237,53,1553302800,29,11,40,Clouds
34238,54,1553302800,30,3,33,Clouds
34239,55,1553302800,36,0,36,Clouds
34240,56,1553302800,32,8,40,Clouds
34241,57,1553302800,21,2,23,Clouds
34242,58,1553302800,30,10,40,Clouds
34243,59,1553302800,8,12,20,Clouds
34244,60,1553302800,11,19,30,Clouds
34245,61,1553302800,14,11,25,Clouds
34246,62,1553302800,38,2,40,Clouds
34247,63,1553302800,18,17,35,Clouds
34248,64,1553302800,27,13,40,Clouds
34249,65,1553302800,40,0,40,Clouds
34250,66,1553302800,27,13,40,Clouds
34251,67,1553302800,28,12,40,Clouds
34252,68,1553302800,37,3,40,Clouds
34253,69,1553302800,34,6,40,Clouds
34254,70,1553302800,25,3,28,Clouds
34255,71,1553302800,25,15,40,Clouds
34256,72,1553302800,18,13,31,Clouds
34257,73,1553302800,3,27,30,Clouds
34258,74,1553302800,20,10,30,Clouds
34259,75,1553302800,29,11,40,Clouds
34260,76,1553302800,19,19,38,Clouds
34261,77,1553302800,13,16,29,Clouds
34262,78,1553302800,22,18,40,Clouds
34263,79,1553302800,19,8,27,Clouds
34264,80,1553302800,34,6,40,Clouds
34265,81,1553302800,22,18,40,Clouds
34266,82,1553302800,17,5,22,Clouds
34267,83,1553302800,15,25,40,Clouds
34268,84,1553302800,6,24,30,Clouds
34269,85,1553302800,23,12,35,Clouds
34270,86,1553302800,12,26,38,Clouds
34271,87,1553302800,18,20,38,Clouds
34272,88,1553302800,12,18,30,Clouds
34273,89,1553302800,35,5,40,Clouds
34274,90,1553302800,38,2,40,Clouds
34275,91,1553302800,12,18,30,Clouds
34276,92,1553302800,11,29,40,Clouds
34277,93,1553302800,0,40,40,Clouds
34278,94,1553302800,28,12,40,Clouds
34279,95,1553302800,8,32,40,Clouds
34280,96,1553302800,22,8,30,Clouds
34281,97,1553302800,25,15,40,Clouds
34282,98,1553302800,40,0,40,Clouds
34283,99,1553302800,30,0,30,Clouds
34284,100,1553302800,15,10,25,Clouds
34285,101,1553302800,19,11,30,Clouds
34286,102,1553302800,31,9,40,Clouds
34287,103,1553302800,37,3,40,Clouds
34288,104,1553302800,35,5,40,Clouds
34289,105,1553302800,24,12,36,Clouds
34290,106,1553302800,23,17,40,Clouds
34291,107,1553302800,17,23,40,Clouds
34292,108,1553302800,23,17,40,Clouds
34293,109,1553302800,3,26,29,Clouds
34294,110,1553302800,24,16,40,Clouds
34295,111,1553302800,21,19,40,Clouds
34296,112,1553302800,6,24,30,Clouds
34297,113,1553302800,25,15,40,Clouds
34298,114,1553302800,38,2,40,Clouds
34299,115,1553302800,0,30,30,Clouds
34300,2,1553306400,0,20,20,Clouds
34301,3,1553306400,17,3,20,Clouds
34302,4,1553306400,15,5,20,Clouds
34303,5,1553306400,7,33,40,Clouds
34304,6,1553306400,20,0,20,Clouds
34305,7,1553306400,21,8,29,Clouds
34306,8,1553306400,24,6,30,Clouds
34307,9,1553306400,23,1,24,Clouds
34308,10,1553306400,6,10,16,Clouds
34309,11,1553306400,30,0,30,Clouds
34310,12,1553306400,15,5,20,Clouds
34311,13,1553306400,29,1,30,Clouds
34312,14,1553306400,4,26,30,Clouds
34313,15,1553306400,11,5,16,Clouds
34314,16,1553306400,1,19,20,Clouds
34315,17,1553306400,20,0,20,Clouds
34316,18,1553306400,16,14,30,Clouds
34317,19,1553306400,28,2,30,Clouds
34318,21,1553306400,30,0,30,Clouds
34319,22,1553306400,16,4,20,Clouds
34320,23,1553306400,15,15,30,Clouds
34321,24,1553306400,7,13,20,Clouds
34322,25,1553306400,25,5,30,Clouds
34323,26,1553306400,8,12,20,Clouds
34324,27,1553306400,20,0,20,Clouds
34325,28,1553306400,4,26,30,Clouds
34326,29,1553306400,22,7,29,Clouds
34327,30,1553306400,20,0,20,Clouds
34328,31,1553306400,15,5,20,Clouds
34329,32,1553306400,16,14,30,Clouds
34330,33,1553306400,11,12,23,Clouds
34331,34,1553306400,5,25,30,Clouds
34332,35,1553306400,6,24,30,Clouds
34333,36,1553306400,32,8,40,Clouds
34334,37,1553306400,27,3,30,Clouds
34335,38,1553306400,21,19,40,Clouds
34336,39,1553306400,19,1,20,Clouds
34337,40,1553306400,7,14,21,Clouds
34338,41,1553306400,19,1,20,Clouds
34339,42,1553306400,18,12,30,Clouds
34340,43,1553306400,9,21,30,Clouds
34341,44,1553306400,1,29,30,Clouds
34342,45,1553306400,11,19,30,Clouds
34343,46,1553306400,6,14,20,Clouds
34344,47,1553306400,39,1,40,Clouds
34345,48,1553306400,36,4,40,Clouds
34346,49,1553306400,24,16,40,Clouds
34347,50,1553306400,26,14,40,Clouds
34348,51,1553306400,32,8,40,Clouds
34349,52,1553306400,30,2,32,Clouds
34350,53,1553306400,29,11,40,Clouds
34351,54,1553306400,30,3,33,Clouds
34352,55,1553306400,36,0,36,Clouds
34353,56,1553306400,34,6,40,Clouds
34354,57,1553306400,21,2,23,Clouds
34355,58,1553306400,32,8,40,Clouds
34356,59,1553306400,8,12,20,Clouds
34357,60,1553306400,8,22,30,Clouds
34358,61,1553306400,14,11,25,Clouds
34359,62,1553306400,38,2,40,Clouds
34360,63,1553306400,19,16,35,Clouds
34361,64,1553306400,27,13,40,Clouds
34362,65,1553306400,40,0,40,Clouds
34363,66,1553306400,25,15,40,Clouds
34364,67,1553306400,28,12,40,Clouds
34365,68,1553306400,37,3,40,Clouds
34366,69,1553306400,34,6,40,Clouds
34367,70,1553306400,25,3,28,Clouds
34368,71,1553306400,23,17,40,Clouds
34369,72,1553306400,21,10,31,Clouds
34370,73,1553306400,2,28,30,Clouds
34371,74,1553306400,21,9,30,Clouds
34372,75,1553306400,28,12,40,Clouds
34373,76,1553306400,18,20,38,Clouds
34374,77,1553306400,18,11,29,Clouds
34375,78,1553306400,17,23,40,Clouds
34376,79,1553306400,19,8,27,Clouds
34377,80,1553306400,33,7,40,Clouds
34378,81,1553306400,22,18,40,Clouds
34379,82,1553306400,17,5,22,Clouds
34380,83,1553306400,16,24,40,Clouds
34381,84,1553306400,6,24,30,Clouds
34382,85,1553306400,20,15,35,Clouds
34383,86,1553306400,15,23,38,Clouds
34384,87,1553306400,16,22,38,Clouds
34385,88,1553306400,8,22,30,Clouds
34386,89,1553306400,35,5,40,Clouds
34387,90,1553306400,38,2,40,Clouds
34388,91,1553306400,12,18,30,Clouds
34389,92,1553306400,10,30,40,Clouds
34390,93,1553306400,0,40,40,Clouds
34391,94,1553306400,28,12,40,Clouds
34392,95,1553306400,8,32,40,Clouds
34393,96,1553306400,20,10,30,Clouds
34394,97,1553306400,26,14,40,Clouds
34395,98,1553306400,40,0,40,Clouds
34396,99,1553306400,30,0,30,Clouds
34397,100,1553306400,14,11,25,Clouds
34398,101,1553306400,16,14,30,Clouds
34399,102,1553306400,29,11,40,Clouds
34400,103,1553306400,37,3,40,Clouds
34401,104,1553306400,35,5,40,Clouds
34402,105,1553306400,23,13,36,Clouds
34403,106,1553306400,23,17,40,Clouds
34404,107,1553306400,19,21,40,Clouds
34405,108,1553306400,23,17,40,Clouds
34406,109,1553306400,3,26,29,Clouds
34407,110,1553306400,24,16,40,Clouds
34408,111,1553306400,20,20,40,Clouds
34409,112,1553306400,3,27,30,Clouds
34410,113,1553306400,25,15,40,Clouds
34411,114,1553306400,40,0,40,Clouds
34412,115,1553306400,0,30,30,Clouds
34413,2,1553310000,0,20,20,Clouds
34414,3,1553310000,17,3,20,Clouds
34415,4,1553310000,15,5,20,Clouds
34416,5,1553310000,7,33,40,Clouds
34417,6,1553310000,19,1,20,Clouds
34418,7,1553310000,21,8,29,Clouds
34419,8,1553310000,24,6,30,Clouds
34420,9,1553310000,23,1,24,Clouds
34421,10,1553310000,6,10,16,Clouds
34422,11,1553310000,30,0,30,Clouds
34423,12,1553310000,14,6,20,Clouds
34424,13,1553310000,29,1,30,Clouds
34425,14,1553310000,4,26,30,Clouds
34426,15,1553310000,11,5,16,Clouds
34427,16,1553310000,1,19,20,Clouds
34428,17,1553310000,20,0,20,Clouds
34429,18,1553310000,16,14,30,Clouds
34430,19,1553310000,28,2,30,Clouds
34431,21,1553310000,30,0,30,Clouds
34432,22,1553310000,16,4,20,Clouds
34433,23,1553310000,15,15,30,Clouds
34434,24,1553310000,7,13,20,Clouds
34435,25,1553310000,25,5,30,Clouds
34436,26,1553310000,8,12,20,Clouds
34437,27,1553310000,20,0,20,Clouds
34438,28,1553310000,3,27,30,Clouds
34439,29,1553310000,22,7,29,Clouds
34440,30,1553310000,20,0,20,Clouds
34441,31,1553310000,15,5,20,Clouds
34442,32,1553310000,16,14,30,Clouds
34443,33,1553310000,11,12,23,Clouds
34444,34,1553310000,5,25,30,Clouds
34445,35,1553310000,6,24,30,Clouds
34446,36,1553310000,32,8,40,Clouds
34447,37,1553310000,27,3,30,Clouds
34448,38,1553310000,21,19,40,Clouds
34449,39,1553310000,19,1,20,Clouds
34450,40,1553310000,7,14,21,Clouds
34451,41,1553310000,19,1,20,Clouds
34452,42,1553310000,18,12,30,Clouds
34453,43,1553310000,9,21,30,Clouds
34454,44,1553310000,1,29,30,Clouds
34455,45,1553310000,11,19,30,Clouds
34456,46,1553310000,6,14,20,Clouds
34457,47,1553310000,39,1,40,Clouds
34458,48,1553310000,36,4,40,Clouds
34459,49,1553310000,24,16,40,Clouds
34460,50,1553310000,26,14,40,Clouds
34461,51,1553310000,32,8,40,Clouds
34462,52,1553310000,30,2,32,Clouds
34463,53,1553310000,29,11,40,Clouds
34464,54,1553310000,30,3,33,Clouds
34465,55,1553310000,35,0,35,Clouds
34466,56,1553310000,34,6,40,Clouds
34467,57,1553310000,21,2,23,Clouds
34468,58,1553310000,32,8,40,Clouds
34469,59,1553310000,8,12,20,Clouds
34470,60,1553310000,8,22,30,Clouds
34471,61,1553310000,14,11,25,Clouds
34472,62,1553310000,38,2,40,Clouds
34473,63,1553310000,19,16,35,Clouds
34474,64,1553310000,27,13,40,Clouds
34475,65,1553310000,40,0,40,Clouds
34476,66,1553310000,25,15,40,Clouds
34477,67,1553310000,28,12,40,Clouds
34478,68,1553310000,37,3,40,Clouds
34479,69,1553310000,33,7,40,Clouds
34480,70,1553310000,25,3,28,Clouds
34481,71,1553310000,23,17,40,Clouds
34482,72,1553310000,21,10,31,Clouds
34483,73,1553310000,2,28,30,Clouds
34484,74,1553310000,21,9,30,Clouds
34485,75,1553310000,28,12,40,Clouds
34486,76,1553310000,18,20,38,Clouds
34487,77,1553310000,18,11,29,Clouds
34488,78,1553310000,17,23,40,Clouds
34489,79,1553310000,19,8,27,Clouds
34490,80,1553310000,33,7,40,Clouds
34491,81,1553310000,22,18,40,Clouds
34492,82,1553310000,16,6,22,Clouds
34493,83,1553310000,16,24,40,Clouds
34494,84,1553310000,6,24,30,Clouds
34495,85,1553310000,20,15,35,Clouds
34496,86,1553310000,15,23,38,Clouds
34497,87,1553310000,16,22,38,Clouds
34498,88,1553310000,8,22,30,Clouds
34499,89,1553310000,35,5,40,Clouds
34500,90,1553310000,38,2,40,Clouds
34501,91,1553310000,12,18,30,Clouds
34502,92,1553310000,10,30,40,Clouds
34503,93,1553310000,0,40,40,Clouds
34504,94,1553310000,28,12,40,Clouds
34505,95,1553310000,8,32,40,Clouds
34506,96,1553310000,20,10,30,Clouds
34507,97,1553310000,26,14,40,Clouds
34508,98,1553310000,40,0,40,Clouds
34509,99,1553310000,30,0,30,Clouds
34510,100,1553310000,14,11,25,Clouds
34511,101,1553310000,16,14,30,Clouds
34512,102,1553310000,29,11,40,Clouds
34513,103,1553310000,37,3,40,Clouds
34514,104,1553310000,35,5,40,Clouds
34515,105,1553310000,23,13,36,Clouds
34516,106,1553310000,23,17,40,Clouds
34517,107,1553310000,19,21,40,Clouds
34518,108,1553310000,23,17,40,Clouds
34519,109,1553310000,3,26,29,Clouds
34520,110,1553310000,23,17,40,Clouds
34521,111,1553310000,20,20,40,Clouds
34522,112,1553310000,3,27,30,Clouds
34523,113,1553310000,25,15,40,Clouds
34524,114,1553310000,40,0,40,Clouds
34525,115,1553310000,0,30,30,Clouds
34526,2,1553313600,0,20,20,Clouds
34527,3,1553313600,17,3,20,Clouds
34528,4,1553313600,15,5,20,Clouds
34529,5,1553313600,7,33,40,Clouds
34530,6,1553313600,19,1,20,Clouds
34531,7,1553313600,21,8,29,Clouds
34532,8,1553313600,24,6,30,Clouds
34533,9,1553313600,23,1,24,Clouds
34534,10,1553313600,6,10,16,Clouds
34535,11,1553313600,30,0,30,Clouds
34536,12,1553313600,14,6,20,Clouds
34537,13,1553313600,29,1,30,Clouds
34538,14,1553313600,4,26,30,Clouds
34539,15,1553313600,11,5,16,Clouds
34540,16,1553313600,1,19,20,Clouds
34541,17,1553313600,20,0,20,Clouds
34542,18,1553313600,16,14,30,Clouds
34543,19,1553313600,28,2,30,Clouds
34544,21,1553313600,30,0,30,Clouds
34545,22,1553313600,16,4,20,Clouds
34546,23,1553313600,15,15,30,Clouds
34547,24,1553313600,6,13,19,Clouds
34548,25,1553313600,25,5,30,Clouds
34549,26,1553313600,8,12,20,Clouds
34550,27,1553313600,20,0,20,Clouds
34551,28,1553313600,3,27,30,Clouds
34552,29,1553313600,22,7,29,Clouds
34553,30,1553313600,20,0,20,Clouds
34554,31,1553313600,15,5,20,Clouds
34555,32,1553313600,16,14,30,Clouds
34556,33,1553313600,11,12,23,Clouds
34557,34,1553313600,5,25,30,Clouds
34558,35,1553313600,6,24,30,Clouds
34559,36,1553313600,32,8,40,Clouds
34560,37,1553313600,27,3,30,Clouds
34561,38,1553313600,21,19,40,Clouds
34562,39,1553313600,18,2,20,Clouds
34563,40,1553313600,7,14,21,Clouds
34564,41,1553313600,19,1,20,Clouds
34565,42,1553313600,18,12,30,Clouds
34566,43,1553313600,9,21,30,Clouds
34567,44,1553313600,1,29,30,Clouds
34568,45,1553313600,10,20,30,Clouds
34569,46,1553313600,6,14,20,Clouds
34570,47,1553313600,39,1,40,Clouds
34571,48,1553313600,36,4,40,Clouds
34572,49,1553313600,24,16,40,Clouds
34573,50,1553313600,26,14,40,Clouds
34574,51,1553313600,32,8,40,Clouds
34575,52,1553313600,30,2,32,Clouds
34576,53,1553313600,29,11,40,Clouds
34577,54,1553313600,30,3,33,Clouds
34578,55,1553313600,35,0,35,Clouds
34579,56,1553313600,34,6,40,Clouds
34580,57,1553313600,21,2,23,Clouds
34581,58,1553313600,32,8,40,Clouds
34582,59,1553313600,8,12,20,Clouds
34583,60,1553313600,7,23,30,Clouds
34584,61,1553313600,14,11,25,Clouds
34585,62,1553313600,38,2,40,Clouds
34586,63,1553313600,19,16,35,Clouds
34587,64,1553313600,27,13,40,Clouds
34588,65,1553313600,40,0,40,Clouds
34589,66,1553313600,25,15,40,Clouds
34590,67,1553313600,28,12,40,Clouds
34591,68,1553313600,37,3,40,Clouds
34592,69,1553313600,33,7,40,Clouds
34593,70,1553313600,25,3,28,Clouds
34594,71,1553313600,23,17,40,Clouds
34595,72,1553313600,21,10,31,Clouds
34596,73,1553313600,2,28,30,Clouds
34597,74,1553313600,21,9,30,Clouds
34598,75,1553313600,28,12,40,Clouds
34599,76,1553313600,18,20,38,Clouds
34600,77,1553313600,18,11,29,Clouds
34601,78,1553313600,16,24,40,Clouds
34602,79,1553313600,19,8,27,Clouds
34603,80,1553313600,33,7,40,Clouds
34604,81,1553313600,22,18,40,Clouds
34605,82,1553313600,16,6,22,Clouds
34606,83,1553313600,16,24,40,Clouds
34607,84,1553313600,6,24,30,Clouds
34608,85,1553313600,20,15,35,Clouds
34609,86,1553313600,15,23,38,Clouds
34610,87,1553313600,16,22,38,Clouds
34611,88,1553313600,8,22,30,Clouds
34612,89,1553313600,35,5,40,Clouds
34613,90,1553313600,38,2,40,Clouds
34614,91,1553313600,12,18,30,Clouds
34615,92,1553313600,10,30,40,Clouds
34616,93,1553313600,0,40,40,Clouds
34617,94,1553313600,28,12,40,Clouds
34618,95,1553313600,8,32,40,Clouds
34619,96,1553313600,20,10,30,Clouds
34620,97,1553313600,26,14,40,Clouds
34621,98,1553313600,40,0,40,Clouds
34622,99,1553313600,30,0,30,Clouds
34623,100,1553313600,14,11,25,Clouds
34624,101,1553313600,16,14,30,Clouds
34625,102,1553313600,29,11,40,Clouds
34626,103,1553313600,37,3,40,Clouds
34627,104,1553313600,35,5,40,Clouds
34628,105,1553313600,23,13,36,Clouds
34629,106,1553313600,23,17,40,Clouds
34630,107,1553313600,19,21,40,Clouds
34631,108,1553313600,23,17,40,Clouds
34632,109,1553313600,3,26,29,Clouds
34633,110,1553313600,23,17,40,Clouds
34634,111,1553313600,20,20,40,Clouds
34635,112,1553313600,3,27,30,Clouds
34636,113,1553313600,25,15,40,Clouds
34637,114,1553313600,40,0,40,Clouds
34638,115,1553313600,0,30,30,Clouds
34639,2,1553317200,0,20,20,Clouds
34640,3,1553317200,17,3,20,Clouds
34641,4,1553317200,15,5,20,Clouds
34642,5,1553317200,7,33,40,Clouds
34643,6,1553317200,19,1,20,Clouds
34644,7,1553317200,21,8,29,Clouds
34645,8,1553317200,24,6,30,Clouds
34646,9,1553317200,23,1,24,Clouds
34647,10,1553317200,6,10,16,Clouds
34648,11,1553317200,30,0,30,Clouds
34649,12,1553317200,14,6,20,Clouds
34650,13,1553317200,28,1,29,Clouds
34651,14,1553317200,4,26,30,Clouds
34652,15,1553317200,11,5,16,Clouds
34653,16,1553317200,1,19,20,Clouds
34654,17,1553317200,20,0,20,Clouds
34655,18,1553317200,16,14,30,Clouds
34656,19,1553317200,28,2,30,Clouds
34657,21,1553317200,30,0,30,Clouds
34658,22,1553317200,16,4,20,Clouds
34659,23,1553317200,15,15,30,Clouds
34660,24,1553317200,6,13,19,Clouds
34661,25,1553317200,25,5,30,Clouds
34662,26,1553317200,8,12,20,Clouds
34663,27,1553317200,20,0,20,Clouds
34664,28,1553317200,3,27,30,Clouds
34665,29,1553317200,22,7,29,Clouds
34666,30,1553317200,20,0,20,Clouds
34667,31,1553317200,15,5,20,Clouds
34668,32,1553317200,16,14,30,Clouds
34669,33,1553317200,11,12,23,Clouds
34670,34,1553317200,5,25,30,Clouds
34671,35,1553317200,6,24,30,Clouds
34672,36,1553317200,32,8,40,Clouds
34673,37,1553317200,27,3,30,Clouds
34674,38,1553317200,21,19,40,Clouds
34675,39,1553317200,18,2,20,Clouds
34676,40,1553317200,7,14,21,Clouds
34677,41,1553317200,19,1,20,Clouds
34678,42,1553317200,18,12,30,Clouds
34679,43,1553317200,9,21,30,Clouds
34680,44,1553317200,1,29,30,Clouds
34681,45,1553317200,10,20,30,Clouds
34682,46,1553317200,6,14,20,Clouds
34683,47,1553317200,39,1,40,Clouds
34684,48,1553317200,36,4,40,Clouds
34685,49,1553317200,24,16,40,Clouds
34686,50,1553317200,26,14,40,Clouds
34687,51,1553317200,32,8,40,Clouds
34688,52,1553317200,30,2,32,Clouds
34689,53,1553317200,29,11,40,Clouds
34690,54,1553317200,30,3,33,Clouds
34691,55,1553317200,35,0,35,Clouds
34692,56,1553317200,34,6,40,Clouds
34693,57,1553317200,21,2,23,Clouds
34694,58,1553317200,32,8,40,Clouds
34695,59,1553317200,8,12,20,Clouds
34696,60,1553317200,7,23,30,Clouds
34697,61,1553317200,14,11,25,Clouds
34698,62,1553317200,38,2,40,Clouds
34699,63,1553317200,19,16,35,Clouds
34700,64,1553317200,27,13,40,Clouds
34701,65,1553317200,40,0,40,Clouds
34702,66,1553317200,25,15,40,Clouds
34703,67,1553317200,28,12,40,Clouds
34704,68,1553317200,37,3,40,Clouds
34705,69,1553317200,33,7,40,Clouds
34706,70,1553317200,25,3,28,Clouds
34707,71,1553317200,23,17,40,Clouds
34708,72,1553317200,21,10,31,Clouds
34709,73,1553317200,2,28,30,Clouds
34710,74,1553317200,21,9,30,Clouds
34711,75,1553317200,28,12,40,Clouds
34712,76,1553317200,18,20,38,Clouds
34713,77,1553317200,18,11,29,Clouds
34714,78,1553317200,16,24,40,Clouds
34715,79,1553317200,19,8,27,Clouds
34716,80,1553317200,33,7,40,Clouds
34717,81,1553317200,22,18,40,Clouds
34718,82,1553317200,16,6,22,Clouds
34719,83,1553317200,16,24,40,Clouds
34720,84,1553317200,6,24,30,Clouds
34721,85,1553317200,20,15,35,Clouds
34722,86,1553317200,15,23,38,Clouds
34723,87,1553317200,16,22,38,Clouds
34724,88,1553317200,8,22,30,Clouds
34725,89,1553317200,35,5,40,Clouds
34726,90,1553317200,38,2,40,Clouds
34727,91,1553317200,12,18,30,Clouds
34728,92,1553317200,10,30,40,Clouds
34729,93,1553317200,0,40,40,Clouds
34730,94,1553317200,28,12,40,Clouds
34731,95,1553317200,8,32,40,Clouds
34732,96,1553317200,20,10,30,Clouds
34733,97,1553317200,26,14,40,Clouds
34734,98,1553317200,40,0,40,Clouds
34735,99,1553317200,30,0,30,Clouds
34736,100,1553317200,14,11,25,Clouds
34737,101,1553317200,16,14,30,Clouds
34738,102,1553317200,29,11,40,Clouds
34739,103,1553317200,37,3,40,Clouds
34740,104,1553317200,35,5,40,Clouds
34741,105,1553317200,23,13,36,Clouds
34742,106,1553317200,23,17,40,Clouds
34743,107,1553317200,18,22,40,Clouds
34744,108,1553317200,23,17,40,Clouds
34745,109,1553317200,3,26,29,Clouds
34746,110,1553317200,23,17,40,Clouds
34747,111,1553317200,20,20,40,Clouds
34748,112,1553317200,3,27,30,Clouds
34749,113,1553317200,25,15,40,Clouds
34750,114,1553317200,40,0,40,Clouds
34751,115,1553317200,0,30,30,Clouds
34752,2,1553320800,0,20,20,Clouds
34753,3,1553320800,17,3,20,Clouds
34754,4,1553320800,15,5,20,Clouds
34755,5,1553320800,7,33,40,Clouds
34756,6,1553320800,19,1,20,Clouds
34757,7,1553320800,21,8,29,Clouds
34758,8,1553320800,24,6,30,Clouds
34759,9,1553320800,23,1,24,Clouds
34760,10,1553320800,6,10,16,Clouds
34761,11,1553320800,30,0,30,Clouds
34762,12,1553320800,14,6,20,Clouds
34763,13,1553320800,28,1,29,Clouds
34764,14,1553320800,4,26,30,Clouds
34765,15,1553320800,11,5,16,Clouds
34766,16,1553320800,1,19,20,Clouds
34767,17,1553320800,20,0,20,Clouds
34768,18,1553320800,16,14,30,Clouds
34769,19,1553320800,28,2,30,Clouds
34770,21,1553320800,30,0,30,Clouds
34771,22,1553320800,16,4,20,Clouds
34772,23,1553320800,15,15,30,Clouds
34773,24,1553320800,6,13,19,Clouds
34774,25,1553320800,25,5,30,Clouds
34775,26,1553320800,8,12,20,Clouds
34776,27,1553320800,20,0,20,Clouds
34777,28,1553320800,3,27,30,Clouds
34778,29,1553320800,22,7,29,Clouds
34779,30,1553320800,20,0,20,Clouds
34780,31,1553320800,15,5,20,Clouds
34781,32,1553320800,16,14,30,Clouds
34782,33,1553320800,11,12,23,Clouds
34783,34,1553320800,5,25,30,Clouds
34784,35,1553320800,6,24,30,Clouds
34785,36,1553320800,32,8,40,Clouds
34786,37,1553320800,27,3,30,Clouds
34787,38,1553320800,21,19,40,Clouds
34788,39,1553320800,18,2,20,Clouds
34789,40,1553320800,7,14,21,Clouds
34790,41,1553320800,19,1,20,Clouds
34791,42,1553320800,18,12,30,Clouds
34792,43,1553320800,9,21,30,Clouds
34793,44,1553320800,1,29,30,Clouds
34794,45,1553320800,10,20,30,Clouds
34795,46,1553320800,6,14,20,Clouds
34796,47,1553320800,39,1,40,Clouds
34797,48,1553320800,36,4,40,Clouds
34798,49,1553320800,24,16,40,Clouds
34799,50,1553320800,26,14,40,Clouds
34800,51,1553320800,32,8,40,Clouds
34801,52,1553320800,30,2,32,Clouds
34802,53,1553320800,29,11,40,Clouds
34803,54,1553320800,30,3,33,Clouds
34804,55,1553320800,36,0,36,Clouds
34805,56,1553320800,34,6,40,Clouds
34806,57,1553320800,21,2,23,Clouds
34807,58,1553320800,32,8,40,Clouds
34808,59,1553320800,8,12,20,Clouds
34809,60,1553320800,7,23,30,Clouds
34810,61,1553320800,14,11,25,Clouds
34811,62,1553320800,38,2,40,Clouds
34812,63,1553320800,19,16,35,Clouds
34813,64,1553320800,27,13,40,Clouds
34814,65,1553320800,40,0,40,Clouds
34815,66,1553320800,25,15,40,Clouds
34816,67,1553320800,28,12,40,Clouds
34817,68,1553320800,37,3,40,Clouds
34818,69,1553320800,33,7,40,Clouds
34819,70,1553320800,25,3,28,Clouds
34820,71,1553320800,23,17,40,Clouds
34821,72,1553320800,21,10,31,Clouds
34822,73,1553320800,2,28,30,Clouds
34823,74,1553320800,21,9,30,Clouds
34824,75,1553320800,28,12,40,Clouds
34825,76,1553320800,18,20,38,Clouds
34826,77,1553320800,18,11,29,Clouds
34827,78,1553320800,16,24,40,Clouds
34828,79,1553320800,19,8,27,Clouds
34829,80,1553320800,33,7,40,Clouds
34830,81,1553320800,22,18,40,Clouds
34831,82,1553320800,16,6,22,Clouds
34832,83,1553320800,16,24,40,Clouds
34833,84,1553320800,6,24,30,Clouds
34834,85,1553320800,20,15,35,Clouds
34835,86,1553320800,15,23,38,Clouds
34836,87,1553320800,16,22,38,Clouds
34837,88,1553320800,8,22,30,Clouds
34838,89,1553320800,35,5,40,Clouds
34839,90,1553320800,38,2,40,Clouds
34840,91,1553320800,12,18,30,Clouds
34841,92,1553320800,10,30,40,Clouds
34842,93,1553320800,0,40,40,Clouds
34843,94,1553320800,28,12,40,Clouds
34844,95,1553320800,8,32,40,Clouds
34845,96,1553320800,20,10,30,Clouds
34846,97,1553320800,26,14,40,Clouds
34847,98,1553320800,40,0,40,Clouds
34848,99,1553320800,30,0,30,Clouds
34849,100,1553320800,14,11,25,Clouds
34850,101,1553320800,16,14,30,Clouds
34851,102,1553320800,29,11,40,Clouds
34852,103,1553320800,37,3,40,Clouds
34853,104,1553320800,35,5,40,Clouds
34854,105,1553320800,23,13,36,Clouds
34855,106,1553320800,23,17,40,Clouds
34856,107,1553320800,18,22,40,Clouds
34857,108,1553320800,23,17,40,Clouds
34858,109,1553320800,3,26,29,Clouds
34859,110,1553320800,23,17,40,Clouds
34860,111,1553320800,20,20,40,Clouds
34861,112,1553320800,3,27,30,Clouds
34862,113,1553320800,25,15,40,Clouds
34863,114,1553320800,40,0,40,Clouds
34864,115,1553320800,0,30,30,Clouds
34865,2,1553324400,1,19,20,Clouds
34866,3,1553324400,19,1,20,Clouds
34867,4,1553324400,15,5,20,Clouds
34868,5,1553324400,6,34,40,Clouds
34869,6,1553324400,20,0,20,Clouds
34870,7,1553324400,23,6,29,Clouds
34871,8,1553324400,24,6,30,Clouds
34872,9,1553324400,22,2,24,Clouds
34873,10,1553324400,6,10,16,Clouds
34874,11,1553324400,30,0,30,Clouds
34875,12,1553324400,16,4,20,Clouds
34876,13,1553324400,29,1,30,Clouds
34877,14,1553324400,2,28,30,Clouds
34878,15,1553324400,10,6,16,Clouds
34879,16,1553324400,1,19,20,Clouds
34880,17,1553324400,20,0,20,Clouds
34881,18,1553324400,16,14,30,Clouds
34882,19,1553324400,26,4,30,Clouds
34883,21,1553324400,30,0,30,Clouds
34884,22,1553324400,15,5,20,Clouds
34885,23,1553324400,15,15,30,Clouds
34886,24,1553324400,2,17,19,Clouds
34887,25,1553324400,23,7,30,Clouds
34888,26,1553324400,6,14,20,Clouds
34889,27,1553324400,20,0,20,Clouds
34890,28,1553324400,4,26,30,Clouds
34891,29,1553324400,22,7,29,Clouds
34892,30,1553324400,19,1,20,Clouds
34893,31,1553324400,16,4,20,Clouds
34894,32,1553324400,16,14,30,Clouds
34895,33,1553324400,7,16,23,Clouds
34896,34,1553324400,9,21,30,Clouds
34897,35,1553324400,7,23,30,Clouds
34898,36,1553324400,32,8,40,Clouds
34899,37,1553324400,27,3,30,Clouds
34900,38,1553324400,20,20,40,Clouds
34901,39,1553324400,19,1,20,Clouds
34902,40,1553324400,7,14,21,Clouds
34903,41,1553324400,19,1,20,Clouds
34904,42,1553324400,19,11,30,Clouds
34905,43,1553324400,9,21,30,Clouds
34906,44,1553324400,3,27,30,Clouds
34907,45,1553324400,11,19,30,Clouds
34908,46,1553324400,5,15,20,Clouds
34909,47,1553324400,40,0,40,Clouds
34910,48,1553324400,35,5,40,Clouds
34911,49,1553324400,24,16,40,Clouds
34912,50,1553324400,25,15,40,Clouds
34913,51,1553324400,32,8,40,Clouds
34914,52,1553324400,28,4,32,Clouds
34915,53,1553324400,29,11,40,Clouds
34916,54,1553324400,32,1,33,Clouds
34917,55,1553324400,36,0,36,Clouds
34918,56,1553324400,35,5,40,Clouds
34919,57,1553324400,21,2,23,Clouds
34920,58,1553324400,32,8,40,Clouds
34921,59,1553324400,9,11,20,Clouds
34922,60,1553324400,6,24,30,Clouds
34923,61,1553324400,14,11,25,Clouds
34924,62,1553324400,38,2,40,Clouds
34925,63,1553324400,19,16,35,Clouds
34926,64,1553324400,27,13,40,Clouds
34927,65,1553324400,40,0,40,Clouds
34928,66,1553324400,26,14,40,Clouds
34929,67,1553324400,27,13,40,Clouds
34930,68,1553324400,36,4,40,Clouds
34931,69,1553324400,33,7,40,Clouds
34932,70,1553324400,24,4,28,Clouds
34933,71,1553324400,22,18,40,Clouds
34934,72,1553324400,19,12,31,Clouds
34935,73,1553324400,2,28,30,Clouds
34936,74,1553324400,23,7,30,Clouds
34937,75,1553324400,28,12,40,Clouds
34938,76,1553324400,21,17,38,Clouds
34939,77,1553324400,15,14,29,Clouds
34940,78,1553324400,16,24,40,Clouds
34941,79,1553324400,19,8,27,Clouds
34942,80,1553324400,34,6,40,Clouds
34943,81,1553324400,22,18,40,Clouds
34944,82,1553324400,16,6,22,Clouds
34945,83,1553324400,17,23,40,Clouds
34946,84,1553324400,6,24,30,Clouds
34947,85,1553324400,20,15,35,Clouds
34948,86,1553324400,15,23,38,Clouds
34949,87,1553324400,16,22,38,Clouds
34950,88,1553324400,6,24,30,Clouds
34951,89,1553324400,35,5,40,Clouds
34952,90,1553324400,38,2,40,Clouds
34953,91,1553324400,12,18,30,Clouds
34954,92,1553324400,12,28,40,Clouds
34955,93,1553324400,0,40,40,Clouds
34956,94,1553324400,28,12,40,Clouds
34957,95,1553324400,8,32,40,Clouds
34958,96,1553324400,20,10,30,Clouds
34959,97,1553324400,26,14,40,Clouds
34960,98,1553324400,40,0,40,Clouds
34961,99,1553324400,30,0,30,Clouds
34962,100,1553324400,14,11,25,Clouds
34963,101,1553324400,16,14,30,Clouds
34964,102,1553324400,29,11,40,Clouds
34965,103,1553324400,37,3,40,Clouds
34966,104,1553324400,35,5,40,Clouds
34967,105,1553324400,23,13,36,Clouds
34968,106,1553324400,23,17,40,Clouds
34969,107,1553324400,18,22,40,Clouds
34970,108,1553324400,25,15,40,Clouds
34971,109,1553324400,10,19,29,Clouds
34972,110,1553324400,23,17,40,Clouds
34973,111,1553324400,21,19,40,Clouds
34974,112,1553324400,5,25,30,Clouds
34975,113,1553324400,25,15,40,Clouds
34976,114,1553324400,40,0,40,Clouds
34977,115,1553324400,2,28,30,Clouds
34978,2,1553328000,6,14,20,Clear
34979,3,1553328000,20,0,20,Clear
34980,4,1553328000,15,5,20,Clear
34981,5,1553328000,8,32,40,Clear
34982,6,1553328000,19,1,20,Clear
34983,7,1553328000,23,6,29,Clear
34984,8,1553328000,24,6,30,Clear
34985,9,1553328000,16,8,24,Clear
34986,10,1553328000,7,9,16,Clear
34987,11,1553328000,28,2,30,Clear
34988,12,1553328000,18,2,20,Clear
34989,13,1553328000,29,1,30,Clear
34990,14,1553328000,10,20,30,Clear
34991,15,1553328000,11,5,16,Clear
34992,16,1553328000,1,19,20,Clear
34993,17,1553328000,20,0,20,Clear
34994,18,1553328000,17,13,30,Clear
34995,19,1553328000,23,7,30,Clear
34996,21,1553328000,30,0,30,Clear
34997,22,1553328000,13,7,20,Clear
34998,23,1553328000,15,15,30,Clear
34999,24,1553328000,1,18,19,Clear
35000,25,1553328000,24,6,30,Clear
35001,26,1553328000,4,16,20,Clear
35002,27,1553328000,18,2,20,Clear
35003,28,1553328000,5,25,30,Clear
35004,29,1553328000,22,7,29,Clear
35005,30,1553328000,20,0,20,Clear
35006,31,1553328000,14,6,20,Clear
35007,32,1553328000,16,14,30,Clear
35008,33,1553328000,1,22,23,Clear
35009,34,1553328000,18,12,30,Clear
35010,35,1553328000,7,23,30,Clear
35011,36,1553328000,31,9,40,Clear
35012,37,1553328000,27,3,30,Clear
35013,38,1553328000,21,19,40,Clear
35014,39,1553328000,18,2,20,Clear
35015,40,1553328000,8,13,21,Clear
35016,41,1553328000,18,2,20,Clear
35017,42,1553328000,22,8,30,Clear
35018,43,1553328000,10,20,30,Clear
35019,44,1553328000,5,25,30,Clear
35020,45,1553328000,10,20,30,Clear
35021,46,1553328000,4,16,20,Clear
35022,47,1553328000,40,0,40,Clear
35023,48,1553328000,33,7,40,Clear
35024,49,1553328000,22,18,40,Clear
35025,50,1553328000,30,10,40,Clear
35026,51,1553328000,29,11,40,Clear
35027,52,1553328000,22,10,32,Clear
35028,53,1553328000,28,12,40,Clear
35029,54,1553328000,32,1,33,Clear
35030,55,1553328000,36,0,36,Clear
35031,56,1553328000,36,4,40,Clear
35032,57,1553328000,20,3,23,Clear
35033,58,1553328000,27,13,40,Clear
35034,59,1553328000,8,12,20,Clear
35035,60,1553328000,8,22,30,Clear
35036,61,1553328000,17,8,25,Clear
35037,62,1553328000,38,2,40,Clear
35038,63,1553328000,18,17,35,Clear
35039,64,1553328000,27,13,40,Clear
35040,65,1553328000,40,0,40,Clear
35041,66,1553328000,25,15,40,Clear
35042,67,1553328000,24,16,40,Clear
35043,68,1553328000,30,10,40,Clear
35044,69,1553328000,31,9,40,Clear
35045,70,1553328000,23,5,28,Clear
35046,71,1553328000,25,15,40,Clear
35047,72,1553328000,19,12,31,Clear
35048,73,1553328000,5,25,30,Clear
35049,74,1553328000,24,6,30,Clear
35050,75,1553328000,29,11,40,Clear
35051,76,1553328000,23,15,38,Clear
35052,77,1553328000,17,12,29,Clear
35053,78,1553328000,18,22,40,Clear
35054,79,1553328000,18,9,27,Clear
35055,80,1553328000,34,6,40,Clear
35056,81,1553328000,22,18,40,Clear
35057,82,1553328000,17,5,22,Clear
35058,83,1553328000,17,23,40,Clear
35059,84,1553328000,8,22,30,Clear
35060,85,1553328000,22,13,35,Clear
35061,86,1553328000,16,22,38,Clear
35062,87,1553328000,16,22,38,Clear
35063,88,1553328000,5,25,30,Clear
35064,89,1553328000,36,4,40,Clear
35065,90,1553328000,34,6,40,Clear
35066,91,1553328000,13,17,30,Clear
35067,92,1553328000,12,28,40,Clear
35068,93,1553328000,0,40,40,Clear
35069,94,1553328000,28,12,40,Clear
35070,95,1553328000,8,32,40,Clear
35071,96,1553328000,20,10,30,Clear
35072,97,1553328000,29,11,40,Clear
35073,98,1553328000,40,0,40,Clear
35074,99,1553328000,29,1,30,Clear
35075,100,1553328000,10,15,25,Clear
35076,101,1553328000,16,14,30,Clear
35077,102,1553328000,29,11,40,Clear
35078,103,1553328000,37,3,40,Clear
35079,104,1553328000,35,5,40,Clear
35080,105,1553328000,23,13,36,Clear
35081,106,1553328000,24,16,40,Clear
35082,107,1553328000,20,20,40,Clear
35083,108,1553328000,27,13,40,Clear
35084,109,1553328000,14,15,29,Clear
35085,110,1553328000,23,17,40,Clear
35086,111,1553328000,24,16,40,Clear
35087,112,1553328000,8,22,30,Clear
35088,113,1553328000,24,16,40,Clear
35089,114,1553328000,39,1,40,Clear
35090,115,1553328000,3,27,30,Clear
35091,2,1553331600,8,12,20,Clear
35092,3,1553331600,20,0,20,Clear
35093,4,1553331600,15,5,20,Clear
35094,5,1553331600,12,28,40,Clear
35095,6,1553331600,20,0,20,Clear
35096,7,1553331600,27,2,29,Clear
35097,8,1553331600,23,7,30,Clear
35098,9,1553331600,11,13,24,Clear
35099,10,1553331600,4,12,16,Clear
35100,11,1553331600,28,2,30,Clear
35101,12,1553331600,20,0,20,Clear
35102,13,1553331600,28,2,30,Clear
35103,14,1553331600,9,21,30,Clear
35104,15,1553331600,14,2,16,Clear
35105,16,1553331600,3,17,20,Clear
35106,17,1553331600,19,1,20,Clear
35107,18,1553331600,18,12,30,Clear
35108,19,1553331600,20,10,30,Clear
35109,21,1553331600,29,1,30,Clear
35110,22,1553331600,9,11,20,Clear
35111,23,1553331600,15,15,30,Clear
35112,24,1553331600,0,20,20,Clear
35113,25,1553331600,25,5,30,Clear
35114,26,1553331600,5,15,20,Clear
35115,27,1553331600,12,8,20,Clear
35116,28,1553331600,10,20,30,Clear
35117,29,1553331600,22,7,29,Clear
35118,30,1553331600,18,2,20,Clear
35119,31,1553331600,12,8,20,Clear
35120,32,1553331600,16,14,30,Clear
35121,33,1553331600,0,23,23,Clear
35122,34,1553331600,5,25,30,Clear
35123,35,1553331600,10,20,30,Clear
35124,36,1553331600,36,4,40,Clear
35125,37,1553331600,27,3,30,Clear
35126,38,1553331600,24,16,40,Clear
35127,39,1553331600,15,5,20,Clear
35128,40,1553331600,4,17,21,Clear
35129,41,1553331600,18,2,20,Clear
35130,42,1553331600,21,9,30,Clear
35131,43,1553331600,12,18,30,Clear
35132,44,1553331600,5,25,30,Clear
35133,45,1553331600,12,18,30,Clear
35134,46,1553331600,2,18,20,Clear
35135,47,1553331600,40,0,40,Clear
35136,48,1553331600,30,10,40,Clear
35137,49,1553331600,25,15,40,Clear
35138,50,1553331600,33,7,40,Clear
35139,51,1553331600,28,12,40,Clear
35140,52,1553331600,25,7,32,Clear
35141,53,1553331600,37,3,40,Clear
35142,54,1553331600,30,3,33,Clear
35143,55,1553331600,35,1,36,Clear
35144,56,1553331600,35,5,40,Clear
35145,57,1553331600,20,3,23,Clear
35146,58,1553331600,24,16,40,Clear
35147,59,1553331600,10,10,20,Clear
35148,60,1553331600,9,21,30,Clear
35149,61,1553331600,17,8,25,Clear
35150,62,1553331600,37,3,40,Clear
35151,63,1553331600,17,18,35,Clear
35152,64,1553331600,26,14,40,Clear
35153,65,1553331600,38,2,40,Clear
35154,66,1553331600,24,16,40,Clear
35155,67,1553331600,23,17,40,Clear
35156,68,1553331600,26,13,39,Clear
35157,69,1553331600,27,13,40,Clear
35158,70,1553331600,18,10,28,Clear
35159,71,1553331600,31,9,40,Clear
35160,72,1553331600,23,8,31,Clear
35161,73,1553331600,4,26,30,Clear
35162,74,1553331600,27,3,30,Clear
35163,75,1553331600,32,8,40,Clear
35164,76,1553331600,24,14,38,Clear
35165,77,1553331600,16,13,29,Clear
35166,78,1553331600,18,22,40,Clear
35167,79,1553331600,21,6,27,Clear
35168,80,1553331600,34,6,40,Clear
35169,81,1553331600,21,19,40,Clear
35170,82,1553331600,17,5,22,Clear
35171,83,1553331600,18,22,40,Clear
35172,84,1553331600,9,21,30,Clear
35173,85,1553331600,24,11,35,Clear
35174,86,1553331600,13,25,38,Clear
35175,87,1553331600,16,22,38,Clear
35176,88,1553331600,7,23,30,Clear
35177,89,1553331600,36,4,40,Clear
35178,90,1553331600,30,10,40,Clear
35179,91,1553331600,13,17,30,Clear
35180,92,1553331600,12,28,40,Clear
35181,93,1553331600,1,39,40,Clear
35182,94,1553331600,28,12,40,Clear
35183,95,1553331600,9,31,40,Clear
35184,96,1553331600,20,10,30,Clear
35185,97,1553331600,32,8,40,Clear
35186,98,1553331600,39,1,40,Clear
35187,99,1553331600,28,2,30,Clear
35188,100,1553331600,9,16,25,Clear
35189,101,1553331600,19,11,30,Clear
35190,102,1553331600,31,9,40,Clear
35191,103,1553331600,36,4,40,Clear
35192,104,1553331600,35,5,40,Clear
35193,105,1553331600,21,15,36,Clear
35194,106,1553331600,27,13,40,Clear
35195,107,1553331600,21,19,40,Clear
35196,108,1553331600,30,10,40,Clear
35197,109,1553331600,15,14,29,Clear
35198,110,1553331600,24,16,40,Clear
35199,111,1553331600,23,17,40,Clear
35200,112,1553331600,16,14,30,Clear
35201,113,1553331600,23,17,40,Clear
35202,114,1553331600,38,2,40,Clear
35203,115,1553331600,6,24,30,Clear
35204,2,1553335200,14,6,20,Clear
35205,3,1553335200,18,2,20,Clear
35206,4,1553335200,16,4,20,Clear
35207,5,1553335200,7,33,40,Clear
35208,6,1553335200,20,0,20,Clear
35209,7,1553335200,29,0,29,Clear
35210,8,1553335200,20,9,29,Clear
35211,9,1553335200,1,23,24,Clear
35212,10,1553335200,4,12,16,Clear
35213,11,1553335200,28,2,30,Clear
35214,12,1553335200,20,0,20,Clear
35215,13,1553335200,26,4,30,Clear
35216,14,1553335200,22,7,29,Clear
35217,15,1553335200,16,0,16,Clear
35218,16,1553335200,11,9,20,Clear
35219,17,1553335200,20,0,20,Clear
35220,18,1553335200,17,13,30,Clear
35221,19,1553335200,20,10,30,Clear
35222,21,1553335200,25,5,30,Clear
35223,22,1553335200,6,14,20,Clear
35224,23,1553335200,14,16,30,Clear
35225,24,1553335200,0,19,19,Clear
35226,25,1553335200,25,5,30,Clear
35227,26,1553335200,2,18,20,Clear
35228,27,1553335200,8,12,20,Clear
35229,28,1553335200,14,15,29,Clear
35230,29,1553335200,19,10,29,Clear
35231,30,1553335200,20,0,20,Clear
35232,31,1553335200,12,8,20,Clear
35233,32,1553335200,15,15,30,Clear
35234,33,1553335200,6,17,23,Clear
35235,34,1553335200,19,11,30,Clear
35236,35,1553335200,6,24,30,Clear
35237,36,1553335200,33,7,40,Clear
35238,37,1553335200,27,3,30,Clear
35239,38,1553335200,22,18,40,Clear
35240,39,1553335200,13,7,20,Clear
35241,40,1553335200,2,17,19,Clear
35242,41,1553335200,19,1,20,Clear
35243,42,1553335200,23,7,30,Clear
35244,43,1553335200,18,12,30,Clear
35245,44,1553335200,8,20,28,Clear
35246,45,1553335200,14,16,30,Clear
35247,46,1553335200,2,17,19,Clear
35248,47,1553335200,39,1,40,Clear
35249,48,1553335200,22,18,40,Clear
35250,49,1553335200,27,13,40,Clear
35251,50,1553335200,34,6,40,Clear
35252,51,1553335200,24,16,40,Clear
35253,52,1553335200,21,11,32,Clear
35254,53,1553335200,36,4,40,Clear
35255,54,1553335200,29,4,33,Clear
35256,55,1553335200,33,3,36,Clear
35257,56,1553335200,34,6,40,Clear
35258,57,1553335200,21,1,22,Clear
35259,58,1553335200,20,20,40,Clear
35260,59,1553335200,10,10,20,Clear
35261,60,1553335200,12,18,30,Clear
35262,61,1553335200,20,5,25,Clear
35263,62,1553335200,37,3,40,Clear
35264,63,1553335200,16,18,34,Clear
35265,64,1553335200,22,18,40,Clear
35266,65,1553335200,36,4,40,Clear
35267,66,1553335200,22,18,40,Clear
35268,67,1553335200,27,13,40,Clear
35269,68,1553335200,22,17,39,Clear
35270,69,1553335200,26,14,40,Clear
35271,70,1553335200,19,8,27,Clear
35272,71,1553335200,32,8,40,Clear
35273,72,1553335200,25,6,31,Clear
35274,73,1553335200,11,19,30,Clear
35275,74,1553335200,13,17,30,Clear
35276,75,1553335200,12,28,40,Clear
35277,76,1553335200,24,14,38,Clear
35278,77,1553335200,16,13,29,Clear
35279,78,1553335200,18,22,40,Clear
35280,79,1553335200,22,5,27,Clear
35281,80,1553335200,33,7,40,Clear
35282,81,1553335200,22,18,40,Clear
35283,82,1553335200,19,3,22,Clear
35284,83,1553335200,19,21,40,Clear
35285,84,1553335200,11,19,30,Clear
35286,85,1553335200,32,3,35,Clear
35287,86,1553335200,13,23,36,Clear
35288,87,1553335200,14,23,37,Clear
35289,88,1553335200,10,20,30,Clear
35290,89,1553335200,37,3,40,Clear
35291,90,1553335200,28,12,40,Clear
35292,91,1553335200,13,17,30,Clear
35293,92,1553335200,11,28,39,Clear
35294,93,1553335200,1,39,40,Clear
35295,94,1553335200,28,12,40,Clear
35296,95,1553335200,14,26,40,Clear
35297,96,1553335200,20,10,30,Clear
35298,97,1553335200,33,7,40,Clear
35299,98,1553335200,38,2,40,Clear
35300,99,1553335200,28,2,30,Clear
35301,100,1553335200,11,14,25,Clear
35302,101,1553335200,22,7,29,Clear
35303,102,1553335200,31,9,40,Clear
35304,103,1553335200,36,4,40,Clear
35305,104,1553335200,35,5,40,Clear
35306,105,1553335200,22,14,36,Clear
35307,106,1553335200,27,13,40,Clear
35308,107,1553335200,23,17,40,Clear
35309,108,1553335200,32,8,40,Clear
35310,109,1553335200,15,13,28,Clear
35311,110,1553335200,26,13,39,Clear
35312,111,1553335200,27,13,40,Clear
35313,112,1553335200,18,12,30,Clear
35314,113,1553335200,22,18,40,Clear
35315,114,1553335200,38,2,40,Clear
35316,115,1553335200,11,19,30,Clear
35317,2,1553338800,20,0,20,Clouds
35318,3,1553338800,17,3,20,Clouds
35319,4,1553338800,16,4,20,Clouds
35320,5,1553338800,11,29,40,Clouds
35321,6,1553338800,20,0,20,Clouds
35322,7,1553338800,29,0,29,Clouds
35323,8,1553338800,18,12,30,Clouds
35324,9,1553338800,9,14,23,Clouds
35325,10,1553338800,0,16,16,Clouds
35326,11,1553338800,29,1,30,Clouds
35327,12,1553338800,19,1,20,Clouds
35328,13,1553338800,29,1,30,Clouds
35329,14,1553338800,10,20,30,Clouds
35330,15,1553338800,16,0,16,Clouds
35331,16,1553338800,17,3,20,Clouds
35332,17,1553338800,18,2,20,Clouds
35333,18,1553338800,17,13,30,Clouds
35334,19,1553338800,18,12,30,Clouds
35335,21,1553338800,19,11,30,Clouds
35336,22,1553338800,1,19,20,Clouds
35337,23,1553338800,14,16,30,Clouds
35338,24,1553338800,0,20,20,Clouds
35339,25,1553338800,24,6,30,Clouds
35340,26,1553338800,1,19,20,Clouds
35341,27,1553338800,1,19,20,Clouds
35342,28,1553338800,18,11,29,Clouds
35343,29,1553338800,10,19,29,Clouds
35344,30,1553338800,17,2,19,Clouds
35345,31,1553338800,10,10,20,Clouds
35346,32,1553338800,8,22,30,Clouds
35347,33,1553338800,6,17,23,Clouds
35348,34,1553338800,19,11,30,Clouds
35349,35,1553338800,7,23,30,Clouds
35350,36,1553338800,30,10,40,Clouds
35351,37,1553338800,26,4,30,Clouds
35352,38,1553338800,19,21,40,Clouds
35353,39,1553338800,14,6,20,Clouds
35354,40,1553338800,13,8,21,Clouds
35355,41,1553338800,19,1,20,Clouds
35356,42,1553338800,20,10,30,Clouds
35357,43,1553338800,17,13,30,Clouds
35358,44,1553338800,14,14,28,Clouds
35359,45,1553338800,14,16,30,Clouds
35360,46,1553338800,1,19,20,Clouds
35361,47,1553338800,40,0,40,Clouds
35362,48,1553338800,17,23,40,Clouds
35363,49,1553338800,28,12,40,Clouds
35364,50,1553338800,37,3,40,Clouds
35365,51,1553338800,19,21,40,Clouds
35366,52,1553338800,19,13,32,Clouds
35367,53,1553338800,36,4,40,Clouds
35368,54,1553338800,28,5,33,Clouds
35369,55,1553338800,35,1,36,Clouds
35370,56,1553338800,38,2,40,Clouds
35371,57,1553338800,21,2,23,Clouds
35372,58,1553338800,25,15,40,Clouds
35373,59,1553338800,9,11,20,Clouds
35374,60,1553338800,19,11,30,Clouds
35375,61,1553338800,16,9,25,Clouds
35376,62,1553338800,35,5,40,Clouds
35377,63,1553338800,17,18,35,Clouds
35378,64,1553338800,24,16,40,Clouds
35379,65,1553338800,36,4,40,Clouds
35380,66,1553338800,24,16,40,Clouds
35381,67,1553338800,32,8,40,Clouds
35382,68,1553338800,13,27,40,Clouds
35383,69,1553338800,23,17,40,Clouds
35384,70,1553338800,21,7,28,Clouds
35385,71,1553338800,25,15,40,Clouds
35386,72,1553338800,31,0,31,Clouds
35387,73,1553338800,18,12,30,Clouds
35388,74,1553338800,16,14,30,Clouds
35389,75,1553338800,14,26,40,Clouds
35390,76,1553338800,27,11,38,Clouds
35391,77,1553338800,22,7,29,Clouds
35392,78,1553338800,19,21,40,Clouds
35393,79,1553338800,14,13,27,Clouds
35394,80,1553338800,27,13,40,Clouds
35395,81,1553338800,22,18,40,Clouds
35396,82,1553338800,21,1,22,Clouds
35397,83,1553338800,23,17,40,Clouds
35398,84,1553338800,19,11,30,Clouds
35399,85,1553338800,35,0,35,Clouds
35400,86,1553338800,13,23,36,Clouds
35401,87,1553338800,13,24,37,Clouds
35402,88,1553338800,14,16,30,Clouds
35403,89,1553338800,35,5,40,Clouds
35404,90,1553338800,28,12,40,Clouds
35405,91,1553338800,8,22,30,Clouds
35406,92,1553338800,10,29,39,Clouds
35407,93,1553338800,2,38,40,Clouds
35408,94,1553338800,28,12,40,Clouds
35409,95,1553338800,13,27,40,Clouds
35410,96,1553338800,20,10,30,Clouds
35411,97,1553338800,38,2,40,Clouds
35412,98,1553338800,35,5,40,Clouds
35413,99,1553338800,28,2,30,Clouds
35414,100,1553338800,9,16,25,Clouds
35415,101,1553338800,26,3,29,Clouds
35416,102,1553338800,36,4,40,Clouds
35417,103,1553338800,40,0,40,Clouds
35418,104,1553338800,35,5,40,Clouds
35419,105,1553338800,22,14,36,Clouds
35420,106,1553338800,28,12,40,Clouds
35421,107,1553338800,27,13,40,Clouds
35422,108,1553338800,38,2,40,Clouds
35423,109,1553338800,15,14,29,Clouds
35424,110,1553338800,31,8,39,Clouds
35425,111,1553338800,28,12,40,Clouds
35426,112,1553338800,25,5,30,Clouds
35427,113,1553338800,18,22,40,Clouds
35428,114,1553338800,38,2,40,Clouds
35429,115,1553338800,15,15,30,Clouds
35430,2,1553342400,20,0,20,Clouds
35431,3,1553342400,15,5,20,Clouds
35432,4,1553342400,16,4,20,Clouds
35433,5,1553342400,12,28,40,Clouds
35434,6,1553342400,18,2,20,Clouds
35435,7,1553342400,27,2,29,Clouds
35436,8,1553342400,13,17,30,Clouds
35437,9,1553342400,0,23,23,Clouds
35438,10,1553342400,0,16,16,Clouds
35439,11,1553342400,28,2,30,Clouds
35440,12,1553342400,19,1,20,Clouds
35441,13,1553342400,29,1,30,Clouds
35442,14,1553342400,2,28,30,Clouds
35443,15,1553342400,16,0,16,Clouds
35444,16,1553342400,18,2,20,Clouds
35445,17,1553342400,14,6,20,Clouds
35446,18,1553342400,13,17,30,Clouds
35447,19,1553342400,22,8,30,Clouds
35448,21,1553342400,12,18,30,Clouds
35449,22,1553342400,13,7,20,Clouds
35450,23,1553342400,10,20,30,Clouds
35451,24,1553342400,0,20,20,Clouds
35452,25,1553342400,23,7,30,Clouds
35453,26,1553342400,2,18,20,Clouds
35454,27,1553342400,0,20,20,Clouds
35455,28,1553342400,19,11,30,Clouds
35456,29,1553342400,5,24,29,Clouds
35457,30,1553342400,17,2,19,Clouds
35458,31,1553342400,9,11,20,Clouds
35459,32,1553342400,23,7,30,Clouds
35460,33,1553342400,0,23,23,Clouds
35461,34,1553342400,26,4,30,Clouds
35462,35,1553342400,8,22,30,Clouds
35463,36,1553342400,30,10,40,Clouds
35464,37,1553342400,25,5,30,Clouds
35465,38,1553342400,23,17,40,Clouds
35466,39,1553342400,11,9,20,Clouds
35467,40,1553342400,11,10,21,Clouds
35468,41,1553342400,19,1,20,Clouds
35469,42,1553342400,22,8,30,Clouds
35470,43,1553342400,17,13,30,Clouds
35471,44,1553342400,26,4,30,Clouds
35472,45,1553342400,14,16,30,Clouds
35473,46,1553342400,1,19,20,Clouds
35474,47,1553342400,40,0,40,Clouds
35475,48,1553342400,19,21,40,Clouds
35476,49,1553342400,26,14,40,Clouds
35477,50,1553342400,39,1,40,Clouds
35478,51,1553342400,17,23,40,Clouds
35479,52,1553342400,10,22,32,Clouds
35480,53,1553342400,33,7,40,Clouds
35481,54,1553342400,26,7,33,Clouds
35482,55,1553342400,35,1,36,Clouds
35483,56,1553342400,40,0,40,Clouds
35484,57,1553342400,21,2,23,Clouds
35485,58,1553342400,29,11,40,Clouds
35486,59,1553342400,7,13,20,Clouds
35487,60,1553342400,28,2,30,Clouds
35488,61,1553342400,19,6,25,Clouds
35489,62,1553342400,33,7,40,Clouds
35490,63,1553342400,18,17,35,Clouds
35491,64,1553342400,22,18,40,Clouds
35492,65,1553342400,35,5,40,Clouds
35493,66,1553342400,26,14,40,Clouds
35494,67,1553342400,36,4,40,Clouds
35495,68,1553342400,13,27,40,Clouds
35496,69,1553342400,20,20,40,Clouds
35497,70,1553342400,22,6,28,Clouds
35498,71,1553342400,25,15,40,Clouds
35499,72,1553342400,30,1,31,Clouds
35500,73,1553342400,24,6,30,Clouds
35501,74,1553342400,13,17,30,Clouds
35502,75,1553342400,17,23,40,Clouds
35503,76,1553342400,26,12,38,Clouds
35504,77,1553342400,18,11,29,Clouds
35505,78,1553342400,26,14,40,Clouds
35506,79,1553342400,15,12,27,Clouds
35507,80,1553342400,30,10,40,Clouds
35508,81,1553342400,22,18,40,Clouds
35509,82,1553342400,20,2,22,Clouds
35510,83,1553342400,26,14,40,Clouds
35511,84,1553342400,21,9,30,Clouds
35512,85,1553342400,29,6,35,Clouds
35513,86,1553342400,18,20,38,Clouds
35514,87,1553342400,18,20,38,Clouds
35515,88,1553342400,18,12,30,Clouds
35516,89,1553342400,34,6,40,Clouds
35517,90,1553342400,28,12,40,Clouds
35518,91,1553342400,7,23,30,Clouds
35519,92,1553342400,13,27,40,Clouds
35520,93,1553342400,2,38,40,Clouds
35521,94,1553342400,30,10,40,Clouds
35522,95,1553342400,20,20,40,Clouds
35523,96,1553342400,23,7,30,Clouds
35524,97,1553342400,40,0,40,Clouds
35525,98,1553342400,34,6,40,Clouds
35526,99,1553342400,30,0,30,Clouds
35527,100,1553342400,3,22,25,Clouds
35528,101,1553342400,27,3,30,Clouds
35529,102,1553342400,34,6,40,Clouds
35530,103,1553342400,40,0,40,Clouds
35531,104,1553342400,34,6,40,Clouds
35532,105,1553342400,21,15,36,Clouds
35533,106,1553342400,30,10,40,Clouds
35534,107,1553342400,27,13,40,Clouds
35535,108,1553342400,39,1,40,Clouds
35536,109,1553342400,17,12,29,Clouds
35537,110,1553342400,33,7,40,Clouds
35538,111,1553342400,34,6,40,Clouds
35539,112,1553342400,30,0,30,Clouds
35540,113,1553342400,16,24,40,Clouds
35541,114,1553342400,37,3,40,Clouds
35542,115,1553342400,19,11,30,Clouds
35543,2,1553346000,20,0,20,Clouds
35544,3,1553346000,15,5,20,Clouds
35545,4,1553346000,14,6,20,Clouds
35546,5,1553346000,19,21,40,Clouds
35547,6,1553346000,14,6,20,Clouds
35548,7,1553346000,14,15,29,Clouds
35549,8,1553346000,10,20,30,Clouds
35550,9,1553346000,0,23,23,Clouds
35551,10,1553346000,0,16,16,Clouds
35552,11,1553346000,28,2,30,Clouds
35553,12,1553346000,19,1,20,Clouds
35554,13,1553346000,28,2,30,Clouds
35555,14,1553346000,14,16,30,Clouds
35556,15,1553346000,16,0,16,Clouds
35557,16,1553346000,17,3,20,Clouds
35558,17,1553346000,14,6,20,Clouds
35559,18,1553346000,17,13,30,Clouds
35560,19,1553346000,20,10,30,Clouds
35561,21,1553346000,7,23,30,Clouds
35562,22,1553346000,14,6,20,Clouds
35563,23,1553346000,2,28,30,Clouds
35564,24,1553346000,0,20,20,Clouds
35565,25,1553346000,23,7,30,Clouds
35566,26,1553346000,1,19,20,Clouds
35567,27,1553346000,1,19,20,Clouds
35568,28,1553346000,21,9,30,Clouds
35569,29,1553346000,0,29,29,Clouds
35570,30,1553346000,20,0,20,Clouds
35571,31,1553346000,0,20,20,Clouds
35572,32,1553346000,18,12,30,Clouds
35573,33,1553346000,0,23,23,Clouds
35574,34,1553346000,27,3,30,Clouds
35575,35,1553346000,12,18,30,Clouds
35576,36,1553346000,27,13,40,Clouds
35577,37,1553346000,27,3,30,Clouds
35578,38,1553346000,21,19,40,Clouds
35579,39,1553346000,11,9,20,Clouds
35580,40,1553346000,9,12,21,Clouds
35581,41,1553346000,19,1,20,Clouds
35582,42,1553346000,18,12,30,Clouds
35583,43,1553346000,20,10,30,Clouds
35584,44,1553346000,30,0,30,Clouds
35585,45,1553346000,14,16,30,Clouds
35586,46,1553346000,0,20,20,Clouds
35587,47,1553346000,39,1,40,Clouds
35588,48,1553346000,16,24,40,Clouds
35589,49,1553346000,24,16,40,Clouds
35590,50,1553346000,38,2,40,Clouds
35591,51,1553346000,13,27,40,Clouds
35592,52,1553346000,6,26,32,Clouds
35593,53,1553346000,33,7,40,Clouds
35594,54,1553346000,25,8,33,Clouds
35595,55,1553346000,36,0,36,Clouds
35596,56,1553346000,40,0,40,Clouds
35597,57,1553346000,22,1,23,Clouds
35598,58,1553346000,28,12,40,Clouds
35599,59,1553346000,7,13,20,Clouds
35600,60,1553346000,28,2,30,Clouds
35601,61,1553346000,14,11,25,Clouds
35602,62,1553346000,33,7,40,Clouds
35603,63,1553346000,14,21,35,Clouds
35604,64,1553346000,22,18,40,Clouds
35605,65,1553346000,35,5,40,Clouds
35606,66,1553346000,29,11,40,Clouds
35607,67,1553346000,36,4,40,Clouds
35608,68,1553346000,22,18,40,Clouds
35609,69,1553346000,12,28,40,Clouds
35610,70,1553346000,27,1,28,Clouds
35611,71,1553346000,29,11,40,Clouds
35612,72,1553346000,29,2,31,Clouds
35613,73,1553346000,26,4,30,Clouds
35614,74,1553346000,12,18,30,Clouds
35615,75,1553346000,18,22,40,Clouds
35616,76,1553346000,27,11,38,Clouds
35617,77,1553346000,14,15,29,Clouds
35618,78,1553346000,30,10,40,Clouds
35619,79,1553346000,18,9,27,Clouds
35620,80,1553346000,33,7,40,Clouds
35621,81,1553346000,22,18,40,Clouds
35622,82,1553346000,22,0,22,Clouds
35623,83,1553346000,31,9,40,Clouds
35624,84,1553346000,23,7,30,Clouds
35625,85,1553346000,31,4,35,Clouds
35626,86,1553346000,20,18,38,Clouds
35627,87,1553346000,18,20,38,Clouds
35628,88,1553346000,23,7,30,Clouds
35629,89,1553346000,35,5,40,Clouds
35630,90,1553346000,30,10,40,Clouds
35631,91,1553346000,9,21,30,Clouds
35632,92,1553346000,16,24,40,Clouds
35633,93,1553346000,2,38,40,Clouds
35634,94,1553346000,30,10,40,Clouds
35635,95,1553346000,28,12,40,Clouds
35636,96,1553346000,23,7,30,Clouds
35637,97,1553346000,40,0,40,Clouds
35638,98,1553346000,24,16,40,Clouds
35639,99,1553346000,27,3,30,Clouds
35640,100,1553346000,6,19,25,Clouds
35641,101,1553346000,30,0,30,Clouds
35642,102,1553346000,31,9,40,Clouds
35643,103,1553346000,40,0,40,Clouds
35644,104,1553346000,35,5,40,Clouds
35645,105,1553346000,23,13,36,Clouds
35646,106,1553346000,30,10,40,Clouds
35647,107,1553346000,29,11,40,Clouds
35648,108,1553346000,37,3,40,Clouds
35649,109,1553346000,18,11,29,Clouds
35650,110,1553346000,34,6,40,Clouds
35651,111,1553346000,40,0,40,Clouds
35652,112,1553346000,30,0,30,Clouds
35653,113,1553346000,16,24,40,Clouds
35654,114,1553346000,40,0,40,Clouds
35655,115,1553346000,27,3,30,Clouds
35656,2,1553349600,20,0,20,Clouds
35657,3,1553349600,17,3,20,Clouds
35658,4,1553349600,12,8,20,Clouds
35659,5,1553349600,21,19,40,Clouds
35660,6,1553349600,12,8,20,Clouds
35661,7,1553349600,18,11,29,Clouds
35662,8,1553349600,6,24,30,Clouds
35663,9,1553349600,6,18,24,Clouds
35664,10,1553349600,0,16,16,Clouds
35665,11,1553349600,27,3,30,Clouds
35666,12,1553349600,13,7,20,Clouds
35667,13,1553349600,28,2,30,Clouds
35668,14,1553349600,9,21,30,Clouds
35669,15,1553349600,13,3,16,Clouds
35670,16,1553349600,17,3,20,Clouds
35671,17,1553349600,14,6,20,Clouds
35672,18,1553349600,18,12,30,Clouds
35673,19,1553349600,26,4,30,Clouds
35674,21,1553349600,2,28,30,Clouds
35675,22,1553349600,14,6,20,Clouds
35676,23,1553349600,15,15,30,Clouds
35677,24,1553349600,2,18,20,Clouds
35678,25,1553349600,24,6,30,Clouds
35679,26,1553349600,3,17,20,Clouds
35680,27,1553349600,2,18,20,Clouds
35681,28,1553349600,26,4,30,Clouds
35682,29,1553349600,1,28,29,Clouds
35683,30,1553349600,20,0,20,Clouds
35684,31,1553349600,3,17,20,Clouds
35685,32,1553349600,16,14,30,Clouds
35686,33,1553349600,0,23,23,Clouds
35687,34,1553349600,10,20,30,Clouds
35688,35,1553349600,10,20,30,Clouds
35689,36,1553349600,31,9,40,Clouds
35690,37,1553349600,28,2,30,Clouds
35691,38,1553349600,19,21,40,Clouds
35692,39,1553349600,16,4,20,Clouds
35693,40,1553349600,6,15,21,Clouds
35694,41,1553349600,17,3,20,Clouds
35695,42,1553349600,18,12,30,Clouds
35696,43,1553349600,15,15,30,Clouds
35697,44,1553349600,30,0,30,Clouds
35698,45,1553349600,14,16,30,Clouds
35699,46,1553349600,0,20,20,Clouds
35700,47,1553349600,39,1,40,Clouds
35701,48,1553349600,16,24,40,Clouds
35702,49,1553349600,29,11,40,Clouds
35703,50,1553349600,38,2,40,Clouds
35704,51,1553349600,22,18,40,Clouds
35705,52,1553349600,6,26,32,Clouds
35706,53,1553349600,33,7,40,Clouds
35707,54,1553349600,25,8,33,Clouds
35708,55,1553349600,35,1,36,Clouds
35709,56,1553349600,40,0,40,Clouds
35710,57,1553349600,22,1,23,Clouds
35711,58,1553349600,29,11,40,Clouds
35712,59,1553349600,7,13,20,Clouds
35713,60,1553349600,29,1,30,Clouds
35714,61,1553349600,16,9,25,Clouds
35715,62,1553349600,31,9,40,Clouds
35716,63,1553349600,13,22,35,Clouds
35717,64,1553349600,21,19,40,Clouds
35718,65,1553349600,39,1,40,Clouds
35719,66,1553349600,30,10,40,Clouds
35720,67,1553349600,37,3,40,Clouds
35721,68,1553349600,26,14,40,Clouds
35722,69,1553349600,24,16,40,Clouds
35723,70,1553349600,27,1,28,Clouds
35724,71,1553349600,29,11,40,Clouds
35725,72,1553349600,30,1,31,Clouds
35726,73,1553349600,30,0,30,Clouds
35727,74,1553349600,12,17,29,Clouds
35728,75,1553349600,20,20,40,Clouds
35729,76,1553349600,25,13,38,Clouds
35730,77,1553349600,8,21,29,Clouds
35731,78,1553349600,31,9,40,Clouds
35732,79,1553349600,18,9,27,Clouds
35733,80,1553349600,35,5,40,Clouds
35734,81,1553349600,22,18,40,Clouds
35735,82,1553349600,22,0,22,Clouds
35736,83,1553349600,32,8,40,Clouds
35737,84,1553349600,24,6,30,Clouds
35738,85,1553349600,33,2,35,Clouds
35739,86,1553349600,21,17,38,Clouds
35740,87,1553349600,18,20,38,Clouds
35741,88,1553349600,28,2,30,Clouds
35742,89,1553349600,37,3,40,Clouds
35743,90,1553349600,32,8,40,Clouds
35744,91,1553349600,14,16,30,Clouds
35745,92,1553349600,11,29,40,Clouds
35746,93,1553349600,2,38,40,Clouds
35747,94,1553349600,30,10,40,Clouds
35748,95,1553349600,28,12,40,Clouds
35749,96,1553349600,25,5,30,Clouds
35750,97,1553349600,40,0,40,Clouds
35751,98,1553349600,23,17,40,Clouds
35752,99,1553349600,27,3,30,Clouds
35753,100,1553349600,3,22,25,Clouds
35754,101,1553349600,30,0,30,Clouds
35755,102,1553349600,33,7,40,Clouds
35756,103,1553349600,40,0,40,Clouds
35757,104,1553349600,34,6,40,Clouds
35758,105,1553349600,23,13,36,Clouds
35759,106,1553349600,31,9,40,Clouds
35760,107,1553349600,33,7,40,Clouds
35761,108,1553349600,32,8,40,Clouds
35762,109,1553349600,20,9,29,Clouds
35763,110,1553349600,36,4,40,Clouds
35764,111,1553349600,40,0,40,Clouds
35765,112,1553349600,28,2,30,Clouds
35766,113,1553349600,15,25,40,Clouds
35767,114,1553349600,38,2,40,Clouds
35768,115,1553349600,30,0,30,Clouds
35769,2,1553353200,18,2,20,Clouds
35770,3,1553353200,15,5,20,Clouds
35771,4,1553353200,10,10,20,Clouds
35772,5,1553353200,24,16,40,Clouds
35773,6,1553353200,12,8,20,Clouds
35774,7,1553353200,19,10,29,Clouds
35775,8,1553353200,9,21,30,Clouds
35776,9,1553353200,1,23,24,Clouds
35777,10,1553353200,5,11,16,Clouds
35778,11,1553353200,27,3,30,Clouds
35779,12,1553353200,12,8,20,Clouds
35780,13,1553353200,29,1,30,Clouds
35781,14,1553353200,8,22,30,Clouds
35782,15,1553353200,14,2,16,Clouds
35783,16,1553353200,20,0,20,Clouds
35784,17,1553353200,11,9,20,Clouds
35785,18,1553353200,24,6,30,Clouds
35786,19,1553353200,24,6,30,Clouds
35787,21,1553353200,0,30,30,Clouds
35788,22,1553353200,16,4,20,Clouds
35789,23,1553353200,11,19,30,Clouds
35790,24,1553353200,1,19,20,Clouds
35791,25,1553353200,24,6,30,Clouds
35792,26,1553353200,2,18,20,Clouds
35793,27,1553353200,0,20,20,Clouds
35794,28,1553353200,19,11,30,Clouds
35795,29,1553353200,11,18,29,Clouds
35796,30,1553353200,16,4,20,Clouds
35797,31,1553353200,9,11,20,Clouds
35798,32,1553353200,14,16,30,Clouds
35799,33,1553353200,1,22,23,Clouds
35800,34,1553353200,24,6,30,Clouds
35801,35,1553353200,8,22,30,Clouds
35802,36,1553353200,28,12,40,Clouds
35803,37,1553353200,25,5,30,Clouds
35804,38,1553353200,17,23,40,Clouds
35805,39,1553353200,12,8,20,Clouds
35806,40,1553353200,4,17,21,Clouds
35807,41,1553353200,20,0,20,Clouds
35808,42,1553353200,17,13,30,Clouds
35809,43,1553353200,11,19,30,Clouds
35810,44,1553353200,30,0,30,Clouds
35811,45,1553353200,13,17,30,Clouds
35812,46,1553353200,3,17,20,Clouds
35813,47,1553353200,37,3,40,Clouds
35814,48,1553353200,12,28,40,Clouds
35815,49,1553353200,32,8,40,Clouds
35816,50,1553353200,38,2,40,Clouds
35817,51,1553353200,19,21,40,Clouds
35818,52,1553353200,1,31,32,Clouds
35819,53,1553353200,31,9,40,Clouds
35820,54,1553353200,26,7,33,Clouds
35821,55,1553353200,35,1,36,Clouds
35822,56,1553353200,40,0,40,Clouds
35823,57,1553353200,23,0,23,Clouds
35824,58,1553353200,38,2,40,Clouds
35825,59,1553353200,7,13,20,Clouds
35826,60,1553353200,29,1,30,Clouds
35827,61,1553353200,14,11,25,Clouds
35828,62,1553353200,32,8,40,Clouds
35829,63,1553353200,9,26,35,Clouds
35830,64,1553353200,20,20,40,Clouds
35831,65,1553353200,39,1,40,Clouds
35832,66,1553353200,32,8,40,Clouds
35833,67,1553353200,38,2,40,Clouds
35834,68,1553353200,33,7,40,Clouds
35835,69,1553353200,21,19,40,Clouds
35836,70,1553353200,21,7,28,Clouds
35837,71,1553353200,27,13,40,Clouds
35838,72,1553353200,8,23,31,Clouds
35839,73,1553353200,24,6,30,Clouds
35840,74,1553353200,13,17,30,Clouds
35841,75,1553353200,20,20,40,Clouds
35842,76,1553353200,32,6,38,Clouds
35843,77,1553353200,6,23,29,Clouds
35844,78,1553353200,31,9,40,Clouds
35845,79,1553353200,17,10,27,Clouds
35846,80,1553353200,20,20,40,Clouds
35847,81,1553353200,22,18,40,Clouds
35848,82,1553353200,22,0,22,Clouds
35849,83,1553353200,36,4,40,Clouds
35850,84,1553353200,27,3,30,Clouds
35851,85,1553353200,34,1,35,Clouds
35852,86,1553353200,23,15,38,Clouds
35853,87,1553353200,15,23,38,Clouds
35854,88,1553353200,27,3,30,Clouds
35855,89,1553353200,36,4,40,Clouds
35856,90,1553353200,32,8,40,Clouds
35857,91,1553353200,15,15,30,Clouds
35858,92,1553353200,12,28,40,Clouds
35859,93,1553353200,2,38,40,Clouds
35860,94,1553353200,30,10,40,Clouds
35861,95,1553353200,32,8,40,Clouds
35862,96,1553353200,30,0,30,Clouds
35863,97,1553353200,32,8,40,Clouds
35864,98,1553353200,16,24,40,Clouds
35865,99,1553353200,28,2,30,Clouds
35866,100,1553353200,1,24,25,Clouds
35867,101,1553353200,29,1,30,Clouds
35868,102,1553353200,33,7,40,Clouds
35869,103,1553353200,39,1,40,Clouds
35870,104,1553353200,34,6,40,Clouds
35871,105,1553353200,25,11,36,Clouds
35872,106,1553353200,32,8,40,Clouds
35873,107,1553353200,37,3,40,Clouds
35874,108,1553353200,31,9,40,Clouds
35875,109,1553353200,23,6,29,Clouds
35876,110,1553353200,40,0,40,Clouds
35877,111,1553353200,40,0,40,Clouds
35878,112,1553353200,23,7,30,Clouds
35879,113,1553353200,15,25,40,Clouds
35880,114,1553353200,36,4,40,Clouds
35881,115,1553353200,27,3,30,Clouds
35882,2,1553356800,17,3,20,Clouds
35883,3,1553356800,20,0,20,Clouds
35884,4,1553356800,12,8,20,Clouds
35885,5,1553356800,29,11,40,Clouds
35886,6,1553356800,11,9,20,Clouds
35887,7,1553356800,17,12,29,Clouds
35888,8,1553356800,7,23,30,Clouds
35889,9,1553356800,0,24,24,Clouds
35890,10,1553356800,1,15,16,Clouds
35891,11,1553356800,30,0,30,Clouds
35892,12,1553356800,14,6,20,Clouds
35893,13,1553356800,24,6,30,Clouds
35894,14,1553356800,1,29,30,Clouds
35895,15,1553356800,13,3,16,Clouds
35896,16,1553356800,19,1,20,Clouds
35897,17,1553356800,8,12,20,Clouds
35898,18,1553356800,25,5,30,Clouds
35899,19,1553356800,29,1,30,Clouds
35900,21,1553356800,9,21,30,Clouds
35901,22,1553356800,15,5,20,Clouds
35902,23,1553356800,12,18,30,Clouds
35903,24,1553356800,1,19,20,Clouds
35904,25,1553356800,26,4,30,Clouds
35905,26,1553356800,3,17,20,Clouds
35906,27,1553356800,1,19,20,Clouds
35907,28,1553356800,24,6,30,Clouds
35908,29,1553356800,0,29,29,Clouds
35909,30,1553356800,17,3,20,Clouds
35910,31,1553356800,1,19,20,Clouds
35911,32,1553356800,15,15,30,Clouds
35912,33,1553356800,0,23,23,Clouds
35913,34,1553356800,12,18,30,Clouds
35914,35,1553356800,12,18,30,Clouds
35915,36,1553356800,26,14,40,Clouds
35916,37,1553356800,24,6,30,Clouds
35917,38,1553356800,20,20,40,Clouds
35918,39,1553356800,12,8,20,Clouds
35919,40,1553356800,2,19,21,Clouds
35920,41,1553356800,18,2,20,Clouds
35921,42,1553356800,21,9,30,Clouds
35922,43,1553356800,15,15,30,Clouds
35923,44,1553356800,28,2,30,Clouds
35924,45,1553356800,9,21,30,Clouds
35925,46,1553356800,0,20,20,Clouds
35926,47,1553356800,36,4,40,Clouds
35927,48,1553356800,14,26,40,Clouds
35928,49,1553356800,32,8,40,Clouds
35929,50,1553356800,40,0,40,Clouds
35930,51,1553356800,17,23,40,Clouds
35931,52,1553356800,18,14,32,Clouds
35932,53,1553356800,32,8,40,Clouds
35933,54,1553356800,27,6,33,Clouds
35934,55,1553356800,35,1,36,Clouds
35935,56,1553356800,37,3,40,Clouds
35936,57,1553356800,22,1,23,Clouds
35937,58,1553356800,39,1,40,Clouds
35938,59,1553356800,8,12,20,Clouds
35939,60,1553356800,29,1,30,Clouds
35940,61,1553356800,13,12,25,Clouds
35941,62,1553356800,31,9,40,Clouds
35942,63,1553356800,8,27,35,Clouds
35943,64,1553356800,18,22,40,Clouds
35944,65,1553356800,40,0,40,Clouds
35945,66,1553356800,33,7,40,Clouds
35946,67,1553356800,38,2,40,Clouds
35947,68,1553356800,38,2,40,Clouds
35948,69,1553356800,18,22,40,Clouds
35949,70,1553356800,20,8,28,Clouds
35950,71,1553356800,25,15,40,Clouds
35951,72,1553356800,9,22,31,Clouds
35952,73,1553356800,27,3,30,Clouds
35953,74,1553356800,11,19,30,Clouds
35954,75,1553356800,20,20,40,Clouds
35955,76,1553356800,29,9,38,Clouds
35956,77,1553356800,6,23,29,Clouds
35957,78,1553356800,30,10,40,Clouds
35958,79,1553356800,18,9,27,Clouds
35959,80,1553356800,20,20,40,Clouds
35960,81,1553356800,27,13,40,Clouds
35961,82,1553356800,21,1,22,Clouds
35962,83,1553356800,32,8,40,Clouds
35963,84,1553356800,28,2,30,Clouds
35964,85,1553356800,34,1,35,Clouds
35965,86,1553356800,15,23,38,Clouds
35966,87,1553356800,14,24,38,Clouds
35967,88,1553356800,29,1,30,Clouds
35968,89,1553356800,37,3,40,Clouds
35969,90,1553356800,34,6,40,Clouds
35970,91,1553356800,20,10,30,Clouds
35971,92,1553356800,12,28,40,Clouds
35972,93,1553356800,1,39,40,Clouds
35973,94,1553356800,30,10,40,Clouds
35974,95,1553356800,31,9,40,Clouds
35975,96,1553356800,30,0,30,Clouds
35976,97,1553356800,37,3,40,Clouds
35977,98,1553356800,15,25,40,Clouds
35978,99,1553356800,27,3,30,Clouds
35979,100,1553356800,1,24,25,Clouds
35980,101,1553356800,28,2,30,Clouds
35981,102,1553356800,34,6,40,Clouds
35982,103,1553356800,39,1,40,Clouds
35983,104,1553356800,34,6,40,Clouds
35984,105,1553356800,25,11,36,Clouds
35985,106,1553356800,29,11,40,Clouds
35986,107,1553356800,35,5,40,Clouds
35987,108,1553356800,34,6,40,Clouds
35988,109,1553356800,21,8,29,Clouds
35989,110,1553356800,40,0,40,Clouds
35990,111,1553356800,32,8,40,Clouds
35991,112,1553356800,22,8,30,Clouds
35992,113,1553356800,16,24,40,Clouds
35993,114,1553356800,39,1,40,Clouds
35994,115,1553356800,30,0,30,Clouds
35995,2,1553360400,15,5,20,Clouds
35996,3,1553360400,14,6,20,Clouds
35997,4,1553360400,11,9,20,Clouds
35998,5,1553360400,22,18,40,Clouds
35999,6,1553360400,11,9,20,Clouds
36000,7,1553360400,14,15,29,Clouds
36001,8,1553360400,1,29,30,Clouds
36002,9,1553360400,18,6,24,Clouds
36003,10,1553360400,1,15,16,Clouds
36004,11,1553360400,30,0,30,Clouds
36005,12,1553360400,16,4,20,Clouds
36006,13,1553360400,26,4,30,Clouds
36007,14,1553360400,14,16,30,Clouds
36008,15,1553360400,13,3,16,Clouds
36009,16,1553360400,19,1,20,Clouds
36010,17,1553360400,9,11,20,Clouds
36011,18,1553360400,23,7,30,Clouds
36012,19,1553360400,29,1,30,Clouds
36013,21,1553360400,5,25,30,Clouds
36014,22,1553360400,13,7,20,Clouds
36015,23,1553360400,15,15,30,Clouds
36016,24,1553360400,4,16,20,Clouds
36017,25,1553360400,26,4,30,Clouds
36018,26,1553360400,1,19,20,Clouds
36019,27,1553360400,2,18,20,Clouds
36020,28,1553360400,26,4,30,Clouds
36021,29,1553360400,0,29,29,Clouds
36022,30,1553360400,20,0,20,Clouds
36023,31,1553360400,4,16,20,Clouds
36024,32,1553360400,14,16,30,Clouds
36025,33,1553360400,4,19,23,Clouds
36026,34,1553360400,8,22,30,Clouds
36027,35,1553360400,13,17,30,Clouds
36028,36,1553360400,27,13,40,Clouds
36029,37,1553360400,24,6,30,Clouds
36030,38,1553360400,16,23,39,Clouds
36031,39,1553360400,18,2,20,Clouds
36032,40,1553360400,0,21,21,Clouds
36033,41,1553360400,20,0,20,Clouds
36034,42,1553360400,19,11,30,Clouds
36035,43,1553360400,24,6,30,Clouds
36036,44,1553360400,28,2,30,Clouds
36037,45,1553360400,2,28,30,Clouds
36038,46,1553360400,3,17,20,Clouds
36039,47,1553360400,36,4,40,Clouds
36040,48,1553360400,18,22,40,Clouds
36041,49,1553360400,24,16,40,Clouds
36042,50,1553360400,39,1,40,Clouds
36043,51,1553360400,11,29,40,Clouds
36044,52,1553360400,22,10,32,Clouds
36045,53,1553360400,31,9,40,Clouds
36046,54,1553360400,27,6,33,Clouds
36047,55,1553360400,36,0,36,Clouds
36048,56,1553360400,33,7,40,Clouds
36049,57,1553360400,23,0,23,Clouds
36050,58,1553360400,31,9,40,Clouds
36051,59,1553360400,10,10,20,Clouds
36052,60,1553360400,29,1,30,Clouds
36053,61,1553360400,15,10,25,Clouds
36054,62,1553360400,28,12,40,Clouds
36055,63,1553360400,6,29,35,Clouds
36056,64,1553360400,19,21,40,Clouds
36057,65,1553360400,40,0,40,Clouds
36058,66,1553360400,39,1,40,Clouds
36059,67,1553360400,34,6,40,Clouds
36060,68,1553360400,40,0,40,Clouds
36061,69,1553360400,27,13,40,Clouds
36062,70,1553360400,28,0,28,Clouds
36063,71,1553360400,23,17,40,Clouds
36064,72,1553360400,10,21,31,Clouds
36065,73,1553360400,27,3,30,Clouds
36066,74,1553360400,7,23,30,Clouds
36067,75,1553360400,23,17,40,Clouds
36068,76,1553360400,31,7,38,Clouds
36069,77,1553360400,14,15,29,Clouds
36070,78,1553360400,29,11,40,Clouds
36071,79,1553360400,18,9,27,Clouds
36072,80,1553360400,23,17,40,Clouds
36073,81,1553360400,28,12,40,Clouds
36074,82,1553360400,22,0,22,Clouds
36075,83,1553360400,31,9,40,Clouds
36076,84,1553360400,30,0,30,Clouds
36077,85,1553360400,35,0,35,Clouds
36078,86,1553360400,19,19,38,Clouds
36079,87,1553360400,16,22,38,Clouds
36080,88,1553360400,28,2,30,Clouds
36081,89,1553360400,37,3,40,Clouds
36082,90,1553360400,35,5,40,Clouds
36083,91,1553360400,28,2,30,Clouds
36084,92,1553360400,16,24,40,Clouds
36085,93,1553360400,1,39,40,Clouds
36086,94,1553360400,30,10,40,Clouds
36087,95,1553360400,28,12,40,Clouds
36088,96,1553360400,28,2,30,Clouds
36089,97,1553360400,20,20,40,Clouds
36090,98,1553360400,15,25,40,Clouds
36091,99,1553360400,25,5,30,Clouds
36092,100,1553360400,3,22,25,Clouds
36093,101,1553360400,30,0,30,Clouds
36094,102,1553360400,35,5,40,Clouds
36095,103,1553360400,36,4,40,Clouds
36096,104,1553360400,32,8,40,Clouds
36097,105,1553360400,25,11,36,Clouds
36098,106,1553360400,30,10,40,Clouds
36099,107,1553360400,31,9,40,Clouds
36100,108,1553360400,36,4,40,Clouds
36101,109,1553360400,22,7,29,Clouds
36102,110,1553360400,39,1,40,Clouds
36103,111,1553360400,34,6,40,Clouds
36104,112,1553360400,20,10,30,Clouds
36105,113,1553360400,16,24,40,Clouds
36106,114,1553360400,38,2,40,Clouds
36107,115,1553360400,30,0,30,Clouds
36108,2,1553364000,18,2,20,Clouds
36109,3,1553364000,18,2,20,Clouds
36110,4,1553364000,14,6,20,Clouds
36111,5,1553364000,26,14,40,Clouds
36112,6,1553364000,10,10,20,Clouds
36113,7,1553364000,15,14,29,Clouds
36114,8,1553364000,1,29,30,Clouds
36115,9,1553364000,18,6,24,Clouds
36116,10,1553364000,3,13,16,Clouds
36117,11,1553364000,29,1,30,Clouds
36118,12,1553364000,13,7,20,Clouds
36119,13,1553364000,26,4,30,Clouds
36120,14,1553364000,11,19,30,Clouds
36121,15,1553364000,14,2,16,Clouds
36122,16,1553364000,20,0,20,Clouds
36123,17,1553364000,13,7,20,Clouds
36124,18,1553364000,26,4,30,Clouds
36125,19,1553364000,30,0,30,Clouds
36126,21,1553364000,7,23,30,Clouds
36127,22,1553364000,11,9,20,Clouds
36128,23,1553364000,14,16,30,Clouds
36129,24,1553364000,9,11,20,Clouds
36130,25,1553364000,28,2,30,Clouds
36131,26,1553364000,6,14,20,Clouds
36132,27,1553364000,1,19,20,Clouds
36133,28,1553364000,29,1,30,Clouds
36134,29,1553364000,0,29,29,Clouds
36135,30,1553364000,20,0,20,Clouds
36136,31,1553364000,1,19,20,Clouds
36137,32,1553364000,10,20,30,Clouds
36138,33,1553364000,2,21,23,Clouds
36139,34,1553364000,9,21,30,Clouds
36140,35,1553364000,10,20,30,Clouds
36141,36,1553364000,28,12,40,Clouds
36142,37,1553364000,27,3,30,Clouds
36143,38,1553364000,11,29,40,Clouds
36144,39,1553364000,18,2,20,Clouds
36145,40,1553364000,2,19,21,Clouds
36146,41,1553364000,17,3,20,Clouds
36147,42,1553364000,10,20,30,Clouds
36148,43,1553364000,24,6,30,Clouds
36149,44,1553364000,30,0,30,Clouds
36150,45,1553364000,0,30,30,Clouds
36151,46,1553364000,4,16,20,Clouds
36152,47,1553364000,39,1,40,Clouds
36153,48,1553364000,28,12,40,Clouds
36154,49,1553364000,23,17,40,Clouds
36155,50,1553364000,33,7,40,Clouds
36156,51,1553364000,5,35,40,Clouds
36157,52,1553364000,19,13,32,Clouds
36158,53,1553364000,31,9,40,Clouds
36159,54,1553364000,22,11,33,Clouds
36160,55,1553364000,35,1,36,Clouds
36161,56,1553364000,34,6,40,Clouds
36162,57,1553364000,20,3,23,Clouds
36163,58,1553364000,33,7,40,Clouds
36164,59,1553364000,11,9,20,Clouds
36165,60,1553364000,7,23,30,Clouds
36166,61,1553364000,19,6,25,Clouds
36167,62,1553364000,21,19,40,Clouds
36168,63,1553364000,5,30,35,Clouds
36169,64,1553364000,22,18,40,Clouds
36170,65,1553364000,40,0,40,Clouds
36171,66,1553364000,35,5,40,Clouds
36172,67,1553364000,30,10,40,Clouds
36173,68,1553364000,36,4,40,Clouds
36174,69,1553364000,35,5,40,Clouds
36175,70,1553364000,21,7,28,Clouds
36176,71,1553364000,28,12,40,Clouds
36177,72,1553364000,7,24,31,Clouds
36178,73,1553364000,27,3,30,Clouds
36179,74,1553364000,8,22,30,Clouds
36180,75,1553364000,26,14,40,Clouds
36181,76,1553364000,31,7,38,Clouds
36182,77,1553364000,11,18,29,Clouds
36183,78,1553364000,36,4,40,Clouds
36184,79,1553364000,19,8,27,Clouds
36185,80,1553364000,24,16,40,Clouds
36186,81,1553364000,29,11,40,Clouds
36187,82,1553364000,19,3,22,Clouds
36188,83,1553364000,34,6,40,Clouds
36189,84,1553364000,30,0,30,Clouds
36190,85,1553364000,34,1,35,Clouds
36191,86,1553364000,21,17,38,Clouds
36192,87,1553364000,14,24,38,Clouds
36193,88,1553364000,27,3,30,Clouds
36194,89,1553364000,35,4,39,Clouds
36195,90,1553364000,35,5,40,Clouds
36196,91,1553364000,24,6,30,Clouds
36197,92,1553364000,12,28,40,Clouds
36198,93,1553364000,1,39,40,Clouds
36199,94,1553364000,30,10,40,Clouds
36200,95,1553364000,30,10,40,Clouds
36201,96,1553364000,28,2,30,Clouds
36202,97,1553364000,17,23,40,Clouds
36203,98,1553364000,8,32,40,Clouds
36204,99,1553364000,27,3,30,Clouds
36205,100,1553364000,1,24,25,Clouds
36206,101,1553364000,29,1,30,Clouds
36207,102,1553364000,14,26,40,Clouds
36208,103,1553364000,37,3,40,Clouds
36209,104,1553364000,34,6,40,Clouds
36210,105,1553364000,25,11,36,Clouds
36211,106,1553364000,31,9,40,Clouds
36212,107,1553364000,31,9,40,Clouds
36213,108,1553364000,39,1,40,Clouds
36214,109,1553364000,22,7,29,Clouds
36215,110,1553364000,37,3,40,Clouds
36216,111,1553364000,40,0,40,Clouds
36217,112,1553364000,29,1,30,Clouds
36218,113,1553364000,15,25,40,Clouds
36219,114,1553364000,38,2,40,Clouds
36220,115,1553364000,22,8,30,Clouds
36221,2,1553367600,19,1,20,Clouds
36222,3,1553367600,18,2,20,Clouds
36223,4,1553367600,16,4,20,Clouds
36224,5,1553367600,17,23,40,Clouds
36225,6,1553367600,6,14,20,Clouds
36226,7,1553367600,14,15,29,Clouds
36227,8,1553367600,1,29,30,Clouds
36228,9,1553367600,24,0,24,Clouds
36229,10,1553367600,0,16,16,Clouds
36230,11,1553367600,29,1,30,Clouds
36231,12,1553367600,17,3,20,Clouds
36232,13,1553367600,28,2,30,Clouds
36233,14,1553367600,7,23,30,Clouds
36234,15,1553367600,15,1,16,Clouds
36235,16,1553367600,20,0,20,Clouds
36236,17,1553367600,16,4,20,Clouds
36237,18,1553367600,25,5,30,Clouds
36238,19,1553367600,20,10,30,Clouds
36239,21,1553367600,7,23,30,Clouds
36240,22,1553367600,13,7,20,Clouds
36241,23,1553367600,8,22,30,Clouds
36242,24,1553367600,7,13,20,Clouds
36243,25,1553367600,29,1,30,Clouds
36244,26,1553367600,7,13,20,Clouds
36245,27,1553367600,3,17,20,Clouds
36246,28,1553367600,28,2,30,Clouds
36247,29,1553367600,0,29,29,Clouds
36248,30,1553367600,20,0,20,Clouds
36249,31,1553367600,16,4,20,Clouds
36250,32,1553367600,15,15,30,Clouds
36251,33,1553367600,4,19,23,Clouds
36252,34,1553367600,3,27,30,Clouds
36253,35,1553367600,2,28,30,Clouds
36254,36,1553367600,27,13,40,Clouds
36255,37,1553367600,25,5,30,Clouds
36256,38,1553367600,14,26,40,Clouds
36257,39,1553367600,20,0,20,Clouds
36258,40,1553367600,5,16,21,Clouds
36259,41,1553367600,15,5,20,Clouds
36260,42,1553367600,10,20,30,Clouds
36261,43,1553367600,21,9,30,Clouds
36262,44,1553367600,29,1,30,Clouds
36263,45,1553367600,0,30,30,Clouds
36264,46,1553367600,0,20,20,Clouds
36265,47,1553367600,38,2,40,Clouds
36266,48,1553367600,29,11,40,Clouds
36267,49,1553367600,28,12,40,Clouds
36268,50,1553367600,33,7,40,Clouds
36269,51,1553367600,6,34,40,Clouds
36270,52,1553367600,20,12,32,Clouds
36271,53,1553367600,31,9,40,Clouds
36272,54,1553367600,24,9,33,Clouds
36273,55,1553367600,35,1,36,Clouds
36274,56,1553367600,34,6,40,Clouds
36275,57,1553367600,21,2,23,Clouds
36276,58,1553367600,39,1,40,Clouds
36277,59,1553367600,12,8,20,Clouds
36278,60,1553367600,11,19,30,Clouds
36279,61,1553367600,18,7,25,Clouds
36280,62,1553367600,20,20,40,Clouds
36281,63,1553367600,2,33,35,Clouds
36282,64,1553367600,19,21,40,Clouds
36283,65,1553367600,40,0,40,Clouds
36284,66,1553367600,39,1,40,Clouds
36285,67,1553367600,24,16,40,Clouds
36286,68,1553367600,32,8,40,Clouds
36287,69,1553367600,30,10,40,Clouds
36288,70,1553367600,23,5,28,Clouds
36289,71,1553367600,30,10,40,Clouds
36290,72,1553367600,7,24,31,Clouds
36291,73,1553367600,26,4,30,Clouds
36292,74,1553367600,10,20,30,Clouds
36293,75,1553367600,30,10,40,Clouds
36294,76,1553367600,30,8,38,Clouds
36295,77,1553367600,11,18,29,Clouds
36296,78,1553367600,35,5,40,Clouds
36297,79,1553367600,20,7,27,Clouds
36298,80,1553367600,24,16,40,Clouds
36299,81,1553367600,29,11,40,Clouds
36300,82,1553367600,22,0,22,Clouds
36301,83,1553367600,34,6,40,Clouds
36302,84,1553367600,30,0,30,Clouds
36303,85,1553367600,33,2,35,Clouds
36304,86,1553367600,26,12,38,Clouds
36305,87,1553367600,11,27,38,Clouds
36306,88,1553367600,27,3,30,Clouds
36307,89,1553367600,33,6,39,Clouds
36308,90,1553367600,35,5,40,Clouds
36309,91,1553367600,18,12,30,Clouds
36310,92,1553367600,12,28,40,Clouds
36311,93,1553367600,2,38,40,Clouds
36312,94,1553367600,30,10,40,Clouds
36313,95,1553367600,36,4,40,Clouds
36314,96,1553367600,28,2,30,Clouds
36315,97,1553367600,19,21,40,Clouds
36316,98,1553367600,8,32,40,Clouds
36317,99,1553367600,28,2,30,Clouds
36318,100,1553367600,1,24,25,Clouds
36319,101,1553367600,25,5,30,Clouds
36320,102,1553367600,15,25,40,Clouds
36321,103,1553367600,37,3,40,Clouds
36322,104,1553367600,35,5,40,Clouds
36323,105,1553367600,25,11,36,Clouds
36324,106,1553367600,31,9,40,Clouds
36325,107,1553367600,34,6,40,Clouds
36326,108,1553367600,37,3,40,Clouds
36327,109,1553367600,21,8,29,Clouds
36328,110,1553367600,38,2,40,Clouds
36329,111,1553367600,35,5,40,Clouds
36330,112,1553367600,26,4,30,Clouds
36331,113,1553367600,18,22,40,Clouds
36332,114,1553367600,36,4,40,Clouds
36333,115,1553367600,21,9,30,Clouds
36334,2,1553371200,19,1,20,Clear
36335,3,1553371200,16,4,20,Clear
36336,4,1553371200,14,6,20,Clear
36337,5,1553371200,17,23,40,Clear
36338,6,1553371200,2,17,19,Clear
36339,7,1553371200,14,15,29,Clear
36340,8,1553371200,4,26,30,Clear
36341,9,1553371200,21,3,24,Clear
36342,10,1553371200,2,14,16,Clear
36343,11,1553371200,28,2,30,Clear
36344,12,1553371200,14,6,20,Clear
36345,13,1553371200,27,3,30,Clear
36346,14,1553371200,6,24,30,Clear
36347,15,1553371200,16,0,16,Clear
36348,16,1553371200,14,6,20,Clear
36349,17,1553371200,16,4,20,Clear
36350,18,1553371200,17,13,30,Clear
36351,19,1553371200,18,12,30,Clear
36352,21,1553371200,4,26,30,Clear
36353,22,1553371200,13,7,20,Clear
36354,23,1553371200,15,15,30,Clear
36355,24,1553371200,6,14,20,Clear
36356,25,1553371200,30,0,30,Clear
36357,26,1553371200,2,18,20,Clear
36358,27,1553371200,9,11,20,Clear
36359,28,1553371200,27,3,30,Clear
36360,29,1553371200,0,29,29,Clear
36361,30,1553371200,20,0,20,Clear
36362,31,1553371200,19,1,20,Clear
36363,32,1553371200,13,17,30,Clear
36364,33,1553371200,10,13,23,Clear
36365,34,1553371200,2,28,30,Clear
36366,35,1553371200,8,22,30,Clear
36367,36,1553371200,26,14,40,Clear
36368,37,1553371200,24,6,30,Clear
36369,38,1553371200,19,21,40,Clear
36370,39,1553371200,15,5,20,Clear
36371,40,1553371200,5,16,21,Clear
36372,41,1553371200,15,5,20,Clear
36373,42,1553371200,9,21,30,Clear
36374,43,1553371200,21,9,30,Clear
36375,44,1553371200,26,4,30,Clear
36376,45,1553371200,0,30,30,Clear
36377,46,1553371200,2,18,20,Clear
36378,47,1553371200,37,3,40,Clear
36379,48,1553371200,32,8,40,Clear
36380,49,1553371200,34,6,40,Clear
36381,50,1553371200,29,11,40,Clear
36382,51,1553371200,25,15,40,Clear
36383,52,1553371200,22,10,32,Clear
36384,53,1553371200,31,9,40,Clear
36385,54,1553371200,25,8,33,Clear
36386,55,1553371200,35,1,36,Clear
36387,56,1553371200,31,9,40,Clear
36388,57,1553371200,23,0,23,Clear
36389,58,1553371200,37,3,40,Clear
36390,59,1553371200,13,7,20,Clear
36391,60,1553371200,15,15,30,Clear
36392,61,1553371200,19,6,25,Clear
36393,62,1553371200,20,20,40,Clear
36394,63,1553371200,2,33,35,Clear
36395,64,1553371200,17,23,40,Clear
36396,65,1553371200,40,0,40,Clear
36397,66,1553371200,35,5,40,Clear
36398,67,1553371200,23,17,40,Clear
36399,68,1553371200,33,7,40,Clear
36400,69,1553371200,27,13,40,Clear
36401,70,1553371200,22,6,28,Clear
36402,71,1553371200,26,14,40,Clear
36403,72,1553371200,6,25,31,Clear
36404,73,1553371200,25,5,30,Clear
36405,74,1553371200,10,20,30,Clear
36406,75,1553371200,30,10,40,Clear
36407,76,1553371200,20,18,38,Clear
36408,77,1553371200,13,16,29,Clear
36409,78,1553371200,38,2,40,Clear
36410,79,1553371200,20,7,27,Clear
36411,80,1553371200,23,17,40,Clear
36412,81,1553371200,29,11,40,Clear
36413,82,1553371200,21,1,22,Clear
36414,83,1553371200,34,6,40,Clear
36415,84,1553371200,29,1,30,Clear
36416,85,1553371200,32,3,35,Clear
36417,86,1553371200,20,18,38,Clear
36418,87,1553371200,11,27,38,Clear
36419,88,1553371200,26,4,30,Clear
36420,89,1553371200,34,5,39,Clear
36421,90,1553371200,38,2,40,Clear
36422,91,1553371200,12,18,30,Clear
36423,92,1553371200,13,27,40,Clear
36424,93,1553371200,2,38,40,Clear
36425,94,1553371200,30,10,40,Clear
36426,95,1553371200,37,3,40,Clear
36427,96,1553371200,28,2,30,Clear
36428,97,1553371200,18,22,40,Clear
36429,98,1553371200,10,30,40,Clear
36430,99,1553371200,30,0,30,Clear
36431,100,1553371200,4,21,25,Clear
36432,101,1553371200,23,7,30,Clear
36433,102,1553371200,15,25,40,Clear
36434,103,1553371200,38,2,40,Clear
36435,104,1553371200,35,5,40,Clear
36436,105,1553371200,25,11,36,Clear
36437,106,1553371200,31,9,40,Clear
36438,107,1553371200,34,6,40,Clear
36439,108,1553371200,37,3,40,Clear
36440,109,1553371200,22,7,29,Clear
36441,110,1553371200,39,1,40,Clear
36442,111,1553371200,33,7,40,Clear
36443,112,1553371200,24,6,30,Clear
36444,113,1553371200,20,20,40,Clear
36445,114,1553371200,33,7,40,Clear
36446,115,1553371200,16,14,30,Clear
36447,2,1553374800,18,2,20,Clouds
36448,3,1553374800,11,9,20,Clouds
36449,4,1553374800,14,6,20,Clouds
36450,5,1553374800,14,26,40,Clouds
36451,6,1553374800,1,19,20,Clouds
36452,7,1553374800,17,12,29,Clouds
36453,8,1553374800,3,27,30,Clouds
36454,9,1553374800,16,8,24,Clouds
36455,10,1553374800,1,15,16,Clouds
36456,11,1553374800,28,2,30,Clouds
36457,12,1553374800,13,7,20,Clouds
36458,13,1553374800,27,3,30,Clouds
36459,14,1553374800,4,26,30,Clouds
36460,15,1553374800,15,1,16,Clouds
36461,16,1553374800,12,8,20,Clouds
36462,17,1553374800,14,6,20,Clouds
36463,18,1553374800,21,9,30,Clouds
36464,19,1553374800,14,16,30,Clouds
36465,21,1553374800,16,14,30,Clouds
36466,22,1553374800,14,6,20,Clouds
36467,23,1553374800,10,20,30,Clouds
36468,24,1553374800,7,13,20,Clouds
36469,25,1553374800,30,0,30,Clouds
36470,26,1553374800,1,19,20,Clouds
36471,27,1553374800,6,14,20,Clouds
36472,28,1553374800,30,0,30,Clouds
36473,29,1553374800,3,26,29,Clouds
36474,30,1553374800,19,1,20,Clouds
36475,31,1553374800,16,4,20,Clouds
36476,32,1553374800,16,14,30,Clouds
36477,33,1553374800,5,18,23,Clouds
36478,34,1553374800,8,22,30,Clouds
36479,35,1553374800,4,26,30,Clouds
36480,36,1553374800,25,14,39,Clouds
36481,37,1553374800,24,6,30,Clouds
36482,38,1553374800,18,22,40,Clouds
36483,39,1553374800,14,6,20,Clouds
36484,40,1553374800,8,13,21,Clouds
36485,41,1553374800,16,4,20,Clouds
36486,42,1553374800,6,24,30,Clouds
36487,43,1553374800,20,10,30,Clouds
36488,44,1553374800,22,8,30,Clouds
36489,45,1553374800,2,28,30,Clouds
36490,46,1553374800,0,20,20,Clouds
36491,47,1553374800,36,4,40,Clouds
36492,48,1553374800,28,12,40,Clouds
36493,49,1553374800,36,4,40,Clouds
36494,50,1553374800,29,11,40,Clouds
36495,51,1553374800,32,8,40,Clouds
36496,52,1553374800,24,8,32,Clouds
36497,53,1553374800,28,12,40,Clouds
36498,54,1553374800,24,9,33,Clouds
36499,55,1553374800,35,1,36,Clouds
36500,56,1553374800,29,11,40,Clouds
36501,57,1553374800,23,0,23,Clouds
36502,58,1553374800,35,5,40,Clouds
36503,59,1553374800,11,9,20,Clouds
36504,60,1553374800,19,11,30,Clouds
36505,61,1553374800,17,8,25,Clouds
36506,62,1553374800,22,18,40,Clouds
36507,63,1553374800,3,32,35,Clouds
36508,64,1553374800,18,22,40,Clouds
36509,65,1553374800,38,2,40,Clouds
36510,66,1553374800,36,4,40,Clouds
36511,67,1553374800,25,15,40,Clouds
36512,68,1553374800,39,1,40,Clouds
36513,69,1553374800,29,11,40,Clouds
36514,70,1553374800,24,4,28,Clouds
36515,71,1553374800,15,25,40,Clouds
36516,72,1553374800,6,25,31,Clouds
36517,73,1553374800,27,3,30,Clouds
36518,74,1553374800,12,18,30,Clouds
36519,75,1553374800,31,9,40,Clouds
36520,76,1553374800,17,21,38,Clouds
36521,77,1553374800,14,15,29,Clouds
36522,78,1553374800,37,3,40,Clouds
36523,79,1553374800,20,7,27,Clouds
36524,80,1553374800,23,17,40,Clouds
36525,81,1553374800,30,10,40,Clouds
36526,82,1553374800,20,2,22,Clouds
36527,83,1553374800,31,9,40,Clouds
36528,84,1553374800,30,0,30,Clouds
36529,85,1553374800,33,2,35,Clouds
36530,86,1553374800,20,18,38,Clouds
36531,87,1553374800,13,25,38,Clouds
36532,88,1553374800,24,6,30,Clouds
36533,89,1553374800,34,5,39,Clouds
36534,90,1553374800,38,2,40,Clouds
36535,91,1553374800,14,16,30,Clouds
36536,92,1553374800,9,31,40,Clouds
36537,93,1553374800,2,38,40,Clouds
36538,94,1553374800,30,10,40,Clouds
36539,95,1553374800,35,5,40,Clouds
36540,96,1553374800,30,0,30,Clouds
36541,97,1553374800,24,16,40,Clouds
36542,98,1553374800,20,20,40,Clouds
36543,99,1553374800,29,1,30,Clouds
36544,100,1553374800,2,23,25,Clouds
36545,101,1553374800,22,8,30,Clouds
36546,102,1553374800,16,24,40,Clouds
36547,103,1553374800,38,2,40,Clouds
36548,104,1553374800,35,5,40,Clouds
36549,105,1553374800,25,11,36,Clouds
36550,106,1553374800,31,9,40,Clouds
36551,107,1553374800,33,7,40,Clouds
36552,108,1553374800,37,3,40,Clouds
36553,109,1553374800,22,7,29,Clouds
36554,110,1553374800,39,1,40,Clouds
36555,111,1553374800,31,9,40,Clouds
36556,112,1553374800,30,0,30,Clouds
36557,113,1553374800,21,19,40,Clouds
36558,114,1553374800,35,5,40,Clouds
36559,115,1553374800,12,18,30,Clouds
36560,2,1553378400,20,0,20,Clouds
36561,3,1553378400,8,12,20,Clouds
36562,4,1553378400,12,8,20,Clouds
36563,5,1553378400,13,27,40,Clouds
36564,6,1553378400,1,19,20,Clouds
36565,7,1553378400,14,15,29,Clouds
36566,8,1553378400,7,23,30,Clouds
36567,9,1553378400,20,4,24,Clouds
36568,10,1553378400,1,15,16,Clouds
36569,11,1553378400,27,3,30,Clouds
36570,12,1553378400,15,5,20,Clouds
36571,13,1553378400,28,2,30,Clouds
36572,14,1553378400,1,29,30,Clouds
36573,15,1553378400,16,0,16,Clouds
36574,16,1553378400,14,6,20,Clouds
36575,17,1553378400,14,6,20,Clouds
36576,18,1553378400,18,12,30,Clouds
36577,19,1553378400,15,15,30,Clouds
36578,21,1553378400,19,11,30,Clouds
36579,22,1553378400,13,7,20,Clouds
36580,23,1553378400,10,20,30,Clouds
36581,24,1553378400,8,12,20,Clouds
36582,25,1553378400,30,0,30,Clouds
36583,26,1553378400,1,19,20,Clouds
36584,27,1553378400,10,10,20,Clouds
36585,28,1553378400,27,3,30,Clouds
36586,29,1553378400,1,28,29,Clouds
36587,30,1553378400,19,1,20,Clouds
36588,31,1553378400,16,4,20,Clouds
36589,32,1553378400,16,14,30,Clouds
36590,33,1553378400,13,10,23,Clouds
36591,34,1553378400,5,25,30,Clouds
36592,35,1553378400,3,27,30,Clouds
36593,36,1553378400,25,14,39,Clouds
36594,37,1553378400,24,6,30,Clouds
36595,38,1553378400,20,20,40,Clouds
36596,39,1553378400,15,5,20,Clouds
36597,40,1553378400,8,13,21,Clouds
36598,41,1553378400,15,5,20,Clouds
36599,42,1553378400,6,24,30,Clouds
36600,43,1553378400,18,12,30,Clouds
36601,44,1553378400,19,11,30,Clouds
36602,45,1553378400,2,28,30,Clouds
36603,46,1553378400,0,20,20,Clouds
36604,47,1553378400,37,3,40,Clouds
36605,48,1553378400,28,12,40,Clouds
36606,49,1553378400,37,3,40,Clouds
36607,50,1553378400,33,7,40,Clouds
36608,51,1553378400,33,7,40,Clouds
36609,52,1553378400,22,10,32,Clouds
36610,53,1553378400,27,13,40,Clouds
36611,54,1553378400,25,8,33,Clouds
36612,55,1553378400,34,2,36,Clouds
36613,56,1553378400,29,11,40,Clouds
36614,57,1553378400,23,0,23,Clouds
36615,58,1553378400,40,0,40,Clouds
36616,59,1553378400,11,9,20,Clouds
36617,60,1553378400,19,11,30,Clouds
36618,61,1553378400,16,9,25,Clouds
36619,62,1553378400,22,18,40,Clouds
36620,63,1553378400,4,31,35,Clouds
36621,64,1553378400,17,23,40,Clouds
36622,65,1553378400,38,2,40,Clouds
36623,66,1553378400,33,7,40,Clouds
36624,67,1553378400,24,16,40,Clouds
36625,68,1553378400,35,5,40,Clouds
36626,69,1553378400,33,7,40,Clouds
36627,70,1553378400,24,4,28,Clouds
36628,71,1553378400,13,27,40,Clouds
36629,72,1553378400,4,27,31,Clouds
36630,73,1553378400,23,7,30,Clouds
36631,74,1553378400,9,21,30,Clouds
36632,75,1553378400,32,8,40,Clouds
36633,76,1553378400,15,23,38,Clouds
36634,77,1553378400,10,19,29,Clouds
36635,78,1553378400,38,2,40,Clouds
36636,79,1553378400,18,9,27,Clouds
36637,80,1553378400,25,15,40,Clouds
36638,81,1553378400,30,10,40,Clouds
36639,82,1553378400,22,0,22,Clouds
36640,83,1553378400,24,16,40,Clouds
36641,84,1553378400,28,2,30,Clouds
36642,85,1553378400,34,1,35,Clouds
36643,86,1553378400,21,17,38,Clouds
36644,87,1553378400,12,26,38,Clouds
36645,88,1553378400,22,8,30,Clouds
36646,89,1553378400,31,8,39,Clouds
36647,90,1553378400,40,0,40,Clouds
36648,91,1553378400,11,19,30,Clouds
36649,92,1553378400,10,30,40,Clouds
36650,93,1553378400,2,38,40,Clouds
36651,94,1553378400,30,10,40,Clouds
36652,95,1553378400,35,5,40,Clouds
36653,96,1553378400,30,0,30,Clouds
36654,97,1553378400,27,13,40,Clouds
36655,98,1553378400,19,21,40,Clouds
36656,99,1553378400,29,1,30,Clouds
36657,100,1553378400,8,17,25,Clouds
36658,101,1553378400,22,8,30,Clouds
36659,102,1553378400,17,23,40,Clouds
36660,103,1553378400,38,2,40,Clouds
36661,104,1553378400,26,14,40,Clouds
36662,105,1553378400,25,11,36,Clouds
36663,106,1553378400,32,8,40,Clouds
36664,107,1553378400,22,18,40,Clouds
36665,108,1553378400,36,4,40,Clouds
36666,109,1553378400,23,6,29,Clouds
36667,110,1553378400,39,1,40,Clouds
36668,111,1553378400,33,7,40,Clouds
36669,112,1553378400,30,0,30,Clouds
36670,113,1553378400,20,20,40,Clouds
36671,114,1553378400,37,3,40,Clouds
36672,115,1553378400,13,17,30,Clouds
36673,2,1553382000,19,1,20,Clouds
36674,3,1553382000,5,15,20,Clouds
36675,4,1553382000,13,7,20,Clouds
36676,5,1553382000,18,22,40,Clouds
36677,6,1553382000,2,18,20,Clouds
36678,7,1553382000,11,18,29,Clouds
36679,8,1553382000,5,25,30,Clouds
36680,9,1553382000,17,7,24,Clouds
36681,10,1553382000,1,15,16,Clouds
36682,11,1553382000,27,3,30,Clouds
36683,12,1553382000,15,5,20,Clouds
36684,13,1553382000,28,2,30,Clouds
36685,14,1553382000,1,29,30,Clouds
36686,15,1553382000,15,1,16,Clouds
36687,16,1553382000,15,5,20,Clouds
36688,17,1553382000,13,7,20,Clouds
36689,18,1553382000,12,18,30,Clouds
36690,19,1553382000,11,18,29,Clouds
36691,21,1553382000,18,12,30,Clouds
36692,22,1553382000,16,4,20,Clouds
36693,23,1553382000,7,23,30,Clouds
36694,24,1553382000,7,13,20,Clouds
36695,25,1553382000,30,0,30,Clouds
36696,26,1553382000,2,18,20,Clouds
36697,27,1553382000,4,16,20,Clouds
36698,28,1553382000,26,4,30,Clouds
36699,29,1553382000,0,29,29,Clouds
36700,30,1553382000,20,0,20,Clouds
36701,31,1553382000,20,0,20,Clouds
36702,32,1553382000,14,16,30,Clouds
36703,33,1553382000,15,8,23,Clouds
36704,34,1553382000,13,17,30,Clouds
36705,35,1553382000,9,21,30,Clouds
36706,36,1553382000,24,15,39,Clouds
36707,37,1553382000,23,7,30,Clouds
36708,38,1553382000,22,18,40,Clouds
36709,39,1553382000,12,8,20,Clouds
36710,40,1553382000,9,12,21,Clouds
36711,41,1553382000,15,5,20,Clouds
36712,42,1553382000,9,21,30,Clouds
36713,43,1553382000,19,11,30,Clouds
36714,44,1553382000,23,7,30,Clouds
36715,45,1553382000,2,28,30,Clouds
36716,46,1553382000,1,19,20,Clouds
36717,47,1553382000,37,3,40,Clouds
36718,48,1553382000,36,4,40,Clouds
36719,49,1553382000,37,3,40,Clouds
36720,50,1553382000,31,9,40,Clouds
36721,51,1553382000,32,8,40,Clouds
36722,52,1553382000,23,9,32,Clouds
36723,53,1553382000,27,13,40,Clouds
36724,54,1553382000,24,9,33,Clouds
36725,55,1553382000,33,3,36,Clouds
36726,56,1553382000,27,13,40,Clouds
36727,57,1553382000,21,2,23,Clouds
36728,58,1553382000,40,0,40,Clouds
36729,59,1553382000,11,9,20,Clouds
36730,60,1553382000,20,10,30,Clouds
36731,61,1553382000,19,6,25,Clouds
36732,62,1553382000,21,19,40,Clouds
36733,63,1553382000,4,31,35,Clouds
36734,64,1553382000,17,23,40,Clouds
36735,65,1553382000,40,0,40,Clouds
36736,66,1553382000,34,6,40,Clouds
36737,67,1553382000,23,17,40,Clouds
36738,68,1553382000,35,5,40,Clouds
36739,69,1553382000,22,18,40,Clouds
36740,70,1553382000,25,3,28,Clouds
36741,71,1553382000,11,29,40,Clouds
36742,72,1553382000,5,26,31,Clouds
36743,73,1553382000,21,9,30,Clouds
36744,74,1553382000,13,17,30,Clouds
36745,75,1553382000,31,9,40,Clouds
36746,76,1553382000,10,28,38,Clouds
36747,77,1553382000,9,20,29,Clouds
36748,78,1553382000,37,3,40,Clouds
36749,79,1553382000,18,9,27,Clouds
36750,80,1553382000,27,13,40,Clouds
36751,81,1553382000,30,10,40,Clouds
36752,82,1553382000,20,2,22,Clouds
36753,83,1553382000,22,18,40,Clouds
36754,84,1553382000,30,0,30,Clouds
36755,85,1553382000,33,2,35,Clouds
36756,86,1553382000,22,16,38,Clouds
36757,87,1553382000,13,25,38,Clouds
36758,88,1553382000,25,5,30,Clouds
36759,89,1553382000,31,8,39,Clouds
36760,90,1553382000,39,1,40,Clouds
36761,91,1553382000,8,22,30,Clouds
36762,92,1553382000,10,30,40,Clouds
36763,93,1553382000,2,38,40,Clouds
36764,94,1553382000,30,10,40,Clouds
36765,95,1553382000,31,9,40,Clouds
36766,96,1553382000,30,0,30,Clouds
36767,97,1553382000,28,12,40,Clouds
36768,98,1553382000,17,23,40,Clouds
36769,99,1553382000,29,1,30,Clouds
36770,100,1553382000,7,18,25,Clouds
36771,101,1553382000,23,7,30,Clouds
36772,102,1553382000,18,22,40,Clouds
36773,103,1553382000,38,2,40,Clouds
36774,104,1553382000,27,13,40,Clouds
36775,105,1553382000,24,12,36,Clouds
36776,106,1553382000,31,9,40,Clouds
36777,107,1553382000,21,19,40,Clouds
36778,108,1553382000,36,4,40,Clouds
36779,109,1553382000,22,7,29,Clouds
36780,110,1553382000,39,1,40,Clouds
36781,111,1553382000,31,9,40,Clouds
36782,112,1553382000,25,5,30,Clouds
36783,113,1553382000,22,18,40,Clouds
36784,114,1553382000,37,3,40,Clouds
36785,115,1553382000,12,18,30,Clouds
36786,2,1553385600,17,3,20,Clouds
36787,3,1553385600,5,15,20,Clouds
36788,4,1553385600,13,7,20,Clouds
36789,5,1553385600,15,25,40,Clouds
36790,6,1553385600,3,17,20,Clouds
36791,7,1553385600,11,18,29,Clouds
36792,8,1553385600,10,20,30,Clouds
36793,9,1553385600,16,8,24,Clouds
36794,10,1553385600,4,12,16,Clouds
36795,11,1553385600,28,2,30,Clouds
36796,12,1553385600,14,6,20,Clouds
36797,13,1553385600,26,4,30,Clouds
36798,14,1553385600,1,29,30,Clouds
36799,15,1553385600,15,1,16,Clouds
36800,16,1553385600,17,3,20,Clouds
36801,17,1553385600,12,8,20,Clouds
36802,18,1553385600,9,21,30,Clouds
36803,19,1553385600,9,20,29,Clouds
36804,21,1553385600,19,11,30,Clouds
36805,22,1553385600,15,5,20,Clouds
36806,23,1553385600,6,24,30,Clouds
36807,24,1553385600,6,14,20,Clouds
36808,25,1553385600,29,1,30,Clouds
36809,26,1553385600,2,18,20,Clouds
36810,27,1553385600,4,16,20,Clouds
36811,28,1553385600,26,4,30,Clouds
36812,29,1553385600,0,29,29,Clouds
36813,30,1553385600,18,2,20,Clouds
36814,31,1553385600,17,3,20,Clouds
36815,32,1553385600,15,15,30,Clouds
36816,33,1553385600,17,6,23,Clouds
36817,34,1553385600,16,14,30,Clouds
36818,35,1553385600,12,18,30,Clouds
36819,36,1553385600,24,15,39,Clouds
36820,37,1553385600,26,4,30,Clouds
36821,38,1553385600,23,17,40,Clouds
36822,39,1553385600,11,9,20,Clouds
36823,40,1553385600,13,8,21,Clouds
36824,41,1553385600,15,5,20,Clouds
36825,42,1553385600,8,22,30,Clouds
36826,43,1553385600,20,10,30,Clouds
36827,44,1553385600,26,4,30,Clouds
36828,45,1553385600,2,28,30,Clouds
36829,46,1553385600,7,13,20,Clouds
36830,47,1553385600,37,3,40,Clouds
36831,48,1553385600,36,4,40,Clouds
36832,49,1553385600,37,3,40,Clouds
36833,50,1553385600,31,9,40,Clouds
36834,51,1553385600,33,7,40,Clouds
36835,52,1553385600,23,9,32,Clouds
36836,53,1553385600,26,14,40,Clouds
36837,54,1553385600,25,8,33,Clouds
36838,55,1553385600,33,3,36,Clouds
36839,56,1553385600,26,14,40,Clouds
36840,57,1553385600,23,0,23,Clouds
36841,58,1553385600,39,1,40,Clouds
36842,59,1553385600,14,6,20,Clouds
36843,60,1553385600,17,13,30,Clouds
36844,61,1553385600,20,5,25,Clouds
36845,62,1553385600,21,19,40,Clouds
36846,63,1553385600,5,30,35,Clouds
36847,64,1553385600,21,19,40,Clouds
36848,65,1553385600,40,0,40,Clouds
36849,66,1553385600,34,6,40,Clouds
36850,67,1553385600,27,13,40,Clouds
36851,68,1553385600,36,4,40,Clouds
36852,69,1553385600,22,18,40,Clouds
36853,70,1553385600,22,6,28,Clouds
36854,71,1553385600,9,31,40,Clouds
36855,72,1553385600,4,27,31,Clouds
36856,73,1553385600,25,5,30,Clouds
36857,74,1553385600,11,19,30,Clouds
36858,75,1553385600,29,11,40,Clouds
36859,76,1553385600,10,28,38,Clouds
36860,77,1553385600,9,20,29,Clouds
36861,78,1553385600,37,3,40,Clouds
36862,79,1553385600,19,8,27,Clouds
36863,80,1553385600,24,16,40,Clouds
36864,81,1553385600,31,9,40,Clouds
36865,82,1553385600,20,2,22,Clouds
36866,83,1553385600,23,17,40,Clouds
36867,84,1553385600,30,0,30,Clouds
36868,85,1553385600,33,2,35,Clouds
36869,86,1553385600,20,18,38,Clouds
36870,87,1553385600,12,26,38,Clouds
36871,88,1553385600,27,3,30,Clouds
36872,89,1553385600,31,8,39,Clouds
36873,90,1553385600,39,1,40,Clouds
36874,91,1553385600,16,14,30,Clouds
36875,92,1553385600,7,33,40,Clouds
36876,93,1553385600,2,38,40,Clouds
36877,94,1553385600,30,10,40,Clouds
36878,95,1553385600,30,10,40,Clouds
36879,96,1553385600,30,0,30,Clouds
36880,97,1553385600,28,12,40,Clouds
36881,98,1553385600,15,25,40,Clouds
36882,99,1553385600,29,1,30,Clouds
36883,100,1553385600,8,17,25,Clouds
36884,101,1553385600,23,7,30,Clouds
36885,102,1553385600,18,22,40,Clouds
36886,103,1553385600,38,2,40,Clouds
36887,104,1553385600,27,13,40,Clouds
36888,105,1553385600,24,12,36,Clouds
36889,106,1553385600,33,7,40,Clouds
36890,107,1553385600,23,17,40,Clouds
36891,108,1553385600,35,5,40,Clouds
36892,109,1553385600,20,9,29,Clouds
36893,110,1553385600,38,2,40,Clouds
36894,111,1553385600,28,12,40,Clouds
36895,112,1553385600,23,7,30,Clouds
36896,113,1553385600,23,17,40,Clouds
36897,114,1553385600,37,3,40,Clouds
36898,115,1553385600,7,23,30,Clouds
36899,2,1553389200,17,3,20,Clouds
36900,3,1553389200,4,16,20,Clouds
36901,4,1553389200,12,8,20,Clouds
36902,5,1553389200,17,23,40,Clouds
36903,6,1553389200,6,14,20,Clouds
36904,7,1553389200,11,18,29,Clouds
36905,8,1553389200,10,20,30,Clouds
36906,9,1553389200,15,9,24,Clouds
36907,10,1553389200,3,13,16,Clouds
36908,11,1553389200,28,2,30,Clouds
36909,12,1553389200,17,3,20,Clouds
36910,13,1553389200,27,3,30,Clouds
36911,14,1553389200,10,20,30,Clouds
36912,15,1553389200,15,1,16,Clouds
36913,16,1553389200,17,3,20,Clouds
36914,17,1553389200,12,8,20,Clouds
36915,18,1553389200,9,21,30,Clouds
36916,19,1553389200,14,15,29,Clouds
36917,21,1553389200,21,9,30,Clouds
36918,22,1553389200,18,2,20,Clouds
36919,23,1553389200,9,21,30,Clouds
36920,24,1553389200,5,15,20,Clouds
36921,25,1553389200,29,1,30,Clouds
36922,26,1553389200,2,18,20,Clouds
36923,27,1553389200,6,14,20,Clouds
36924,28,1553389200,25,5,30,Clouds
36925,29,1553389200,2,27,29,Clouds
36926,30,1553389200,18,2,20,Clouds
36927,31,1553389200,17,3,20,Clouds
36928,32,1553389200,13,17,30,Clouds
36929,33,1553389200,21,2,23,Clouds
36930,34,1553389200,17,13,30,Clouds
36931,35,1553389200,15,15,30,Clouds
36932,36,1553389200,28,11,39,Clouds
36933,37,1553389200,26,4,30,Clouds
36934,38,1553389200,23,17,40,Clouds
36935,39,1553389200,16,4,20,Clouds
36936,40,1553389200,9,12,21,Clouds
36937,41,1553389200,13,7,20,Clouds
36938,42,1553389200,11,19,30,Clouds
36939,43,1553389200,16,14,30,Clouds
36940,44,1553389200,22,8,30,Clouds
36941,45,1553389200,2,28,30,Clouds
36942,46,1553389200,8,12,20,Clouds
36943,47,1553389200,40,0,40,Clouds
36944,48,1553389200,35,5,40,Clouds
36945,49,1553389200,37,3,40,Clouds
36946,50,1553389200,31,9,40,Clouds
36947,51,1553389200,33,7,40,Clouds
36948,52,1553389200,22,10,32,Clouds
36949,53,1553389200,25,15,40,Clouds
36950,54,1553389200,24,9,33,Clouds
36951,55,1553389200,33,3,36,Clouds
36952,56,1553389200,27,13,40,Clouds
36953,57,1553389200,23,0,23,Clouds
36954,58,1553389200,34,6,40,Clouds
36955,59,1553389200,14,6,20,Clouds
36956,60,1553389200,12,18,30,Clouds
36957,61,1553389200,22,3,25,Clouds
36958,62,1553389200,23,17,40,Clouds
36959,63,1553389200,9,26,35,Clouds
36960,64,1553389200,22,18,40,Clouds
36961,65,1553389200,40,0,40,Clouds
36962,66,1553389200,29,11,40,Clouds
36963,67,1553389200,26,14,40,Clouds
36964,68,1553389200,38,2,40,Clouds
36965,69,1553389200,21,19,40,Clouds
36966,70,1553389200,19,9,28,Clouds
36967,71,1553389200,9,31,40,Clouds
36968,72,1553389200,1,30,31,Clouds
36969,73,1553389200,24,6,30,Clouds
36970,74,1553389200,12,18,30,Clouds
36971,75,1553389200,28,12,40,Clouds
36972,76,1553389200,10,28,38,Clouds
36973,77,1553389200,8,21,29,Clouds
36974,78,1553389200,36,4,40,Clouds
36975,79,1553389200,19,8,27,Clouds
36976,80,1553389200,23,17,40,Clouds
36977,81,1553389200,32,8,40,Clouds
36978,82,1553389200,19,3,22,Clouds
36979,83,1553389200,24,16,40,Clouds
36980,84,1553389200,27,3,30,Clouds
36981,85,1553389200,32,3,35,Clouds
36982,86,1553389200,22,16,38,Clouds
36983,87,1553389200,11,27,38,Clouds
36984,88,1553389200,27,3,30,Clouds
36985,89,1553389200,32,7,39,Clouds
36986,90,1553389200,39,1,40,Clouds
36987,91,1553389200,13,17,30,Clouds
36988,92,1553389200,5,35,40,Clouds
36989,93,1553389200,2,38,40,Clouds
36990,94,1553389200,30,10,40,Clouds
36991,95,1553389200,27,13,40,Clouds
36992,96,1553389200,29,1,30,Clouds
36993,97,1553389200,28,12,40,Clouds
36994,98,1553389200,15,25,40,Clouds
36995,99,1553389200,29,1,30,Clouds
36996,100,1553389200,8,17,25,Clouds
36997,101,1553389200,23,7,30,Clouds
36998,102,1553389200,18,22,40,Clouds
36999,103,1553389200,39,1,40,Clouds
37000,104,1553389200,27,13,40,Clouds
37001,105,1553389200,24,12,36,Clouds
37002,106,1553389200,31,9,40,Clouds
37003,107,1553389200,20,20,40,Clouds
37004,108,1553389200,32,8,40,Clouds
37005,109,1553389200,16,13,29,Clouds
37006,110,1553389200,40,0,40,Clouds
37007,111,1553389200,24,16,40,Clouds
37008,112,1553389200,19,11,30,Clouds
37009,113,1553389200,23,17,40,Clouds
37010,114,1553389200,37,3,40,Clouds
37011,115,1553389200,6,24,30,Clouds
37012,2,1553392800,16,4,20,Clouds
37013,3,1553392800,4,16,20,Clouds
37014,4,1553392800,13,7,20,Clouds
37015,5,1553392800,18,22,40,Clouds
37016,6,1553392800,9,11,20,Clouds
37017,7,1553392800,12,17,29,Clouds
37018,8,1553392800,10,20,30,Clouds
37019,9,1553392800,22,2,24,Clouds
37020,10,1553392800,3,13,16,Clouds
37021,11,1553392800,29,1,30,Clouds
37022,12,1553392800,17,3,20,Clouds
37023,13,1553392800,27,3,30,Clouds
37024,14,1553392800,12,18,30,Clouds
37025,15,1553392800,15,1,16,Clouds
37026,16,1553392800,17,3,20,Clouds
37027,17,1553392800,13,7,20,Clouds
37028,18,1553392800,11,19,30,Clouds
37029,19,1553392800,13,16,29,Clouds
37030,21,1553392800,21,9,30,Clouds
37031,22,1553392800,15,5,20,Clouds
37032,23,1553392800,10,20,30,Clouds
37033,24,1553392800,5,15,20,Clouds
37034,25,1553392800,29,1,30,Clouds
37035,26,1553392800,3,17,20,Clouds
37036,27,1553392800,9,11,20,Clouds
37037,28,1553392800,24,6,30,Clouds
37038,29,1553392800,3,26,29,Clouds
37039,30,1553392800,18,2,20,Clouds
37040,31,1553392800,18,2,20,Clouds
37041,32,1553392800,15,15,30,Clouds
37042,33,1553392800,18,5,23,Clouds
37043,34,1553392800,18,12,30,Clouds
37044,35,1553392800,14,16,30,Clouds
37045,36,1553392800,28,11,39,Clouds
37046,37,1553392800,26,4,30,Clouds
37047,38,1553392800,25,15,40,Clouds
37048,39,1553392800,20,0,20,Clouds
37049,40,1553392800,8,13,21,Clouds
37050,41,1553392800,13,7,20,Clouds
37051,42,1553392800,10,20,30,Clouds
37052,43,1553392800,13,17,30,Clouds
37053,44,1553392800,20,10,30,Clouds
37054,45,1553392800,2,28,30,Clouds
37055,46,1553392800,8,12,20,Clouds
37056,47,1553392800,39,1,40,Clouds
37057,48,1553392800,34,6,40,Clouds
37058,49,1553392800,36,4,40,Clouds
37059,50,1553392800,30,10,40,Clouds
37060,51,1553392800,34,6,40,Clouds
37061,52,1553392800,23,9,32,Clouds
37062,53,1553392800,25,15,40,Clouds
37063,54,1553392800,23,10,33,Clouds
37064,55,1553392800,34,2,36,Clouds
37065,56,1553392800,26,14,40,Clouds
37066,57,1553392800,22,1,23,Clouds
37067,58,1553392800,33,7,40,Clouds
37068,59,1553392800,14,6,20,Clouds
37069,60,1553392800,12,18,30,Clouds
37070,61,1553392800,22,3,25,Clouds
37071,62,1553392800,22,18,40,Clouds
37072,63,1553392800,9,26,35,Clouds
37073,64,1553392800,22,18,40,Clouds
37074,65,1553392800,40,0,40,Clouds
37075,66,1553392800,28,12,40,Clouds
37076,67,1553392800,25,15,40,Clouds
37077,68,1553392800,38,2,40,Clouds
37078,69,1553392800,19,21,40,Clouds
37079,70,1553392800,17,11,28,Clouds
37080,71,1553392800,9,31,40,Clouds
37081,72,1553392800,0,31,31,Clouds
37082,73,1553392800,23,7,30,Clouds
37083,74,1553392800,11,19,30,Clouds
37084,75,1553392800,28,12,40,Clouds
37085,76,1553392800,10,28,38,Clouds
37086,77,1553392800,8,21,29,Clouds
37087,78,1553392800,34,6,40,Clouds
37088,79,1553392800,19,8,27,Clouds
37089,80,1553392800,23,17,40,Clouds
37090,81,1553392800,32,8,40,Clouds
37091,82,1553392800,19,3,22,Clouds
37092,83,1553392800,24,16,40,Clouds
37093,84,1553392800,26,4,30,Clouds
37094,85,1553392800,30,5,35,Clouds
37095,86,1553392800,23,15,38,Clouds
37096,87,1553392800,10,28,38,Clouds
37097,88,1553392800,26,4,30,Clouds
37098,89,1553392800,32,7,39,Clouds
37099,90,1553392800,39,1,40,Clouds
37100,91,1553392800,12,18,30,Clouds
37101,92,1553392800,5,35,40,Clouds
37102,93,1553392800,2,38,40,Clouds
37103,94,1553392800,30,10,40,Clouds
37104,95,1553392800,28,12,40,Clouds
37105,96,1553392800,28,2,30,Clouds
37106,97,1553392800,27,13,40,Clouds
37107,98,1553392800,15,25,40,Clouds
37108,99,1553392800,29,1,30,Clouds
37109,100,1553392800,8,17,25,Clouds
37110,101,1553392800,23,7,30,Clouds
37111,102,1553392800,18,22,40,Clouds
37112,103,1553392800,39,1,40,Clouds
37113,104,1553392800,27,13,40,Clouds
37114,105,1553392800,24,12,36,Clouds
37115,106,1553392800,30,10,40,Clouds
37116,107,1553392800,18,22,40,Clouds
37117,108,1553392800,30,10,40,Clouds
37118,109,1553392800,15,14,29,Clouds
37119,110,1553392800,39,1,40,Clouds
37120,111,1553392800,25,15,40,Clouds
37121,112,1553392800,18,12,30,Clouds
37122,113,1553392800,23,17,40,Clouds
37123,114,1553392800,40,0,40,Clouds
37124,115,1553392800,4,26,30,Clouds
37125,2,1553396400,16,4,20,Clouds
37126,3,1553396400,4,16,20,Clouds
37127,4,1553396400,13,7,20,Clouds
37128,5,1553396400,18,22,40,Clouds
37129,6,1553396400,8,12,20,Clouds
37130,7,1553396400,12,17,29,Clouds
37131,8,1553396400,10,20,30,Clouds
37132,9,1553396400,22,2,24,Clouds
37133,10,1553396400,3,13,16,Clouds
37134,11,1553396400,29,1,30,Clouds
37135,12,1553396400,17,3,20,Clouds
37136,13,1553396400,27,3,30,Clouds
37137,14,1553396400,12,18,30,Clouds
37138,15,1553396400,15,1,16,Clouds
37139,16,1553396400,17,3,20,Clouds
37140,17,1553396400,13,7,20,Clouds
37141,18,1553396400,11,19,30,Clouds
37142,19,1553396400,13,16,29,Clouds
37143,21,1553396400,21,9,30,Clouds
37144,22,1553396400,15,5,20,Clouds
37145,23,1553396400,10,20,30,Clouds
37146,24,1553396400,5,15,20,Clouds
37147,25,1553396400,29,1,30,Clouds
37148,26,1553396400,3,17,20,Clouds
37149,27,1553396400,9,11,20,Clouds
37150,28,1553396400,23,7,30,Clouds
37151,29,1553396400,1,28,29,Clouds
37152,30,1553396400,18,2,20,Clouds
37153,31,1553396400,18,2,20,Clouds
37154,32,1553396400,15,15,30,Clouds
37155,33,1553396400,17,6,23,Clouds
37156,34,1553396400,18,12,30,Clouds
37157,35,1553396400,14,16,30,Clouds
37158,36,1553396400,28,11,39,Clouds
37159,37,1553396400,26,4,30,Clouds
37160,38,1553396400,25,15,40,Clouds
37161,39,1553396400,20,0,20,Clouds
37162,40,1553396400,8,13,21,Clouds
37163,41,1553396400,13,7,20,Clouds
37164,42,1553396400,10,20,30,Clouds
37165,43,1553396400,13,17,30,Clouds
37166,44,1553396400,20,10,30,Clouds
37167,45,1553396400,2,28,30,Clouds
37168,46,1553396400,8,12,20,Clouds
37169,47,1553396400,39,1,40,Clouds
37170,48,1553396400,34,6,40,Clouds
37171,49,1553396400,36,4,40,Clouds
37172,50,1553396400,30,10,40,Clouds
37173,51,1553396400,34,6,40,Clouds
37174,52,1553396400,23,9,32,Clouds
37175,53,1553396400,25,15,40,Clouds
37176,54,1553396400,23,10,33,Clouds
37177,55,1553396400,34,2,36,Clouds
37178,56,1553396400,26,14,40,Clouds
37179,57,1553396400,22,1,23,Clouds
37180,58,1553396400,32,8,40,Clouds
37181,59,1553396400,14,6,20,Clouds
37182,60,1553396400,12,18,30,Clouds
37183,61,1553396400,22,3,25,Clouds
37184,62,1553396400,22,18,40,Clouds
37185,63,1553396400,9,26,35,Clouds
37186,64,1553396400,22,18,40,Clouds
37187,65,1553396400,40,0,40,Clouds
37188,66,1553396400,28,12,40,Clouds
37189,67,1553396400,25,15,40,Clouds
37190,68,1553396400,38,2,40,Clouds
37191,69,1553396400,19,21,40,Clouds
37192,70,1553396400,17,11,28,Clouds
37193,71,1553396400,9,31,40,Clouds
37194,72,1553396400,0,31,31,Clouds
37195,73,1553396400,23,7,30,Clouds
37196,74,1553396400,11,19,30,Clouds
37197,75,1553396400,28,12,40,Clouds
37198,76,1553396400,10,28,38,Clouds
37199,77,1553396400,8,21,29,Clouds
37200,78,1553396400,34,6,40,Clouds
37201,79,1553396400,19,8,27,Clouds
37202,80,1553396400,23,17,40,Clouds
37203,81,1553396400,32,8,40,Clouds
37204,82,1553396400,18,4,22,Clouds
37205,83,1553396400,24,16,40,Clouds
37206,84,1553396400,25,5,30,Clouds
37207,85,1553396400,30,5,35,Clouds
37208,86,1553396400,23,15,38,Clouds
37209,87,1553396400,10,28,38,Clouds
37210,88,1553396400,26,4,30,Clouds
37211,89,1553396400,32,7,39,Clouds
37212,90,1553396400,39,1,40,Clouds
37213,91,1553396400,12,18,30,Clouds
37214,92,1553396400,5,35,40,Clouds
37215,93,1553396400,2,38,40,Clouds
37216,94,1553396400,30,10,40,Clouds
37217,95,1553396400,28,12,40,Clouds
37218,96,1553396400,28,2,30,Clouds
37219,97,1553396400,27,13,40,Clouds
37220,98,1553396400,15,25,40,Clouds
37221,99,1553396400,29,1,30,Clouds
37222,100,1553396400,8,17,25,Clouds
37223,101,1553396400,23,7,30,Clouds
37224,102,1553396400,18,22,40,Clouds
37225,103,1553396400,39,1,40,Clouds
37226,104,1553396400,27,13,40,Clouds
37227,105,1553396400,24,12,36,Clouds
37228,106,1553396400,30,10,40,Clouds
37229,107,1553396400,18,22,40,Clouds
37230,108,1553396400,30,10,40,Clouds
37231,109,1553396400,15,14,29,Clouds
37232,110,1553396400,39,1,40,Clouds
37233,111,1553396400,25,15,40,Clouds
37234,112,1553396400,18,12,30,Clouds
37235,113,1553396400,23,17,40,Clouds
37236,114,1553396400,40,0,40,Clouds
37237,115,1553396400,4,26,30,Clouds
37238,2,1553400000,16,4,20,Clouds
37239,3,1553400000,4,16,20,Clouds
37240,4,1553400000,13,7,20,Clouds
37241,5,1553400000,18,22,40,Clouds
37242,6,1553400000,8,12,20,Clouds
37243,7,1553400000,12,17,29,Clouds
37244,8,1553400000,10,20,30,Clouds
37245,9,1553400000,22,2,24,Clouds
37246,10,1553400000,3,13,16,Clouds
37247,11,1553400000,29,1,30,Clouds
37248,12,1553400000,17,3,20,Clouds
37249,13,1553400000,27,3,30,Clouds
37250,14,1553400000,12,18,30,Clouds
37251,15,1553400000,15,1,16,Clouds
37252,16,1553400000,17,3,20,Clouds
37253,17,1553400000,13,7,20,Clouds
37254,18,1553400000,11,19,30,Clouds
37255,19,1553400000,13,16,29,Clouds
37256,21,1553400000,21,9,30,Clouds
37257,22,1553400000,15,5,20,Clouds
37258,23,1553400000,10,20,30,Clouds
37259,24,1553400000,5,15,20,Clouds
37260,25,1553400000,29,1,30,Clouds
37261,26,1553400000,3,17,20,Clouds
37262,27,1553400000,9,11,20,Clouds
37263,28,1553400000,23,7,30,Clouds
37264,29,1553400000,1,28,29,Clouds
37265,30,1553400000,18,2,20,Clouds
37266,31,1553400000,18,2,20,Clouds
37267,32,1553400000,15,15,30,Clouds
37268,33,1553400000,17,6,23,Clouds
37269,34,1553400000,18,12,30,Clouds
37270,35,1553400000,14,16,30,Clouds
37271,36,1553400000,28,11,39,Clouds
37272,37,1553400000,26,4,30,Clouds
37273,38,1553400000,25,15,40,Clouds
37274,39,1553400000,20,0,20,Clouds
37275,40,1553400000,8,13,21,Clouds
37276,41,1553400000,13,7,20,Clouds
37277,42,1553400000,10,20,30,Clouds
37278,43,1553400000,13,17,30,Clouds
37279,44,1553400000,19,11,30,Clouds
37280,45,1553400000,2,28,30,Clouds
37281,46,1553400000,8,12,20,Clouds
37282,47,1553400000,39,1,40,Clouds
37283,48,1553400000,34,6,40,Clouds
37284,49,1553400000,36,4,40,Clouds
37285,50,1553400000,30,10,40,Clouds
37286,51,1553400000,34,6,40,Clouds
37287,52,1553400000,23,9,32,Clouds
37288,53,1553400000,25,15,40,Clouds
37289,54,1553400000,23,10,33,Clouds
37290,55,1553400000,34,2,36,Clouds
37291,56,1553400000,26,14,40,Clouds
37292,57,1553400000,22,1,23,Clouds
37293,58,1553400000,32,8,40,Clouds
37294,59,1553400000,14,6,20,Clouds
37295,60,1553400000,12,18,30,Clouds
37296,61,1553400000,22,3,25,Clouds
37297,62,1553400000,22,18,40,Clouds
37298,63,1553400000,9,26,35,Clouds
37299,64,1553400000,22,18,40,Clouds
37300,65,1553400000,40,0,40,Clouds
37301,66,1553400000,28,12,40,Clouds
37302,67,1553400000,25,15,40,Clouds
37303,68,1553400000,38,2,40,Clouds
37304,69,1553400000,19,21,40,Clouds
37305,70,1553400000,17,11,28,Clouds
37306,71,1553400000,9,31,40,Clouds
37307,72,1553400000,0,31,31,Clouds
37308,73,1553400000,23,7,30,Clouds
37309,74,1553400000,11,19,30,Clouds
37310,75,1553400000,28,12,40,Clouds
37311,76,1553400000,10,28,38,Clouds
37312,77,1553400000,8,21,29,Clouds
37313,78,1553400000,34,6,40,Clouds
37314,79,1553400000,19,8,27,Clouds
37315,80,1553400000,23,17,40,Clouds
37316,81,1553400000,32,8,40,Clouds
37317,82,1553400000,18,4,22,Clouds
37318,83,1553400000,24,16,40,Clouds
37319,84,1553400000,25,5,30,Clouds
37320,85,1553400000,30,5,35,Clouds
37321,86,1553400000,23,15,38,Clouds
37322,87,1553400000,10,28,38,Clouds
37323,88,1553400000,26,4,30,Clouds
37324,89,1553400000,32,7,39,Clouds
37325,90,1553400000,39,1,40,Clouds
37326,91,1553400000,12,18,30,Clouds
37327,92,1553400000,5,35,40,Clouds
37328,93,1553400000,2,38,40,Clouds
37329,94,1553400000,30,10,40,Clouds
37330,95,1553400000,28,12,40,Clouds
37331,96,1553400000,28,2,30,Clouds
37332,97,1553400000,27,13,40,Clouds
37333,98,1553400000,15,25,40,Clouds
37334,99,1553400000,29,1,30,Clouds
37335,100,1553400000,8,17,25,Clouds
37336,101,1553400000,23,7,30,Clouds
37337,102,1553400000,18,22,40,Clouds
37338,103,1553400000,39,1,40,Clouds
37339,104,1553400000,27,13,40,Clouds
37340,105,1553400000,24,12,36,Clouds
37341,106,1553400000,30,10,40,Clouds
37342,107,1553400000,18,22,40,Clouds
37343,108,1553400000,30,10,40,Clouds
37344,109,1553400000,15,14,29,Clouds
37345,110,1553400000,39,1,40,Clouds
37346,111,1553400000,25,15,40,Clouds
37347,112,1553400000,18,12,30,Clouds
37348,113,1553400000,23,17,40,Clouds
37349,114,1553400000,40,0,40,Clouds
37350,115,1553400000,4,26,30,Clouds
37351,2,1553403600,16,4,20,Clouds
37352,3,1553403600,4,16,20,Clouds
37353,4,1553403600,13,7,20,Clouds
37354,5,1553403600,18,22,40,Clouds
37355,6,1553403600,8,12,20,Clouds
37356,7,1553403600,12,17,29,Clouds
37357,8,1553403600,10,20,30,Clouds
37358,9,1553403600,22,2,24,Clouds
37359,10,1553403600,3,13,16,Clouds
37360,11,1553403600,29,1,30,Clouds
37361,12,1553403600,17,3,20,Clouds
37362,13,1553403600,27,3,30,Clouds
37363,14,1553403600,12,18,30,Clouds
37364,15,1553403600,15,1,16,Clouds
37365,16,1553403600,17,3,20,Clouds
37366,17,1553403600,13,7,20,Clouds
37367,18,1553403600,11,19,30,Clouds
37368,19,1553403600,13,16,29,Clouds
37369,21,1553403600,21,9,30,Clouds
37370,22,1553403600,15,5,20,Clouds
37371,23,1553403600,10,20,30,Clouds
37372,24,1553403600,5,15,20,Clouds
37373,25,1553403600,29,1,30,Clouds
37374,26,1553403600,3,17,20,Clouds
37375,27,1553403600,9,11,20,Clouds
37376,28,1553403600,23,7,30,Clouds
37377,29,1553403600,1,28,29,Clouds
37378,30,1553403600,18,2,20,Clouds
37379,31,1553403600,18,2,20,Clouds
37380,32,1553403600,15,15,30,Clouds
37381,33,1553403600,17,6,23,Clouds
37382,34,1553403600,18,12,30,Clouds
37383,35,1553403600,14,16,30,Clouds
37384,36,1553403600,28,11,39,Clouds
37385,37,1553403600,26,4,30,Clouds
37386,38,1553403600,25,15,40,Clouds
37387,39,1553403600,20,0,20,Clouds
37388,40,1553403600,8,13,21,Clouds
37389,41,1553403600,13,7,20,Clouds
37390,42,1553403600,10,20,30,Clouds
37391,43,1553403600,13,17,30,Clouds
37392,44,1553403600,19,11,30,Clouds
37393,45,1553403600,2,28,30,Clouds
37394,46,1553403600,8,12,20,Clouds
37395,47,1553403600,39,1,40,Clouds
37396,48,1553403600,34,6,40,Clouds
37397,49,1553403600,36,4,40,Clouds
37398,50,1553403600,30,10,40,Clouds
37399,51,1553403600,34,6,40,Clouds
37400,52,1553403600,23,9,32,Clouds
37401,53,1553403600,25,15,40,Clouds
37402,54,1553403600,23,10,33,Clouds
37403,55,1553403600,34,2,36,Clouds
37404,56,1553403600,26,14,40,Clouds
37405,57,1553403600,22,1,23,Clouds
37406,58,1553403600,32,8,40,Clouds
37407,59,1553403600,14,6,20,Clouds
37408,60,1553403600,12,18,30,Clouds
37409,61,1553403600,22,3,25,Clouds
37410,62,1553403600,22,18,40,Clouds
37411,63,1553403600,9,26,35,Clouds
37412,64,1553403600,22,18,40,Clouds
37413,65,1553403600,40,0,40,Clouds
37414,66,1553403600,28,12,40,Clouds
37415,67,1553403600,25,15,40,Clouds
37416,68,1553403600,38,2,40,Clouds
37417,69,1553403600,19,21,40,Clouds
37418,70,1553403600,17,11,28,Clouds
37419,71,1553403600,9,31,40,Clouds
37420,72,1553403600,0,31,31,Clouds
37421,73,1553403600,23,7,30,Clouds
37422,74,1553403600,11,19,30,Clouds
37423,75,1553403600,28,12,40,Clouds
37424,76,1553403600,10,28,38,Clouds
37425,77,1553403600,8,21,29,Clouds
37426,78,1553403600,34,6,40,Clouds
37427,79,1553403600,19,8,27,Clouds
37428,80,1553403600,23,17,40,Clouds
37429,81,1553403600,32,8,40,Clouds
37430,82,1553403600,18,4,22,Clouds
37431,83,1553403600,24,16,40,Clouds
37432,84,1553403600,25,5,30,Clouds
37433,85,1553403600,30,5,35,Clouds
37434,86,1553403600,23,15,38,Clouds
37435,87,1553403600,10,28,38,Clouds
37436,88,1553403600,26,4,30,Clouds
37437,89,1553403600,32,7,39,Clouds
37438,90,1553403600,39,1,40,Clouds
37439,91,1553403600,12,18,30,Clouds
37440,92,1553403600,5,35,40,Clouds
37441,93,1553403600,2,38,40,Clouds
37442,94,1553403600,30,10,40,Clouds
37443,95,1553403600,28,12,40,Clouds
37444,96,1553403600,28,2,30,Clouds
37445,97,1553403600,27,13,40,Clouds
37446,98,1553403600,15,25,40,Clouds
37447,99,1553403600,29,1,30,Clouds
37448,100,1553403600,8,17,25,Clouds
37449,101,1553403600,23,7,30,Clouds
37450,102,1553403600,18,22,40,Clouds
37451,103,1553403600,39,1,40,Clouds
37452,104,1553403600,27,13,40,Clouds
37453,105,1553403600,24,12,36,Clouds
37454,106,1553403600,30,10,40,Clouds
37455,107,1553403600,18,22,40,Clouds
37456,108,1553403600,30,10,40,Clouds
37457,109,1553403600,15,14,29,Clouds
37458,110,1553403600,39,1,40,Clouds
37459,111,1553403600,25,15,40,Clouds
37460,112,1553403600,18,12,30,Clouds
37461,113,1553403600,23,17,40,Clouds
37462,114,1553403600,40,0,40,Clouds
37463,115,1553403600,4,26,30,Clouds
37464,2,1553407200,16,4,20,Clouds
37465,3,1553407200,4,16,20,Clouds
37466,4,1553407200,13,7,20,Clouds
37467,5,1553407200,18,22,40,Clouds
37468,6,1553407200,8,12,20,Clouds
37469,7,1553407200,12,17,29,Clouds
37470,8,1553407200,10,20,30,Clouds
37471,9,1553407200,22,2,24,Clouds
37472,10,1553407200,3,13,16,Clouds
37473,11,1553407200,29,1,30,Clouds
37474,12,1553407200,17,3,20,Clouds
37475,13,1553407200,27,3,30,Clouds
37476,14,1553407200,12,18,30,Clouds
37477,15,1553407200,15,1,16,Clouds
37478,16,1553407200,17,3,20,Clouds
37479,17,1553407200,13,7,20,Clouds
37480,18,1553407200,11,19,30,Clouds
37481,19,1553407200,13,16,29,Clouds
37482,21,1553407200,21,9,30,Clouds
37483,22,1553407200,15,5,20,Clouds
37484,23,1553407200,10,20,30,Clouds
37485,24,1553407200,5,15,20,Clouds
37486,25,1553407200,29,1,30,Clouds
37487,26,1553407200,3,17,20,Clouds
37488,27,1553407200,9,11,20,Clouds
37489,28,1553407200,23,7,30,Clouds
37490,29,1553407200,1,28,29,Clouds
37491,30,1553407200,18,2,20,Clouds
37492,31,1553407200,18,2,20,Clouds
37493,32,1553407200,15,15,30,Clouds
37494,33,1553407200,17,6,23,Clouds
37495,34,1553407200,18,12,30,Clouds
37496,35,1553407200,14,16,30,Clouds
37497,36,1553407200,28,11,39,Clouds
37498,37,1553407200,26,4,30,Clouds
37499,38,1553407200,25,15,40,Clouds
37500,39,1553407200,20,0,20,Clouds
37501,40,1553407200,8,13,21,Clouds
37502,41,1553407200,13,7,20,Clouds
37503,42,1553407200,10,20,30,Clouds
37504,43,1553407200,13,17,30,Clouds
37505,44,1553407200,19,11,30,Clouds
37506,45,1553407200,2,28,30,Clouds
37507,46,1553407200,8,12,20,Clouds
37508,47,1553407200,39,1,40,Clouds
37509,48,1553407200,34,6,40,Clouds
37510,49,1553407200,36,4,40,Clouds
37511,50,1553407200,30,10,40,Clouds
37512,51,1553407200,34,6,40,Clouds
37513,52,1553407200,23,9,32,Clouds
37514,53,1553407200,25,15,40,Clouds
37515,54,1553407200,23,10,33,Clouds
37516,55,1553407200,34,2,36,Clouds
37517,56,1553407200,26,14,40,Clouds
37518,57,1553407200,22,1,23,Clouds
37519,58,1553407200,32,8,40,Clouds
37520,59,1553407200,14,6,20,Clouds
37521,60,1553407200,12,18,30,Clouds
37522,61,1553407200,22,3,25,Clouds
37523,62,1553407200,22,18,40,Clouds
37524,63,1553407200,9,26,35,Clouds
37525,64,1553407200,22,18,40,Clouds
37526,65,1553407200,40,0,40,Clouds
37527,66,1553407200,28,12,40,Clouds
37528,67,1553407200,25,15,40,Clouds
37529,68,1553407200,38,2,40,Clouds
37530,69,1553407200,19,21,40,Clouds
37531,70,1553407200,17,11,28,Clouds
37532,71,1553407200,9,31,40,Clouds
37533,72,1553407200,0,31,31,Clouds
37534,73,1553407200,23,7,30,Clouds
37535,74,1553407200,11,19,30,Clouds
37536,75,1553407200,28,12,40,Clouds
37537,76,1553407200,10,28,38,Clouds
37538,77,1553407200,8,21,29,Clouds
37539,78,1553407200,34,6,40,Clouds
37540,79,1553407200,19,8,27,Clouds
37541,80,1553407200,23,17,40,Clouds
37542,81,1553407200,32,8,40,Clouds
37543,82,1553407200,18,4,22,Clouds
37544,83,1553407200,24,16,40,Clouds
37545,84,1553407200,25,5,30,Clouds
37546,85,1553407200,30,5,35,Clouds
37547,86,1553407200,23,15,38,Clouds
37548,87,1553407200,10,28,38,Clouds
37549,88,1553407200,26,4,30,Clouds
37550,89,1553407200,32,7,39,Clouds
37551,90,1553407200,39,1,40,Clouds
37552,91,1553407200,12,18,30,Clouds
37553,92,1553407200,5,35,40,Clouds
37554,93,1553407200,2,38,40,Clouds
37555,94,1553407200,30,10,40,Clouds
37556,95,1553407200,28,12,40,Clouds
37557,96,1553407200,28,2,30,Clouds
37558,97,1553407200,27,13,40,Clouds
37559,99,1553407200,29,1,30,Clouds
37560,100,1553407200,8,17,25,Clouds
37561,101,1553407200,23,7,30,Clouds
37562,102,1553407200,18,22,40,Clouds
37563,103,1553407200,39,1,40,Clouds
37564,104,1553407200,27,13,40,Clouds
37565,105,1553407200,24,12,36,Clouds
37566,106,1553407200,30,10,40,Clouds
37567,107,1553407200,18,22,40,Clouds
37568,108,1553407200,30,10,40,Clouds
37569,109,1553407200,15,14,29,Clouds
37570,110,1553407200,39,1,40,Clouds
37571,111,1553407200,25,15,40,Clouds
37572,112,1553407200,18,12,30,Clouds
37573,113,1553407200,23,17,40,Clouds
37574,114,1553407200,40,0,40,Clouds
37575,115,1553407200,4,26,30,Clouds
37576,2,1553410800,15,5,20,Clouds
37577,3,1553410800,5,15,20,Clouds
37578,4,1553410800,13,7,20,Clouds
37579,5,1553410800,18,22,40,Clouds
37580,6,1553410800,9,11,20,Clouds
37581,7,1553410800,12,17,29,Clouds
37582,8,1553410800,11,19,30,Clouds
37583,9,1553410800,23,1,24,Clouds
37584,10,1553410800,3,13,16,Clouds
37585,11,1553410800,28,2,30,Clouds
37586,12,1553410800,17,3,20,Clouds
37587,13,1553410800,27,3,30,Clouds
37588,14,1553410800,13,17,30,Clouds
37589,15,1553410800,14,2,16,Clouds
37590,16,1553410800,17,3,20,Clouds
37591,17,1553410800,13,7,20,Clouds
37592,18,1553410800,10,20,30,Clouds
37593,19,1553410800,12,17,29,Clouds
37594,21,1553410800,22,8,30,Clouds
37595,22,1553410800,13,7,20,Clouds
37596,23,1553410800,9,21,30,Clouds
37597,24,1553410800,1,19,20,Clouds
37598,25,1553410800,29,1,30,Clouds
37599,26,1553410800,3,17,20,Clouds
37600,27,1553410800,10,10,20,Clouds
37601,28,1553410800,23,7,30,Clouds
37602,29,1553410800,0,29,29,Clouds
37603,30,1553410800,18,2,20,Clouds
37604,31,1553410800,20,0,20,Clouds
37605,32,1553410800,15,15,30,Clouds
37606,33,1553410800,18,5,23,Clouds
37607,34,1553410800,19,11,30,Clouds
37608,35,1553410800,13,17,30,Clouds
37609,36,1553410800,28,12,40,Clouds
37610,37,1553410800,26,4,30,Clouds
37611,38,1553410800,26,14,40,Clouds
37612,39,1553410800,20,0,20,Clouds
37613,40,1553410800,8,13,21,Clouds
37614,41,1553410800,13,7,20,Clouds
37615,42,1553410800,10,20,30,Clouds
37616,43,1553410800,13,17,30,Clouds
37617,44,1553410800,20,10,30,Clouds
37618,45,1553410800,1,29,30,Clouds
37619,46,1553410800,8,12,20,Clouds
37620,47,1553410800,40,0,40,Clouds
37621,48,1553410800,33,7,40,Clouds
37622,49,1553410800,36,4,40,Clouds
37623,50,1553410800,29,11,40,Clouds
37624,51,1553410800,34,6,40,Clouds
37625,52,1553410800,23,9,32,Clouds
37626,53,1553410800,25,15,40,Clouds
37627,54,1553410800,25,8,33,Clouds
37628,55,1553410800,34,2,36,Clouds
37629,56,1553410800,26,14,40,Clouds
37630,57,1553410800,22,1,23,Clouds
37631,58,1553410800,31,9,40,Clouds
37632,59,1553410800,14,6,20,Clouds
37633,60,1553410800,12,18,30,Clouds
37634,61,1553410800,22,3,25,Clouds
37635,62,1553410800,22,18,40,Clouds
37636,63,1553410800,9,26,35,Clouds
37637,64,1553410800,22,18,40,Clouds
37638,65,1553410800,40,0,40,Clouds
37639,66,1553410800,29,11,40,Clouds
37640,67,1553410800,24,16,40,Clouds
37641,68,1553410800,37,3,40,Clouds
37642,69,1553410800,19,21,40,Clouds
37643,70,1553410800,17,11,28,Clouds
37644,71,1553410800,9,31,40,Clouds
37645,72,1553410800,0,31,31,Clouds
37646,73,1553410800,24,6,30,Clouds
37647,74,1553410800,12,18,30,Clouds
37648,75,1553410800,29,11,40,Clouds
37649,76,1553410800,11,27,38,Clouds
37650,77,1553410800,8,21,29,Clouds
37651,78,1553410800,35,5,40,Clouds
37652,79,1553410800,19,8,27,Clouds
37653,80,1553410800,23,17,40,Clouds
37654,81,1553410800,32,8,40,Clouds
37655,82,1553410800,19,3,22,Clouds
37656,83,1553410800,24,16,40,Clouds
37657,84,1553410800,24,6,30,Clouds
37658,85,1553410800,30,5,35,Clouds
37659,86,1553410800,23,15,38,Clouds
37660,87,1553410800,10,28,38,Clouds
37661,88,1553410800,26,4,30,Clouds
37662,89,1553410800,32,7,39,Clouds
37663,90,1553410800,39,1,40,Clouds
37664,91,1553410800,12,18,30,Clouds
37665,92,1553410800,5,35,40,Clouds
37666,93,1553410800,2,38,40,Clouds
37667,94,1553410800,30,10,40,Clouds
37668,95,1553410800,28,12,40,Clouds
37669,96,1553410800,28,2,30,Clouds
37670,97,1553410800,27,13,40,Clouds
37671,99,1553410800,29,1,30,Clouds
37672,100,1553410800,8,17,25,Clouds
37673,101,1553410800,23,7,30,Clouds
37674,102,1553410800,18,22,40,Clouds
37675,103,1553410800,39,1,40,Clouds
37676,104,1553410800,27,13,40,Clouds
37677,105,1553410800,24,12,36,Clouds
37678,106,1553410800,30,10,40,Clouds
37679,107,1553410800,18,22,40,Clouds
37680,108,1553410800,31,9,40,Clouds
37681,109,1553410800,15,14,29,Clouds
37682,110,1553410800,39,1,40,Clouds
37683,111,1553410800,26,14,40,Clouds
37684,112,1553410800,19,11,30,Clouds
37685,113,1553410800,23,17,40,Clouds
37686,114,1553410800,40,0,40,Clouds
37687,115,1553410800,5,25,30,Clouds
37688,2,1553414400,15,5,20,Clouds
37689,3,1553414400,6,14,20,Clouds
37690,4,1553414400,16,4,20,Clouds
37691,5,1553414400,15,25,40,Clouds
37692,6,1553414400,10,10,20,Clouds
37693,7,1553414400,12,17,29,Clouds
37694,8,1553414400,10,20,30,Clouds
37695,9,1553414400,21,3,24,Clouds
37696,10,1553414400,3,13,16,Clouds
37697,11,1553414400,26,4,30,Clouds
37698,12,1553414400,19,1,20,Clouds
37699,13,1553414400,27,3,30,Clouds
37700,14,1553414400,8,22,30,Clouds
37701,15,1553414400,14,2,16,Clouds
37702,16,1553414400,16,4,20,Clouds
37703,17,1553414400,13,7,20,Clouds
37704,18,1553414400,11,19,30,Clouds
37705,19,1553414400,9,20,29,Clouds
37706,21,1553414400,22,8,30,Clouds
37707,22,1553414400,11,9,20,Clouds
37708,23,1553414400,7,23,30,Clouds
37709,24,1553414400,0,20,20,Clouds
37710,25,1553414400,30,0,30,Clouds
37711,26,1553414400,0,20,20,Clouds
37712,27,1553414400,10,10,20,Clouds
37713,28,1553414400,27,3,30,Clouds
37714,29,1553414400,0,29,29,Clouds
37715,30,1553414400,18,2,20,Clouds
37716,31,1553414400,18,2,20,Clouds
37717,32,1553414400,16,14,30,Clouds
37718,33,1553414400,18,5,23,Clouds
37719,34,1553414400,23,7,30,Clouds
37720,35,1553414400,12,18,30,Clouds
37721,36,1553414400,27,13,40,Clouds
37722,37,1553414400,26,4,30,Clouds
37723,38,1553414400,22,18,40,Clouds
37724,39,1553414400,19,1,20,Clouds
37725,40,1553414400,8,13,21,Clouds
37726,41,1553414400,13,7,20,Clouds
37727,42,1553414400,13,17,30,Clouds
37728,43,1553414400,13,17,30,Clouds
37729,44,1553414400,21,9,30,Clouds
37730,45,1553414400,0,30,30,Clouds
37731,46,1553414400,8,12,20,Clouds
37732,47,1553414400,40,0,40,Clouds
37733,48,1553414400,31,9,40,Clouds
37734,49,1553414400,37,3,40,Clouds
37735,50,1553414400,31,9,40,Clouds
37736,51,1553414400,32,8,40,Clouds
37737,52,1553414400,16,16,32,Clouds
37738,53,1553414400,24,16,40,Clouds
37739,54,1553414400,25,8,33,Clouds
37740,55,1553414400,34,2,36,Clouds
37741,56,1553414400,27,13,40,Clouds
37742,57,1553414400,21,2,23,Clouds
37743,58,1553414400,26,14,40,Clouds
37744,59,1553414400,14,6,20,Clouds
37745,60,1553414400,16,14,30,Clouds
37746,61,1553414400,23,2,25,Clouds
37747,62,1553414400,22,18,40,Clouds
37748,63,1553414400,7,28,35,Clouds
37749,64,1553414400,22,18,40,Clouds
37750,65,1553414400,40,0,40,Clouds
37751,66,1553414400,26,14,40,Clouds
37752,67,1553414400,24,16,40,Clouds
37753,68,1553414400,37,3,40,Clouds
37754,69,1553414400,18,22,40,Clouds
37755,70,1553414400,17,11,28,Clouds
37756,71,1553414400,10,30,40,Clouds
37757,72,1553414400,2,29,31,Clouds
37758,73,1553414400,25,5,30,Clouds
37759,74,1553414400,13,17,30,Clouds
37760,75,1553414400,30,10,40,Clouds
37761,76,1553414400,11,27,38,Clouds
37762,77,1553414400,7,22,29,Clouds
37763,78,1553414400,36,4,40,Clouds
37764,79,1553414400,19,8,27,Clouds
37765,80,1553414400,24,16,40,Clouds
37766,81,1553414400,32,8,40,Clouds
37767,82,1553414400,20,2,22,Clouds
37768,83,1553414400,24,16,40,Clouds
37769,84,1553414400,26,4,30,Clouds
37770,85,1553414400,33,2,35,Clouds
37771,86,1553414400,24,14,38,Clouds
37772,87,1553414400,11,27,38,Clouds
37773,88,1553414400,26,4,30,Clouds
37774,89,1553414400,32,7,39,Clouds
37775,90,1553414400,37,3,40,Clouds
37776,91,1553414400,11,19,30,Clouds
37777,92,1553414400,5,35,40,Clouds
37778,93,1553414400,2,38,40,Clouds
37779,94,1553414400,30,10,40,Clouds
37780,95,1553414400,29,11,40,Clouds
37781,96,1553414400,29,1,30,Clouds
37782,97,1553414400,29,11,40,Clouds
37783,99,1553414400,29,1,30,Clouds
37784,100,1553414400,7,18,25,Clouds
37785,101,1553414400,24,6,30,Clouds
37786,102,1553414400,18,22,40,Clouds
37787,103,1553414400,39,1,40,Clouds
37788,104,1553414400,27,13,40,Clouds
37789,105,1553414400,24,12,36,Clouds
37790,106,1553414400,30,10,40,Clouds
37791,107,1553414400,20,20,40,Clouds
37792,108,1553414400,33,7,40,Clouds
37793,109,1553414400,17,12,29,Clouds
37794,110,1553414400,38,2,40,Clouds
37795,111,1553414400,30,10,40,Clouds
37796,112,1553414400,21,9,30,Clouds
37797,113,1553414400,23,17,40,Clouds
37798,114,1553414400,39,1,40,Clouds
37799,115,1553414400,6,24,30,Clouds
37800,2,1553418000,20,0,20,Clouds
37801,3,1553418000,5,15,20,Clouds
37802,4,1553418000,15,5,20,Clouds
37803,5,1553418000,18,22,40,Clouds
37804,6,1553418000,10,10,20,Clouds
37805,7,1553418000,12,17,29,Clouds
37806,8,1553418000,12,18,30,Clouds
37807,9,1553418000,19,5,24,Clouds
37808,10,1553418000,2,14,16,Clouds
37809,11,1553418000,26,4,30,Clouds
37810,12,1553418000,20,0,20,Clouds
37811,13,1553418000,27,3,30,Clouds
37812,14,1553418000,1,29,30,Clouds
37813,15,1553418000,16,0,16,Clouds
37814,16,1553418000,16,4,20,Clouds
37815,17,1553418000,13,7,20,Clouds
37816,18,1553418000,10,20,30,Clouds
37817,19,1553418000,6,23,29,Clouds
37818,21,1553418000,22,8,30,Clouds
37819,22,1553418000,12,8,20,Clouds
37820,23,1553418000,3,27,30,Clouds
37821,24,1553418000,3,17,20,Clouds
37822,25,1553418000,30,0,30,Clouds
37823,26,1553418000,2,18,20,Clouds
37824,27,1553418000,8,12,20,Clouds
37825,28,1553418000,28,2,30,Clouds
37826,29,1553418000,1,28,29,Clouds
37827,30,1553418000,16,4,20,Clouds
37828,31,1553418000,19,1,20,Clouds
37829,32,1553418000,15,15,30,Clouds
37830,33,1553418000,19,4,23,Clouds
37831,34,1553418000,24,6,30,Clouds
37832,35,1553418000,10,20,30,Clouds
37833,36,1553418000,25,15,40,Clouds
37834,37,1553418000,26,4,30,Clouds
37835,38,1553418000,14,26,40,Clouds
37836,39,1553418000,19,1,20,Clouds
37837,40,1553418000,6,15,21,Clouds
37838,41,1553418000,12,8,20,Clouds
37839,42,1553418000,10,20,30,Clouds
37840,43,1553418000,12,18,30,Clouds
37841,44,1553418000,23,7,30,Clouds
37842,45,1553418000,0,30,30,Clouds
37843,46,1553418000,9,11,20,Clouds
37844,47,1553418000,40,0,40,Clouds
37845,48,1553418000,31,9,40,Clouds
37846,49,1553418000,40,0,40,Clouds
37847,50,1553418000,35,5,40,Clouds
37848,51,1553418000,31,9,40,Clouds
37849,52,1553418000,17,15,32,Clouds
37850,53,1553418000,24,16,40,Clouds
37851,54,1553418000,26,7,33,Clouds
37852,55,1553418000,34,2,36,Clouds
37853,56,1553418000,28,12,40,Clouds
37854,57,1553418000,20,3,23,Clouds
37855,58,1553418000,23,17,40,Clouds
37856,59,1553418000,13,7,20,Clouds
37857,60,1553418000,18,12,30,Clouds
37858,61,1553418000,25,0,25,Clouds
37859,62,1553418000,21,19,40,Clouds
37860,63,1553418000,7,28,35,Clouds
37861,64,1553418000,22,18,40,Clouds
37862,65,1553418000,40,0,40,Clouds
37863,66,1553418000,26,13,39,Clouds
37864,67,1553418000,26,14,40,Clouds
37865,68,1553418000,31,9,40,Clouds
37866,69,1553418000,16,24,40,Clouds
37867,70,1553418000,17,11,28,Clouds
37868,71,1553418000,12,28,40,Clouds
37869,72,1553418000,2,29,31,Clouds
37870,73,1553418000,25,5,30,Clouds
37871,74,1553418000,13,17,30,Clouds
37872,75,1553418000,29,11,40,Clouds
37873,76,1553418000,12,26,38,Clouds
37874,77,1553418000,7,22,29,Clouds
37875,78,1553418000,39,1,40,Clouds
37876,79,1553418000,19,8,27,Clouds
37877,80,1553418000,25,15,40,Clouds
37878,81,1553418000,32,8,40,Clouds
37879,82,1553418000,20,2,22,Clouds
37880,83,1553418000,26,14,40,Clouds
37881,84,1553418000,26,4,30,Clouds
37882,85,1553418000,33,2,35,Clouds
37883,86,1553418000,23,15,38,Clouds
37884,87,1553418000,11,27,38,Clouds
37885,88,1553418000,27,3,30,Clouds
37886,89,1553418000,32,7,39,Clouds
37887,90,1553418000,31,9,40,Clouds
37888,91,1553418000,9,21,30,Clouds
37889,92,1553418000,7,33,40,Clouds
37890,93,1553418000,2,38,40,Clouds
37891,94,1553418000,30,10,40,Clouds
37892,95,1553418000,30,10,40,Clouds
37893,96,1553418000,29,1,30,Clouds
37894,97,1553418000,30,10,40,Clouds
37895,99,1553418000,29,1,30,Clouds
37896,100,1553418000,2,23,25,Clouds
37897,101,1553418000,28,2,30,Clouds
37898,102,1553418000,20,20,40,Clouds
37899,103,1553418000,39,1,40,Clouds
37900,104,1553418000,27,13,40,Clouds
37901,105,1553418000,24,12,36,Clouds
37902,106,1553418000,31,9,40,Clouds
37903,107,1553418000,21,19,40,Clouds
37904,108,1553418000,35,5,40,Clouds
37905,109,1553418000,18,11,29,Clouds
37906,110,1553418000,39,1,40,Clouds
37907,111,1553418000,32,8,40,Clouds
37908,112,1553418000,26,4,30,Clouds
37909,113,1553418000,23,17,40,Clouds
37910,114,1553418000,37,3,40,Clouds
37911,115,1553418000,9,21,30,Clouds
37912,2,1553421600,20,0,20,Clouds
37913,3,1553421600,5,15,20,Clouds
37914,4,1553421600,13,7,20,Clouds
37915,5,1553421600,20,20,40,Clouds
37916,6,1553421600,10,10,20,Clouds
37917,7,1553421600,15,14,29,Clouds
37918,8,1553421600,14,16,30,Clouds
37919,9,1553421600,14,10,24,Clouds
37920,10,1553421600,0,16,16,Clouds
37921,11,1553421600,26,4,30,Clouds
37922,12,1553421600,20,0,20,Clouds
37923,13,1553421600,25,5,30,Clouds
37924,14,1553421600,0,30,30,Clouds
37925,15,1553421600,16,0,16,Clouds
37926,16,1553421600,16,4,20,Clouds
37927,17,1553421600,14,6,20,Clouds
37928,18,1553421600,7,23,30,Clouds
37929,19,1553421600,6,24,30,Clouds
37930,21,1553421600,20,10,30,Clouds
37931,22,1553421600,11,9,20,Clouds
37932,23,1553421600,2,28,30,Clouds
37933,24,1553421600,0,20,20,Clouds
37934,25,1553421600,29,1,30,Clouds
37935,26,1553421600,1,19,20,Clouds
37936,27,1553421600,4,16,20,Clouds
37937,28,1553421600,30,0,30,Clouds
37938,29,1553421600,0,29,29,Clouds
37939,30,1553421600,18,2,20,Clouds
37940,31,1553421600,19,1,20,Clouds
37941,32,1553421600,15,15,30,Clouds
37942,33,1553421600,11,12,23,Clouds
37943,34,1553421600,24,6,30,Clouds
37944,35,1553421600,11,19,30,Clouds
37945,36,1553421600,24,16,40,Clouds
37946,37,1553421600,26,4,30,Clouds
37947,38,1553421600,11,29,40,Clouds
37948,39,1553421600,20,0,20,Clouds
37949,40,1553421600,4,17,21,Clouds
37950,41,1553421600,13,7,20,Clouds
37951,42,1553421600,10,20,30,Clouds
37952,43,1553421600,11,19,30,Clouds
37953,44,1553421600,29,1,30,Clouds
37954,45,1553421600,3,27,30,Clouds
37955,46,1553421600,6,14,20,Clouds
37956,47,1553421600,39,1,40,Clouds
37957,48,1553421600,31,9,40,Clouds
37958,49,1553421600,39,1,40,Clouds
37959,50,1553421600,39,1,40,Clouds
37960,51,1553421600,30,10,40,Clouds
37961,52,1553421600,18,14,32,Clouds
37962,53,1553421600,24,16,40,Clouds
37963,54,1553421600,25,8,33,Clouds
37964,55,1553421600,34,2,36,Clouds
37965,56,1553421600,24,16,40,Clouds
37966,57,1553421600,20,3,23,Clouds
37967,58,1553421600,21,19,40,Clouds
37968,59,1553421600,16,4,20,Clouds
37969,60,1553421600,23,7,30,Clouds
37970,61,1553421600,25,0,25,Clouds
37971,62,1553421600,21,19,40,Clouds
37972,63,1553421600,6,29,35,Clouds
37973,64,1553421600,22,18,40,Clouds
37974,65,1553421600,39,1,40,Clouds
37975,66,1553421600,28,12,40,Clouds
37976,67,1553421600,30,10,40,Clouds
37977,68,1553421600,27,13,40,Clouds
37978,69,1553421600,16,24,40,Clouds
37979,70,1553421600,20,8,28,Clouds
37980,71,1553421600,16,24,40,Clouds
37981,72,1553421600,2,29,31,Clouds
37982,73,1553421600,30,0,30,Clouds
37983,74,1553421600,11,19,30,Clouds
37984,75,1553421600,30,10,40,Clouds
37985,76,1553421600,14,24,38,Clouds
37986,77,1553421600,7,22,29,Clouds
37987,78,1553421600,39,1,40,Clouds
37988,79,1553421600,18,9,27,Clouds
37989,80,1553421600,27,13,40,Clouds
37990,81,1553421600,32,8,40,Clouds
37991,82,1553421600,19,3,22,Clouds
37992,83,1553421600,30,10,40,Clouds
37993,84,1553421600,30,0,30,Clouds
37994,85,1553421600,34,1,35,Clouds
37995,86,1553421600,22,16,38,Clouds
37996,87,1553421600,12,26,38,Clouds
37997,88,1553421600,26,4,30,Clouds
37998,89,1553421600,33,7,40,Clouds
37999,90,1553421600,30,10,40,Clouds
38000,91,1553421600,7,23,30,Clouds
38001,92,1553421600,7,33,40,Clouds
38002,93,1553421600,2,38,40,Clouds
38003,94,1553421600,30,10,40,Clouds
38004,95,1553421600,31,9,40,Clouds
38005,96,1553421600,29,1,30,Clouds
38006,97,1553421600,34,6,40,Clouds
38007,98,1553421600,15,25,40,Clouds
38008,99,1553421600,28,2,30,Clouds
38009,100,1553421600,0,25,25,Clouds
38010,101,1553421600,29,1,30,Clouds
38011,102,1553421600,22,18,40,Clouds
38012,103,1553421600,39,1,40,Clouds
38013,104,1553421600,27,13,40,Clouds
38014,105,1553421600,23,13,36,Clouds
38015,106,1553421600,32,8,40,Clouds
38016,107,1553421600,22,18,40,Clouds
38017,108,1553421600,39,1,40,Clouds
38018,109,1553421600,19,10,29,Clouds
38019,110,1553421600,39,1,40,Clouds
38020,111,1553421600,32,8,40,Clouds
38021,112,1553421600,30,0,30,Clouds
38022,113,1553421600,23,17,40,Clouds
38023,114,1553421600,37,3,40,Clouds
38024,115,1553421600,13,17,30,Clouds
38025,2,1553425200,20,0,20,Clouds
38026,3,1553425200,6,14,20,Clouds
38027,4,1553425200,12,8,20,Clouds
38028,5,1553425200,18,22,40,Clouds
38029,6,1553425200,4,16,20,Clouds
38030,7,1553425200,15,14,29,Clouds
38031,8,1553425200,12,18,30,Clouds
38032,9,1553425200,0,24,24,Clouds
38033,10,1553425200,0,16,16,Clouds
38034,11,1553425200,29,1,30,Clouds
38035,12,1553425200,20,0,20,Clouds
38036,13,1553425200,25,5,30,Clouds
38037,14,1553425200,0,30,30,Clouds
38038,15,1553425200,16,0,16,Clouds
38039,16,1553425200,13,7,20,Clouds
38040,17,1553425200,14,6,20,Clouds
38041,18,1553425200,5,25,30,Clouds
38042,19,1553425200,1,29,30,Clouds
38043,21,1553425200,19,11,30,Clouds
38044,22,1553425200,11,9,20,Clouds
38045,23,1553425200,4,26,30,Clouds
38046,24,1553425200,3,17,20,Clouds
38047,25,1553425200,28,2,30,Clouds
38048,26,1553425200,1,19,20,Clouds
38049,27,1553425200,1,19,20,Clouds
38050,28,1553425200,30,0,30,Clouds
38051,29,1553425200,0,29,29,Clouds
38052,30,1553425200,17,3,20,Clouds
38053,31,1553425200,18,2,20,Clouds
38054,32,1553425200,9,21,30,Clouds
38055,33,1553425200,3,20,23,Clouds
38056,34,1553425200,28,2,30,Clouds
38057,35,1553425200,12,18,30,Clouds
38058,36,1553425200,24,16,40,Clouds
38059,37,1553425200,28,2,30,Clouds
38060,38,1553425200,15,25,40,Clouds
38061,39,1553425200,18,2,20,Clouds
38062,40,1553425200,0,21,21,Clouds
38063,41,1553425200,13,7,20,Clouds
38064,42,1553425200,16,14,30,Clouds
38065,43,1553425200,14,16,30,Clouds
38066,44,1553425200,30,0,30,Clouds
38067,45,1553425200,4,26,30,Clouds
38068,46,1553425200,7,13,20,Clouds
38069,47,1553425200,38,2,40,Clouds
38070,48,1553425200,26,14,40,Clouds
38071,49,1553425200,40,0,40,Clouds
38072,50,1553425200,39,1,40,Clouds
38073,51,1553425200,26,14,40,Clouds
38074,52,1553425200,17,15,32,Clouds
38075,53,1553425200,23,17,40,Clouds
38076,54,1553425200,25,8,33,Clouds
38077,55,1553425200,35,1,36,Clouds
38078,56,1553425200,27,13,40,Clouds
38079,57,1553425200,22,1,23,Clouds
38080,58,1553425200,18,22,40,Clouds
38081,59,1553425200,16,4,20,Clouds
38082,60,1553425200,30,0,30,Clouds
38083,61,1553425200,25,0,25,Clouds
38084,62,1553425200,20,20,40,Clouds
38085,63,1553425200,7,28,35,Clouds
38086,64,1553425200,23,17,40,Clouds
38087,65,1553425200,36,4,40,Clouds
38088,66,1553425200,26,14,40,Clouds
38089,67,1553425200,30,10,40,Clouds
38090,68,1553425200,25,15,40,Clouds
38091,69,1553425200,16,24,40,Clouds
38092,70,1553425200,25,3,28,Clouds
38093,71,1553425200,19,21,40,Clouds
38094,72,1553425200,5,26,31,Clouds
38095,73,1553425200,27,3,30,Clouds
38096,74,1553425200,13,17,30,Clouds
38097,75,1553425200,33,7,40,Clouds
38098,76,1553425200,15,23,38,Clouds
38099,77,1553425200,2,27,29,Clouds
38100,78,1553425200,38,2,40,Clouds
38101,79,1553425200,19,8,27,Clouds
38102,80,1553425200,29,11,40,Clouds
38103,81,1553425200,38,2,40,Clouds
38104,82,1553425200,19,3,22,Clouds
38105,83,1553425200,31,9,40,Clouds
38106,84,1553425200,30,0,30,Clouds
38107,85,1553425200,35,0,35,Clouds
38108,86,1553425200,24,14,38,Clouds
38109,87,1553425200,12,26,38,Clouds
38110,88,1553425200,27,3,30,Clouds
38111,89,1553425200,33,7,40,Clouds
38112,90,1553425200,31,9,40,Clouds
38113,91,1553425200,6,24,30,Clouds
38114,92,1553425200,8,32,40,Clouds
38115,93,1553425200,2,38,40,Clouds
38116,94,1553425200,30,10,40,Clouds
38117,95,1553425200,30,10,40,Clouds
38118,96,1553425200,30,0,30,Clouds
38119,97,1553425200,36,4,40,Clouds
38120,98,1553425200,14,26,40,Clouds
38121,99,1553425200,29,1,30,Clouds
38122,100,1553425200,0,25,25,Clouds
38123,101,1553425200,30,0,30,Clouds
38124,102,1553425200,23,17,40,Clouds
38125,103,1553425200,39,1,40,Clouds
38126,104,1553425200,27,13,40,Clouds
38127,105,1553425200,23,13,36,Clouds
38128,106,1553425200,32,8,40,Clouds
38129,107,1553425200,24,16,40,Clouds
38130,108,1553425200,40,0,40,Clouds
38131,109,1553425200,19,10,29,Clouds
38132,110,1553425200,35,5,40,Clouds
38133,111,1553425200,40,0,40,Clouds
38134,112,1553425200,30,0,30,Clouds
38135,113,1553425200,24,16,40,Clouds
38136,114,1553425200,39,1,40,Clouds
38137,115,1553425200,20,10,30,Clouds
38138,2,1553428800,20,0,20,Clouds
38139,3,1553428800,6,14,20,Clouds
38140,4,1553428800,11,9,20,Clouds
38141,5,1553428800,22,18,40,Clouds
38142,6,1553428800,4,16,20,Clouds
38143,7,1553428800,14,15,29,Clouds
38144,8,1553428800,6,24,30,Clouds
38145,9,1553428800,0,24,24,Clouds
38146,10,1553428800,0,16,16,Clouds
38147,11,1553428800,29,1,30,Clouds
38148,12,1553428800,20,0,20,Clouds
38149,13,1553428800,24,6,30,Clouds
38150,14,1553428800,1,29,30,Clouds
38151,15,1553428800,16,0,16,Clouds
38152,16,1553428800,13,7,20,Clouds
38153,17,1553428800,10,10,20,Clouds
38154,18,1553428800,8,22,30,Clouds
38155,19,1553428800,1,29,30,Clouds
38156,21,1553428800,16,14,30,Clouds
38157,22,1553428800,7,13,20,Clouds
38158,23,1553428800,0,30,30,Clouds
38159,24,1553428800,0,20,20,Clouds
38160,25,1553428800,29,1,30,Clouds
38161,26,1553428800,4,16,20,Clouds
38162,27,1553428800,0,20,20,Clouds
38163,28,1553428800,30,0,30,Clouds
38164,29,1553428800,0,29,29,Clouds
38165,30,1553428800,20,0,20,Clouds
38166,31,1553428800,10,10,20,Clouds
38167,32,1553428800,4,26,30,Clouds
38168,33,1553428800,0,23,23,Clouds
38169,34,1553428800,30,0,30,Clouds
38170,35,1553428800,19,11,30,Clouds
38171,36,1553428800,22,18,40,Clouds
38172,37,1553428800,28,2,30,Clouds
38173,38,1553428800,11,29,40,Clouds
38174,39,1553428800,17,3,20,Clouds
38175,40,1553428800,0,21,21,Clouds
38176,41,1553428800,13,7,20,Clouds
38177,42,1553428800,16,14,30,Clouds
38178,43,1553428800,24,6,30,Clouds
38179,44,1553428800,30,0,30,Clouds
38180,45,1553428800,5,25,30,Clouds
38181,46,1553428800,0,20,20,Clouds
38182,47,1553428800,38,2,40,Clouds
38183,48,1553428800,21,19,40,Clouds
38184,49,1553428800,36,4,40,Clouds
38185,50,1553428800,40,0,40,Clouds
38186,51,1553428800,16,24,40,Clouds
38187,52,1553428800,13,19,32,Clouds
38188,53,1553428800,24,16,40,Clouds
38189,54,1553428800,26,7,33,Clouds
38190,55,1553428800,35,1,36,Clouds
38191,56,1553428800,31,9,40,Clouds
38192,57,1553428800,23,0,23,Clouds
38193,58,1553428800,17,23,40,Clouds
38194,59,1553428800,19,1,20,Clouds
38195,60,1553428800,30,0,30,Clouds
38196,61,1553428800,25,0,25,Clouds
38197,62,1553428800,19,21,40,Clouds
38198,63,1553428800,7,28,35,Clouds
38199,64,1553428800,25,15,40,Clouds
38200,65,1553428800,38,2,40,Clouds
38201,66,1553428800,29,11,40,Clouds
38202,67,1553428800,34,6,40,Clouds
38203,68,1553428800,30,10,40,Clouds
38204,69,1553428800,19,21,40,Clouds
38205,70,1553428800,26,2,28,Clouds
38206,71,1553428800,20,20,40,Clouds
38207,72,1553428800,9,22,31,Clouds
38208,73,1553428800,30,0,30,Clouds
38209,74,1553428800,14,16,30,Clouds
38210,75,1553428800,30,10,40,Clouds
38211,76,1553428800,16,22,38,Clouds
38212,77,1553428800,1,28,29,Clouds
38213,78,1553428800,40,0,40,Clouds
38214,79,1553428800,24,3,27,Clouds
38215,80,1553428800,33,7,40,Clouds
38216,81,1553428800,40,0,40,Clouds
38217,82,1553428800,20,2,22,Clouds
38218,83,1553428800,34,6,40,Clouds
38219,84,1553428800,30,0,30,Clouds
38220,85,1553428800,35,0,35,Clouds
38221,86,1553428800,29,9,38,Clouds
38222,87,1553428800,14,24,38,Clouds
38223,88,1553428800,28,2,30,Clouds
38224,89,1553428800,33,7,40,Clouds
38225,90,1553428800,31,9,40,Clouds
38226,91,1553428800,6,24,30,Clouds
38227,92,1553428800,9,31,40,Clouds
38228,93,1553428800,2,38,40,Clouds
38229,94,1553428800,29,11,40,Clouds
38230,95,1553428800,36,4,40,Clouds
38231,96,1553428800,30,0,30,Clouds
38232,97,1553428800,36,4,40,Clouds
38233,98,1553428800,12,28,40,Clouds
38234,99,1553428800,28,2,30,Clouds
38235,100,1553428800,2,23,25,Clouds
38236,101,1553428800,30,0,30,Clouds
38237,102,1553428800,26,14,40,Clouds
38238,103,1553428800,40,0,40,Clouds
38239,104,1553428800,27,12,39,Clouds
38240,105,1553428800,27,9,36,Clouds
38241,106,1553428800,34,6,40,Clouds
38242,107,1553428800,24,16,40,Clouds
38243,108,1553428800,40,0,40,Clouds
38244,109,1553428800,20,9,29,Clouds
38245,110,1553428800,40,0,40,Clouds
38246,111,1553428800,40,0,40,Clouds
38247,112,1553428800,30,0,30,Clouds
38248,113,1553428800,24,16,40,Clouds
38249,114,1553428800,40,0,40,Clouds
38250,115,1553428800,24,6,30,Clouds
38251,2,1553432400,20,0,20,Clouds
38252,3,1553432400,9,11,20,Clouds
38253,4,1553432400,9,11,20,Clouds
38254,5,1553432400,27,13,40,Clouds
38255,6,1553432400,2,18,20,Clouds
38256,7,1553432400,15,14,29,Clouds
38257,8,1553432400,8,22,30,Clouds
38258,9,1553432400,0,24,24,Clouds
38259,10,1553432400,0,16,16,Clouds
38260,11,1553432400,29,1,30,Clouds
38261,12,1553432400,20,0,20,Clouds
38262,13,1553432400,23,7,30,Clouds
38263,14,1553432400,1,29,30,Clouds
38264,15,1553432400,16,0,16,Clouds
38265,16,1553432400,12,8,20,Clouds
38266,17,1553432400,12,8,20,Clouds
38267,18,1553432400,10,20,30,Clouds
38268,19,1553432400,1,29,30,Clouds
38269,21,1553432400,12,18,30,Clouds
38270,22,1553432400,2,18,20,Clouds
38271,23,1553432400,0,30,30,Clouds
38272,24,1553432400,0,20,20,Clouds
38273,25,1553432400,27,3,30,Clouds
38274,26,1553432400,2,18,20,Clouds
38275,27,1553432400,1,19,20,Clouds
38276,28,1553432400,30,0,30,Clouds
38277,29,1553432400,0,29,29,Clouds
38278,30,1553432400,18,2,20,Clouds
38279,31,1553432400,3,17,20,Clouds
38280,32,1553432400,0,30,30,Clouds
38281,33,1553432400,0,23,23,Clouds
38282,34,1553432400,28,2,30,Clouds
38283,35,1553432400,19,11,30,Clouds
38284,36,1553432400,23,17,40,Clouds
38285,37,1553432400,28,2,30,Clouds
38286,38,1553432400,10,30,40,Clouds
38287,39,1553432400,18,2,20,Clouds
38288,40,1553432400,1,20,21,Clouds
38289,41,1553432400,12,8,20,Clouds
38290,42,1553432400,19,11,30,Clouds
38291,43,1553432400,30,0,30,Clouds
38292,44,1553432400,30,0,30,Clouds
38293,45,1553432400,9,21,30,Clouds
38294,46,1553432400,0,20,20,Clouds
38295,47,1553432400,38,2,40,Clouds
38296,48,1553432400,19,21,40,Clouds
38297,49,1553432400,40,0,40,Clouds
38298,50,1553432400,38,2,40,Clouds
38299,51,1553432400,19,21,40,Clouds
38300,52,1553432400,7,25,32,Clouds
38301,53,1553432400,24,16,40,Clouds
38302,54,1553432400,25,8,33,Clouds
38303,55,1553432400,35,1,36,Clouds
38304,56,1553432400,32,8,40,Clouds
38305,57,1553432400,22,1,23,Clouds
38306,58,1553432400,19,21,40,Clouds
38307,59,1553432400,20,0,20,Clouds
38308,60,1553432400,29,1,30,Clouds
38309,61,1553432400,25,0,25,Clouds
38310,62,1553432400,20,20,40,Clouds
38311,63,1553432400,6,29,35,Clouds
38312,64,1553432400,17,23,40,Clouds
38313,65,1553432400,39,1,40,Clouds
38314,66,1553432400,31,9,40,Clouds
38315,67,1553432400,39,1,40,Clouds
38316,68,1553432400,27,13,40,Clouds
38317,69,1553432400,22,18,40,Clouds
38318,70,1553432400,26,2,28,Clouds
38319,71,1553432400,23,17,40,Clouds
38320,72,1553432400,10,21,31,Clouds
38321,73,1553432400,30,0,30,Clouds
38322,74,1553432400,15,15,30,Clouds
38323,75,1553432400,26,14,40,Clouds
38324,76,1553432400,16,22,38,Clouds
38325,77,1553432400,1,28,29,Clouds
38326,78,1553432400,40,0,40,Clouds
38327,79,1553432400,27,0,27,Clouds
38328,80,1553432400,37,3,40,Clouds
38329,81,1553432400,40,0,40,Clouds
38330,82,1553432400,22,0,22,Clouds
38331,83,1553432400,40,0,40,Clouds
38332,84,1553432400,30,0,30,Clouds
38333,85,1553432400,35,0,35,Clouds
38334,86,1553432400,26,12,38,Clouds
38335,87,1553432400,14,24,38,Clouds
38336,88,1553432400,30,0,30,Clouds
38337,89,1553432400,33,7,40,Clouds
38338,90,1553432400,31,9,40,Clouds
38339,91,1553432400,3,27,30,Clouds
38340,92,1553432400,11,29,40,Clouds
38341,93,1553432400,2,38,40,Clouds
38342,94,1553432400,29,11,40,Clouds
38343,95,1553432400,38,2,40,Clouds
38344,96,1553432400,30,0,30,Clouds
38345,97,1553432400,40,0,40,Clouds
38346,98,1553432400,9,31,40,Clouds
38347,99,1553432400,29,1,30,Clouds
38348,100,1553432400,0,25,25,Clouds
38349,101,1553432400,30,0,30,Clouds
38350,102,1553432400,33,7,40,Clouds
38351,103,1553432400,40,0,40,Clouds
38352,104,1553432400,27,12,39,Clouds
38353,105,1553432400,24,12,36,Clouds
38354,106,1553432400,35,5,40,Clouds
38355,107,1553432400,24,16,40,Clouds
38356,108,1553432400,40,0,40,Clouds
38357,109,1553432400,23,6,29,Clouds
38358,110,1553432400,40,0,40,Clouds
38359,111,1553432400,40,0,40,Clouds
38360,112,1553432400,30,0,30,Clouds
38361,113,1553432400,25,15,40,Clouds
38362,114,1553432400,39,1,40,Clouds
38363,115,1553432400,30,0,30,Clouds
38364,2,1553436000,20,0,20,Clouds
38365,3,1553436000,11,9,20,Clouds
38366,4,1553436000,15,5,20,Clouds
38367,5,1553436000,28,12,40,Clouds
38368,6,1553436000,1,19,20,Clouds
38369,7,1553436000,14,15,29,Clouds
38370,8,1553436000,2,28,30,Clouds
38371,9,1553436000,0,24,24,Clouds
38372,10,1553436000,0,16,16,Clouds
38373,11,1553436000,26,4,30,Clouds
38374,12,1553436000,20,0,20,Clouds
38375,13,1553436000,22,8,30,Clouds
38376,14,1553436000,0,30,30,Clouds
38377,15,1553436000,16,0,16,Clouds
38378,16,1553436000,13,7,20,Clouds
38379,17,1553436000,14,6,20,Clouds
38380,18,1553436000,15,15,30,Clouds
38381,19,1553436000,2,28,30,Clouds
38382,21,1553436000,8,22,30,Clouds
38383,22,1553436000,1,19,20,Clouds
38384,23,1553436000,0,30,30,Clouds
38385,24,1553436000,3,17,20,Clouds
38386,25,1553436000,24,6,30,Clouds
38387,26,1553436000,1,19,20,Clouds
38388,27,1553436000,0,20,20,Clouds
38389,28,1553436000,21,9,30,Clouds
38390,29,1553436000,0,29,29,Clouds
38391,30,1553436000,20,0,20,Clouds
38392,31,1553436000,1,19,20,Clouds
38393,32,1553436000,2,28,30,Clouds
38394,33,1553436000,2,21,23,Clouds
38395,34,1553436000,26,4,30,Clouds
38396,35,1553436000,20,10,30,Clouds
38397,36,1553436000,25,15,40,Clouds
38398,37,1553436000,25,5,30,Clouds
38399,38,1553436000,8,32,40,Clouds
38400,39,1553436000,20,0,20,Clouds
38401,40,1553436000,0,21,21,Clouds
38402,41,1553436000,12,8,20,Clouds
38403,42,1553436000,23,7,30,Clouds
38404,43,1553436000,30,0,30,Clouds
38405,44,1553436000,30,0,30,Clouds
38406,45,1553436000,8,22,30,Clouds
38407,46,1553436000,0,20,20,Clouds
38408,47,1553436000,38,2,40,Clouds
38409,48,1553436000,19,21,40,Clouds
38410,49,1553436000,40,0,40,Clouds
38411,50,1553436000,38,2,40,Clouds
38412,51,1553436000,12,27,39,Clouds
38413,52,1553436000,5,27,32,Clouds
38414,53,1553436000,25,15,40,Clouds
38415,54,1553436000,23,10,33,Clouds
38416,55,1553436000,35,1,36,Clouds
38417,56,1553436000,35,5,40,Clouds
38418,57,1553436000,22,1,23,Clouds
38419,58,1553436000,20,20,40,Clouds
38420,59,1553436000,20,0,20,Clouds
38421,60,1553436000,29,1,30,Clouds
38422,61,1553436000,25,0,25,Clouds
38423,62,1553436000,23,17,40,Clouds
38424,63,1553436000,7,28,35,Clouds
38425,64,1553436000,15,25,40,Clouds
38426,65,1553436000,40,0,40,Clouds
38427,66,1553436000,29,11,40,Clouds
38428,67,1553436000,37,3,40,Clouds
38429,68,1553436000,22,18,40,Clouds
38430,69,1553436000,18,22,40,Clouds
38431,70,1553436000,24,4,28,Clouds
38432,71,1553436000,25,15,40,Clouds
38433,72,1553436000,19,12,31,Clouds
38434,73,1553436000,30,0,30,Clouds
38435,74,1553436000,16,14,30,Clouds
38436,75,1553436000,30,10,40,Clouds
38437,76,1553436000,15,23,38,Clouds
38438,77,1553436000,14,15,29,Clouds
38439,78,1553436000,40,0,40,Clouds
38440,79,1553436000,27,0,27,Clouds
38441,80,1553436000,40,0,40,Clouds
38442,81,1553436000,40,0,40,Clouds
38443,82,1553436000,22,0,22,Clouds
38444,83,1553436000,40,0,40,Clouds
38445,84,1553436000,29,1,30,Clouds
38446,85,1553436000,34,1,35,Clouds
38447,86,1553436000,33,5,38,Clouds
38448,87,1553436000,16,22,38,Clouds
38449,88,1553436000,30,0,30,Clouds
38450,89,1553436000,34,6,40,Clouds
38451,90,1553436000,32,8,40,Clouds
38452,91,1553436000,2,28,30,Clouds
38453,92,1553436000,8,32,40,Clouds
38454,93,1553436000,3,37,40,Clouds
38455,94,1553436000,29,11,40,Clouds
38456,95,1553436000,39,1,40,Clouds
38457,96,1553436000,30,0,30,Clouds
38458,97,1553436000,39,1,40,Clouds
38459,98,1553436000,2,38,40,Clouds
38460,99,1553436000,28,2,30,Clouds
38461,100,1553436000,2,23,25,Clouds
38462,101,1553436000,28,2,30,Clouds
38463,102,1553436000,19,21,40,Clouds
38464,103,1553436000,40,0,40,Clouds
38465,104,1553436000,28,12,40,Clouds
38466,105,1553436000,25,11,36,Clouds
38467,106,1553436000,35,5,40,Clouds
38468,107,1553436000,29,11,40,Clouds
38469,108,1553436000,40,0,40,Clouds
38470,109,1553436000,26,3,29,Clouds
38471,110,1553436000,39,1,40,Clouds
38472,111,1553436000,37,3,40,Clouds
38473,112,1553436000,30,0,30,Clouds
38474,113,1553436000,23,17,40,Clouds
38475,114,1553436000,39,1,40,Clouds
38476,115,1553436000,30,0,30,Clouds
38477,2,1553439600,20,0,20,Clouds
38478,3,1553439600,10,10,20,Clouds
38479,4,1553439600,18,2,20,Clouds
38480,5,1553439600,38,2,40,Clouds
38481,6,1553439600,1,19,20,Clouds
38482,7,1553439600,14,15,29,Clouds
38483,8,1553439600,2,28,30,Clouds
38484,9,1553439600,1,23,24,Clouds
38485,10,1553439600,0,16,16,Clouds
38486,11,1553439600,25,5,30,Clouds
38487,12,1553439600,20,0,20,Clouds
38488,13,1553439600,21,9,30,Clouds
38489,14,1553439600,7,23,30,Clouds
38490,15,1553439600,16,0,16,Clouds
38491,16,1553439600,11,9,20,Clouds
38492,17,1553439600,13,7,20,Clouds
38493,18,1553439600,21,9,30,Clouds
38494,19,1553439600,3,27,30,Clouds
38495,21,1553439600,0,30,30,Clouds
38496,22,1553439600,3,17,20,Clouds
38497,23,1553439600,0,30,30,Clouds
38498,24,1553439600,1,19,20,Clouds
38499,25,1553439600,24,6,30,Clouds
38500,26,1553439600,0,20,20,Clouds
38501,27,1553439600,0,20,20,Clouds
38502,28,1553439600,26,4,30,Clouds
38503,29,1553439600,0,29,29,Clouds
38504,30,1553439600,18,2,20,Clouds
38505,31,1553439600,2,18,20,Clouds
38506,32,1553439600,4,26,30,Clouds
38507,33,1553439600,0,23,23,Clouds
38508,34,1553439600,30,0,30,Clouds
38509,35,1553439600,23,7,30,Clouds
38510,36,1553439600,19,21,40,Clouds
38511,37,1553439600,26,4,30,Clouds
38512,38,1553439600,7,33,40,Clouds
38513,39,1553439600,15,5,20,Clouds
38514,40,1553439600,0,21,21,Clouds
38515,41,1553439600,12,8,20,Clouds
38516,42,1553439600,26,4,30,Clouds
38517,43,1553439600,29,1,30,Clouds
38518,44,1553439600,30,0,30,Clouds
38519,45,1553439600,7,23,30,Clouds
38520,46,1553439600,2,18,20,Clouds
38521,47,1553439600,39,1,40,Clouds
38522,48,1553439600,24,16,40,Clouds
38523,49,1553439600,34,6,40,Clouds
38524,50,1553439600,38,2,40,Clouds
38525,51,1553439600,8,31,39,Clouds
38526,52,1553439600,1,31,32,Clouds
38527,53,1553439600,23,17,40,Clouds
38528,54,1553439600,22,11,33,Clouds
38529,55,1553439600,35,1,36,Clouds
38530,56,1553439600,33,7,40,Clouds
38531,57,1553439600,22,1,23,Clouds
38532,58,1553439600,21,19,40,Clouds
38533,59,1553439600,18,2,20,Clouds
38534,60,1553439600,30,0,30,Clouds
38535,61,1553439600,25,0,25,Clouds
38536,62,1553439600,20,20,40,Clouds
38537,63,1553439600,7,28,35,Clouds
38538,64,1553439600,18,22,40,Clouds
38539,65,1553439600,40,0,40,Clouds
38540,66,1553439600,30,10,40,Clouds
38541,67,1553439600,38,2,40,Clouds
38542,68,1553439600,21,19,40,Clouds
38543,69,1553439600,27,13,40,Clouds
38544,70,1553439600,28,0,28,Clouds
38545,71,1553439600,29,11,40,Clouds
38546,72,1553439600,20,11,31,Clouds
38547,73,1553439600,27,3,30,Clouds
38548,74,1553439600,17,13,30,Clouds
38549,75,1553439600,36,4,40,Clouds
38550,76,1553439600,19,19,38,Clouds
38551,77,1553439600,3,26,29,Clouds
38552,78,1553439600,40,0,40,Clouds
38553,79,1553439600,26,1,27,Clouds
38554,80,1553439600,39,1,40,Clouds
38555,81,1553439600,32,8,40,Clouds
38556,82,1553439600,22,0,22,Clouds
38557,83,1553439600,40,0,40,Clouds
38558,84,1553439600,30,0,30,Clouds
38559,85,1553439600,29,6,35,Clouds
38560,86,1553439600,36,2,38,Clouds
38561,87,1553439600,15,23,38,Clouds
38562,88,1553439600,30,0,30,Clouds
38563,89,1553439600,34,6,40,Clouds
38564,90,1553439600,32,8,40,Clouds
38565,91,1553439600,0,30,30,Clouds
38566,92,1553439600,3,37,40,Clouds
38567,93,1553439600,3,37,40,Clouds
38568,94,1553439600,29,11,40,Clouds
38569,95,1553439600,40,0,40,Clouds
38570,96,1553439600,30,0,30,Clouds
38571,97,1553439600,36,4,40,Clouds
38572,98,1553439600,0,40,40,Clouds
38573,99,1553439600,29,1,30,Clouds
38574,100,1553439600,3,22,25,Clouds
38575,101,1553439600,30,0,30,Clouds
38576,102,1553439600,30,10,40,Clouds
38577,103,1553439600,39,1,40,Clouds
38578,104,1553439600,27,13,40,Clouds
38579,105,1553439600,25,11,36,Clouds
38580,106,1553439600,37,3,40,Clouds
38581,107,1553439600,34,6,40,Clouds
38582,108,1553439600,39,1,40,Clouds
38583,109,1553439600,23,6,29,Clouds
38584,110,1553439600,40,0,40,Clouds
38585,111,1553439600,38,2,40,Clouds
38586,112,1553439600,30,0,30,Clouds
38587,113,1553439600,24,16,40,Clouds
38588,114,1553439600,37,3,40,Clouds
38589,115,1553439600,26,4,30,Clouds
38590,2,1553443200,20,0,20,Rain
38591,3,1553443200,5,15,20,Rain
38592,4,1553443200,14,6,20,Rain
38593,5,1553443200,34,6,40,Rain
38594,6,1553443200,2,18,20,Rain
38595,7,1553443200,14,15,29,Rain
38596,8,1553443200,0,30,30,Rain
38597,9,1553443200,9,15,24,Rain
38598,10,1553443200,3,13,16,Rain
38599,11,1553443200,27,3,30,Rain
38600,12,1553443200,19,1,20,Rain
38601,13,1553443200,21,9,30,Rain
38602,14,1553443200,0,30,30,Rain
38603,15,1553443200,16,0,16,Rain
38604,16,1553443200,8,12,20,Rain
38605,17,1553443200,8,12,20,Rain
38606,18,1553443200,26,4,30,Rain
38607,19,1553443200,5,25,30,Rain
38608,21,1553443200,0,30,30,Rain
38609,22,1553443200,1,19,20,Rain
38610,23,1553443200,0,30,30,Rain
38611,24,1553443200,1,19,20,Rain
38612,25,1553443200,24,6,30,Rain
38613,26,1553443200,0,20,20,Rain
38614,27,1553443200,2,18,20,Rain
38615,28,1553443200,29,1,30,Rain
38616,29,1553443200,0,29,29,Rain
38617,30,1553443200,18,2,20,Rain
38618,31,1553443200,1,19,20,Rain
38619,32,1553443200,4,26,30,Rain
38620,33,1553443200,0,23,23,Rain
38621,34,1553443200,27,3,30,Rain
38622,35,1553443200,26,4,30,Rain
38623,36,1553443200,14,26,40,Rain
38624,37,1553443200,21,9,30,Rain
38625,38,1553443200,2,38,40,Rain
38626,39,1553443200,12,8,20,Rain
38627,40,1553443200,0,21,21,Rain
38628,41,1553443200,12,8,20,Rain
38629,42,1553443200,28,2,30,Rain
38630,43,1553443200,13,17,30,Rain
38631,44,1553443200,29,1,30,Rain
38632,45,1553443200,4,26,30,Rain
38633,46,1553443200,0,20,20,Rain
38634,47,1553443200,37,3,40,Rain
38635,48,1553443200,20,20,40,Rain
38636,49,1553443200,36,4,40,Rain
38637,50,1553443200,39,1,40,Rain
38638,51,1553443200,10,29,39,Rain
38639,52,1553443200,0,32,32,Rain
38640,53,1553443200,24,16,40,Rain
38641,54,1553443200,20,13,33,Rain
38642,55,1553443200,34,1,35,Rain
38643,56,1553443200,36,4,40,Rain
38644,57,1553443200,19,4,23,Rain
38645,58,1553443200,28,12,40,Rain
38646,59,1553443200,19,1,20,Rain
38647,60,1553443200,28,2,30,Rain
38648,61,1553443200,25,0,25,Rain
38649,62,1553443200,20,20,40,Rain
38650,63,1553443200,6,29,35,Rain
38651,64,1553443200,17,23,40,Rain
38652,65,1553443200,40,0,40,Rain
38653,66,1553443200,32,8,40,Rain
38654,67,1553443200,38,2,40,Rain
38655,68,1553443200,23,17,40,Rain
38656,69,1553443200,29,11,40,Rain
38657,70,1553443200,28,0,28,Rain
38658,71,1553443200,34,6,40,Rain
38659,72,1553443200,24,7,31,Rain
38660,73,1553443200,27,3,30,Rain
38661,74,1553443200,20,10,30,Rain
38662,75,1553443200,40,0,40,Rain
38663,76,1553443200,20,18,38,Rain
38664,77,1553443200,0,29,29,Rain
38665,78,1553443200,40,0,40,Rain
38666,79,1553443200,27,0,27,Rain
38667,80,1553443200,39,1,40,Rain
38668,81,1553443200,35,5,40,Rain
38669,82,1553443200,22,0,22,Rain
38670,83,1553443200,37,3,40,Rain
38671,84,1553443200,28,2,30,Rain
38672,85,1553443200,29,6,35,Rain
38673,86,1553443200,32,6,38,Rain
38674,87,1553443200,14,24,38,Rain
38675,88,1553443200,29,1,30,Rain
38676,89,1553443200,33,7,40,Rain
38677,90,1553443200,32,8,40,Rain
38678,91,1553443200,1,29,30,Rain
38679,92,1553443200,6,34,40,Rain
38680,93,1553443200,3,37,40,Rain
38681,94,1553443200,29,11,40,Rain
38682,95,1553443200,40,0,40,Rain
38683,96,1553443200,29,1,30,Rain
38684,97,1553443200,38,1,39,Rain
38685,98,1553443200,17,23,40,Rain
38686,99,1553443200,29,1,30,Rain
38687,100,1553443200,3,22,25,Rain
38688,101,1553443200,30,0,30,Rain
38689,102,1553443200,31,9,40,Rain
38690,103,1553443200,39,1,40,Rain
38691,104,1553443200,27,13,40,Rain
38692,105,1553443200,25,11,36,Rain
38693,106,1553443200,38,2,40,Rain
38694,107,1553443200,32,8,40,Rain
38695,108,1553443200,36,4,40,Rain
38696,109,1553443200,25,4,29,Rain
38697,110,1553443200,39,1,40,Rain
38698,111,1553443200,37,3,40,Rain
38699,112,1553443200,27,3,30,Rain
38700,113,1553443200,23,17,40,Rain
38701,114,1553443200,38,2,40,Rain
38702,115,1553443200,30,0,30,Rain
38703,2,1553446800,17,3,20,Rain
38704,3,1553446800,6,14,20,Rain
38705,4,1553446800,16,4,20,Rain
38706,5,1553446800,40,0,40,Rain
38707,6,1553446800,1,19,20,Rain
38708,7,1553446800,11,18,29,Rain
38709,8,1553446800,0,30,30,Rain
38710,9,1553446800,1,23,24,Rain
38711,10,1553446800,3,13,16,Rain
38712,11,1553446800,28,2,30,Rain
38713,12,1553446800,17,3,20,Rain
38714,13,1553446800,19,11,30,Rain
38715,14,1553446800,12,18,30,Rain
38716,15,1553446800,16,0,16,Rain
38717,16,1553446800,10,10,20,Rain
38718,17,1553446800,11,9,20,Rain
38719,18,1553446800,26,4,30,Rain
38720,19,1553446800,5,25,30,Rain
38721,21,1553446800,2,28,30,Rain
38722,22,1553446800,2,18,20,Rain
38723,23,1553446800,0,30,30,Rain
38724,24,1553446800,0,20,20,Rain
38725,25,1553446800,21,9,30,Rain
38726,26,1553446800,2,18,20,Rain
38727,27,1553446800,3,17,20,Rain
38728,28,1553446800,24,6,30,Rain
38729,29,1553446800,2,27,29,Rain
38730,30,1553446800,17,3,20,Rain
38731,31,1553446800,0,20,20,Rain
38732,32,1553446800,5,25,30,Rain
38733,33,1553446800,1,22,23,Rain
38734,34,1553446800,26,4,30,Rain
38735,35,1553446800,30,0,30,Rain
38736,36,1553446800,10,30,40,Rain
38737,37,1553446800,22,8,30,Rain
38738,38,1553446800,2,38,40,Rain
38739,39,1553446800,9,11,20,Rain
38740,40,1553446800,1,20,21,Rain
38741,41,1553446800,13,7,20,Rain
38742,42,1553446800,26,4,30,Rain
38743,43,1553446800,16,14,30,Rain
38744,44,1553446800,28,2,30,Rain
38745,45,1553446800,5,25,30,Rain
38746,46,1553446800,0,20,20,Rain
38747,47,1553446800,38,2,40,Rain
38748,48,1553446800,19,21,40,Rain
38749,49,1553446800,39,1,40,Rain
38750,50,1553446800,40,0,40,Rain
38751,51,1553446800,10,29,39,Rain
38752,52,1553446800,5,27,32,Rain
38753,53,1553446800,22,18,40,Rain
38754,54,1553446800,22,11,33,Rain
38755,55,1553446800,35,0,35,Rain
38756,56,1553446800,36,4,40,Rain
38757,57,1553446800,23,0,23,Rain
38758,58,1553446800,33,7,40,Rain
38759,59,1553446800,18,2,20,Rain
38760,60,1553446800,30,0,30,Rain
38761,61,1553446800,25,0,25,Rain
38762,62,1553446800,22,18,40,Rain
38763,63,1553446800,4,31,35,Rain
38764,64,1553446800,19,21,40,Rain
38765,65,1553446800,38,2,40,Rain
38766,66,1553446800,33,7,40,Rain
38767,67,1553446800,35,5,40,Rain
38768,68,1553446800,23,17,40,Rain
38769,69,1553446800,25,15,40,Rain
38770,70,1553446800,17,11,28,Rain
38771,71,1553446800,33,7,40,Rain
38772,72,1553446800,24,7,31,Rain
38773,73,1553446800,29,1,30,Rain
38774,74,1553446800,19,11,30,Rain
38775,75,1553446800,36,4,40,Rain
38776,76,1553446800,24,14,38,Rain
38777,77,1553446800,0,29,29,Rain
38778,78,1553446800,39,1,40,Rain
38779,79,1553446800,27,0,27,Rain
38780,80,1553446800,37,3,40,Rain
38781,81,1553446800,36,4,40,Rain
38782,82,1553446800,22,0,22,Rain
38783,83,1553446800,29,11,40,Rain
38784,84,1553446800,28,2,30,Rain
38785,85,1553446800,27,8,35,Rain
38786,86,1553446800,36,2,38,Rain
38787,87,1553446800,15,23,38,Rain
38788,88,1553446800,30,0,30,Rain
38789,89,1553446800,33,7,40,Rain
38790,90,1553446800,32,8,40,Rain
38791,91,1553446800,1,29,30,Rain
38792,92,1553446800,19,21,40,Rain
38793,93,1553446800,3,37,40,Rain
38794,94,1553446800,29,11,40,Rain
38795,95,1553446800,35,5,40,Rain
38796,96,1553446800,29,1,30,Rain
38797,97,1553446800,24,15,39,Rain
38798,98,1553446800,16,24,40,Rain
38799,99,1553446800,27,3,30,Rain
38800,100,1553446800,7,18,25,Rain
38801,101,1553446800,30,0,30,Rain
38802,102,1553446800,29,11,40,Rain
38803,103,1553446800,40,0,40,Rain
38804,104,1553446800,27,13,40,Rain
38805,105,1553446800,26,10,36,Rain
38806,106,1553446800,38,2,40,Rain
38807,107,1553446800,34,6,40,Rain
38808,108,1553446800,38,2,40,Rain
38809,109,1553446800,29,0,29,Rain
38810,110,1553446800,38,2,40,Rain
38811,111,1553446800,40,0,40,Rain
38812,112,1553446800,20,10,30,Rain
38813,113,1553446800,23,17,40,Rain
38814,114,1553446800,38,2,40,Rain
38815,115,1553446800,28,2,30,Rain
38816,2,1553450400,18,2,20,Clouds
38817,3,1553450400,2,18,20,Clouds
38818,4,1553450400,18,2,20,Clouds
38819,5,1553450400,38,2,40,Clouds
38820,6,1553450400,1,19,20,Clouds
38821,7,1553450400,14,15,29,Clouds
38822,8,1553450400,6,24,30,Clouds
38823,9,1553450400,8,16,24,Clouds
38824,10,1553450400,5,11,16,Clouds
38825,11,1553450400,27,3,30,Clouds
38826,12,1553450400,20,0,20,Clouds
38827,13,1553450400,18,12,30,Clouds
38828,14,1553450400,11,19,30,Clouds
38829,15,1553450400,16,0,16,Clouds
38830,16,1553450400,10,10,20,Clouds
38831,17,1553450400,13,7,20,Clouds
38832,18,1553450400,23,7,30,Clouds
38833,19,1553450400,12,18,30,Clouds
38834,21,1553450400,0,30,30,Clouds
38835,22,1553450400,1,19,20,Clouds
38836,23,1553450400,2,28,30,Clouds
38837,24,1553450400,1,19,20,Clouds
38838,25,1553450400,20,10,30,Clouds
38839,26,1553450400,0,20,20,Clouds
38840,27,1553450400,2,18,20,Clouds
38841,28,1553450400,30,0,30,Clouds
38842,29,1553450400,1,28,29,Clouds
38843,30,1553450400,18,2,20,Clouds
38844,31,1553450400,2,18,20,Clouds
38845,32,1553450400,7,23,30,Clouds
38846,33,1553450400,0,23,23,Clouds
38847,34,1553450400,26,4,30,Clouds
38848,35,1553450400,23,7,30,Clouds
38849,36,1553450400,10,30,40,Clouds
38850,37,1553450400,22,8,30,Clouds
38851,38,1553450400,5,35,40,Clouds
38852,39,1553450400,14,6,20,Clouds
38853,40,1553450400,1,20,21,Clouds
38854,41,1553450400,15,5,20,Clouds
38855,42,1553450400,25,5,30,Clouds
38856,43,1553450400,19,11,30,Clouds
38857,44,1553450400,28,2,30,Clouds
38858,45,1553450400,8,22,30,Clouds
38859,46,1553450400,2,18,20,Clouds
38860,47,1553450400,38,2,40,Clouds
38861,48,1553450400,13,27,40,Clouds
38862,49,1553450400,34,6,40,Clouds
38863,50,1553450400,40,0,40,Clouds
38864,51,1553450400,12,27,39,Clouds
38865,52,1553450400,8,24,32,Clouds
38866,53,1553450400,23,17,40,Clouds
38867,54,1553450400,21,12,33,Clouds
38868,55,1553450400,33,2,35,Clouds
38869,56,1553450400,36,4,40,Clouds
38870,57,1553450400,22,1,23,Clouds
38871,58,1553450400,40,0,40,Clouds
38872,59,1553450400,20,0,20,Clouds
38873,60,1553450400,30,0,30,Clouds
38874,61,1553450400,23,2,25,Clouds
38875,62,1553450400,20,20,40,Clouds
38876,63,1553450400,3,32,35,Clouds
38877,64,1553450400,18,22,40,Clouds
38878,65,1553450400,39,1,40,Clouds
38879,66,1553450400,37,3,40,Clouds
38880,67,1553450400,36,4,40,Clouds
38881,68,1553450400,20,20,40,Clouds
38882,69,1553450400,17,23,40,Clouds
38883,70,1553450400,12,16,28,Clouds
38884,71,1553450400,30,10,40,Clouds
38885,72,1553450400,21,10,31,Clouds
38886,73,1553450400,25,5,30,Clouds
38887,74,1553450400,18,12,30,Clouds
38888,75,1553450400,36,4,40,Clouds
38889,76,1553450400,23,15,38,Clouds
38890,77,1553450400,1,28,29,Clouds
38891,78,1553450400,39,1,40,Clouds
38892,79,1553450400,26,1,27,Clouds
38893,80,1553450400,36,4,40,Clouds
38894,81,1553450400,36,4,40,Clouds
38895,82,1553450400,21,1,22,Clouds
38896,83,1553450400,32,8,40,Clouds
38897,84,1553450400,25,5,30,Clouds
38898,85,1553450400,28,7,35,Clouds
38899,86,1553450400,38,0,38,Clouds
38900,87,1553450400,15,23,38,Clouds
38901,88,1553450400,28,2,30,Clouds
38902,89,1553450400,33,7,40,Clouds
38903,90,1553450400,33,7,40,Clouds
38904,91,1553450400,3,27,30,Clouds
38905,92,1553450400,21,19,40,Clouds
38906,93,1553450400,3,37,40,Clouds
38907,94,1553450400,29,11,40,Clouds
38908,95,1553450400,39,1,40,Clouds
38909,96,1553450400,29,1,30,Clouds
38910,97,1553450400,26,13,39,Clouds
38911,98,1553450400,18,22,40,Clouds
38912,99,1553450400,29,1,30,Clouds
38913,100,1553450400,2,23,25,Clouds
38914,101,1553450400,24,6,30,Clouds
38915,102,1553450400,27,13,40,Clouds
38916,103,1553450400,40,0,40,Clouds
38917,104,1553450400,28,12,40,Clouds
38918,105,1553450400,28,8,36,Clouds
38919,106,1553450400,38,2,40,Clouds
38920,107,1553450400,34,6,40,Clouds
38921,108,1553450400,36,4,40,Clouds
38922,109,1553450400,28,1,29,Clouds
38923,110,1553450400,40,0,40,Clouds
38924,111,1553450400,39,1,40,Clouds
38925,112,1553450400,23,7,30,Clouds
38926,113,1553450400,20,20,40,Clouds
38927,114,1553450400,40,0,40,Clouds
38928,115,1553450400,29,1,30,Clouds
38929,2,1553454000,19,1,20,Clouds
38930,3,1553454000,1,19,20,Clouds
38931,4,1553454000,13,7,20,Clouds
38932,5,1553454000,35,5,40,Clouds
38933,6,1553454000,2,18,20,Clouds
38934,7,1553454000,14,15,29,Clouds
38935,8,1553454000,6,24,30,Clouds
38936,9,1553454000,13,11,24,Clouds
38937,10,1553454000,1,15,16,Clouds
38938,11,1553454000,26,4,30,Clouds
38939,12,1553454000,18,2,20,Clouds
38940,13,1553454000,20,10,30,Clouds
38941,14,1553454000,10,20,30,Clouds
38942,15,1553454000,16,0,16,Clouds
38943,16,1553454000,11,9,20,Clouds
38944,17,1553454000,15,5,20,Clouds
38945,18,1553454000,22,8,30,Clouds
38946,19,1553454000,10,20,30,Clouds
38947,21,1553454000,0,30,30,Clouds
38948,22,1553454000,5,15,20,Clouds
38949,23,1553454000,0,30,30,Clouds
38950,24,1553454000,0,19,19,Clouds
38951,25,1553454000,19,11,30,Clouds
38952,26,1553454000,1,19,20,Clouds
38953,27,1553454000,5,15,20,Clouds
38954,28,1553454000,29,1,30,Clouds
38955,29,1553454000,1,28,29,Clouds
38956,30,1553454000,19,1,20,Clouds
38957,31,1553454000,2,18,20,Clouds
38958,32,1553454000,7,23,30,Clouds
38959,33,1553454000,0,23,23,Clouds
38960,34,1553454000,22,8,30,Clouds
38961,35,1553454000,20,10,30,Clouds
38962,36,1553454000,10,30,40,Clouds
38963,37,1553454000,20,10,30,Clouds
38964,38,1553454000,1,39,40,Clouds
38965,39,1553454000,17,3,20,Clouds
38966,40,1553454000,2,19,21,Clouds
38967,41,1553454000,16,4,20,Clouds
38968,42,1553454000,24,6,30,Clouds
38969,43,1553454000,17,13,30,Clouds
38970,44,1553454000,29,1,30,Clouds
38971,45,1553454000,6,24,30,Clouds
38972,46,1553454000,1,19,20,Clouds
38973,47,1553454000,40,0,40,Clouds
38974,48,1553454000,6,34,40,Clouds
38975,49,1553454000,36,4,40,Clouds
38976,50,1553454000,35,5,40,Clouds
38977,51,1553454000,12,27,39,Clouds
38978,52,1553454000,9,23,32,Clouds
38979,53,1553454000,23,17,40,Clouds
38980,54,1553454000,11,22,33,Clouds
38981,55,1553454000,34,1,35,Clouds
38982,56,1553454000,39,1,40,Clouds
38983,57,1553454000,21,2,23,Clouds
38984,58,1553454000,37,3,40,Clouds
38985,59,1553454000,16,4,20,Clouds
38986,60,1553454000,28,2,30,Clouds
38987,61,1553454000,23,2,25,Clouds
38988,62,1553454000,22,18,40,Clouds
38989,63,1553454000,2,33,35,Clouds
38990,64,1553454000,18,22,40,Clouds
38991,65,1553454000,40,0,40,Clouds
38992,66,1553454000,34,6,40,Clouds
38993,67,1553454000,34,6,40,Clouds
38994,68,1553454000,26,14,40,Clouds
38995,69,1553454000,12,28,40,Clouds
38996,70,1553454000,6,22,28,Clouds
38997,71,1553454000,31,9,40,Clouds
38998,72,1553454000,22,9,31,Clouds
38999,73,1553454000,22,8,30,Clouds
39000,74,1553454000,18,12,30,Clouds
39001,75,1553454000,37,3,40,Clouds
39002,76,1553454000,27,11,38,Clouds
39003,77,1553454000,5,24,29,Clouds
39004,78,1553454000,40,0,40,Clouds
39005,79,1553454000,26,1,27,Clouds
39006,80,1553454000,37,3,40,Clouds
39007,81,1553454000,36,4,40,Clouds
39008,82,1553454000,20,2,22,Clouds
39009,83,1553454000,31,9,40,Clouds
39010,84,1553454000,27,3,30,Clouds
39011,85,1553454000,28,7,35,Clouds
39012,86,1553454000,35,3,38,Clouds
39013,87,1553454000,12,26,38,Clouds
39014,88,1553454000,28,2,30,Clouds
39015,89,1553454000,33,7,40,Clouds
39016,90,1553454000,35,5,40,Clouds
39017,91,1553454000,3,27,30,Clouds
39018,92,1553454000,24,16,40,Clouds
39019,93,1553454000,3,37,40,Clouds
39020,94,1553454000,29,11,40,Clouds
39021,95,1553454000,38,2,40,Clouds
39022,96,1553454000,29,1,30,Clouds
39023,97,1553454000,25,14,39,Clouds
39024,98,1553454000,17,23,40,Clouds
39025,99,1553454000,29,1,30,Clouds
39026,100,1553454000,9,16,25,Clouds
39027,101,1553454000,26,4,30,Clouds
39028,102,1553454000,28,12,40,Clouds
39029,103,1553454000,40,0,40,Clouds
39030,104,1553454000,28,12,40,Clouds
39031,105,1553454000,28,8,36,Clouds
39032,106,1553454000,38,2,40,Clouds
39033,107,1553454000,32,8,40,Clouds
39034,108,1553454000,37,3,40,Clouds
39035,109,1553454000,27,2,29,Clouds
39036,110,1553454000,39,1,40,Clouds
39037,111,1553454000,38,2,40,Clouds
39038,112,1553454000,27,3,30,Clouds
39039,113,1553454000,20,20,40,Clouds
39040,114,1553454000,39,1,40,Clouds
39041,115,1553454000,29,1,30,Clouds
39042,2,1553457600,19,1,20,Clouds
39043,3,1553457600,1,19,20,Clouds
39044,4,1553457600,11,9,20,Clouds
39045,5,1553457600,35,5,40,Clouds
39046,6,1553457600,1,19,20,Clouds
39047,7,1553457600,13,16,29,Clouds
39048,8,1553457600,8,21,29,Clouds
39049,9,1553457600,22,2,24,Clouds
39050,10,1553457600,5,11,16,Clouds
39051,11,1553457600,25,5,30,Clouds
39052,12,1553457600,19,1,20,Clouds
39053,13,1553457600,19,11,30,Clouds
39054,14,1553457600,12,18,30,Clouds
39055,15,1553457600,14,2,16,Clouds
39056,16,1553457600,9,11,20,Clouds
39057,17,1553457600,14,6,20,Clouds
39058,18,1553457600,22,8,30,Clouds
39059,19,1553457600,10,20,30,Clouds
39060,21,1553457600,5,25,30,Clouds
39061,22,1553457600,4,16,20,Clouds
39062,23,1553457600,5,25,30,Clouds
39063,24,1553457600,8,11,19,Clouds
39064,25,1553457600,18,12,30,Clouds
39065,26,1553457600,1,19,20,Clouds
39066,27,1553457600,10,10,20,Clouds
39067,28,1553457600,25,5,30,Clouds
39068,29,1553457600,3,26,29,Clouds
39069,30,1553457600,19,1,20,Clouds
39070,31,1553457600,10,10,20,Clouds
39071,32,1553457600,9,21,30,Clouds
39072,33,1553457600,7,16,23,Clouds
39073,34,1553457600,20,10,30,Clouds
39074,35,1553457600,23,7,30,Clouds
39075,36,1553457600,10,30,40,Clouds
39076,37,1553457600,20,10,30,Clouds
39077,38,1553457600,12,28,40,Clouds
39078,39,1553457600,14,6,20,Clouds
39079,40,1553457600,5,16,21,Clouds
39080,41,1553457600,15,5,20,Clouds
39081,42,1553457600,18,12,30,Clouds
39082,43,1553457600,15,15,30,Clouds
39083,44,1553457600,26,4,30,Clouds
39084,45,1553457600,5,25,30,Clouds
39085,46,1553457600,1,19,20,Clouds
39086,47,1553457600,40,0,40,Clouds
39087,48,1553457600,7,33,40,Clouds
39088,49,1553457600,40,0,40,Clouds
39089,50,1553457600,33,7,40,Clouds
39090,51,1553457600,15,24,39,Clouds
39091,52,1553457600,10,22,32,Clouds
39092,53,1553457600,20,20,40,Clouds
39093,54,1553457600,10,23,33,Clouds
39094,55,1553457600,34,1,35,Clouds
39095,56,1553457600,40,0,40,Clouds
39096,57,1553457600,23,0,23,Clouds
39097,58,1553457600,36,4,40,Clouds
39098,59,1553457600,18,2,20,Clouds
39099,60,1553457600,26,4,30,Clouds
39100,61,1553457600,22,3,25,Clouds
39101,62,1553457600,23,17,40,Clouds
39102,63,1553457600,3,32,35,Clouds
39103,64,1553457600,17,23,40,Clouds
39104,65,1553457600,39,1,40,Clouds
39105,66,1553457600,35,5,40,Clouds
39106,67,1553457600,35,5,40,Clouds
39107,68,1553457600,23,17,40,Clouds
39108,69,1553457600,0,40,40,Clouds
39109,70,1553457600,4,24,28,Clouds
39110,71,1553457600,29,11,40,Clouds
39111,72,1553457600,18,13,31,Clouds
39112,73,1553457600,23,7,30,Clouds
39113,74,1553457600,15,15,30,Clouds
39114,75,1553457600,34,6,40,Clouds
39115,76,1553457600,27,11,38,Clouds
39116,77,1553457600,4,25,29,Clouds
39117,78,1553457600,37,3,40,Clouds
39118,79,1553457600,25,2,27,Clouds
39119,80,1553457600,38,2,40,Clouds
39120,81,1553457600,36,4,40,Clouds
39121,82,1553457600,20,2,22,Clouds
39122,83,1553457600,27,13,40,Clouds
39123,84,1553457600,26,4,30,Clouds
39124,85,1553457600,21,14,35,Clouds
39125,86,1553457600,34,4,38,Clouds
39126,87,1553457600,18,20,38,Clouds
39127,88,1553457600,29,1,30,Clouds
39128,89,1553457600,35,5,40,Clouds
39129,90,1553457600,36,4,40,Clouds
39130,91,1553457600,0,30,30,Clouds
39131,92,1553457600,21,19,40,Clouds
39132,93,1553457600,5,35,40,Clouds
39133,94,1553457600,29,11,40,Clouds
39134,95,1553457600,40,0,40,Clouds
39135,96,1553457600,29,1,30,Clouds
39136,97,1553457600,26,13,39,Clouds
39137,98,1553457600,18,22,40,Clouds
39138,99,1553457600,28,2,30,Clouds
39139,100,1553457600,15,10,25,Clouds
39140,101,1553457600,26,4,30,Clouds
39141,102,1553457600,27,13,40,Clouds
39142,103,1553457600,39,1,40,Clouds
39143,104,1553457600,27,13,40,Clouds
39144,105,1553457600,27,9,36,Clouds
39145,106,1553457600,38,2,40,Clouds
39146,107,1553457600,33,7,40,Clouds
39147,108,1553457600,37,3,40,Clouds
39148,109,1553457600,29,0,29,Clouds
39149,110,1553457600,39,1,40,Clouds
39150,111,1553457600,37,3,40,Clouds
39151,112,1553457600,20,10,30,Clouds
39152,113,1553457600,20,20,40,Clouds
39153,114,1553457600,40,0,40,Clouds
39154,115,1553457600,18,12,30,Clouds
39155,2,1553461200,19,1,20,Clouds
39156,3,1553461200,1,19,20,Clouds
39157,4,1553461200,9,11,20,Clouds
39158,5,1553461200,36,4,40,Clouds
39159,6,1553461200,1,19,20,Clouds
39160,7,1553461200,9,20,29,Clouds
39161,8,1553461200,11,19,30,Clouds
39162,9,1553461200,20,4,24,Clouds
39163,10,1553461200,10,6,16,Clouds
39164,11,1553461200,26,4,30,Clouds
39165,12,1553461200,18,2,20,Clouds
39166,13,1553461200,19,11,30,Clouds
39167,14,1553461200,15,15,30,Clouds
39168,15,1553461200,15,1,16,Clouds
39169,16,1553461200,10,10,20,Clouds
39170,17,1553461200,14,6,20,Clouds
39171,18,1553461200,21,9,30,Clouds
39172,19,1553461200,8,22,30,Clouds
39173,21,1553461200,5,25,30,Clouds
39174,22,1553461200,5,15,20,Clouds
39175,23,1553461200,9,21,30,Clouds
39176,24,1553461200,3,15,18,Clouds
39177,25,1553461200,23,7,30,Clouds
39178,26,1553461200,3,17,20,Clouds
39179,27,1553461200,13,7,20,Clouds
39180,28,1553461200,27,3,30,Clouds
39181,29,1553461200,9,20,29,Clouds
39182,30,1553461200,18,2,20,Clouds
39183,31,1553461200,10,9,19,Clouds
39184,32,1553461200,16,14,30,Clouds
39185,33,1553461200,14,9,23,Clouds
39186,34,1553461200,12,18,30,Clouds
39187,35,1553461200,21,9,30,Clouds
39188,36,1553461200,12,28,40,Clouds
39189,37,1553461200,21,9,30,Clouds
39190,38,1553461200,14,26,40,Clouds
39191,39,1553461200,15,5,20,Clouds
39192,40,1553461200,8,13,21,Clouds
39193,41,1553461200,15,5,20,Clouds
39194,42,1553461200,21,9,30,Clouds
39195,43,1553461200,11,19,30,Clouds
39196,44,1553461200,25,5,30,Clouds
39197,45,1553461200,3,27,30,Clouds
39198,46,1553461200,3,17,20,Clouds
39199,47,1553461200,40,0,40,Clouds
39200,48,1553461200,4,36,40,Clouds
39201,49,1553461200,39,1,40,Clouds
39202,50,1553461200,31,9,40,Clouds
39203,51,1553461200,17,22,39,Clouds
39204,52,1553461200,16,16,32,Clouds
39205,53,1553461200,20,20,40,Clouds
39206,54,1553461200,7,26,33,Clouds
39207,55,1553461200,34,1,35,Clouds
39208,56,1553461200,36,4,40,Clouds
39209,57,1553461200,22,1,23,Clouds
39210,58,1553461200,36,4,40,Clouds
39211,59,1553461200,19,1,20,Clouds
39212,60,1553461200,26,4,30,Clouds
39213,61,1553461200,20,5,25,Clouds
39214,62,1553461200,21,19,40,Clouds
39215,63,1553461200,6,29,35,Clouds
39216,64,1553461200,20,20,40,Clouds
39217,65,1553461200,40,0,40,Clouds
39218,66,1553461200,32,8,40,Clouds
39219,67,1553461200,26,14,40,Clouds
39220,68,1553461200,20,20,40,Clouds
39221,69,1553461200,2,38,40,Clouds
39222,70,1553461200,5,23,28,Clouds
39223,71,1553461200,27,13,40,Clouds
39224,72,1553461200,15,16,31,Clouds
39225,73,1553461200,18,12,30,Clouds
39226,74,1553461200,15,15,30,Clouds
39227,75,1553461200,37,3,40,Clouds
39228,76,1553461200,28,10,38,Clouds
39229,77,1553461200,5,24,29,Clouds
39230,78,1553461200,34,6,40,Clouds
39231,79,1553461200,27,0,27,Clouds
39232,80,1553461200,40,0,40,Clouds
39233,81,1553461200,35,5,40,Clouds
39234,82,1553461200,20,2,22,Clouds
39235,83,1553461200,25,15,40,Clouds
39236,84,1553461200,24,6,30,Clouds
39237,85,1553461200,18,17,35,Clouds
39238,86,1553461200,33,5,38,Clouds
39239,87,1553461200,18,20,38,Clouds
39240,88,1553461200,28,2,30,Clouds
39241,89,1553461200,37,3,40,Clouds
39242,90,1553461200,35,5,40,Clouds
39243,91,1553461200,0,30,30,Clouds
39244,92,1553461200,20,20,40,Clouds
39245,93,1553461200,6,34,40,Clouds
39246,94,1553461200,29,11,40,Clouds
39247,95,1553461200,40,0,40,Clouds
39248,96,1553461200,27,3,30,Clouds
39249,97,1553461200,22,17,39,Clouds
39250,98,1553461200,19,21,40,Clouds
39251,99,1553461200,26,4,30,Clouds
39252,100,1553461200,22,3,25,Clouds
39253,101,1553461200,19,11,30,Clouds
39254,102,1553461200,30,10,40,Clouds
39255,103,1553461200,30,10,40,Clouds
39256,104,1553461200,27,13,40,Clouds
39257,105,1553461200,28,8,36,Clouds
39258,106,1553461200,35,5,40,Clouds
39259,107,1553461200,31,9,40,Clouds
39260,108,1553461200,33,7,40,Clouds
39261,109,1553461200,24,5,29,Clouds
39262,110,1553461200,29,11,40,Clouds
39263,111,1553461200,38,2,40,Clouds
39264,112,1553461200,19,11,30,Clouds
39265,113,1553461200,20,20,40,Clouds
39266,114,1553461200,40,0,40,Clouds
39267,115,1553461200,13,17,30,Clouds
39268,2,1553464800,17,3,20,Clouds
39269,3,1553464800,0,20,20,Clouds
39270,4,1553464800,8,12,20,Clouds
39271,5,1553464800,34,6,40,Clouds
39272,6,1553464800,1,19,20,Clouds
39273,7,1553464800,8,21,29,Clouds
39274,8,1553464800,12,18,30,Clouds
39275,9,1553464800,21,3,24,Clouds
39276,10,1553464800,9,7,16,Clouds
39277,11,1553464800,25,5,30,Clouds
39278,12,1553464800,14,6,20,Clouds
39279,13,1553464800,19,11,30,Clouds
39280,14,1553464800,12,18,30,Clouds
39281,15,1553464800,15,1,16,Clouds
39282,16,1553464800,13,7,20,Clouds
39283,17,1553464800,13,7,20,Clouds
39284,18,1553464800,16,14,30,Clouds
39285,19,1553464800,6,24,30,Clouds
39286,21,1553464800,8,22,30,Clouds
39287,22,1553464800,5,15,20,Clouds
39288,23,1553464800,12,18,30,Clouds
39289,24,1553464800,5,14,19,Clouds
39290,25,1553464800,24,6,30,Clouds
39291,26,1553464800,3,17,20,Clouds
39292,27,1553464800,14,6,20,Clouds
39293,28,1553464800,29,1,30,Clouds
39294,29,1553464800,12,17,29,Clouds
39295,30,1553464800,17,3,20,Clouds
39296,31,1553464800,18,2,20,Clouds
39297,32,1553464800,19,11,30,Clouds
39298,33,1553464800,14,9,23,Clouds
39299,34,1553464800,11,19,30,Clouds
39300,35,1553464800,23,7,30,Clouds
39301,36,1553464800,11,29,40,Clouds
39302,37,1553464800,20,10,30,Clouds
39303,38,1553464800,18,22,40,Clouds
39304,39,1553464800,19,1,20,Clouds
39305,40,1553464800,9,12,21,Clouds
39306,41,1553464800,15,5,20,Clouds
39307,42,1553464800,26,4,30,Clouds
39308,43,1553464800,7,23,30,Clouds
39309,44,1553464800,23,7,30,Clouds
39310,45,1553464800,4,26,30,Clouds
39311,46,1553464800,9,11,20,Clouds
39312,47,1553464800,40,0,40,Clouds
39313,48,1553464800,9,31,40,Clouds
39314,49,1553464800,36,4,40,Clouds
39315,50,1553464800,30,10,40,Clouds
39316,51,1553464800,18,22,40,Clouds
39317,52,1553464800,15,17,32,Clouds
39318,53,1553464800,20,20,40,Clouds
39319,54,1553464800,8,25,33,Clouds
39320,55,1553464800,34,1,35,Clouds
39321,56,1553464800,37,3,40,Clouds
39322,57,1553464800,22,1,23,Clouds
39323,58,1553464800,34,6,40,Clouds
39324,59,1553464800,19,1,20,Clouds
39325,60,1553464800,17,13,30,Clouds
39326,61,1553464800,23,2,25,Clouds
39327,62,1553464800,21,19,40,Clouds
39328,63,1553464800,7,28,35,Clouds
39329,64,1553464800,17,23,40,Clouds
39330,65,1553464800,38,2,40,Clouds
39331,66,1553464800,32,8,40,Clouds
39332,67,1553464800,25,15,40,Clouds
39333,68,1553464800,26,14,40,Clouds
39334,69,1553464800,0,40,40,Clouds
39335,70,1553464800,0,28,28,Clouds
39336,71,1553464800,24,16,40,Clouds
39337,72,1553464800,13,18,31,Clouds
39338,73,1553464800,18,12,30,Clouds
39339,74,1553464800,13,17,30,Clouds
39340,75,1553464800,40,0,40,Clouds
39341,76,1553464800,27,11,38,Clouds
39342,77,1553464800,2,27,29,Clouds
39343,78,1553464800,34,6,40,Clouds
39344,79,1553464800,27,0,27,Clouds
39345,80,1553464800,32,8,40,Clouds
39346,81,1553464800,26,14,40,Clouds
39347,82,1553464800,22,0,22,Clouds
39348,83,1553464800,26,14,40,Clouds
39349,84,1553464800,24,6,30,Clouds
39350,85,1553464800,18,17,35,Clouds
39351,86,1553464800,34,4,38,Clouds
39352,87,1553464800,18,20,38,Clouds
39353,88,1553464800,22,8,30,Clouds
39354,89,1553464800,36,4,40,Clouds
39355,90,1553464800,35,5,40,Clouds
39356,91,1553464800,22,8,30,Clouds
39357,92,1553464800,21,19,40,Clouds
39358,93,1553464800,8,32,40,Clouds
39359,94,1553464800,29,11,40,Clouds
39360,95,1553464800,38,2,40,Clouds
39361,96,1553464800,28,2,30,Clouds
39362,97,1553464800,21,18,39,Clouds
39363,98,1553464800,19,21,40,Clouds
39364,99,1553464800,26,4,30,Clouds
39365,100,1553464800,25,0,25,Clouds
39366,101,1553464800,16,14,30,Clouds
39367,102,1553464800,30,10,40,Clouds
39368,103,1553464800,30,10,40,Clouds
39369,104,1553464800,27,13,40,Clouds
39370,105,1553464800,28,8,36,Clouds
39371,106,1553464800,35,5,40,Clouds
39372,107,1553464800,33,7,40,Clouds
39373,108,1553464800,35,5,40,Clouds
39374,109,1553464800,26,3,29,Clouds
39375,110,1553464800,31,9,40,Clouds
39376,111,1553464800,36,4,40,Clouds
39377,112,1553464800,13,17,30,Clouds
39378,113,1553464800,20,20,40,Clouds
39379,114,1553464800,40,0,40,Clouds
39380,115,1553464800,6,24,30,Clouds
39381,2,1553468400,18,2,20,Clouds
39382,3,1553468400,1,19,20,Clouds
39383,4,1553468400,8,12,20,Clouds
39384,5,1553468400,39,1,40,Clouds
39385,6,1553468400,6,14,20,Clouds
39386,7,1553468400,6,23,29,Clouds
39387,8,1553468400,14,16,30,Clouds
39388,9,1553468400,24,0,24,Clouds
39389,10,1553468400,8,8,16,Clouds
39390,11,1553468400,25,5,30,Clouds
39391,12,1553468400,4,16,20,Clouds
39392,13,1553468400,20,10,30,Clouds
39393,14,1553468400,16,14,30,Clouds
39394,15,1553468400,12,4,16,Clouds
39395,16,1553468400,19,1,20,Clouds
39396,17,1553468400,13,7,20,Clouds
39397,18,1553468400,16,14,30,Clouds
39398,19,1553468400,5,25,30,Clouds
39399,21,1553468400,9,21,30,Clouds
39400,22,1553468400,7,13,20,Clouds
39401,23,1553468400,13,17,30,Clouds
39402,24,1553468400,4,16,20,Clouds
39403,25,1553468400,24,6,30,Clouds
39404,26,1553468400,3,17,20,Clouds
39405,27,1553468400,15,5,20,Clouds
39406,28,1553468400,30,0,30,Clouds
39407,29,1553468400,10,19,29,Clouds
39408,30,1553468400,17,3,20,Clouds
39409,31,1553468400,19,1,20,Clouds
39410,32,1553468400,20,10,30,Clouds
39411,33,1553468400,20,3,23,Clouds
39412,34,1553468400,7,23,30,Clouds
39413,35,1553468400,23,7,30,Clouds
39414,36,1553468400,11,29,40,Clouds
39415,37,1553468400,20,10,30,Clouds
39416,38,1553468400,23,17,40,Clouds
39417,39,1553468400,19,1,20,Clouds
39418,40,1553468400,11,10,21,Clouds
39419,41,1553468400,15,5,20,Clouds
39420,42,1553468400,26,4,30,Clouds
39421,43,1553468400,7,23,30,Clouds
39422,44,1553468400,25,5,30,Clouds
39423,45,1553468400,4,26,30,Clouds
39424,46,1553468400,13,7,20,Clouds
39425,47,1553468400,40,0,40,Clouds
39426,48,1553468400,13,27,40,Clouds
39427,49,1553468400,34,6,40,Clouds
39428,50,1553468400,29,11,40,Clouds
39429,51,1553468400,18,22,40,Clouds
39430,52,1553468400,15,17,32,Clouds
39431,53,1553468400,20,20,40,Clouds
39432,54,1553468400,9,24,33,Clouds
39433,55,1553468400,34,1,35,Clouds
39434,56,1553468400,35,5,40,Clouds
39435,57,1553468400,21,2,23,Clouds
39436,58,1553468400,29,11,40,Clouds
39437,59,1553468400,18,2,20,Clouds
39438,60,1553468400,14,16,30,Clouds
39439,61,1553468400,22,3,25,Clouds
39440,62,1553468400,20,20,40,Clouds
39441,63,1553468400,8,27,35,Clouds
39442,64,1553468400,16,24,40,Clouds
39443,65,1553468400,38,2,40,Clouds
39444,66,1553468400,30,10,40,Clouds
39445,67,1553468400,26,14,40,Clouds
39446,68,1553468400,22,18,40,Clouds
39447,69,1553468400,13,27,40,Clouds
39448,70,1553468400,7,21,28,Clouds
39449,71,1553468400,21,19,40,Clouds
39450,72,1553468400,14,17,31,Clouds
39451,73,1553468400,18,12,30,Clouds
39452,74,1553468400,13,17,30,Clouds
39453,75,1553468400,40,0,40,Clouds
39454,76,1553468400,27,11,38,Clouds
39455,77,1553468400,0,29,29,Clouds
39456,78,1553468400,32,8,40,Clouds
39457,79,1553468400,15,12,27,Clouds
39458,80,1553468400,32,8,40,Clouds
39459,81,1553468400,26,14,40,Clouds
39460,82,1553468400,19,3,22,Clouds
39461,83,1553468400,27,13,40,Clouds
39462,84,1553468400,21,9,30,Clouds
39463,85,1553468400,20,15,35,Clouds
39464,86,1553468400,37,1,38,Clouds
39465,87,1553468400,15,23,38,Clouds
39466,88,1553468400,23,7,30,Clouds
39467,89,1553468400,36,4,40,Clouds
39468,90,1553468400,35,5,40,Clouds
39469,91,1553468400,16,14,30,Clouds
39470,92,1553468400,21,19,40,Clouds
39471,93,1553468400,9,31,40,Clouds
39472,94,1553468400,29,11,40,Clouds
39473,95,1553468400,40,0,40,Clouds
39474,96,1553468400,27,3,30,Clouds
39475,97,1553468400,22,17,39,Clouds
39476,98,1553468400,19,21,40,Clouds
39477,99,1553468400,27,3,30,Clouds
39478,100,1553468400,24,1,25,Clouds
39479,101,1553468400,11,19,30,Clouds
39480,102,1553468400,28,12,40,Clouds
39481,103,1553468400,31,9,40,Clouds
39482,104,1553468400,28,12,40,Clouds
39483,105,1553468400,28,8,36,Clouds
39484,106,1553468400,34,6,40,Clouds
39485,107,1553468400,32,8,40,Clouds
39486,108,1553468400,34,6,40,Clouds
39487,109,1553468400,27,2,29,Clouds
39488,110,1553468400,30,10,40,Clouds
39489,111,1553468400,35,5,40,Clouds
39490,112,1553468400,10,20,30,Clouds
39491,113,1553468400,20,20,40,Clouds
39492,114,1553468400,40,0,40,Clouds
39493,115,1553468400,3,27,30,Clouds
39494,2,1553472000,19,1,20,Clouds
39495,3,1553472000,6,14,20,Clouds
39496,4,1553472000,6,14,20,Clouds
39497,5,1553472000,35,5,40,Clouds
39498,6,1553472000,7,13,20,Clouds
39499,7,1553472000,9,20,29,Clouds
39500,8,1553472000,13,17,30,Clouds
39501,9,1553472000,24,0,24,Clouds
39502,10,1553472000,16,0,16,Clouds
39503,11,1553472000,26,4,30,Clouds
39504,12,1553472000,4,16,20,Clouds
39505,13,1553472000,20,10,30,Clouds
39506,14,1553472000,21,9,30,Clouds
39507,15,1553472000,11,5,16,Clouds
39508,16,1553472000,19,1,20,Clouds
39509,17,1553472000,14,6,20,Clouds
39510,18,1553472000,12,18,30,Clouds
39511,19,1553472000,8,22,30,Clouds
39512,21,1553472000,10,20,30,Clouds
39513,22,1553472000,11,9,20,Clouds
39514,23,1553472000,16,14,30,Clouds
39515,24,1553472000,7,13,20,Clouds
39516,25,1553472000,27,3,30,Clouds
39517,26,1553472000,1,19,20,Clouds
39518,27,1553472000,19,1,20,Clouds
39519,28,1553472000,30,0,30,Clouds
39520,29,1553472000,9,20,29,Clouds
39521,30,1553472000,18,2,20,Clouds
39522,31,1553472000,18,2,20,Clouds
39523,32,1553472000,20,10,30,Clouds
39524,33,1553472000,23,0,23,Clouds
39525,34,1553472000,7,23,30,Clouds
39526,35,1553472000,20,10,30,Clouds
39527,36,1553472000,29,11,40,Clouds
39528,37,1553472000,21,9,30,Clouds
39529,38,1553472000,24,16,40,Clouds
39530,39,1553472000,20,0,20,Clouds
39531,40,1553472000,12,9,21,Clouds
39532,41,1553472000,14,6,20,Clouds
39533,42,1553472000,30,0,30,Clouds
39534,43,1553472000,3,27,30,Clouds
39535,44,1553472000,26,4,30,Clouds
39536,45,1553472000,3,27,30,Clouds
39537,46,1553472000,19,1,20,Clouds
39538,47,1553472000,40,0,40,Clouds
39539,48,1553472000,14,26,40,Clouds
39540,49,1553472000,33,7,40,Clouds
39541,50,1553472000,23,17,40,Clouds
39542,51,1553472000,19,21,40,Clouds
39543,52,1553472000,17,15,32,Clouds
39544,53,1553472000,20,20,40,Clouds
39545,54,1553472000,13,20,33,Clouds
39546,55,1553472000,34,1,35,Clouds
39547,56,1553472000,32,8,40,Clouds
39548,57,1553472000,22,1,23,Clouds
39549,58,1553472000,27,13,40,Clouds
39550,59,1553472000,19,1,20,Clouds
39551,60,1553472000,10,20,30,Clouds
39552,61,1553472000,23,2,25,Clouds
39553,62,1553472000,18,22,40,Clouds
39554,63,1553472000,9,26,35,Clouds
39555,64,1553472000,15,25,40,Clouds
39556,65,1553472000,38,2,40,Clouds
39557,66,1553472000,22,18,40,Clouds
39558,67,1553472000,30,10,40,Clouds
39559,68,1553472000,22,18,40,Clouds
39560,69,1553472000,17,23,40,Clouds
39561,70,1553472000,3,25,28,Clouds
39562,71,1553472000,15,25,40,Clouds
39563,72,1553472000,15,16,31,Clouds
39564,73,1553472000,17,13,30,Clouds
39565,74,1553472000,14,16,30,Clouds
39566,75,1553472000,38,2,40,Clouds
39567,76,1553472000,30,8,38,Clouds
39568,77,1553472000,1,28,29,Clouds
39569,78,1553472000,31,9,40,Clouds
39570,79,1553472000,16,11,27,Clouds
39571,80,1553472000,29,11,40,Clouds
39572,81,1553472000,26,14,40,Clouds
39573,82,1553472000,19,3,22,Clouds
39574,83,1553472000,28,12,40,Clouds
39575,84,1553472000,19,11,30,Clouds
39576,85,1553472000,19,16,35,Clouds
39577,86,1553472000,38,0,38,Clouds
39578,87,1553472000,14,24,38,Clouds
39579,88,1553472000,22,8,30,Clouds
39580,89,1553472000,36,4,40,Clouds
39581,90,1553472000,34,6,40,Clouds
39582,91,1553472000,13,17,30,Clouds
39583,92,1553472000,17,23,40,Clouds
39584,93,1553472000,9,31,40,Clouds
39585,94,1553472000,29,11,40,Clouds
39586,95,1553472000,39,1,40,Clouds
39587,96,1553472000,10,20,30,Clouds
39588,97,1553472000,22,17,39,Clouds
39589,98,1553472000,19,21,40,Clouds
39590,99,1553472000,27,3,30,Clouds
39591,100,1553472000,25,0,25,Clouds
39592,101,1553472000,11,19,30,Clouds
39593,102,1553472000,28,12,40,Clouds
39594,103,1553472000,31,9,40,Clouds
39595,104,1553472000,28,12,40,Clouds
39596,105,1553472000,27,9,36,Clouds
39597,106,1553472000,32,8,40,Clouds
39598,107,1553472000,31,9,40,Clouds
39599,108,1553472000,34,6,40,Clouds
39600,109,1553472000,26,3,29,Clouds
39601,110,1553472000,29,11,40,Clouds
39602,111,1553472000,34,6,40,Clouds
39603,112,1553472000,6,24,30,Clouds
39604,113,1553472000,19,21,40,Clouds
39605,114,1553472000,40,0,40,Clouds
39606,115,1553472000,1,29,30,Clouds
39607,2,1553475600,20,0,20,Clouds
39608,3,1553475600,8,12,20,Clouds
39609,4,1553475600,4,16,20,Clouds
39610,5,1553475600,36,4,40,Clouds
39611,6,1553475600,15,5,20,Clouds
39612,7,1553475600,10,19,29,Clouds
39613,8,1553475600,12,18,30,Clouds
39614,9,1553475600,24,0,24,Clouds
39615,10,1553475600,16,0,16,Clouds
39616,11,1553475600,27,3,30,Clouds
39617,12,1553475600,5,15,20,Clouds
39618,13,1553475600,20,10,30,Clouds
39619,14,1553475600,30,0,30,Clouds
39620,15,1553475600,12,4,16,Clouds
39621,16,1553475600,18,2,20,Clouds
39622,17,1553475600,13,7,20,Clouds
39623,18,1553475600,13,17,30,Clouds
39624,19,1553475600,12,18,30,Clouds
39625,21,1553475600,13,17,30,Clouds
39626,22,1553475600,11,9,20,Clouds
39627,23,1553475600,17,13,30,Clouds
39628,24,1553475600,14,6,20,Clouds
39629,25,1553475600,27,3,30,Clouds
39630,26,1553475600,3,17,20,Clouds
39631,27,1553475600,20,0,20,Clouds
39632,28,1553475600,29,1,30,Clouds
39633,29,1553475600,8,21,29,Clouds
39634,30,1553475600,15,5,20,Clouds
39635,31,1553475600,18,2,20,Clouds
39636,32,1553475600,20,10,30,Clouds
39637,33,1553475600,22,1,23,Clouds
39638,34,1553475600,8,22,30,Clouds
39639,35,1553475600,21,9,30,Clouds
39640,36,1553475600,30,10,40,Clouds
39641,37,1553475600,22,8,30,Clouds
39642,38,1553475600,24,16,40,Clouds
39643,39,1553475600,16,4,20,Clouds
39644,40,1553475600,13,8,21,Clouds
39645,41,1553475600,13,7,20,Clouds
39646,42,1553475600,30,0,30,Clouds
39647,43,1553475600,1,29,30,Clouds
39648,44,1553475600,24,6,30,Clouds
39649,45,1553475600,4,26,30,Clouds
39650,46,1553475600,19,1,20,Clouds
39651,47,1553475600,40,0,40,Clouds
39652,48,1553475600,14,26,40,Clouds
39653,49,1553475600,29,11,40,Clouds
39654,50,1553475600,25,15,40,Clouds
39655,51,1553475600,19,21,40,Clouds
39656,52,1553475600,19,13,32,Clouds
39657,53,1553475600,22,18,40,Clouds
39658,54,1553475600,12,21,33,Clouds
39659,55,1553475600,35,1,36,Clouds
39660,56,1553475600,33,7,40,Clouds
39661,57,1553475600,22,1,23,Clouds
39662,58,1553475600,28,12,40,Clouds
39663,59,1553475600,20,0,20,Clouds
39664,60,1553475600,9,21,30,Clouds
39665,61,1553475600,22,3,25,Clouds
39666,62,1553475600,19,21,40,Clouds
39667,63,1553475600,10,25,35,Clouds
39668,64,1553475600,17,23,40,Clouds
39669,65,1553475600,38,2,40,Clouds
39670,66,1553475600,18,22,40,Clouds
39671,67,1553475600,31,9,40,Clouds
39672,68,1553475600,24,16,40,Clouds
39673,69,1553475600,13,27,40,Clouds
39674,70,1553475600,1,27,28,Clouds
39675,71,1553475600,18,22,40,Clouds
39676,72,1553475600,10,21,31,Clouds
39677,73,1553475600,14,16,30,Clouds
39678,74,1553475600,14,16,30,Clouds
39679,75,1553475600,34,6,40,Clouds
39680,76,1553475600,28,10,38,Clouds
39681,77,1553475600,20,9,29,Clouds
39682,78,1553475600,27,13,40,Clouds
39683,79,1553475600,16,11,27,Clouds
39684,80,1553475600,30,10,40,Clouds
39685,81,1553475600,26,14,40,Clouds
39686,82,1553475600,20,2,22,Clouds
39687,83,1553475600,29,11,40,Clouds
39688,84,1553475600,18,12,30,Clouds
39689,85,1553475600,18,17,35,Clouds
39690,86,1553475600,32,6,38,Clouds
39691,87,1553475600,14,24,38,Clouds
39692,88,1553475600,21,9,30,Clouds
39693,89,1553475600,36,4,40,Clouds
39694,90,1553475600,34,6,40,Clouds
39695,91,1553475600,14,16,30,Clouds
39696,92,1553475600,17,23,40,Clouds
39697,93,1553475600,9,31,40,Clouds
39698,94,1553475600,29,11,40,Clouds
39699,95,1553475600,38,2,40,Clouds
39700,96,1553475600,10,20,30,Clouds
39701,97,1553475600,22,17,39,Clouds
39702,98,1553475600,19,21,40,Clouds
39703,99,1553475600,28,2,30,Clouds
39704,100,1553475600,7,18,25,Clouds
39705,101,1553475600,9,21,30,Clouds
39706,102,1553475600,28,12,40,Clouds
39707,103,1553475600,31,9,40,Clouds
39708,104,1553475600,28,12,40,Clouds
39709,105,1553475600,27,9,36,Clouds
39710,106,1553475600,32,8,40,Clouds
39711,107,1553475600,30,10,40,Clouds
39712,108,1553475600,34,6,40,Clouds
39713,109,1553475600,22,7,29,Clouds
39714,110,1553475600,26,14,40,Clouds
39715,111,1553475600,30,10,40,Clouds
39716,112,1553475600,1,29,30,Clouds
39717,113,1553475600,19,21,40,Clouds
39718,114,1553475600,40,0,40,Clouds
39719,115,1553475600,18,12,30,Clouds
39720,2,1553479200,20,0,20,Clouds
39721,3,1553479200,8,12,20,Clouds
39722,4,1553479200,4,16,20,Clouds
39723,5,1553479200,35,5,40,Clouds
39724,6,1553479200,17,3,20,Clouds
39725,7,1553479200,10,19,29,Clouds
39726,8,1553479200,13,17,30,Clouds
39727,9,1553479200,23,1,24,Clouds
39728,10,1553479200,16,0,16,Clouds
39729,11,1553479200,27,3,30,Clouds
39730,12,1553479200,4,16,20,Clouds
39731,13,1553479200,20,10,30,Clouds
39732,14,1553479200,30,0,30,Clouds
39733,15,1553479200,9,7,16,Clouds
39734,16,1553479200,18,2,20,Clouds
39735,17,1553479200,13,7,20,Clouds
39736,18,1553479200,13,17,30,Clouds
39737,19,1553479200,12,18,30,Clouds
39738,21,1553479200,14,16,30,Clouds
39739,22,1553479200,12,8,20,Clouds
39740,23,1553479200,18,12,30,Clouds
39741,24,1553479200,16,4,20,Clouds
39742,25,1553479200,27,3,30,Clouds
39743,26,1553479200,3,17,20,Clouds
39744,27,1553479200,20,0,20,Clouds
39745,28,1553479200,29,1,30,Clouds
39746,29,1553479200,9,20,29,Clouds
39747,30,1553479200,16,4,20,Clouds
39748,31,1553479200,18,2,20,Clouds
39749,32,1553479200,21,9,30,Clouds
39750,33,1553479200,22,1,23,Clouds
39751,34,1553479200,8,22,30,Clouds
39752,35,1553479200,21,9,30,Clouds
39753,36,1553479200,30,10,40,Clouds
39754,37,1553479200,22,8,30,Clouds
39755,38,1553479200,24,16,40,Clouds
39756,39,1553479200,17,3,20,Clouds
39757,40,1553479200,12,9,21,Clouds
39758,41,1553479200,13,7,20,Clouds
39759,42,1553479200,29,1,30,Clouds
39760,43,1553479200,0,30,30,Clouds
39761,44,1553479200,23,7,30,Clouds
39762,45,1553479200,4,26,30,Clouds
39763,46,1553479200,19,1,20,Clouds
39764,47,1553479200,40,0,40,Clouds
39765,48,1553479200,12,28,40,Clouds
39766,49,1553479200,29,11,40,Clouds
39767,50,1553479200,26,14,40,Clouds
39768,51,1553479200,19,21,40,Clouds
39769,52,1553479200,20,12,32,Clouds
39770,53,1553479200,22,18,40,Clouds
39771,54,1553479200,15,18,33,Clouds
39772,55,1553479200,35,1,36,Clouds
39773,56,1553479200,32,8,40,Clouds
39774,57,1553479200,22,1,23,Clouds
39775,58,1553479200,28,12,40,Clouds
39776,59,1553479200,20,0,20,Clouds
39777,60,1553479200,5,25,30,Clouds
39778,61,1553479200,22,3,25,Clouds
39779,62,1553479200,19,21,40,Clouds
39780,63,1553479200,10,25,35,Clouds
39781,64,1553479200,16,24,40,Clouds
39782,65,1553479200,38,2,40,Clouds
39783,66,1553479200,17,23,40,Clouds
39784,67,1553479200,30,10,40,Clouds
39785,68,1553479200,24,16,40,Clouds
39786,69,1553479200,13,27,40,Clouds
39787,70,1553479200,1,27,28,Clouds
39788,71,1553479200,18,22,40,Clouds
39789,72,1553479200,10,21,31,Clouds
39790,73,1553479200,14,16,30,Clouds
39791,74,1553479200,14,16,30,Clouds
39792,75,1553479200,34,6,40,Clouds
39793,76,1553479200,28,10,38,Clouds
39794,77,1553479200,20,9,29,Clouds
39795,78,1553479200,27,13,40,Clouds
39796,79,1553479200,16,11,27,Clouds
39797,80,1553479200,30,10,40,Clouds
39798,81,1553479200,26,14,40,Clouds
39799,82,1553479200,20,2,22,Clouds
39800,83,1553479200,29,11,40,Clouds
39801,84,1553479200,17,13,30,Clouds
39802,85,1553479200,18,17,35,Clouds
39803,86,1553479200,21,17,38,Clouds
39804,87,1553479200,13,25,38,Clouds
39805,88,1553479200,20,10,30,Clouds
39806,89,1553479200,36,4,40,Clouds
39807,90,1553479200,33,7,40,Clouds
39808,91,1553479200,14,16,30,Clouds
39809,92,1553479200,17,23,40,Clouds
39810,93,1553479200,9,31,40,Clouds
39811,94,1553479200,29,11,40,Clouds
39812,95,1553479200,36,4,40,Clouds
39813,96,1553479200,10,20,30,Clouds
39814,97,1553479200,20,19,39,Clouds
39815,98,1553479200,20,20,40,Clouds
39816,99,1553479200,27,3,30,Clouds
39817,100,1553479200,8,17,25,Clouds
39818,101,1553479200,9,21,30,Clouds
39819,102,1553479200,28,12,40,Clouds
39820,103,1553479200,31,9,40,Clouds
39821,104,1553479200,28,12,40,Clouds
39822,105,1553479200,27,9,36,Clouds
39823,106,1553479200,32,8,40,Clouds
39824,107,1553479200,30,10,40,Clouds
39825,108,1553479200,35,5,40,Clouds
39826,109,1553479200,21,8,29,Clouds
39827,110,1553479200,26,14,40,Clouds
39828,111,1553479200,27,13,40,Clouds
39829,112,1553479200,0,30,30,Clouds
39830,113,1553479200,20,20,40,Clouds
39831,114,1553479200,40,0,40,Clouds
39832,115,1553479200,18,12,30,Clouds
39833,2,1553482800,20,0,20,Clouds
39834,3,1553482800,8,12,20,Clouds
39835,4,1553482800,4,16,20,Clouds
39836,5,1553482800,35,5,40,Clouds
39837,6,1553482800,17,3,20,Clouds
39838,7,1553482800,10,19,29,Clouds
39839,8,1553482800,13,17,30,Clouds
39840,9,1553482800,23,1,24,Clouds
39841,10,1553482800,16,0,16,Clouds
39842,11,1553482800,27,3,30,Clouds
39843,12,1553482800,4,16,20,Clouds
39844,13,1553482800,20,10,30,Clouds
39845,14,1553482800,30,0,30,Clouds
39846,15,1553482800,9,7,16,Clouds
39847,16,1553482800,18,2,20,Clouds
39848,17,1553482800,13,7,20,Clouds
39849,18,1553482800,13,17,30,Clouds
39850,19,1553482800,12,18,30,Clouds
39851,21,1553482800,14,16,30,Clouds
39852,22,1553482800,12,8,20,Clouds
39853,23,1553482800,18,12,30,Clouds
39854,24,1553482800,16,4,20,Clouds
39855,25,1553482800,27,3,30,Clouds
39856,26,1553482800,3,17,20,Clouds
39857,27,1553482800,20,0,20,Clouds
39858,28,1553482800,28,2,30,Clouds
39859,29,1553482800,9,20,29,Clouds
39860,30,1553482800,16,4,20,Clouds
39861,31,1553482800,18,2,20,Clouds
39862,32,1553482800,21,9,30,Clouds
39863,33,1553482800,22,1,23,Clouds
39864,34,1553482800,8,22,30,Clouds
39865,35,1553482800,21,9,30,Clouds
39866,36,1553482800,30,10,40,Clouds
39867,37,1553482800,22,8,30,Clouds
39868,38,1553482800,24,16,40,Clouds
39869,39,1553482800,17,3,20,Clouds
39870,40,1553482800,12,9,21,Clouds
39871,41,1553482800,13,7,20,Clouds
39872,42,1553482800,29,1,30,Clouds
39873,43,1553482800,0,30,30,Clouds
39874,44,1553482800,23,7,30,Clouds
39875,45,1553482800,4,26,30,Clouds
39876,46,1553482800,19,1,20,Clouds
39877,47,1553482800,40,0,40,Clouds
39878,48,1553482800,17,23,40,Clouds
39879,49,1553482800,29,11,40,Clouds
39880,50,1553482800,26,14,40,Clouds
39881,51,1553482800,19,21,40,Clouds
39882,52,1553482800,20,12,32,Clouds
39883,53,1553482800,22,18,40,Clouds
39884,54,1553482800,15,18,33,Clouds
39885,55,1553482800,35,1,36,Clouds
39886,56,1553482800,32,8,40,Clouds
39887,57,1553482800,22,1,23,Clouds
39888,58,1553482800,28,12,40,Clouds
39889,59,1553482800,20,0,20,Clouds
39890,60,1553482800,5,25,30,Clouds
39891,61,1553482800,22,3,25,Clouds
39892,62,1553482800,19,21,40,Clouds
39893,63,1553482800,10,25,35,Clouds
39894,64,1553482800,16,24,40,Clouds
39895,65,1553482800,38,2,40,Clouds
39896,66,1553482800,17,23,40,Clouds
39897,67,1553482800,30,10,40,Clouds
39898,68,1553482800,24,16,40,Clouds
39899,69,1553482800,13,27,40,Clouds
39900,70,1553482800,1,27,28,Clouds
39901,71,1553482800,18,22,40,Clouds
39902,72,1553482800,10,21,31,Clouds
39903,73,1553482800,14,16,30,Clouds
39904,74,1553482800,14,16,30,Clouds
39905,75,1553482800,34,6,40,Clouds
39906,76,1553482800,28,10,38,Clouds
39907,77,1553482800,20,9,29,Clouds
39908,78,1553482800,27,13,40,Clouds
39909,79,1553482800,16,11,27,Clouds
39910,80,1553482800,30,10,40,Clouds
39911,81,1553482800,26,14,40,Clouds
39912,82,1553482800,20,2,22,Clouds
39913,83,1553482800,29,11,40,Clouds
39914,84,1553482800,17,13,30,Clouds
39915,85,1553482800,18,17,35,Clouds
39916,86,1553482800,21,17,38,Clouds
39917,87,1553482800,13,25,38,Clouds
39918,88,1553482800,20,10,30,Clouds
39919,89,1553482800,36,4,40,Clouds
39920,90,1553482800,33,7,40,Clouds
39921,91,1553482800,14,16,30,Clouds
39922,92,1553482800,17,23,40,Clouds
39923,93,1553482800,9,31,40,Clouds
39924,94,1553482800,29,11,40,Clouds
39925,95,1553482800,36,4,40,Clouds
39926,96,1553482800,10,20,30,Clouds
39927,97,1553482800,20,19,39,Clouds
39928,98,1553482800,20,20,40,Clouds
39929,99,1553482800,27,3,30,Clouds
39930,100,1553482800,8,17,25,Clouds
39931,101,1553482800,9,21,30,Clouds
39932,102,1553482800,28,12,40,Clouds
39933,103,1553482800,31,9,40,Clouds
39934,104,1553482800,28,12,40,Clouds
39935,105,1553482800,27,9,36,Clouds
39936,106,1553482800,32,8,40,Clouds
39937,107,1553482800,30,10,40,Clouds
39938,108,1553482800,35,5,40,Clouds
39939,109,1553482800,21,8,29,Clouds
39940,110,1553482800,26,14,40,Clouds
39941,111,1553482800,27,13,40,Clouds
39942,112,1553482800,0,30,30,Clouds
39943,113,1553482800,20,20,40,Clouds
39944,114,1553482800,40,0,40,Clouds
39945,115,1553482800,18,12,30,Clouds
39946,2,1553486400,20,0,20,Clouds
39947,3,1553486400,8,12,20,Clouds
39948,4,1553486400,4,16,20,Clouds
39949,5,1553486400,35,5,40,Clouds
39950,6,1553486400,17,3,20,Clouds
39951,7,1553486400,10,19,29,Clouds
39952,8,1553486400,13,17,30,Clouds
39953,9,1553486400,23,1,24,Clouds
39954,10,1553486400,16,0,16,Clouds
39955,11,1553486400,27,3,30,Clouds
39956,12,1553486400,3,17,20,Clouds
39957,13,1553486400,20,10,30,Clouds
39958,14,1553486400,30,0,30,Clouds
39959,15,1553486400,9,7,16,Clouds
39960,16,1553486400,18,2,20,Clouds
39961,17,1553486400,13,7,20,Clouds
39962,18,1553486400,13,17,30,Clouds
39963,19,1553486400,12,18,30,Clouds
39964,21,1553486400,14,16,30,Clouds
39965,22,1553486400,12,8,20,Clouds
39966,23,1553486400,18,12,30,Clouds
39967,24,1553486400,16,4,20,Clouds
39968,25,1553486400,27,3,30,Clouds
39969,26,1553486400,3,17,20,Clouds
39970,27,1553486400,20,0,20,Clouds
39971,28,1553486400,28,2,30,Clouds
39972,29,1553486400,9,20,29,Clouds
39973,30,1553486400,16,4,20,Clouds
39974,31,1553486400,18,2,20,Clouds
39975,32,1553486400,21,9,30,Clouds
39976,33,1553486400,22,1,23,Clouds
39977,34,1553486400,8,22,30,Clouds
39978,35,1553486400,21,9,30,Clouds
39979,36,1553486400,30,10,40,Clouds
39980,37,1553486400,22,8,30,Clouds
39981,38,1553486400,24,16,40,Clouds
39982,39,1553486400,17,3,20,Clouds
39983,40,1553486400,12,9,21,Clouds
39984,41,1553486400,13,7,20,Clouds
39985,42,1553486400,29,1,30,Clouds
39986,43,1553486400,0,30,30,Clouds
39987,44,1553486400,23,7,30,Clouds
39988,45,1553486400,4,26,30,Clouds
39989,46,1553486400,19,1,20,Clouds
39990,47,1553486400,40,0,40,Clouds
39991,48,1553486400,29,11,40,Clouds
39992,49,1553486400,29,11,40,Clouds
39993,50,1553486400,26,14,40,Clouds
39994,51,1553486400,19,21,40,Clouds
39995,52,1553486400,20,12,32,Clouds
39996,53,1553486400,22,18,40,Clouds
39997,54,1553486400,15,18,33,Clouds
39998,55,1553486400,35,1,36,Clouds
39999,56,1553486400,32,8,40,Clouds
40000,57,1553486400,22,1,23,Clouds
40001,58,1553486400,28,12,40,Clouds
40002,59,1553486400,20,0,20,Clouds
40003,60,1553486400,5,25,30,Clouds
40004,61,1553486400,22,3,25,Clouds
40005,62,1553486400,19,21,40,Clouds
40006,63,1553486400,11,24,35,Clouds
40007,64,1553486400,16,24,40,Clouds
40008,65,1553486400,38,2,40,Clouds
40009,66,1553486400,17,23,40,Clouds
40010,67,1553486400,30,10,40,Clouds
40011,68,1553486400,24,16,40,Clouds
40012,69,1553486400,13,27,40,Clouds
40013,70,1553486400,1,27,28,Clouds
40014,71,1553486400,18,22,40,Clouds
40015,72,1553486400,10,21,31,Clouds
40016,73,1553486400,14,16,30,Clouds
40017,74,1553486400,14,16,30,Clouds
40018,75,1553486400,34,6,40,Clouds
40019,76,1553486400,28,10,38,Clouds
40020,77,1553486400,20,9,29,Clouds
40021,78,1553486400,27,13,40,Clouds
40022,79,1553486400,16,11,27,Clouds
40023,80,1553486400,30,10,40,Clouds
40024,81,1553486400,26,14,40,Clouds
40025,82,1553486400,20,2,22,Clouds
40026,83,1553486400,20,20,40,Clouds
40027,84,1553486400,17,13,30,Clouds
40028,85,1553486400,18,17,35,Clouds
40029,86,1553486400,21,17,38,Clouds
40030,87,1553486400,13,25,38,Clouds
40031,88,1553486400,20,10,30,Clouds
40032,89,1553486400,36,4,40,Clouds
40033,90,1553486400,33,7,40,Clouds
40034,91,1553486400,14,16,30,Clouds
40035,92,1553486400,17,23,40,Clouds
40036,93,1553486400,9,31,40,Clouds
40037,94,1553486400,29,11,40,Clouds
40038,95,1553486400,36,4,40,Clouds
40039,96,1553486400,10,20,30,Clouds
40040,97,1553486400,12,28,40,Clouds
40041,98,1553486400,20,20,40,Clouds
40042,99,1553486400,27,3,30,Clouds
40043,100,1553486400,8,17,25,Clouds
40044,101,1553486400,9,21,30,Clouds
40045,102,1553486400,28,12,40,Clouds
40046,103,1553486400,31,9,40,Clouds
40047,104,1553486400,28,12,40,Clouds
40048,105,1553486400,27,9,36,Clouds
40049,106,1553486400,32,8,40,Clouds
40050,107,1553486400,30,10,40,Clouds
40051,108,1553486400,35,5,40,Clouds
40052,109,1553486400,21,8,29,Clouds
40053,110,1553486400,26,14,40,Clouds
40054,111,1553486400,27,13,40,Clouds
40055,112,1553486400,0,30,30,Clouds
40056,113,1553486400,20,20,40,Clouds
40057,114,1553486400,40,0,40,Clouds
40058,115,1553486400,18,12,30,Clouds
40059,2,1553490000,20,0,20,Clouds
40060,3,1553490000,8,12,20,Clouds
40061,4,1553490000,4,16,20,Clouds
40062,5,1553490000,35,5,40,Clouds
40063,6,1553490000,17,3,20,Clouds
40064,7,1553490000,10,19,29,Clouds
40065,8,1553490000,13,17,30,Clouds
40066,9,1553490000,23,1,24,Clouds
40067,10,1553490000,16,0,16,Clouds
40068,11,1553490000,27,3,30,Clouds
40069,12,1553490000,3,17,20,Clouds
40070,13,1553490000,20,10,30,Clouds
40071,14,1553490000,30,0,30,Clouds
40072,15,1553490000,9,7,16,Clouds
40073,16,1553490000,18,2,20,Clouds
40074,17,1553490000,13,7,20,Clouds
40075,18,1553490000,13,17,30,Clouds
40076,19,1553490000,12,18,30,Clouds
40077,21,1553490000,14,16,30,Clouds
40078,22,1553490000,12,8,20,Clouds
40079,23,1553490000,18,12,30,Clouds
40080,24,1553490000,16,4,20,Clouds
40081,25,1553490000,27,3,30,Clouds
40082,26,1553490000,3,17,20,Clouds
40083,27,1553490000,20,0,20,Clouds
40084,28,1553490000,28,2,30,Clouds
40085,29,1553490000,19,10,29,Clouds
40086,30,1553490000,16,4,20,Clouds
40087,31,1553490000,18,2,20,Clouds
40088,32,1553490000,21,9,30,Clouds
40089,33,1553490000,22,1,23,Clouds
40090,34,1553490000,8,22,30,Clouds
40091,35,1553490000,21,9,30,Clouds
40092,36,1553490000,30,10,40,Clouds
40093,37,1553490000,22,8,30,Clouds
40094,38,1553490000,24,16,40,Clouds
40095,39,1553490000,17,3,20,Clouds
40096,40,1553490000,12,9,21,Clouds
40097,41,1553490000,13,7,20,Clouds
40098,42,1553490000,29,1,30,Clouds
40099,43,1553490000,0,30,30,Clouds
40100,44,1553490000,23,7,30,Clouds
40101,45,1553490000,4,26,30,Clouds
40102,46,1553490000,19,1,20,Clouds
40103,47,1553490000,40,0,40,Clouds
40104,48,1553490000,29,11,40,Clouds
40105,49,1553490000,29,11,40,Clouds
40106,50,1553490000,26,14,40,Clouds
40107,51,1553490000,19,21,40,Clouds
40108,52,1553490000,20,12,32,Clouds
40109,53,1553490000,22,18,40,Clouds
40110,54,1553490000,15,18,33,Clouds
40111,55,1553490000,35,1,36,Clouds
40112,56,1553490000,32,8,40,Clouds
40113,57,1553490000,22,1,23,Clouds
40114,58,1553490000,28,12,40,Clouds
40115,59,1553490000,20,0,20,Clouds
40116,60,1553490000,5,25,30,Clouds
40117,61,1553490000,21,4,25,Clouds
40118,62,1553490000,19,21,40,Clouds
40119,63,1553490000,27,8,35,Clouds
40120,64,1553490000,16,24,40,Clouds
40121,65,1553490000,38,2,40,Clouds
40122,66,1553490000,17,23,40,Clouds
40123,67,1553490000,30,10,40,Clouds
40124,68,1553490000,24,16,40,Clouds
40125,69,1553490000,13,27,40,Clouds
40126,70,1553490000,1,27,28,Clouds
40127,71,1553490000,18,22,40,Clouds
40128,72,1553490000,10,21,31,Clouds
40129,73,1553490000,14,16,30,Clouds
40130,74,1553490000,14,16,30,Clouds
40131,75,1553490000,34,6,40,Clouds
40132,76,1553490000,28,10,38,Clouds
40133,77,1553490000,20,9,29,Clouds
40134,78,1553490000,27,13,40,Clouds
40135,79,1553490000,16,11,27,Clouds
40136,80,1553490000,30,10,40,Clouds
40137,81,1553490000,26,14,40,Clouds
40138,82,1553490000,20,2,22,Clouds
40139,83,1553490000,11,29,40,Clouds
40140,84,1553490000,17,13,30,Clouds
40141,85,1553490000,9,26,35,Clouds
40142,86,1553490000,21,17,38,Clouds
40143,87,1553490000,13,25,38,Clouds
40144,88,1553490000,20,10,30,Clouds
40145,89,1553490000,36,4,40,Clouds
40146,90,1553490000,33,7,40,Clouds
40147,91,1553490000,14,16,30,Clouds
40148,92,1553490000,17,23,40,Clouds
40149,93,1553490000,9,31,40,Clouds
40150,94,1553490000,29,11,40,Clouds
40151,95,1553490000,36,4,40,Clouds
40152,96,1553490000,10,20,30,Clouds
40153,97,1553490000,12,28,40,Clouds
40154,98,1553490000,20,20,40,Clouds
40155,99,1553490000,27,3,30,Clouds
40156,100,1553490000,8,17,25,Clouds
40157,101,1553490000,9,21,30,Clouds
40158,102,1553490000,28,12,40,Clouds
40159,103,1553490000,31,9,40,Clouds
40160,104,1553490000,28,12,40,Clouds
40161,105,1553490000,27,9,36,Clouds
40162,106,1553490000,32,8,40,Clouds
40163,107,1553490000,30,10,40,Clouds
40164,108,1553490000,35,5,40,Clouds
40165,109,1553490000,21,8,29,Clouds
40166,110,1553490000,26,14,40,Clouds
40167,111,1553490000,27,13,40,Clouds
40168,112,1553490000,0,30,30,Clouds
40169,113,1553490000,20,20,40,Clouds
40170,114,1553490000,40,0,40,Clouds
40171,115,1553490000,18,12,30,Clouds
40172,2,1553493600,20,0,20,Clouds
40173,3,1553493600,8,12,20,Clouds
40174,4,1553493600,4,16,20,Clouds
40175,5,1553493600,35,5,40,Clouds
40176,6,1553493600,17,3,20,Clouds
40177,7,1553493600,10,19,29,Clouds
40178,8,1553493600,13,17,30,Clouds
40179,9,1553493600,23,1,24,Clouds
40180,10,1553493600,16,0,16,Clouds
40181,11,1553493600,27,3,30,Clouds
40182,12,1553493600,3,17,20,Clouds
40183,13,1553493600,20,10,30,Clouds
40184,14,1553493600,30,0,30,Clouds
40185,15,1553493600,9,7,16,Clouds
40186,16,1553493600,18,2,20,Clouds
40187,17,1553493600,13,7,20,Clouds
40188,18,1553493600,13,17,30,Clouds
40189,19,1553493600,12,18,30,Clouds
40190,21,1553493600,14,16,30,Clouds
40191,22,1553493600,12,8,20,Clouds
40192,23,1553493600,18,12,30,Clouds
40193,24,1553493600,16,4,20,Clouds
40194,25,1553493600,27,3,30,Clouds
40195,26,1553493600,3,17,20,Clouds
40196,27,1553493600,20,0,20,Clouds
40197,28,1553493600,28,2,30,Clouds
40198,29,1553493600,19,10,29,Clouds
40199,30,1553493600,16,4,20,Clouds
40200,31,1553493600,18,2,20,Clouds
40201,32,1553493600,21,9,30,Clouds
40202,33,1553493600,22,1,23,Clouds
40203,34,1553493600,8,22,30,Clouds
40204,35,1553493600,21,9,30,Clouds
40205,36,1553493600,30,10,40,Clouds
40206,37,1553493600,22,8,30,Clouds
40207,38,1553493600,24,16,40,Clouds
40208,39,1553493600,17,3,20,Clouds
40209,40,1553493600,12,9,21,Clouds
40210,41,1553493600,13,7,20,Clouds
40211,42,1553493600,29,1,30,Clouds
40212,43,1553493600,0,30,30,Clouds
40213,44,1553493600,23,7,30,Clouds
40214,45,1553493600,4,26,30,Clouds
40215,46,1553493600,19,1,20,Clouds
40216,47,1553493600,40,0,40,Clouds
40217,48,1553493600,29,11,40,Clouds
40218,49,1553493600,29,11,40,Clouds
40219,50,1553493600,26,14,40,Clouds
40220,51,1553493600,19,21,40,Clouds
40221,52,1553493600,20,12,32,Clouds
40222,53,1553493600,22,18,40,Clouds
40223,54,1553493600,15,18,33,Clouds
40224,55,1553493600,35,1,36,Clouds
40225,56,1553493600,32,8,40,Clouds
40226,57,1553493600,22,1,23,Clouds
40227,58,1553493600,28,12,40,Clouds
40228,59,1553493600,20,0,20,Clouds
40229,60,1553493600,6,24,30,Clouds
40230,61,1553493600,21,4,25,Clouds
40231,62,1553493600,19,21,40,Clouds
40232,63,1553493600,27,8,35,Clouds
40233,64,1553493600,16,24,40,Clouds
40234,65,1553493600,38,2,40,Clouds
40235,66,1553493600,17,23,40,Clouds
40236,67,1553493600,30,10,40,Clouds
40237,68,1553493600,24,16,40,Clouds
40238,69,1553493600,13,27,40,Clouds
40239,70,1553493600,1,27,28,Clouds
40240,71,1553493600,18,22,40,Clouds
40241,72,1553493600,10,21,31,Clouds
40242,73,1553493600,14,16,30,Clouds
40243,74,1553493600,14,16,30,Clouds
40244,75,1553493600,34,6,40,Clouds
40245,76,1553493600,28,10,38,Clouds
40246,77,1553493600,20,9,29,Clouds
40247,78,1553493600,17,23,40,Clouds
40248,79,1553493600,16,11,27,Clouds
40249,80,1553493600,31,9,40,Clouds
40250,81,1553493600,26,14,40,Clouds
40251,82,1553493600,20,2,22,Clouds
40252,83,1553493600,11,29,40,Clouds
40253,84,1553493600,17,13,30,Clouds
40254,85,1553493600,9,26,35,Clouds
40255,86,1553493600,21,17,38,Clouds
40256,87,1553493600,13,25,38,Clouds
40257,88,1553493600,20,10,30,Clouds
40258,89,1553493600,36,4,40,Clouds
40259,90,1553493600,33,7,40,Clouds
40260,91,1553493600,14,16,30,Clouds
40261,92,1553493600,17,23,40,Clouds
40262,93,1553493600,9,31,40,Clouds
40263,94,1553493600,29,11,40,Clouds
40264,95,1553493600,36,4,40,Clouds
40265,96,1553493600,10,20,30,Clouds
40266,97,1553493600,12,28,40,Clouds
40267,98,1553493600,20,20,40,Clouds
40268,99,1553493600,27,3,30,Clouds
40269,100,1553493600,8,17,25,Clouds
40270,101,1553493600,9,21,30,Clouds
40271,102,1553493600,28,12,40,Clouds
40272,103,1553493600,31,9,40,Clouds
40273,104,1553493600,28,12,40,Clouds
40274,105,1553493600,27,9,36,Clouds
40275,106,1553493600,32,8,40,Clouds
40276,107,1553493600,30,10,40,Clouds
40277,108,1553493600,35,5,40,Clouds
40278,109,1553493600,21,8,29,Clouds
40279,110,1553493600,26,14,40,Clouds
40280,111,1553493600,27,13,40,Clouds
40281,112,1553493600,0,30,30,Clouds
40282,113,1553493600,20,20,40,Clouds
40283,114,1553493600,40,0,40,Clouds
40284,115,1553493600,18,12,30,Clouds
40285,2,1553497200,20,0,20,Clouds
40286,3,1553497200,7,13,20,Clouds
40287,4,1553497200,5,15,20,Clouds
40288,5,1553497200,19,21,40,Clouds
40289,6,1553497200,18,2,20,Clouds
40290,7,1553497200,11,18,29,Clouds
40291,8,1553497200,11,19,30,Clouds
40292,9,1553497200,19,5,24,Clouds
40293,10,1553497200,14,2,16,Clouds
40294,11,1553497200,27,3,30,Clouds
40295,12,1553497200,7,13,20,Clouds
40296,13,1553497200,21,9,30,Clouds
40297,14,1553497200,18,12,30,Clouds
40298,15,1553497200,13,3,16,Clouds
40299,16,1553497200,18,2,20,Clouds
40300,17,1553497200,15,5,20,Clouds
40301,18,1553497200,11,19,30,Clouds
40302,19,1553497200,10,20,30,Clouds
40303,21,1553497200,14,16,30,Clouds
40304,22,1553497200,9,11,20,Clouds
40305,23,1553497200,16,14,30,Clouds
40306,24,1553497200,14,6,20,Clouds
40307,25,1553497200,26,4,30,Clouds
40308,26,1553497200,2,18,20,Clouds
40309,27,1553497200,17,3,20,Clouds
40310,28,1553497200,26,4,30,Clouds
40311,29,1553497200,18,11,29,Clouds
40312,30,1553497200,14,6,20,Clouds
40313,31,1553497200,2,18,20,Clouds
40314,32,1553497200,15,15,30,Clouds
40315,33,1553497200,16,7,23,Clouds
40316,34,1553497200,12,18,30,Clouds
40317,35,1553497200,25,5,30,Clouds
40318,36,1553497200,29,11,40,Clouds
40319,37,1553497200,21,9,30,Clouds
40320,38,1553497200,22,18,40,Clouds
40321,39,1553497200,18,2,20,Clouds
40322,40,1553497200,11,10,21,Clouds
40323,41,1553497200,13,7,20,Clouds
40324,42,1553497200,29,1,30,Clouds
40325,43,1553497200,7,23,30,Clouds
40326,44,1553497200,30,0,30,Clouds
40327,45,1553497200,6,24,30,Clouds
40328,46,1553497200,20,0,20,Clouds
40329,47,1553497200,40,0,40,Clouds
40330,48,1553497200,28,12,40,Clouds
40331,49,1553497200,25,15,40,Clouds
40332,50,1553497200,27,13,40,Clouds
40333,51,1553497200,18,22,40,Clouds
40334,52,1553497200,16,16,32,Clouds
40335,53,1553497200,20,20,40,Clouds
40336,54,1553497200,15,18,33,Clouds
40337,55,1553497200,36,0,36,Clouds
40338,56,1553497200,36,4,40,Clouds
40339,57,1553497200,21,2,23,Clouds
40340,58,1553497200,37,3,40,Clouds
40341,59,1553497200,20,0,20,Clouds
40342,60,1553497200,9,21,30,Clouds
40343,61,1553497200,23,2,25,Clouds
40344,62,1553497200,34,6,40,Clouds
40345,63,1553497200,26,9,35,Clouds
40346,64,1553497200,32,8,40,Clouds
40347,65,1553497200,37,3,40,Clouds
40348,66,1553497200,34,6,40,Clouds
40349,67,1553497200,32,8,40,Clouds
40350,68,1553497200,19,21,40,Clouds
40351,69,1553497200,9,31,40,Clouds
40352,70,1553497200,1,27,28,Clouds
40353,71,1553497200,18,22,40,Clouds
40354,72,1553497200,11,20,31,Clouds
40355,73,1553497200,15,15,30,Clouds
40356,74,1553497200,15,15,30,Clouds
40357,75,1553497200,35,5,40,Clouds
40358,76,1553497200,29,9,38,Clouds
40359,77,1553497200,20,9,29,Clouds
40360,78,1553497200,20,20,40,Clouds
40361,79,1553497200,16,11,27,Clouds
40362,80,1553497200,33,7,40,Clouds
40363,81,1553497200,26,14,40,Clouds
40364,82,1553497200,21,1,22,Clouds
40365,83,1553497200,14,26,40,Clouds
40366,84,1553497200,22,8,30,Clouds
40367,85,1553497200,9,26,35,Clouds
40368,86,1553497200,23,15,38,Clouds
40369,87,1553497200,14,24,38,Clouds
40370,88,1553497200,22,8,30,Clouds
40371,89,1553497200,36,4,40,Clouds
40372,90,1553497200,31,9,40,Clouds
40373,91,1553497200,15,15,30,Clouds
40374,92,1553497200,17,23,40,Clouds
40375,93,1553497200,9,31,40,Clouds
40376,94,1553497200,29,11,40,Clouds
40377,95,1553497200,37,3,40,Clouds
40378,96,1553497200,10,20,30,Clouds
40379,97,1553497200,15,25,40,Clouds
40380,98,1553497200,22,18,40,Clouds
40381,99,1553497200,26,4,30,Clouds
40382,100,1553497200,7,18,25,Clouds
40383,101,1553497200,14,16,30,Clouds
40384,102,1553497200,28,12,40,Clouds
40385,103,1553497200,31,9,40,Clouds
40386,104,1553497200,28,12,40,Clouds
40387,105,1553497200,28,8,36,Clouds
40388,106,1553497200,32,8,40,Clouds
40389,107,1553497200,36,4,40,Clouds
40390,108,1553497200,36,4,40,Clouds
40391,109,1553497200,26,3,29,Clouds
40392,110,1553497200,26,14,40,Clouds
40393,111,1553497200,27,13,40,Clouds
40394,112,1553497200,1,29,30,Clouds
40395,113,1553497200,20,20,40,Clouds
40396,114,1553497200,38,2,40,Clouds
40397,115,1553497200,18,12,30,Clouds
40398,2,1553500800,20,0,20,Clouds
40399,3,1553500800,11,9,20,Clouds
40400,4,1553500800,7,13,20,Clouds
40401,5,1553500800,16,23,39,Clouds
40402,6,1553500800,20,0,20,Clouds
40403,7,1553500800,12,17,29,Clouds
40404,8,1553500800,17,13,30,Clouds
40405,9,1553500800,6,18,24,Clouds
40406,10,1553500800,13,3,16,Clouds
40407,11,1553500800,24,6,30,Clouds
40408,12,1553500800,19,1,20,Clouds
40409,13,1553500800,21,9,30,Clouds
40410,14,1553500800,16,14,30,Clouds
40411,15,1553500800,15,1,16,Clouds
40412,16,1553500800,20,0,20,Clouds
40413,17,1553500800,16,4,20,Clouds
40414,18,1553500800,15,15,30,Clouds
40415,19,1553500800,25,5,30,Clouds
40416,21,1553500800,13,17,30,Clouds
40417,22,1553500800,6,14,20,Clouds
40418,23,1553500800,14,16,30,Clouds
40419,24,1553500800,10,10,20,Clouds
40420,25,1553500800,19,11,30,Clouds
40421,26,1553500800,0,20,20,Clouds
40422,27,1553500800,13,7,20,Clouds
40423,28,1553500800,30,0,30,Clouds
40424,29,1553500800,19,10,29,Clouds
40425,30,1553500800,13,7,20,Clouds
40426,31,1553500800,1,19,20,Clouds
40427,32,1553500800,19,11,30,Clouds
40428,33,1553500800,14,9,23,Clouds
40429,34,1553500800,24,6,30,Clouds
40430,35,1553500800,30,0,30,Clouds
40431,36,1553500800,28,12,40,Clouds
40432,37,1553500800,22,8,30,Clouds
40433,38,1553500800,20,20,40,Clouds
40434,39,1553500800,18,2,20,Clouds
40435,40,1553500800,5,16,21,Clouds
40436,41,1553500800,15,5,20,Clouds
40437,42,1553500800,30,0,30,Clouds
40438,43,1553500800,13,17,30,Clouds
40439,44,1553500800,30,0,30,Clouds
40440,45,1553500800,11,19,30,Clouds
40441,46,1553500800,18,2,20,Clouds
40442,47,1553500800,38,2,40,Clouds
40443,48,1553500800,29,11,40,Clouds
40444,49,1553500800,25,15,40,Clouds
40445,50,1553500800,34,6,40,Clouds
40446,51,1553500800,34,6,40,Clouds
40447,52,1553500800,24,8,32,Clouds
40448,53,1553500800,20,20,40,Clouds
40449,54,1553500800,11,22,33,Clouds
40450,55,1553500800,30,6,36,Clouds
40451,56,1553500800,37,3,40,Clouds
40452,57,1553500800,23,0,23,Clouds
40453,58,1553500800,25,15,40,Clouds
40454,59,1553500800,20,0,20,Clouds
40455,60,1553500800,26,4,30,Clouds
40456,61,1553500800,11,14,25,Clouds
40457,62,1553500800,29,11,40,Clouds
40458,63,1553500800,26,9,35,Clouds
40459,64,1553500800,28,12,40,Clouds
40460,65,1553500800,27,13,40,Clouds
40461,66,1553500800,21,19,40,Clouds
40462,67,1553500800,28,12,40,Clouds
40463,68,1553500800,27,13,40,Clouds
40464,69,1553500800,1,39,40,Clouds
40465,70,1553500800,7,21,28,Clouds
40466,71,1553500800,25,15,40,Clouds
40467,72,1553500800,14,17,31,Clouds
40468,73,1553500800,20,10,30,Clouds
40469,74,1553500800,17,13,30,Clouds
40470,75,1553500800,36,4,40,Clouds
40471,76,1553500800,38,0,38,Clouds
40472,77,1553500800,22,7,29,Clouds
40473,78,1553500800,26,14,40,Clouds
40474,79,1553500800,18,9,27,Clouds
40475,80,1553500800,37,3,40,Clouds
40476,81,1553500800,26,14,40,Clouds
40477,82,1553500800,22,0,22,Clouds
40478,83,1553500800,18,22,40,Clouds
40479,84,1553500800,24,6,30,Clouds
40480,85,1553500800,14,21,35,Clouds
40481,86,1553500800,24,14,38,Clouds
40482,87,1553500800,19,19,38,Clouds
40483,88,1553500800,28,2,30,Clouds
40484,89,1553500800,38,2,40,Clouds
40485,90,1553500800,17,23,40,Clouds
40486,91,1553500800,13,17,30,Clouds
40487,92,1553500800,17,23,40,Clouds
40488,93,1553500800,17,23,40,Clouds
40489,94,1553500800,12,28,40,Clouds
40490,95,1553500800,22,18,40,Clouds
40491,96,1553500800,11,19,30,Clouds
40492,97,1553500800,25,15,40,Clouds
40493,98,1553500800,21,19,40,Clouds
40494,99,1553500800,23,7,30,Clouds
40495,100,1553500800,14,11,25,Clouds
40496,101,1553500800,21,9,30,Clouds
40497,102,1553500800,35,5,40,Clouds
40498,103,1553500800,29,11,40,Clouds
40499,104,1553500800,28,12,40,Clouds
40500,105,1553500800,27,9,36,Clouds
40501,106,1553500800,34,6,40,Clouds
40502,107,1553500800,39,1,40,Clouds
40503,108,1553500800,40,0,40,Clouds
40504,109,1553500800,28,1,29,Clouds
40505,110,1553500800,28,12,40,Clouds
40506,111,1553500800,32,8,40,Clouds
40507,112,1553500800,11,19,30,Clouds
40508,113,1553500800,18,22,40,Clouds
40509,114,1553500800,32,8,40,Clouds
40510,115,1553500800,27,3,30,Clouds
40511,2,1553504400,20,0,20,Clouds
40512,3,1553504400,20,0,20,Clouds
40513,4,1553504400,17,3,20,Clouds
40514,5,1553504400,40,0,40,Clouds
40515,6,1553504400,19,1,20,Clouds
40516,7,1553504400,23,6,29,Clouds
40517,8,1553504400,21,9,30,Clouds
40518,9,1553504400,0,24,24,Clouds
40519,10,1553504400,12,4,16,Clouds
40520,11,1553504400,17,13,30,Clouds
40521,12,1553504400,19,1,20,Clouds
40522,13,1553504400,18,12,30,Clouds
40523,14,1553504400,23,7,30,Clouds
40524,15,1553504400,16,0,16,Clouds
40525,16,1553504400,19,1,20,Clouds
40526,17,1553504400,16,4,20,Clouds
40527,18,1553504400,10,20,30,Clouds
40528,19,1553504400,14,16,30,Clouds
40529,21,1553504400,13,16,29,Clouds
40530,22,1553504400,5,15,20,Clouds
40531,23,1553504400,17,12,29,Clouds
40532,24,1553504400,19,1,20,Clouds
40533,25,1553504400,8,22,30,Clouds
40534,26,1553504400,17,3,20,Clouds
40535,27,1553504400,2,18,20,Clouds
40536,28,1553504400,30,0,30,Clouds
40537,29,1553504400,14,15,29,Clouds
40538,30,1553504400,17,3,20,Clouds
40539,31,1553504400,7,12,19,Clouds
40540,32,1553504400,21,9,30,Clouds
40541,33,1553504400,11,12,23,Clouds
40542,34,1553504400,16,14,30,Clouds
40543,35,1553504400,27,3,30,Clouds
40544,36,1553504400,23,17,40,Clouds
40545,37,1553504400,20,10,30,Clouds
40546,38,1553504400,24,16,40,Clouds
40547,39,1553504400,19,1,20,Clouds
40548,40,1553504400,1,20,21,Clouds
40549,41,1553504400,20,0,20,Clouds
40550,42,1553504400,30,0,30,Clouds
40551,43,1553504400,30,0,30,Clouds
40552,44,1553504400,30,0,30,Clouds
40553,45,1553504400,13,17,30,Clouds
40554,46,1553504400,17,3,20,Clouds
40555,47,1553504400,35,5,40,Clouds
40556,48,1553504400,29,11,40,Clouds
40557,49,1553504400,28,12,40,Clouds
40558,50,1553504400,40,0,40,Clouds
40559,51,1553504400,29,11,40,Clouds
40560,52,1553504400,11,20,31,Clouds
40561,53,1553504400,34,6,40,Clouds
40562,54,1553504400,5,28,33,Clouds
40563,55,1553504400,27,9,36,Clouds
40564,56,1553504400,18,22,40,Clouds
40565,57,1553504400,9,14,23,Clouds
40566,58,1553504400,0,40,40,Clouds
40567,59,1553504400,15,5,20,Clouds
40568,60,1553504400,25,5,30,Clouds
40569,61,1553504400,14,11,25,Clouds
40570,62,1553504400,21,18,39,Clouds
40571,63,1553504400,22,13,35,Clouds
40572,64,1553504400,22,18,40,Clouds
40573,65,1553504400,25,15,40,Clouds
40574,66,1553504400,15,24,39,Clouds
40575,67,1553504400,24,16,40,Clouds
40576,68,1553504400,2,38,40,Clouds
40577,69,1553504400,1,38,39,Clouds
40578,70,1553504400,6,21,27,Clouds
40579,71,1553504400,29,11,40,Clouds
40580,72,1553504400,24,7,31,Clouds
40581,73,1553504400,27,3,30,Clouds
40582,74,1553504400,29,1,30,Clouds
40583,75,1553504400,33,7,40,Clouds
40584,76,1553504400,38,0,38,Clouds
40585,77,1553504400,24,5,29,Clouds
40586,78,1553504400,30,10,40,Clouds
40587,79,1553504400,21,6,27,Clouds
40588,80,1553504400,39,1,40,Clouds
40589,81,1553504400,30,10,40,Clouds
40590,82,1553504400,21,1,22,Clouds
40591,83,1553504400,28,12,40,Clouds
40592,84,1553504400,30,0,30,Clouds
40593,85,1553504400,35,0,35,Clouds
40594,86,1553504400,38,0,38,Clouds
40595,87,1553504400,29,9,38,Clouds
40596,88,1553504400,29,1,30,Clouds
40597,89,1553504400,30,10,40,Clouds
40598,90,1553504400,0,39,39,Clouds
40599,91,1553504400,12,17,29,Clouds
40600,92,1553504400,40,0,40,Clouds
40601,93,1553504400,40,0,40,Clouds
40602,94,1553504400,37,3,40,Clouds
40603,95,1553504400,40,0,40,Clouds
40604,96,1553504400,22,8,30,Clouds
40605,97,1553504400,40,0,40,Clouds
40606,98,1553504400,17,23,40,Clouds
40607,99,1553504400,23,6,29,Clouds
40608,100,1553504400,25,0,25,Clouds
40609,101,1553504400,30,0,30,Clouds
40610,102,1553504400,39,1,40,Clouds
40611,103,1553504400,27,13,40,Clouds
40612,104,1553504400,29,11,40,Clouds
40613,105,1553504400,26,10,36,Clouds
40614,106,1553504400,40,0,40,Clouds
40615,107,1553504400,40,0,40,Clouds
40616,108,1553504400,40,0,40,Clouds
40617,109,1553504400,29,0,29,Clouds
40618,110,1553504400,37,3,40,Clouds
40619,111,1553504400,40,0,40,Clouds
40620,112,1553504400,23,7,30,Clouds
40621,113,1553504400,16,23,39,Clouds
40622,114,1553504400,20,19,39,Clouds
40623,115,1553504400,28,2,30,Clouds
40624,2,1553508000,18,2,20,Clouds
40625,3,1553508000,17,3,20,Clouds
40626,4,1553508000,17,3,20,Clouds
40627,5,1553508000,40,0,40,Clouds
40628,6,1553508000,18,2,20,Clouds
40629,7,1553508000,29,0,29,Clouds
40630,8,1553508000,10,20,30,Clouds
40631,9,1553508000,2,22,24,Clouds
40632,10,1553508000,14,2,16,Clouds
40633,11,1553508000,1,29,30,Clouds
40634,12,1553508000,19,1,20,Clouds
40635,13,1553508000,6,24,30,Clouds
40636,14,1553508000,28,2,30,Clouds
40637,15,1553508000,14,2,16,Clouds
40638,16,1553508000,15,5,20,Clouds
40639,17,1553508000,18,2,20,Clouds
40640,18,1553508000,30,0,30,Clouds
40641,19,1553508000,1,25,26,Clouds
40642,21,1553508000,6,23,29,Clouds
40643,22,1553508000,15,5,20,Clouds
40644,23,1553508000,13,16,29,Clouds
40645,24,1553508000,17,3,20,Clouds
40646,25,1553508000,0,30,30,Clouds
40647,26,1553508000,10,10,20,Clouds
40648,27,1553508000,8,12,20,Clouds
40649,28,1553508000,30,0,30,Clouds
40650,29,1553508000,25,4,29,Clouds
40651,30,1553508000,20,0,20,Clouds
40652,31,1553508000,15,4,19,Clouds
40653,32,1553508000,18,11,29,Clouds
40654,33,1553508000,8,15,23,Clouds
40655,34,1553508000,30,0,30,Clouds
40656,35,1553508000,28,2,30,Clouds
40657,36,1553508000,3,37,40,Clouds
40658,37,1553508000,16,14,30,Clouds
40659,38,1553508000,40,0,40,Clouds
40660,39,1553508000,20,0,20,Clouds
40661,40,1553508000,19,2,21,Clouds
40662,41,1553508000,19,1,20,Clouds
40663,42,1553508000,28,2,30,Clouds
40664,43,1553508000,30,0,30,Clouds
40665,44,1553508000,30,0,30,Clouds
40666,45,1553508000,30,0,30,Clouds
40667,46,1553508000,20,0,20,Clouds
40668,47,1553508000,18,21,39,Clouds
40669,48,1553508000,7,33,40,Clouds
40670,49,1553508000,14,26,40,Clouds
40671,50,1553508000,39,1,40,Clouds
40672,51,1553508000,18,22,40,Clouds
40673,52,1553508000,10,21,31,Clouds
40674,53,1553508000,29,11,40,Clouds
40675,54,1553508000,5,28,33,Clouds
40676,55,1553508000,21,15,36,Clouds
40677,56,1553508000,0,40,40,Clouds
40678,57,1553508000,4,19,23,Clouds
40679,58,1553508000,1,39,40,Clouds
40680,59,1553508000,20,0,20,Clouds
40681,60,1553508000,30,0,30,Clouds
40682,61,1553508000,25,0,25,Clouds
40683,62,1553508000,0,39,39,Clouds
40684,63,1553508000,2,33,35,Clouds
40685,64,1553508000,8,31,39,Clouds
40686,65,1553508000,29,11,40,Clouds
40687,66,1553508000,1,38,39,Clouds
40688,67,1553508000,25,15,40,Clouds
40689,68,1553508000,0,39,39,Clouds
40690,69,1553508000,0,39,39,Clouds
40691,70,1553508000,5,21,26,Clouds
40692,71,1553508000,38,2,40,Clouds
40693,72,1553508000,31,0,31,Clouds
40694,73,1553508000,30,0,30,Clouds
40695,74,1553508000,28,2,30,Clouds
40696,75,1553508000,39,1,40,Clouds
40697,76,1553508000,36,2,38,Clouds
40698,77,1553508000,28,1,29,Clouds
40699,78,1553508000,39,1,40,Clouds
40700,79,1553508000,26,1,27,Clouds
40701,80,1553508000,39,1,40,Clouds
40702,81,1553508000,40,0,40,Clouds
40703,82,1553508000,22,0,22,Clouds
40704,83,1553508000,40,0,40,Clouds
40705,84,1553508000,30,0,30,Clouds
40706,85,1553508000,35,0,35,Clouds
40707,86,1553508000,37,1,38,Clouds
40708,87,1553508000,38,0,38,Clouds
40709,88,1553508000,30,0,30,Clouds
40710,89,1553508000,29,11,40,Clouds
40711,90,1553508000,1,38,39,Clouds
40712,91,1553508000,15,14,29,Clouds
40713,92,1553508000,39,1,40,Clouds
40714,93,1553508000,40,0,40,Clouds
40715,94,1553508000,40,0,40,Clouds
40716,95,1553508000,40,0,40,Clouds
40717,96,1553508000,30,0,30,Clouds
40718,97,1553508000,40,0,40,Clouds
40719,98,1553508000,21,19,40,Clouds
40720,99,1553508000,5,24,29,Clouds
40721,100,1553508000,24,1,25,Clouds
40722,101,1553508000,30,0,30,Clouds
40723,102,1553508000,40,0,40,Clouds
40724,103,1553508000,34,6,40,Clouds
40725,104,1553508000,34,6,40,Clouds
40726,105,1553508000,36,0,36,Clouds
40727,106,1553508000,40,0,40,Clouds
40728,107,1553508000,40,0,40,Clouds
40729,108,1553508000,40,0,40,Clouds
40730,109,1553508000,27,2,29,Clouds
40731,110,1553508000,40,0,40,Clouds
40732,111,1553508000,38,2,40,Clouds
40733,112,1553508000,30,0,30,Clouds
40734,113,1553508000,0,39,39,Clouds
40735,114,1553508000,12,26,38,Clouds
40736,115,1553508000,30,0,30,Clouds
40737,2,1553511600,14,6,20,Clouds
40738,3,1553511600,15,5,20,Clouds
40739,4,1553511600,18,1,19,Clouds
40740,5,1553511600,29,11,40,Clouds
40741,6,1553511600,20,0,20,Clouds
40742,7,1553511600,29,0,29,Clouds
40743,8,1553511600,4,26,30,Clouds
40744,9,1553511600,4,19,23,Clouds
40745,10,1553511600,14,2,16,Clouds
40746,11,1553511600,0,30,30,Clouds
40747,12,1553511600,18,2,20,Clouds
40748,13,1553511600,0,30,30,Clouds
40749,14,1553511600,24,5,29,Clouds
40750,15,1553511600,16,0,16,Clouds
40751,16,1553511600,15,5,20,Clouds
40752,17,1553511600,18,2,20,Clouds
40753,18,1553511600,30,0,30,Clouds
40754,19,1553511600,1,25,26,Clouds
40755,21,1553511600,0,29,29,Clouds
40756,22,1553511600,19,1,20,Clouds
40757,23,1553511600,24,5,29,Clouds
40758,24,1553511600,20,0,20,Clouds
40759,25,1553511600,8,22,30,Clouds
40760,26,1553511600,8,12,20,Clouds
40761,27,1553511600,0,20,20,Clouds
40762,28,1553511600,30,0,30,Clouds
40763,29,1553511600,24,5,29,Clouds
40764,30,1553511600,18,2,20,Clouds
40765,31,1553511600,14,5,19,Clouds
40766,32,1553511600,11,18,29,Clouds
40767,33,1553511600,16,7,23,Clouds
40768,34,1553511600,22,8,30,Clouds
40769,35,1553511600,26,4,30,Clouds
40770,36,1553511600,0,40,40,Clouds
40771,37,1553511600,12,18,30,Clouds
40772,38,1553511600,40,0,40,Clouds
40773,39,1553511600,17,3,20,Clouds
40774,40,1553511600,19,2,21,Clouds
40775,41,1553511600,18,2,20,Clouds
40776,42,1553511600,30,0,30,Clouds
40777,43,1553511600,30,0,30,Clouds
40778,44,1553511600,30,0,30,Clouds
40779,45,1553511600,30,0,30,Clouds
40780,46,1553511600,18,2,20,Clouds
40781,47,1553511600,3,36,39,Clouds
40782,48,1553511600,2,38,40,Clouds
40783,49,1553511600,0,40,40,Clouds
40784,50,1553511600,40,0,40,Clouds
40785,51,1553511600,24,16,40,Clouds
40786,52,1553511600,11,20,31,Clouds
40787,53,1553511600,22,17,39,Clouds
40788,54,1553511600,2,31,33,Clouds
40789,55,1553511600,11,25,36,Clouds
40790,56,1553511600,6,34,40,Clouds
40791,57,1553511600,1,22,23,Clouds
40792,58,1553511600,10,30,40,Clouds
40793,59,1553511600,20,0,20,Clouds
40794,60,1553511600,30,0,30,Clouds
40795,61,1553511600,25,0,25,Clouds
40796,62,1553511600,0,39,39,Clouds
40797,63,1553511600,0,35,35,Clouds
40798,64,1553511600,0,39,39,Clouds
40799,65,1553511600,14,26,40,Clouds
40800,66,1553511600,3,36,39,Clouds
40801,67,1553511600,21,19,40,Clouds
40802,68,1553511600,11,28,39,Clouds
40803,69,1553511600,5,34,39,Clouds
40804,70,1553511600,0,27,27,Clouds
40805,71,1553511600,35,5,40,Clouds
40806,72,1553511600,28,3,31,Clouds
40807,73,1553511600,27,3,30,Clouds
40808,74,1553511600,30,0,30,Clouds
40809,75,1553511600,40,0,40,Clouds
40810,76,1553511600,38,0,38,Clouds
40811,77,1553511600,27,2,29,Clouds
40812,78,1553511600,40,0,40,Clouds
40813,79,1553511600,26,1,27,Clouds
40814,80,1553511600,39,1,40,Clouds
40815,81,1553511600,38,2,40,Clouds
40816,82,1553511600,22,0,22,Clouds
40817,83,1553511600,40,0,40,Clouds
40818,84,1553511600,30,0,30,Clouds
40819,85,1553511600,35,0,35,Clouds
40820,86,1553511600,37,1,38,Clouds
40821,87,1553511600,38,0,38,Clouds
40822,88,1553511600,29,1,30,Clouds
40823,89,1553511600,12,28,40,Clouds
40824,90,1553511600,0,39,39,Clouds
40825,91,1553511600,12,17,29,Clouds
40826,92,1553511600,38,2,40,Clouds
40827,93,1553511600,40,0,40,Clouds
40828,94,1553511600,40,0,40,Clouds
40829,95,1553511600,39,1,40,Clouds
40830,96,1553511600,30,0,30,Clouds
40831,97,1553511600,40,0,40,Clouds
40832,98,1553511600,15,25,40,Clouds
40833,99,1553511600,1,28,29,Clouds
40834,100,1553511600,23,2,25,Clouds
40835,101,1553511600,30,0,30,Clouds
40836,102,1553511600,40,0,40,Clouds
40837,103,1553511600,32,8,40,Clouds
40838,104,1553511600,36,4,40,Clouds
40839,105,1553511600,36,0,36,Clouds
40840,106,1553511600,40,0,40,Clouds
40841,107,1553511600,40,0,40,Clouds
40842,108,1553511600,40,0,40,Clouds
40843,109,1553511600,29,0,29,Clouds
40844,110,1553511600,40,0,40,Clouds
40845,111,1553511600,40,0,40,Clouds
40846,112,1553511600,30,0,30,Clouds
40847,113,1553511600,9,30,39,Clouds
40848,114,1553511600,4,34,38,Clouds
40849,115,1553511600,30,0,30,Clouds
40850,2,1553515200,17,3,20,Clouds
40851,3,1553515200,14,6,20,Clouds
40852,4,1553515200,18,2,20,Clouds
40853,5,1553515200,38,2,40,Clouds
40854,6,1553515200,17,3,20,Clouds
40855,7,1553515200,28,1,29,Clouds
40856,8,1553515200,4,26,30,Clouds
40857,9,1553515200,0,23,23,Clouds
40858,10,1553515200,16,0,16,Clouds
40859,11,1553515200,0,30,30,Clouds
40860,12,1553515200,20,0,20,Clouds
40861,13,1553515200,1,29,30,Clouds
40862,14,1553515200,21,9,30,Clouds
40863,15,1553515200,16,0,16,Clouds
40864,16,1553515200,18,2,20,Clouds
40865,17,1553515200,18,2,20,Clouds
40866,18,1553515200,30,0,30,Clouds
40867,19,1553515200,0,26,26,Clouds
40868,21,1553515200,12,17,29,Clouds
40869,22,1553515200,15,5,20,Clouds
40870,23,1553515200,22,7,29,Clouds
40871,24,1553515200,18,2,20,Clouds
40872,25,1553515200,10,20,30,Clouds
40873,26,1553515200,5,15,20,Clouds
40874,27,1553515200,5,15,20,Clouds
40875,28,1553515200,18,12,30,Clouds
40876,29,1553515200,26,3,29,Clouds
40877,30,1553515200,19,1,20,Clouds
40878,31,1553515200,18,1,19,Clouds
40879,32,1553515200,0,29,29,Clouds
40880,33,1553515200,16,7,23,Clouds
40881,34,1553515200,27,3,30,Clouds
40882,35,1553515200,30,0,30,Clouds
40883,36,1553515200,6,34,40,Clouds
40884,37,1553515200,10,20,30,Clouds
40885,38,1553515200,39,1,40,Clouds
40886,39,1553515200,17,3,20,Clouds
40887,40,1553515200,16,5,21,Clouds
40888,41,1553515200,18,2,20,Clouds
40889,42,1553515200,30,0,30,Clouds
40890,43,1553515200,30,0,30,Clouds
40891,44,1553515200,30,0,30,Clouds
40892,45,1553515200,29,1,30,Clouds
40893,46,1553515200,19,1,20,Clouds
40894,47,1553515200,1,38,39,Clouds
40895,48,1553515200,12,28,40,Clouds
40896,49,1553515200,6,34,40,Clouds
40897,50,1553515200,40,0,40,Clouds
40898,51,1553515200,20,20,40,Clouds
40899,52,1553515200,11,20,31,Clouds
40900,53,1553515200,23,16,39,Clouds
40901,54,1553515200,4,29,33,Clouds
40902,55,1553515200,9,27,36,Clouds
40903,56,1553515200,4,35,39,Clouds
40904,57,1553515200,1,22,23,Clouds
40905,58,1553515200,8,32,40,Clouds
40906,59,1553515200,20,0,20,Clouds
40907,60,1553515200,30,0,30,Clouds
40908,61,1553515200,16,9,25,Clouds
40909,62,1553515200,5,35,40,Clouds
40910,63,1553515200,1,34,35,Clouds
40911,64,1553515200,5,35,40,Clouds
40912,65,1553515200,9,31,40,Clouds
40913,66,1553515200,7,33,40,Clouds
40914,67,1553515200,21,19,40,Clouds
40915,68,1553515200,1,38,39,Clouds
40916,69,1553515200,9,30,39,Clouds
40917,70,1553515200,0,27,27,Clouds
40918,71,1553515200,36,4,40,Clouds
40919,72,1553515200,21,10,31,Clouds
40920,73,1553515200,30,0,30,Clouds
40921,74,1553515200,29,1,30,Clouds
40922,75,1553515200,34,6,40,Clouds
40923,76,1553515200,38,0,38,Clouds
40924,77,1553515200,25,4,29,Clouds
40925,78,1553515200,27,13,40,Clouds
40926,79,1553515200,27,0,27,Clouds
40927,80,1553515200,39,1,40,Clouds
40928,81,1553515200,40,0,40,Clouds
40929,82,1553515200,21,1,22,Clouds
40930,83,1553515200,40,0,40,Clouds
40931,84,1553515200,29,1,30,Clouds
40932,85,1553515200,35,0,35,Clouds
40933,86,1553515200,38,0,38,Clouds
40934,87,1553515200,38,0,38,Clouds
40935,88,1553515200,30,0,30,Clouds
40936,89,1553515200,7,33,40,Clouds
40937,90,1553515200,0,39,39,Clouds
40938,91,1553515200,14,15,29,Clouds
40939,92,1553515200,39,1,40,Clouds
40940,93,1553515200,40,0,40,Clouds
40941,94,1553515200,40,0,40,Clouds
40942,95,1553515200,40,0,40,Clouds
40943,96,1553515200,30,0,30,Clouds
40944,97,1553515200,39,1,40,Clouds
40945,98,1553515200,10,30,40,Clouds
40946,99,1553515200,0,30,30,Clouds
40947,100,1553515200,21,4,25,Clouds
40948,101,1553515200,30,0,30,Clouds
40949,102,1553515200,36,4,40,Clouds
40950,103,1553515200,29,11,40,Clouds
40951,104,1553515200,37,3,40,Clouds
40952,105,1553515200,36,0,36,Clouds
40953,106,1553515200,40,0,40,Clouds
40954,107,1553515200,40,0,40,Clouds
40955,108,1553515200,40,0,40,Clouds
40956,109,1553515200,29,0,29,Clouds
40957,110,1553515200,39,1,40,Clouds
40958,111,1553515200,40,0,40,Clouds
40959,112,1553515200,30,0,30,Clouds
40960,113,1553515200,6,33,39,Clouds
40961,114,1553515200,4,34,38,Clouds
40962,115,1553515200,29,1,30,Clouds
40963,2,1553518800,20,0,20,Clouds
40964,3,1553518800,20,0,20,Clouds
40965,4,1553518800,20,0,20,Clouds
40966,5,1553518800,37,3,40,Clouds
40967,6,1553518800,18,2,20,Clouds
40968,7,1553518800,28,1,29,Clouds
40969,8,1553518800,7,23,30,Clouds
40970,9,1553518800,0,24,24,Clouds
40971,10,1553518800,13,3,16,Clouds
40972,11,1553518800,1,29,30,Clouds
40973,12,1553518800,20,0,20,Clouds
40974,13,1553518800,0,30,30,Clouds
40975,14,1553518800,12,18,30,Clouds
40976,15,1553518800,16,0,16,Clouds
40977,16,1553518800,19,1,20,Clouds
40978,17,1553518800,17,3,20,Clouds
40979,18,1553518800,28,2,30,Clouds
40980,19,1553518800,6,24,30,Clouds
40981,21,1553518800,12,17,29,Clouds
40982,22,1553518800,12,8,20,Clouds
40983,23,1553518800,24,5,29,Clouds
40984,24,1553518800,18,2,20,Clouds
40985,25,1553518800,13,17,30,Clouds
40986,26,1553518800,1,19,20,Clouds
40987,27,1553518800,5,15,20,Clouds
40988,28,1553518800,30,0,30,Clouds
40989,29,1553518800,26,3,29,Clouds
40990,30,1553518800,18,2,20,Clouds
40991,31,1553518800,17,3,20,Clouds
40992,32,1553518800,14,15,29,Clouds
40993,33,1553518800,18,5,23,Clouds
40994,34,1553518800,30,0,30,Clouds
40995,35,1553518800,28,2,30,Clouds
40996,36,1553518800,1,39,40,Clouds
40997,37,1553518800,12,18,30,Clouds
40998,38,1553518800,39,1,40,Clouds
40999,39,1553518800,20,0,20,Clouds
41000,40,1553518800,18,3,21,Clouds
41001,41,1553518800,16,4,20,Clouds
41002,42,1553518800,30,0,30,Clouds
41003,43,1553518800,29,1,30,Clouds
41004,44,1553518800,28,2,30,Clouds
41005,45,1553518800,29,1,30,Clouds
41006,46,1553518800,18,2,20,Clouds
41007,47,1553518800,1,39,40,Clouds
41008,48,1553518800,17,23,40,Clouds
41009,49,1553518800,9,31,40,Clouds
41010,50,1553518800,39,1,40,Clouds
41011,51,1553518800,15,25,40,Clouds
41012,52,1553518800,12,19,31,Clouds
41013,53,1553518800,22,17,39,Clouds
41014,54,1553518800,8,25,33,Clouds
41015,55,1553518800,10,26,36,Clouds
41016,56,1553518800,5,35,40,Clouds
41017,57,1553518800,0,23,23,Clouds
41018,58,1553518800,10,30,40,Clouds
41019,59,1553518800,20,0,20,Clouds
41020,60,1553518800,21,9,30,Clouds
41021,61,1553518800,21,4,25,Clouds
41022,62,1553518800,5,35,40,Clouds
41023,63,1553518800,1,34,35,Clouds
41024,64,1553518800,23,17,40,Clouds
41025,65,1553518800,12,28,40,Clouds
41026,66,1553518800,9,31,40,Clouds
41027,67,1553518800,19,21,40,Clouds
41028,68,1553518800,1,39,40,Clouds
41029,69,1553518800,2,38,40,Clouds
41030,70,1553518800,2,26,28,Clouds
41031,71,1553518800,35,5,40,Clouds
41032,72,1553518800,24,7,31,Clouds
41033,73,1553518800,30,0,30,Clouds
41034,74,1553518800,30,0,30,Clouds
41035,75,1553518800,36,4,40,Clouds
41036,76,1553518800,37,1,38,Clouds
41037,77,1553518800,25,4,29,Clouds
41038,78,1553518800,32,8,40,Clouds
41039,79,1553518800,27,0,27,Clouds
41040,80,1553518800,40,0,40,Clouds
41041,81,1553518800,39,1,40,Clouds
41042,82,1553518800,22,0,22,Clouds
41043,83,1553518800,40,0,40,Clouds
41044,84,1553518800,30,0,30,Clouds
41045,85,1553518800,35,0,35,Clouds
41046,86,1553518800,37,1,38,Clouds
41047,87,1553518800,38,0,38,Clouds
41048,88,1553518800,29,1,30,Clouds
41049,89,1553518800,6,34,40,Clouds
41050,90,1553518800,4,36,40,Clouds
41051,91,1553518800,15,15,30,Clouds
41052,92,1553518800,40,0,40,Clouds
41053,93,1553518800,40,0,40,Clouds
41054,94,1553518800,39,1,40,Clouds
41055,95,1553518800,40,0,40,Clouds
41056,96,1553518800,30,0,30,Clouds
41057,97,1553518800,40,0,40,Clouds
41058,98,1553518800,12,28,40,Clouds
41059,99,1553518800,0,30,30,Clouds
41060,100,1553518800,23,2,25,Clouds
41061,101,1553518800,29,1,30,Clouds
41062,102,1553518800,37,3,40,Clouds
41063,103,1553518800,33,7,40,Clouds
41064,104,1553518800,38,2,40,Clouds
41065,105,1553518800,36,0,36,Clouds
41066,106,1553518800,40,0,40,Clouds
41067,107,1553518800,39,1,40,Clouds
41068,108,1553518800,40,0,40,Clouds
41069,109,1553518800,29,0,29,Clouds
41070,110,1553518800,39,1,40,Clouds
41071,111,1553518800,30,10,40,Clouds
41072,112,1553518800,25,5,30,Clouds
41073,113,1553518800,10,30,40,Clouds
41074,114,1553518800,1,37,38,Clouds
41075,115,1553518800,27,3,30,Clouds
41076,2,1553522400,19,1,20,Clouds
41077,3,1553522400,20,0,20,Clouds
41078,4,1553522400,20,0,20,Clouds
41079,5,1553522400,36,4,40,Clouds
41080,6,1553522400,16,4,20,Clouds
41081,7,1553522400,29,0,29,Clouds
41082,8,1553522400,12,18,30,Clouds
41083,9,1553522400,17,7,24,Clouds
41084,10,1553522400,13,3,16,Clouds
41085,11,1553522400,7,23,30,Clouds
41086,12,1553522400,20,0,20,Clouds
41087,13,1553522400,5,25,30,Clouds
41088,14,1553522400,14,16,30,Clouds
41089,15,1553522400,16,0,16,Clouds
41090,16,1553522400,18,2,20,Clouds
41091,17,1553522400,16,4,20,Clouds
41092,18,1553522400,30,0,30,Clouds
41093,19,1553522400,1,29,30,Clouds
41094,21,1553522400,3,26,29,Clouds
41095,22,1553522400,11,9,20,Clouds
41096,23,1553522400,25,4,29,Clouds
41097,24,1553522400,20,0,20,Clouds
41098,25,1553522400,13,17,30,Clouds
41099,26,1553522400,1,19,20,Clouds
41100,27,1553522400,8,12,20,Clouds
41101,28,1553522400,27,3,30,Clouds
41102,29,1553522400,26,3,29,Clouds
41103,30,1553522400,20,0,20,Clouds
41104,31,1553522400,20,0,20,Clouds
41105,32,1553522400,1,28,29,Clouds
41106,33,1553522400,15,8,23,Clouds
41107,34,1553522400,22,8,30,Clouds
41108,35,1553522400,30,0,30,Clouds
41109,36,1553522400,1,39,40,Clouds
41110,37,1553522400,13,17,30,Clouds
41111,38,1553522400,37,3,40,Clouds
41112,39,1553522400,15,5,20,Clouds
41113,40,1553522400,19,2,21,Clouds
41114,41,1553522400,19,1,20,Clouds
41115,42,1553522400,27,3,30,Clouds
41116,43,1553522400,29,1,30,Clouds
41117,44,1553522400,27,3,30,Clouds
41118,45,1553522400,30,0,30,Clouds
41119,46,1553522400,18,2,20,Clouds
41120,47,1553522400,4,36,40,Clouds
41121,48,1553522400,13,27,40,Clouds
41122,49,1553522400,4,36,40,Clouds
41123,50,1553522400,40,0,40,Clouds
41124,51,1553522400,15,25,40,Clouds
41125,52,1553522400,12,19,31,Clouds
41126,53,1553522400,19,20,39,Clouds
41127,54,1553522400,10,23,33,Clouds
41128,55,1553522400,13,23,36,Clouds
41129,56,1553522400,11,29,40,Clouds
41130,57,1553522400,4,19,23,Clouds
41131,58,1553522400,15,25,40,Clouds
41132,59,1553522400,20,0,20,Clouds
41133,60,1553522400,24,6,30,Clouds
41134,61,1553522400,25,0,25,Clouds
41135,62,1553522400,4,36,40,Clouds
41136,63,1553522400,11,24,35,Clouds
41137,64,1553522400,23,17,40,Clouds
41138,65,1553522400,20,20,40,Clouds
41139,66,1553522400,10,30,40,Clouds
41140,67,1553522400,19,21,40,Clouds
41141,68,1553522400,12,28,40,Clouds
41142,69,1553522400,16,24,40,Clouds
41143,70,1553522400,0,28,28,Clouds
41144,71,1553522400,38,2,40,Clouds
41145,72,1553522400,27,4,31,Clouds
41146,73,1553522400,30,0,30,Clouds
41147,74,1553522400,29,1,30,Clouds
41148,75,1553522400,36,4,40,Clouds
41149,76,1553522400,38,0,38,Clouds
41150,77,1553522400,26,3,29,Clouds
41151,78,1553522400,35,5,40,Clouds
41152,79,1553522400,27,0,27,Clouds
41153,80,1553522400,26,14,40,Clouds
41154,81,1553522400,40,0,40,Clouds
41155,82,1553522400,22,0,22,Clouds
41156,83,1553522400,34,6,40,Clouds
41157,84,1553522400,30,0,30,Clouds
41158,85,1553522400,35,0,35,Clouds
41159,86,1553522400,38,0,38,Clouds
41160,87,1553522400,37,1,38,Clouds
41161,88,1553522400,30,0,30,Clouds
41162,89,1553522400,4,36,40,Clouds
41163,90,1553522400,7,33,40,Clouds
41164,91,1553522400,21,9,30,Clouds
41165,92,1553522400,40,0,40,Clouds
41166,93,1553522400,40,0,40,Clouds
41167,94,1553522400,40,0,40,Clouds
41168,95,1553522400,39,1,40,Clouds
41169,96,1553522400,30,0,30,Clouds
41170,97,1553522400,34,6,40,Clouds
41171,98,1553522400,13,27,40,Clouds
41172,99,1553522400,1,29,30,Clouds
41173,100,1553522400,22,3,25,Clouds
41174,101,1553522400,30,0,30,Clouds
41175,102,1553522400,40,0,40,Clouds
41176,103,1553522400,35,5,40,Clouds
41177,104,1553522400,38,2,40,Clouds
41178,105,1553522400,36,0,36,Clouds
41179,106,1553522400,40,0,40,Clouds
41180,107,1553522400,40,0,40,Clouds
41181,108,1553522400,39,1,40,Clouds
41182,109,1553522400,28,1,29,Clouds
41183,110,1553522400,38,2,40,Clouds
41184,111,1553522400,40,0,40,Clouds
41185,112,1553522400,23,7,30,Clouds
41186,113,1553522400,8,32,40,Clouds
41187,114,1553522400,0,39,39,Clouds
41188,115,1553522400,28,2,30,Clouds
41189,2,1553526000,19,1,20,Clouds
41190,3,1553526000,8,12,20,Clouds
41191,4,1553526000,18,2,20,Clouds
41192,5,1553526000,32,8,40,Clouds
41193,6,1553526000,18,2,20,Clouds
41194,7,1553526000,29,0,29,Clouds
41195,8,1553526000,1,29,30,Clouds
41196,9,1553526000,23,1,24,Clouds
41197,10,1553526000,12,4,16,Clouds
41198,11,1553526000,13,17,30,Clouds
41199,12,1553526000,18,2,20,Clouds
41200,13,1553526000,4,26,30,Clouds
41201,14,1553526000,19,11,30,Clouds
41202,15,1553526000,10,6,16,Clouds
41203,16,1553526000,16,4,20,Clouds
41204,17,1553526000,14,6,20,Clouds
41205,18,1553526000,25,5,30,Clouds
41206,19,1553526000,1,29,30,Clouds
41207,21,1553526000,22,7,29,Clouds
41208,22,1553526000,20,0,20,Clouds
41209,23,1553526000,25,4,29,Clouds
41210,24,1553526000,10,10,20,Clouds
41211,25,1553526000,10,20,30,Clouds
41212,26,1553526000,4,16,20,Clouds
41213,27,1553526000,5,15,20,Clouds
41214,28,1553526000,26,4,30,Clouds
41215,29,1553526000,27,2,29,Clouds
41216,30,1553526000,12,8,20,Clouds
41217,31,1553526000,16,4,20,Clouds
41218,32,1553526000,16,13,29,Clouds
41219,33,1553526000,8,14,22,Clouds
41220,34,1553526000,30,0,30,Clouds
41221,35,1553526000,29,1,30,Clouds
41222,36,1553526000,1,39,40,Clouds
41223,37,1553526000,11,19,30,Clouds
41224,38,1553526000,29,11,40,Clouds
41225,39,1553526000,11,9,20,Clouds
41226,40,1553526000,21,0,21,Clouds
41227,41,1553526000,18,2,20,Clouds
41228,42,1553526000,28,2,30,Clouds
41229,43,1553526000,29,1,30,Clouds
41230,44,1553526000,27,3,30,Clouds
41231,45,1553526000,28,2,30,Clouds
41232,46,1553526000,20,0,20,Clouds
41233,47,1553526000,3,37,40,Clouds
41234,48,1553526000,9,31,40,Clouds
41235,49,1553526000,2,38,40,Clouds
41236,50,1553526000,40,0,40,Clouds
41237,51,1553526000,14,26,40,Clouds
41238,52,1553526000,21,10,31,Clouds
41239,53,1553526000,20,19,39,Clouds
41240,54,1553526000,12,21,33,Clouds
41241,55,1553526000,11,25,36,Clouds
41242,56,1553526000,10,30,40,Clouds
41243,57,1553526000,0,23,23,Clouds
41244,58,1553526000,11,29,40,Clouds
41245,59,1553526000,18,2,20,Clouds
41246,60,1553526000,29,1,30,Clouds
41247,61,1553526000,24,1,25,Clouds
41248,62,1553526000,1,39,40,Clouds
41249,63,1553526000,11,24,35,Clouds
41250,64,1553526000,18,22,40,Clouds
41251,65,1553526000,18,22,40,Clouds
41252,66,1553526000,3,37,40,Clouds
41253,67,1553526000,22,18,40,Clouds
41254,68,1553526000,11,29,40,Clouds
41255,69,1553526000,7,33,40,Clouds
41256,70,1553526000,0,28,28,Clouds
41257,71,1553526000,36,4,40,Clouds
41258,72,1553526000,31,0,31,Clouds
41259,73,1553526000,30,0,30,Clouds
41260,74,1553526000,29,1,30,Clouds
41261,75,1553526000,39,1,40,Clouds
41262,76,1553526000,37,1,38,Clouds
41263,77,1553526000,29,0,29,Clouds
41264,78,1553526000,40,0,40,Clouds
41265,79,1553526000,24,3,27,Clouds
41266,80,1553526000,32,8,40,Clouds
41267,81,1553526000,40,0,40,Clouds
41268,82,1553526000,20,2,22,Clouds
41269,83,1553526000,34,6,40,Clouds
41270,84,1553526000,27,3,30,Clouds
41271,85,1553526000,35,0,35,Clouds
41272,86,1553526000,35,3,38,Clouds
41273,87,1553526000,37,1,38,Clouds
41274,88,1553526000,29,1,30,Clouds
41275,89,1553526000,7,33,40,Clouds
41276,90,1553526000,10,30,40,Clouds
41277,91,1553526000,16,14,30,Clouds
41278,92,1553526000,37,3,40,Clouds
41279,93,1553526000,40,0,40,Clouds
41280,94,1553526000,40,0,40,Clouds
41281,95,1553526000,37,3,40,Clouds
41282,96,1553526000,30,0,30,Clouds
41283,97,1553526000,35,5,40,Clouds
41284,98,1553526000,15,25,40,Clouds
41285,99,1553526000,0,30,30,Clouds
41286,100,1553526000,21,4,25,Clouds
41287,101,1553526000,29,1,30,Clouds
41288,102,1553526000,39,1,40,Clouds
41289,103,1553526000,34,6,40,Clouds
41290,104,1553526000,38,2,40,Clouds
41291,105,1553526000,36,0,36,Clouds
41292,106,1553526000,33,7,40,Clouds
41293,107,1553526000,36,4,40,Clouds
41294,108,1553526000,33,7,40,Clouds
41295,109,1553526000,25,3,28,Clouds
41296,110,1553526000,39,1,40,Clouds
41297,111,1553526000,38,2,40,Clouds
41298,112,1553526000,24,6,30,Clouds
41299,113,1553526000,13,27,40,Clouds
41300,114,1553526000,1,38,39,Clouds
41301,115,1553526000,23,7,30,Clouds
41302,2,1553529600,20,0,20,Clouds
41303,3,1553529600,12,8,20,Clouds
41304,4,1553529600,17,3,20,Clouds
41305,5,1553529600,32,8,40,Clouds
41306,6,1553529600,20,0,20,Clouds
41307,7,1553529600,29,0,29,Clouds
41308,8,1553529600,9,21,30,Clouds
41309,9,1553529600,24,0,24,Clouds
41310,10,1553529600,9,7,16,Clouds
41311,11,1553529600,12,18,30,Clouds
41312,12,1553529600,19,1,20,Clouds
41313,13,1553529600,3,27,30,Clouds
41314,14,1553529600,17,13,30,Clouds
41315,15,1553529600,14,2,16,Clouds
41316,16,1553529600,18,2,20,Clouds
41317,17,1553529600,13,7,20,Clouds
41318,18,1553529600,27,3,30,Clouds
41319,19,1553529600,9,21,30,Clouds
41320,21,1553529600,25,5,30,Clouds
41321,22,1553529600,13,7,20,Clouds
41322,23,1553529600,19,11,30,Clouds
41323,24,1553529600,3,17,20,Clouds
41324,25,1553529600,11,19,30,Clouds
41325,26,1553529600,3,17,20,Clouds
41326,27,1553529600,10,10,20,Clouds
41327,28,1553529600,27,3,30,Clouds
41328,29,1553529600,28,1,29,Clouds
41329,30,1553529600,16,4,20,Clouds
41330,31,1553529600,16,4,20,Clouds
41331,32,1553529600,11,19,30,Clouds
41332,33,1553529600,6,17,23,Clouds
41333,34,1553529600,28,2,30,Clouds
41334,35,1553529600,30,0,30,Clouds
41335,36,1553529600,1,39,40,Clouds
41336,37,1553529600,11,19,30,Clouds
41337,38,1553529600,30,10,40,Clouds
41338,39,1553529600,12,8,20,Clouds
41339,40,1553529600,21,0,21,Clouds
41340,41,1553529600,17,3,20,Clouds
41341,42,1553529600,30,0,30,Clouds
41342,43,1553529600,30,0,30,Clouds
41343,44,1553529600,28,2,30,Clouds
41344,45,1553529600,27,3,30,Clouds
41345,46,1553529600,18,2,20,Clouds
41346,47,1553529600,3,37,40,Clouds
41347,48,1553529600,4,36,40,Clouds
41348,49,1553529600,1,39,40,Clouds
41349,50,1553529600,38,2,40,Clouds
41350,51,1553529600,17,23,40,Clouds
41351,52,1553529600,21,11,32,Clouds
41352,53,1553529600,20,20,40,Clouds
41353,54,1553529600,15,18,33,Clouds
41354,55,1553529600,10,26,36,Clouds
41355,56,1553529600,4,36,40,Clouds
41356,57,1553529600,3,20,23,Clouds
41357,58,1553529600,6,34,40,Clouds
41358,59,1553529600,17,3,20,Clouds
41359,60,1553529600,23,7,30,Clouds
41360,61,1553529600,24,1,25,Clouds
41361,62,1553529600,7,33,40,Clouds
41362,63,1553529600,9,26,35,Clouds
41363,64,1553529600,13,27,40,Clouds
41364,65,1553529600,15,25,40,Clouds
41365,66,1553529600,8,32,40,Clouds
41366,67,1553529600,25,15,40,Clouds
41367,68,1553529600,9,31,40,Clouds
41368,69,1553529600,8,32,40,Clouds
41369,70,1553529600,1,27,28,Clouds
41370,71,1553529600,40,0,40,Clouds
41371,72,1553529600,31,0,31,Clouds
41372,73,1553529600,29,1,30,Clouds
41373,74,1553529600,29,1,30,Clouds
41374,75,1553529600,40,0,40,Clouds
41375,76,1553529600,38,0,38,Clouds
41376,77,1553529600,28,1,29,Clouds
41377,78,1553529600,38,2,40,Clouds
41378,79,1553529600,24,3,27,Clouds
41379,80,1553529600,38,2,40,Clouds
41380,81,1553529600,40,0,40,Clouds
41381,82,1553529600,22,0,22,Clouds
41382,83,1553529600,35,5,40,Clouds
41383,84,1553529600,30,0,30,Clouds
41384,85,1553529600,35,0,35,Clouds
41385,86,1553529600,31,7,38,Clouds
41386,87,1553529600,38,0,38,Clouds
41387,88,1553529600,28,2,30,Clouds
41388,89,1553529600,10,30,40,Clouds
41389,90,1553529600,10,30,40,Clouds
41390,91,1553529600,9,21,30,Clouds
41391,92,1553529600,36,4,40,Clouds
41392,93,1553529600,40,0,40,Clouds
41393,94,1553529600,40,0,40,Clouds
41394,95,1553529600,35,5,40,Clouds
41395,96,1553529600,30,0,30,Clouds
41396,97,1553529600,33,6,39,Clouds
41397,98,1553529600,14,26,40,Clouds
41398,99,1553529600,3,27,30,Clouds
41399,100,1553529600,13,12,25,Clouds
41400,101,1553529600,26,4,30,Clouds
41401,102,1553529600,31,9,40,Clouds
41402,103,1553529600,36,4,40,Clouds
41403,104,1553529600,38,2,40,Clouds
41404,105,1553529600,31,5,36,Clouds
41405,106,1553529600,34,6,40,Clouds
41406,107,1553529600,35,5,40,Clouds
41407,108,1553529600,36,4,40,Clouds
41408,109,1553529600,25,3,28,Clouds
41409,110,1553529600,31,9,40,Clouds
41410,111,1553529600,36,4,40,Clouds
41411,112,1553529600,29,1,30,Clouds
41412,113,1553529600,3,37,40,Clouds
41413,114,1553529600,6,34,40,Clouds
41414,115,1553529600,25,5,30,Clouds
41415,2,1553533200,20,0,20,Clouds
41416,3,1553533200,13,7,20,Clouds
41417,4,1553533200,18,2,20,Clouds
41418,5,1553533200,25,15,40,Clouds
41419,6,1553533200,19,1,20,Clouds
41420,7,1553533200,13,16,29,Clouds
41421,8,1553533200,2,28,30,Clouds
41422,9,1553533200,20,4,24,Clouds
41423,10,1553533200,16,0,16,Clouds
41424,11,1553533200,6,24,30,Clouds
41425,12,1553533200,20,0,20,Clouds
41426,13,1553533200,2,28,30,Clouds
41427,14,1553533200,13,17,30,Clouds
41428,15,1553533200,16,0,16,Clouds
41429,16,1553533200,20,0,20,Clouds
41430,17,1553533200,16,4,20,Clouds
41431,18,1553533200,25,5,30,Clouds
41432,19,1553533200,8,22,30,Clouds
41433,21,1553533200,28,2,30,Clouds
41434,22,1553533200,11,9,20,Clouds
41435,23,1553533200,8,22,30,Clouds
41436,24,1553533200,1,19,20,Clouds
41437,25,1553533200,19,11,30,Clouds
41438,26,1553533200,1,19,20,Clouds
41439,27,1553533200,10,10,20,Clouds
41440,28,1553533200,28,2,30,Clouds
41441,29,1553533200,23,6,29,Clouds
41442,30,1553533200,16,4,20,Clouds
41443,31,1553533200,16,4,20,Clouds
41444,32,1553533200,27,3,30,Clouds
41445,33,1553533200,0,23,23,Clouds
41446,34,1553533200,25,5,30,Clouds
41447,35,1553533200,28,2,30,Clouds
41448,36,1553533200,9,31,40,Clouds
41449,37,1553533200,12,18,30,Clouds
41450,38,1553533200,28,12,40,Clouds
41451,39,1553533200,11,9,20,Clouds
41452,40,1553533200,19,2,21,Clouds
41453,41,1553533200,16,4,20,Clouds
41454,42,1553533200,30,0,30,Clouds
41455,43,1553533200,27,3,30,Clouds
41456,44,1553533200,22,8,30,Clouds
41457,45,1553533200,22,8,30,Clouds
41458,46,1553533200,14,6,20,Clouds
41459,47,1553533200,4,36,40,Clouds
41460,48,1553533200,4,36,40,Clouds
41461,49,1553533200,8,32,40,Clouds
41462,50,1553533200,38,2,40,Clouds
41463,51,1553533200,30,10,40,Clouds
41464,52,1553533200,20,12,32,Clouds
41465,53,1553533200,24,16,40,Clouds
41466,54,1553533200,17,16,33,Clouds
41467,55,1553533200,13,23,36,Clouds
41468,56,1553533200,11,29,40,Clouds
41469,57,1553533200,5,18,23,Clouds
41470,58,1553533200,8,32,40,Clouds
41471,59,1553533200,20,0,20,Clouds
41472,60,1553533200,22,8,30,Clouds
41473,61,1553533200,25,0,25,Clouds
41474,62,1553533200,11,29,40,Clouds
41475,63,1553533200,10,25,35,Clouds
41476,64,1553533200,15,25,40,Clouds
41477,65,1553533200,18,22,40,Clouds
41478,66,1553533200,12,28,40,Clouds
41479,67,1553533200,27,13,40,Clouds
41480,68,1553533200,13,27,40,Clouds
41481,69,1553533200,11,29,40,Clouds
41482,70,1553533200,2,26,28,Clouds
41483,71,1553533200,39,1,40,Clouds
41484,72,1553533200,30,1,31,Clouds
41485,73,1553533200,28,2,30,Clouds
41486,74,1553533200,28,2,30,Clouds
41487,75,1553533200,36,4,40,Clouds
41488,76,1553533200,35,3,38,Clouds
41489,77,1553533200,29,0,29,Clouds
41490,78,1553533200,39,1,40,Clouds
41491,79,1553533200,27,0,27,Clouds
41492,80,1553533200,39,1,40,Clouds
41493,81,1553533200,40,0,40,Clouds
41494,82,1553533200,21,1,22,Clouds
41495,83,1553533200,35,5,40,Clouds
41496,84,1553533200,28,2,30,Clouds
41497,85,1553533200,31,4,35,Clouds
41498,86,1553533200,33,5,38,Clouds
41499,87,1553533200,38,0,38,Clouds
41500,88,1553533200,28,2,30,Clouds
41501,89,1553533200,9,31,40,Clouds
41502,90,1553533200,22,18,40,Clouds
41503,91,1553533200,13,17,30,Clouds
41504,92,1553533200,38,2,40,Clouds
41505,93,1553533200,39,1,40,Clouds
41506,94,1553533200,39,1,40,Clouds
41507,95,1553533200,37,3,40,Clouds
41508,96,1553533200,29,1,30,Clouds
41509,97,1553533200,31,8,39,Clouds
41510,98,1553533200,16,24,40,Clouds
41511,99,1553533200,5,25,30,Clouds
41512,100,1553533200,5,20,25,Clouds
41513,101,1553533200,29,1,30,Clouds
41514,102,1553533200,36,4,40,Clouds
41515,103,1553533200,40,0,40,Clouds
41516,104,1553533200,38,2,40,Clouds
41517,105,1553533200,29,7,36,Clouds
41518,106,1553533200,37,3,40,Clouds
41519,107,1553533200,36,4,40,Clouds
41520,108,1553533200,35,5,40,Clouds
41521,109,1553533200,27,2,29,Clouds
41522,110,1553533200,31,9,40,Clouds
41523,111,1553533200,38,2,40,Clouds
41524,112,1553533200,25,5,30,Clouds
41525,113,1553533200,2,38,40,Clouds
41526,114,1553533200,19,21,40,Clouds
41527,115,1553533200,25,5,30,Clouds
41528,2,1553540400,17,3,20,Clouds
41529,3,1553540400,18,2,20,Clouds
41530,4,1553540400,20,0,20,Clouds
41531,5,1553540400,26,14,40,Clouds
41532,6,1553540400,16,4,20,Clouds
41533,7,1553540400,25,4,29,Clouds
41534,8,1553540400,12,18,30,Clouds
41535,9,1553540400,12,12,24,Clouds
41536,10,1553540400,12,4,16,Clouds
41537,11,1553540400,30,0,30,Clouds
41538,12,1553540400,14,6,20,Clouds
41539,13,1553540400,26,4,30,Clouds
41540,14,1553540400,16,14,30,Clouds
41541,15,1553540400,15,1,16,Clouds
41542,16,1553540400,0,20,20,Clouds
41543,17,1553540400,20,0,20,Clouds
41544,18,1553540400,25,5,30,Clouds
41545,19,1553540400,28,2,30,Clouds
41546,21,1553540400,24,6,30,Clouds
41547,22,1553540400,2,18,20,Clouds
41548,23,1553540400,1,29,30,Clouds
41549,24,1553540400,15,5,20,Clouds
41550,25,1553540400,29,1,30,Clouds
41551,26,1553540400,15,5,20,Clouds
41552,27,1553540400,18,2,20,Clouds
41553,28,1553540400,26,4,30,Clouds
41554,29,1553540400,28,1,29,Clouds
41555,30,1553540400,19,1,20,Clouds
41556,31,1553540400,15,5,20,Clouds
41557,32,1553540400,11,19,30,Clouds
41558,33,1553540400,6,17,23,Clouds
41559,34,1553540400,5,25,30,Clouds
41560,35,1553540400,28,2,30,Clouds
41561,36,1553540400,37,3,40,Clouds
41562,37,1553540400,30,0,30,Clouds
41563,38,1553540400,10,30,40,Clouds
41564,39,1553540400,15,5,20,Clouds
41565,40,1553540400,21,0,21,Clouds
41566,41,1553540400,19,1,20,Clouds
41567,42,1553540400,16,14,30,Clouds
41568,43,1553540400,12,18,30,Clouds
41569,44,1553540400,10,20,30,Clouds
41570,45,1553540400,14,16,30,Clouds
41571,46,1553540400,18,2,20,Clouds
41572,47,1553540400,40,0,40,Clouds
41573,48,1553540400,6,34,40,Clouds
41574,49,1553540400,21,19,40,Clouds
41575,50,1553540400,21,19,40,Clouds
41576,51,1553540400,38,2,40,Clouds
41577,52,1553540400,32,0,32,Clouds
41578,53,1553540400,40,0,40,Clouds
41579,54,1553540400,33,0,33,Clouds
41580,55,1553540400,35,1,36,Clouds
41581,56,1553540400,40,0,40,Clouds
41582,57,1553540400,21,2,23,Clouds
41583,58,1553540400,38,2,40,Clouds
41584,59,1553540400,20,0,20,Clouds
41585,60,1553540400,8,22,30,Clouds
41586,61,1553540400,25,0,25,Clouds
41587,62,1553540400,40,0,40,Clouds
41588,63,1553540400,34,1,35,Clouds
41589,64,1553540400,19,21,40,Clouds
41590,65,1553540400,40,0,40,Clouds
41591,66,1553540400,39,1,40,Clouds
41592,67,1553540400,29,11,40,Clouds
41593,68,1553540400,40,0,40,Clouds
41594,69,1553540400,28,12,40,Clouds
41595,70,1553540400,3,25,28,Clouds
41596,71,1553540400,35,5,40,Clouds
41597,72,1553540400,10,21,31,Clouds
41598,73,1553540400,28,2,30,Clouds
41599,74,1553540400,12,18,30,Clouds
41600,75,1553540400,26,14,40,Clouds
41601,76,1553540400,32,6,38,Clouds
41602,77,1553540400,28,1,29,Clouds
41603,78,1553540400,36,4,40,Clouds
41604,79,1553540400,27,0,27,Clouds
41605,80,1553540400,19,21,40,Clouds
41606,81,1553540400,40,0,40,Clouds
41607,82,1553540400,18,4,22,Clouds
41608,83,1553540400,21,19,40,Clouds
41609,84,1553540400,20,10,30,Clouds
41610,85,1553540400,26,9,35,Clouds
41611,86,1553540400,0,38,38,Clouds
41612,87,1553540400,29,9,38,Clouds
41613,88,1553540400,21,9,30,Clouds
41614,89,1553540400,40,0,40,Clouds
41615,90,1553540400,40,0,40,Clouds
41616,91,1553540400,7,23,30,Clouds
41617,92,1553540400,0,40,40,Clouds
41618,93,1553540400,0,40,40,Clouds
41619,94,1553540400,0,40,40,Clouds
41620,95,1553540400,23,17,40,Clouds
41621,96,1553540400,26,4,30,Clouds
41622,97,1553540400,18,21,39,Clouds
41623,98,1553540400,23,17,40,Clouds
41624,99,1553540400,17,13,30,Clouds
41625,100,1553540400,0,25,25,Clouds
41626,101,1553540400,21,9,30,Clouds
41627,102,1553540400,39,1,40,Clouds
41628,103,1553540400,39,1,40,Clouds
41629,104,1553540400,40,0,40,Clouds
41630,105,1553540400,36,0,36,Clouds
41631,106,1553540400,32,8,40,Clouds
41632,107,1553540400,36,4,40,Clouds
41633,108,1553540400,35,5,40,Clouds
41634,109,1553540400,24,5,29,Clouds
41635,110,1553540400,31,9,40,Clouds
41636,111,1553540400,33,7,40,Clouds
41637,112,1553540400,13,17,30,Clouds
41638,113,1553540400,29,11,40,Clouds
41639,114,1553540400,40,0,40,Clouds
41640,115,1553540400,20,10,30,Clouds
41641,2,1553544000,9,11,20,Clouds
41642,3,1553544000,20,0,20,Clouds
41643,4,1553544000,19,1,20,Clouds
41644,5,1553544000,13,27,40,Clouds
41645,6,1553544000,9,11,20,Clouds
41646,7,1553544000,12,17,29,Clouds
41647,8,1553544000,16,14,30,Clouds
41648,9,1553544000,17,7,24,Clouds
41649,10,1553544000,14,2,16,Clouds
41650,11,1553544000,22,8,30,Clouds
41651,12,1553544000,12,8,20,Clouds
41652,13,1553544000,29,1,30,Clouds
41653,14,1553544000,21,9,30,Clouds
41654,15,1553544000,12,4,16,Clouds
41655,16,1553544000,3,17,20,Clouds
41656,17,1553544000,18,2,20,Clouds
41657,18,1553544000,17,13,30,Clouds
41658,19,1553544000,28,2,30,Clouds
41659,21,1553544000,29,1,30,Clouds
41660,22,1553544000,4,16,20,Clouds
41661,23,1553544000,13,17,30,Clouds
41662,24,1553544000,20,0,20,Clouds
41663,25,1553544000,28,2,30,Clouds
41664,26,1553544000,17,3,20,Clouds
41665,27,1553544000,20,0,20,Clouds
41666,28,1553544000,22,8,30,Clouds
41667,29,1553544000,25,4,29,Clouds
41668,30,1553544000,20,0,20,Clouds
41669,31,1553544000,20,0,20,Clouds
41670,32,1553544000,12,18,30,Clouds
41671,33,1553544000,11,12,23,Clouds
41672,34,1553544000,11,19,30,Clouds
41673,35,1553544000,26,4,30,Clouds
41674,36,1553544000,40,0,40,Clouds
41675,37,1553544000,30,0,30,Clouds
41676,38,1553544000,30,10,40,Clouds
41677,39,1553544000,16,4,20,Clouds
41678,40,1553544000,20,1,21,Clouds
41679,41,1553544000,20,0,20,Clouds
41680,42,1553544000,16,14,30,Clouds
41681,43,1553544000,0,30,30,Clouds
41682,44,1553544000,1,29,30,Clouds
41683,45,1553544000,14,16,30,Clouds
41684,46,1553544000,12,8,20,Clouds
41685,47,1553544000,39,1,40,Clouds
41686,48,1553544000,15,25,40,Clouds
41687,49,1553544000,38,2,40,Clouds
41688,50,1553544000,19,21,40,Clouds
41689,51,1553544000,39,1,40,Clouds
41690,52,1553544000,30,2,32,Clouds
41691,53,1553544000,40,0,40,Clouds
41692,54,1553544000,33,0,33,Clouds
41693,55,1553544000,36,0,36,Clouds
41694,56,1553544000,29,11,40,Clouds
41695,57,1553544000,21,2,23,Clouds
41696,58,1553544000,32,8,40,Clouds
41697,59,1553544000,15,5,20,Clouds
41698,60,1553544000,1,29,30,Clouds
41699,61,1553544000,23,2,25,Clouds
41700,62,1553544000,40,0,40,Clouds
41701,63,1553544000,34,1,35,Clouds
41702,64,1553544000,30,10,40,Clouds
41703,65,1553544000,39,1,40,Clouds
41704,66,1553544000,35,5,40,Clouds
41705,67,1553544000,33,7,40,Clouds
41706,68,1553544000,39,1,40,Clouds
41707,69,1553544000,38,2,40,Clouds
41708,70,1553544000,7,21,28,Clouds
41709,71,1553544000,40,0,40,Clouds
41710,72,1553544000,1,30,31,Clouds
41711,73,1553544000,23,7,30,Clouds
41712,74,1553544000,11,19,30,Clouds
41713,75,1553544000,20,20,40,Clouds
41714,76,1553544000,28,10,38,Clouds
41715,77,1553544000,27,2,29,Clouds
41716,78,1553544000,25,15,40,Clouds
41717,79,1553544000,24,3,27,Clouds
41718,80,1553544000,25,15,40,Clouds
41719,81,1553544000,40,0,40,Clouds
41720,82,1553544000,17,5,22,Clouds
41721,83,1553544000,13,27,40,Clouds
41722,84,1553544000,10,20,30,Clouds
41723,85,1553544000,18,17,35,Clouds
41724,86,1553544000,1,37,38,Clouds
41725,87,1553544000,2,36,38,Clouds
41726,88,1553544000,15,15,30,Clouds
41727,89,1553544000,39,1,40,Clouds
41728,90,1553544000,39,1,40,Clouds
41729,91,1553544000,1,29,30,Clouds
41730,92,1553544000,0,40,40,Clouds
41731,93,1553544000,0,40,40,Clouds
41732,94,1553544000,0,40,40,Clouds
41733,95,1553544000,9,31,40,Clouds
41734,96,1553544000,24,6,30,Clouds
41735,97,1553544000,10,29,39,Clouds
41736,98,1553544000,37,3,40,Clouds
41737,99,1553544000,28,2,30,Clouds
41738,100,1553544000,11,13,24,Clouds
41739,101,1553544000,18,12,30,Clouds
41740,102,1553544000,39,1,40,Clouds
41741,103,1553544000,39,1,40,Clouds
41742,104,1553544000,40,0,40,Clouds
41743,105,1553544000,35,1,36,Clouds
41744,106,1553544000,31,9,40,Clouds
41745,107,1553544000,33,7,40,Clouds
41746,108,1553544000,36,4,40,Clouds
41747,109,1553544000,24,5,29,Clouds
41748,110,1553544000,33,7,40,Clouds
41749,111,1553544000,27,13,40,Clouds
41750,112,1553544000,14,16,30,Clouds
41751,113,1553544000,38,2,40,Clouds
41752,114,1553544000,39,1,40,Clouds
41753,115,1553544000,9,21,30,Clouds
41754,2,1553547600,8,12,20,Clouds
41755,3,1553547600,20,0,20,Clouds
41756,4,1553547600,17,3,20,Clouds
41757,5,1553547600,12,28,40,Clouds
41758,6,1553547600,8,12,20,Clouds
41759,7,1553547600,8,21,29,Clouds
41760,8,1553547600,30,0,30,Clouds
41761,9,1553547600,11,13,24,Clouds
41762,10,1553547600,14,2,16,Clouds
41763,11,1553547600,29,1,30,Clouds
41764,12,1553547600,14,6,20,Clouds
41765,13,1553547600,25,5,30,Clouds
41766,14,1553547600,26,4,30,Clouds
41767,15,1553547600,9,7,16,Clouds
41768,16,1553547600,6,14,20,Clouds
41769,17,1553547600,18,2,20,Clouds
41770,18,1553547600,28,2,30,Clouds
41771,19,1553547600,20,10,30,Clouds
41772,21,1553547600,30,0,30,Clouds
41773,22,1553547600,9,11,20,Clouds
41774,23,1553547600,14,16,30,Clouds
41775,24,1553547600,17,3,20,Clouds
41776,25,1553547600,25,5,30,Clouds
41777,26,1553547600,18,2,20,Clouds
41778,27,1553547600,20,0,20,Clouds
41779,28,1553547600,21,9,30,Clouds
41780,29,1553547600,27,2,29,Clouds
41781,30,1553547600,19,1,20,Clouds
41782,31,1553547600,19,1,20,Clouds
41783,32,1553547600,10,20,30,Clouds
41784,33,1553547600,11,12,23,Clouds
41785,34,1553547600,17,13,30,Clouds
41786,35,1553547600,21,9,30,Clouds
41787,36,1553547600,40,0,40,Clouds
41788,37,1553547600,29,1,30,Clouds
41789,38,1553547600,32,8,40,Clouds
41790,39,1553547600,18,2,20,Clouds
41791,40,1553547600,20,1,21,Clouds
41792,41,1553547600,20,0,20,Clouds
41793,42,1553547600,11,19,30,Clouds
41794,43,1553547600,0,30,30,Clouds
41795,44,1553547600,1,29,30,Clouds
41796,45,1553547600,15,15,30,Clouds
41797,46,1553547600,18,2,20,Clouds
41798,47,1553547600,38,2,40,Clouds
41799,48,1553547600,27,13,40,Clouds
41800,49,1553547600,38,2,40,Clouds
41801,50,1553547600,12,28,40,Clouds
41802,51,1553547600,40,0,40,Clouds
41803,52,1553547600,32,0,32,Clouds
41804,53,1553547600,40,0,40,Clouds
41805,54,1553547600,32,1,33,Clouds
41806,55,1553547600,36,0,36,Clouds
41807,56,1553547600,22,18,40,Clouds
41808,57,1553547600,22,1,23,Clouds
41809,58,1553547600,33,7,40,Clouds
41810,59,1553547600,13,7,20,Clouds
41811,60,1553547600,0,30,30,Clouds
41812,61,1553547600,25,0,25,Clouds
41813,62,1553547600,40,0,40,Clouds
41814,63,1553547600,31,4,35,Clouds
41815,64,1553547600,35,5,40,Clouds
41816,65,1553547600,38,2,40,Clouds
41817,66,1553547600,19,21,40,Clouds
41818,67,1553547600,13,27,40,Clouds
41819,68,1553547600,38,2,40,Clouds
41820,69,1553547600,38,2,40,Clouds
41821,70,1553547600,15,13,28,Clouds
41822,71,1553547600,33,7,40,Clouds
41823,72,1553547600,0,31,31,Clouds
41824,73,1553547600,17,13,30,Clouds
41825,74,1553547600,7,23,30,Clouds
41826,75,1553547600,20,20,40,Clouds
41827,76,1553547600,25,13,38,Clouds
41828,77,1553547600,28,1,29,Clouds
41829,78,1553547600,16,24,40,Clouds
41830,79,1553547600,24,3,27,Clouds
41831,80,1553547600,25,15,40,Clouds
41832,81,1553547600,40,0,40,Clouds
41833,82,1553547600,14,8,22,Clouds
41834,83,1553547600,6,34,40,Clouds
41835,84,1553547600,9,21,30,Clouds
41836,85,1553547600,12,23,35,Clouds
41837,86,1553547600,11,27,38,Clouds
41838,87,1553547600,0,38,38,Clouds
41839,88,1553547600,12,18,30,Clouds
41840,89,1553547600,40,0,40,Clouds
41841,90,1553547600,40,0,40,Clouds
41842,91,1553547600,3,27,30,Clouds
41843,92,1553547600,7,33,40,Clouds
41844,93,1553547600,0,40,40,Clouds
41845,94,1553547600,0,40,40,Clouds
41846,95,1553547600,2,38,40,Clouds
41847,96,1553547600,24,6,30,Clouds
41848,97,1553547600,0,39,39,Clouds
41849,98,1553547600,40,0,40,Clouds
41850,99,1553547600,28,2,30,Clouds
41851,100,1553547600,1,23,24,Clouds
41852,101,1553547600,13,17,30,Clouds
41853,102,1553547600,39,1,40,Clouds
41854,103,1553547600,40,0,40,Clouds
41855,104,1553547600,40,0,40,Clouds
41856,105,1553547600,36,0,36,Clouds
41857,106,1553547600,30,10,40,Clouds
41858,107,1553547600,30,10,40,Clouds
41859,108,1553547600,34,6,40,Clouds
41860,109,1553547600,21,8,29,Clouds
41861,110,1553547600,30,10,40,Clouds
41862,111,1553547600,27,13,40,Clouds
41863,112,1553547600,7,23,30,Clouds
41864,113,1553547600,40,0,40,Clouds
41865,114,1553547600,40,0,40,Clouds
41866,115,1553547600,6,24,30,Clouds
41867,2,1553551200,8,12,20,Clouds
41868,3,1553551200,18,2,20,Clouds
41869,4,1553551200,19,1,20,Clouds
41870,5,1553551200,10,30,40,Clouds
41871,6,1553551200,12,8,20,Clouds
41872,7,1553551200,9,20,29,Clouds
41873,8,1553551200,30,0,30,Clouds
41874,9,1553551200,23,1,24,Clouds
41875,10,1553551200,15,1,16,Clouds
41876,11,1553551200,30,0,30,Clouds
41877,12,1553551200,12,8,20,Clouds
41878,13,1553551200,28,2,30,Clouds
41879,14,1553551200,27,3,30,Clouds
41880,15,1553551200,12,4,16,Clouds
41881,16,1553551200,10,10,20,Clouds
41882,17,1553551200,20,0,20,Clouds
41883,18,1553551200,23,7,30,Clouds
41884,19,1553551200,29,1,30,Clouds
41885,21,1553551200,30,0,30,Clouds
41886,22,1553551200,14,6,20,Clouds
41887,23,1553551200,12,18,30,Clouds
41888,24,1553551200,17,3,20,Clouds
41889,25,1553551200,30,0,30,Clouds
41890,26,1553551200,20,0,20,Clouds
41891,27,1553551200,20,0,20,Clouds
41892,28,1553551200,22,8,30,Clouds
41893,29,1553551200,25,4,29,Clouds
41894,30,1553551200,20,0,20,Clouds
41895,31,1553551200,20,0,20,Clouds
41896,32,1553551200,30,0,30,Clouds
41897,33,1553551200,20,3,23,Clouds
41898,34,1553551200,11,19,30,Clouds
41899,35,1553551200,18,12,30,Clouds
41900,36,1553551200,40,0,40,Clouds
41901,37,1553551200,30,0,30,Clouds
41902,38,1553551200,35,5,40,Clouds
41903,39,1553551200,19,1,20,Clouds
41904,40,1553551200,18,3,21,Clouds
41905,41,1553551200,20,0,20,Clouds
41906,42,1553551200,7,23,30,Clouds
41907,43,1553551200,1,29,30,Clouds
41908,44,1553551200,1,29,30,Clouds
41909,45,1553551200,15,15,30,Clouds
41910,46,1553551200,19,1,20,Clouds
41911,47,1553551200,38,2,40,Clouds
41912,48,1553551200,34,6,40,Clouds
41913,49,1553551200,38,2,40,Clouds
41914,50,1553551200,5,35,40,Clouds
41915,51,1553551200,40,0,40,Clouds
41916,52,1553551200,28,4,32,Clouds
41917,53,1553551200,40,0,40,Clouds
41918,54,1553551200,33,0,33,Clouds
41919,55,1553551200,36,0,36,Clouds
41920,56,1553551200,17,23,40,Clouds
41921,57,1553551200,23,0,23,Clouds
41922,58,1553551200,38,2,40,Clouds
41923,59,1553551200,15,5,20,Clouds
41924,60,1553551200,0,30,30,Clouds
41925,61,1553551200,23,2,25,Clouds
41926,62,1553551200,40,0,40,Clouds
41927,63,1553551200,32,3,35,Clouds
41928,64,1553551200,36,4,40,Clouds
41929,65,1553551200,40,0,40,Clouds
41930,66,1553551200,18,22,40,Clouds
41931,67,1553551200,12,28,40,Clouds
41932,68,1553551200,38,2,40,Clouds
41933,69,1553551200,40,0,40,Clouds
41934,70,1553551200,15,13,28,Clouds
41935,71,1553551200,39,1,40,Clouds
41936,72,1553551200,0,31,31,Clouds
41937,73,1553551200,9,21,30,Clouds
41938,74,1553551200,5,25,30,Clouds
41939,75,1553551200,21,19,40,Clouds
41940,76,1553551200,24,14,38,Clouds
41941,77,1553551200,29,0,29,Clouds
41942,78,1553551200,12,28,40,Clouds
41943,79,1553551200,21,6,27,Clouds
41944,80,1553551200,28,12,40,Clouds
41945,81,1553551200,39,1,40,Clouds
41946,82,1553551200,13,9,22,Clouds
41947,83,1553551200,0,40,40,Clouds
41948,84,1553551200,2,28,30,Clouds
41949,85,1553551200,11,24,35,Clouds
41950,86,1553551200,4,34,38,Clouds
41951,87,1553551200,0,38,38,Clouds
41952,88,1553551200,3,27,30,Clouds
41953,89,1553551200,40,0,40,Clouds
41954,90,1553551200,40,0,40,Clouds
41955,91,1553551200,0,30,30,Clouds
41956,92,1553551200,2,38,40,Clouds
41957,93,1553551200,0,40,40,Clouds
41958,94,1553551200,0,40,40,Clouds
41959,95,1553551200,0,40,40,Clouds
41960,96,1553551200,20,10,30,Clouds
41961,97,1553551200,0,39,39,Clouds
41962,98,1553551200,40,0,40,Clouds
41963,99,1553551200,30,0,30,Clouds
41964,100,1553551200,0,24,24,Clouds
41965,101,1553551200,13,17,30,Clouds
41966,102,1553551200,26,14,40,Clouds
41967,103,1553551200,32,8,40,Clouds
41968,104,1553551200,32,8,40,Clouds
41969,105,1553551200,35,1,36,Clouds
41970,106,1553551200,29,11,40,Clouds
41971,107,1553551200,30,10,40,Clouds
41972,108,1553551200,32,8,40,Clouds
41973,109,1553551200,19,10,29,Clouds
41974,110,1553551200,30,10,40,Clouds
41975,111,1553551200,15,25,40,Clouds
41976,112,1553551200,2,28,30,Clouds
41977,113,1553551200,40,0,40,Clouds
41978,114,1553551200,40,0,40,Clouds
41979,115,1553551200,2,28,30,Clouds
41980,2,1553554800,7,13,20,Clouds
41981,3,1553554800,20,0,20,Clouds
41982,4,1553554800,20,0,20,Clouds
41983,5,1553554800,8,32,40,Clouds
41984,6,1553554800,14,6,20,Clouds
41985,7,1553554800,9,20,29,Clouds
41986,8,1553554800,28,2,30,Clouds
41987,9,1553554800,24,0,24,Clouds
41988,10,1553554800,11,5,16,Clouds
41989,11,1553554800,30,0,30,Clouds
41990,12,1553554800,8,12,20,Clouds
41991,13,1553554800,27,3,30,Clouds
41992,14,1553554800,30,0,30,Clouds
41993,15,1553554800,11,5,16,Clouds
41994,16,1553554800,19,1,20,Clouds
41995,17,1553554800,20,0,20,Clouds
41996,18,1553554800,23,7,30,Clouds
41997,19,1553554800,28,2,30,Clouds
41998,21,1553554800,30,0,30,Clouds
41999,22,1553554800,20,0,20,Clouds
42000,23,1553554800,18,12,30,Clouds
42001,24,1553554800,17,3,20,Clouds
42002,25,1553554800,30,0,30,Clouds
42003,26,1553554800,20,0,20,Clouds
42004,27,1553554800,20,0,20,Clouds
42005,28,1553554800,15,15,30,Clouds
42006,29,1553554800,27,2,29,Clouds
42007,30,1553554800,20,0,20,Clouds
42008,31,1553554800,16,4,20,Clouds
42009,32,1553554800,30,0,30,Clouds
42010,33,1553554800,23,0,23,Clouds
42011,34,1553554800,19,11,30,Clouds
42012,35,1553554800,11,19,30,Clouds
42013,36,1553554800,40,0,40,Clouds
42014,37,1553554800,30,0,30,Clouds
42015,38,1553554800,38,2,40,Clouds
42016,39,1553554800,18,2,20,Clouds
42017,40,1553554800,21,0,21,Clouds
42018,41,1553554800,20,0,20,Clouds
42019,42,1553554800,7,23,30,Clouds
42020,43,1553554800,2,28,30,Clouds
42021,44,1553554800,0,30,30,Clouds
42022,45,1553554800,14,16,30,Clouds
42023,46,1553554800,20,0,20,Clouds
42024,47,1553554800,40,0,40,Clouds
42025,48,1553554800,38,2,40,Clouds
42026,49,1553554800,37,3,40,Clouds
42027,50,1553554800,0,40,40,Clouds
42028,51,1553554800,39,1,40,Clouds
42029,52,1553554800,32,0,32,Clouds
42030,53,1553554800,40,0,40,Clouds
42031,54,1553554800,33,0,33,Clouds
42032,55,1553554800,36,0,36,Clouds
42033,56,1553554800,24,16,40,Clouds
42034,57,1553554800,23,0,23,Clouds
42035,58,1553554800,40,0,40,Clouds
42036,59,1553554800,8,12,20,Clouds
42037,60,1553554800,0,30,30,Clouds
42038,61,1553554800,24,1,25,Clouds
42039,62,1553554800,40,0,40,Clouds
42040,63,1553554800,35,0,35,Clouds
42041,64,1553554800,40,0,40,Clouds
42042,65,1553554800,40,0,40,Clouds
42043,66,1553554800,22,18,40,Clouds
42044,67,1553554800,9,31,40,Clouds
42045,68,1553554800,38,2,40,Clouds
42046,69,1553554800,36,4,40,Clouds
42047,70,1553554800,11,17,28,Clouds
42048,71,1553554800,39,1,40,Clouds
42049,72,1553554800,2,29,31,Clouds
42050,73,1553554800,9,21,30,Clouds
42051,74,1553554800,3,27,30,Clouds
42052,75,1553554800,20,20,40,Clouds
42053,76,1553554800,20,18,38,Clouds
42054,77,1553554800,29,0,29,Clouds
42055,78,1553554800,5,35,40,Clouds
42056,79,1553554800,21,6,27,Clouds
42057,80,1553554800,28,12,40,Clouds
42058,81,1553554800,38,2,40,Clouds
42059,82,1553554800,9,13,22,Clouds
42060,83,1553554800,1,39,40,Clouds
42061,84,1553554800,0,30,30,Clouds
42062,85,1553554800,5,30,35,Clouds
42063,86,1553554800,2,36,38,Clouds
42064,87,1553554800,1,37,38,Clouds
42065,88,1553554800,3,27,30,Clouds
42066,89,1553554800,40,0,40,Clouds
42067,90,1553554800,40,0,40,Clouds
42068,91,1553554800,1,29,30,Clouds
42069,92,1553554800,1,39,40,Clouds
42070,93,1553554800,0,40,40,Clouds
42071,94,1553554800,0,40,40,Clouds
42072,95,1553554800,1,39,40,Clouds
42073,96,1553554800,8,22,30,Clouds
42074,97,1553554800,0,39,39,Clouds
42075,98,1553554800,40,0,40,Clouds
42076,99,1553554800,30,0,30,Clouds
42077,100,1553554800,1,23,24,Clouds
42078,101,1553554800,11,19,30,Clouds
42079,102,1553554800,26,14,40,Clouds
42080,103,1553554800,33,7,40,Clouds
42081,104,1553554800,33,7,40,Clouds
42082,105,1553554800,35,1,36,Clouds
42083,106,1553554800,28,12,40,Clouds
42084,107,1553554800,27,13,40,Clouds
42085,108,1553554800,28,12,40,Clouds
42086,109,1553554800,12,17,29,Clouds
42087,110,1553554800,31,9,40,Clouds
42088,111,1553554800,9,31,40,Clouds
42089,112,1553554800,0,30,30,Clouds
42090,113,1553554800,40,0,40,Clouds
42091,114,1553554800,38,2,40,Clouds
42092,115,1553554800,0,30,30,Clouds
42093,2,1553558400,5,15,20,Clouds
42094,3,1553558400,20,0,20,Clouds
42095,4,1553558400,20,0,20,Clouds
42096,5,1553558400,6,34,40,Clouds
42097,6,1553558400,20,0,20,Clouds
42098,7,1553558400,12,17,29,Clouds
42099,8,1553558400,29,1,30,Clouds
42100,9,1553558400,24,0,24,Clouds
42101,10,1553558400,15,1,16,Clouds
42102,11,1553558400,30,0,30,Clouds
42103,12,1553558400,7,13,20,Clouds
42104,13,1553558400,28,2,30,Clouds
42105,14,1553558400,30,0,30,Clouds
42106,15,1553558400,10,6,16,Clouds
42107,16,1553558400,19,1,20,Clouds
42108,17,1553558400,19,1,20,Clouds
42109,18,1553558400,28,2,30,Clouds
42110,19,1553558400,30,0,30,Clouds
42111,21,1553558400,30,0,30,Clouds
42112,22,1553558400,18,2,20,Clouds
42113,23,1553558400,21,9,30,Clouds
42114,24,1553558400,20,0,20,Clouds
42115,25,1553558400,30,0,30,Clouds
42116,26,1553558400,20,0,20,Clouds
42117,27,1553558400,20,0,20,Clouds
42118,28,1553558400,18,12,30,Clouds
42119,29,1553558400,29,0,29,Clouds
42120,30,1553558400,20,0,20,Clouds
42121,31,1553558400,19,1,20,Clouds
42122,32,1553558400,30,0,30,Clouds
42123,33,1553558400,22,1,23,Clouds
42124,34,1553558400,16,14,30,Clouds
42125,35,1553558400,12,18,30,Clouds
42126,36,1553558400,40,0,40,Clouds
42127,37,1553558400,30,0,30,Clouds
42128,38,1553558400,37,3,40,Clouds
42129,39,1553558400,16,4,20,Clouds
42130,40,1553558400,21,0,21,Clouds
42131,41,1553558400,18,2,20,Clouds
42132,42,1553558400,9,21,30,Clouds
42133,43,1553558400,0,30,30,Clouds
42134,44,1553558400,0,30,30,Clouds
42135,45,1553558400,15,15,30,Clouds
42136,46,1553558400,20,0,20,Clouds
42137,47,1553558400,39,1,40,Clouds
42138,48,1553558400,39,1,40,Clouds
42139,49,1553558400,38,2,40,Clouds
42140,50,1553558400,0,40,40,Clouds
42141,51,1553558400,40,0,40,Clouds
42142,52,1553558400,31,1,32,Clouds
42143,53,1553558400,40,0,40,Clouds
42144,54,1553558400,33,0,33,Clouds
42145,55,1553558400,36,0,36,Clouds
42146,56,1553558400,27,13,40,Clouds
42147,57,1553558400,23,0,23,Clouds
42148,58,1553558400,39,1,40,Clouds
42149,59,1553558400,10,10,20,Clouds
42150,60,1553558400,11,19,30,Clouds
42151,61,1553558400,25,0,25,Clouds
42152,62,1553558400,38,2,40,Clouds
42153,63,1553558400,35,0,35,Clouds
42154,64,1553558400,39,1,40,Clouds
42155,65,1553558400,40,0,40,Clouds
42156,66,1553558400,24,16,40,Clouds
42157,67,1553558400,15,25,40,Clouds
42158,68,1553558400,40,0,40,Clouds
42159,69,1553558400,38,2,40,Clouds
42160,70,1553558400,16,12,28,Clouds
42161,71,1553558400,35,5,40,Clouds
42162,72,1553558400,2,29,31,Clouds
42163,73,1553558400,10,20,30,Clouds
42164,74,1553558400,3,27,30,Clouds
42165,75,1553558400,16,24,40,Clouds
42166,76,1553558400,10,28,38,Clouds
42167,77,1553558400,29,0,29,Clouds
42168,78,1553558400,12,28,40,Clouds
42169,79,1553558400,20,7,27,Clouds
42170,80,1553558400,27,13,40,Clouds
42171,81,1553558400,40,0,40,Clouds
42172,82,1553558400,8,14,22,Clouds
42173,83,1553558400,1,39,40,Clouds
42174,84,1553558400,1,29,30,Clouds
42175,85,1553558400,0,35,35,Clouds
42176,86,1553558400,1,37,38,Clouds
42177,87,1553558400,2,36,38,Clouds
42178,88,1553558400,2,28,30,Clouds
42179,89,1553558400,40,0,40,Clouds
42180,90,1553558400,40,0,40,Clouds
42181,91,1553558400,2,28,30,Clouds
42182,92,1553558400,0,40,40,Clouds
42183,93,1553558400,0,40,40,Clouds
42184,94,1553558400,0,40,40,Clouds
42185,95,1553558400,0,40,40,Clouds
42186,96,1553558400,8,22,30,Clouds
42187,97,1553558400,8,32,40,Clouds
42188,98,1553558400,40,0,40,Clouds
42189,99,1553558400,30,0,30,Clouds
42190,100,1553558400,10,15,25,Clouds
42191,101,1553558400,10,20,30,Clouds
42192,102,1553558400,25,15,40,Clouds
42193,103,1553558400,33,7,40,Clouds
42194,104,1553558400,34,6,40,Clouds
42195,105,1553558400,35,1,36,Clouds
42196,106,1553558400,27,13,40,Clouds
42197,107,1553558400,5,35,40,Clouds
42198,108,1553558400,19,21,40,Clouds
42199,109,1553558400,7,22,29,Clouds
42200,110,1553558400,30,10,40,Clouds
42201,111,1553558400,2,38,40,Clouds
42202,112,1553558400,0,30,30,Clouds
42203,113,1553558400,40,0,40,Clouds
42204,114,1553558400,40,0,40,Clouds
42205,115,1553558400,0,30,30,Clouds
42206,2,1553562000,4,16,20,Clouds
42207,3,1553562000,20,0,20,Clouds
42208,4,1553562000,20,0,20,Clouds
42209,5,1553562000,7,33,40,Clouds
42210,6,1553562000,19,1,20,Clouds
42211,7,1553562000,16,13,29,Clouds
42212,8,1553562000,29,1,30,Clouds
42213,9,1553562000,24,0,24,Clouds
42214,10,1553562000,16,0,16,Clouds
42215,11,1553562000,30,0,30,Clouds
42216,12,1553562000,6,14,20,Clouds
42217,13,1553562000,30,0,30,Clouds
42218,14,1553562000,30,0,30,Clouds
42219,15,1553562000,9,7,16,Clouds
42220,16,1553562000,18,2,20,Clouds
42221,17,1553562000,20,0,20,Clouds
42222,18,1553562000,23,7,30,Clouds
42223,19,1553562000,28,2,30,Clouds
42224,21,1553562000,30,0,30,Clouds
42225,22,1553562000,19,1,20,Clouds
42226,23,1553562000,21,9,30,Clouds
42227,24,1553562000,19,1,20,Clouds
42228,25,1553562000,30,0,30,Clouds
42229,26,1553562000,20,0,20,Clouds
42230,27,1553562000,20,0,20,Clouds
42231,28,1553562000,15,15,30,Clouds
42232,29,1553562000,29,0,29,Clouds
42233,30,1553562000,20,0,20,Clouds
42234,31,1553562000,20,0,20,Clouds
42235,32,1553562000,29,1,30,Clouds
42236,33,1553562000,23,0,23,Clouds
42237,34,1553562000,12,18,30,Clouds
42238,35,1553562000,14,16,30,Clouds
42239,36,1553562000,39,1,40,Clouds
42240,37,1553562000,30,0,30,Clouds
42241,38,1553562000,39,1,40,Clouds
42242,39,1553562000,17,3,20,Clouds
42243,40,1553562000,21,0,21,Clouds
42244,41,1553562000,18,2,20,Clouds
42245,42,1553562000,4,26,30,Clouds
42246,43,1553562000,1,29,30,Clouds
42247,44,1553562000,1,29,30,Clouds
42248,45,1553562000,15,15,30,Clouds
42249,46,1553562000,19,1,20,Clouds
42250,47,1553562000,40,0,40,Clouds
42251,48,1553562000,39,1,40,Clouds
42252,49,1553562000,40,0,40,Clouds
42253,50,1553562000,0,40,40,Clouds
42254,51,1553562000,40,0,40,Clouds
42255,52,1553562000,32,0,32,Clouds
42256,53,1553562000,40,0,40,Clouds
42257,54,1553562000,31,2,33,Clouds
42258,55,1553562000,36,0,36,Clouds
42259,56,1553562000,27,13,40,Clouds
42260,57,1553562000,22,1,23,Clouds
42261,58,1553562000,38,2,40,Clouds
42262,59,1553562000,10,10,20,Clouds
42263,60,1553562000,7,23,30,Clouds
42264,61,1553562000,25,0,25,Clouds
42265,62,1553562000,38,2,40,Clouds
42266,63,1553562000,35,0,35,Clouds
42267,64,1553562000,39,1,40,Clouds
42268,65,1553562000,40,0,40,Clouds
42269,66,1553562000,27,13,40,Clouds
42270,67,1553562000,34,6,40,Clouds
42271,68,1553562000,39,1,40,Clouds
42272,69,1553562000,38,2,40,Clouds
42273,70,1553562000,17,11,28,Clouds
42274,71,1553562000,39,1,40,Clouds
42275,72,1553562000,5,26,31,Clouds
42276,73,1553562000,9,21,30,Clouds
42277,74,1553562000,4,26,30,Clouds
42278,75,1553562000,16,24,40,Clouds
42279,76,1553562000,5,33,38,Clouds
42280,77,1553562000,26,3,29,Clouds
42281,78,1553562000,5,35,40,Clouds
42282,79,1553562000,20,7,27,Clouds
42283,80,1553562000,25,15,40,Clouds
42284,81,1553562000,38,2,40,Clouds
42285,82,1553562000,8,14,22,Clouds
42286,83,1553562000,0,40,40,Clouds
42287,84,1553562000,0,30,30,Clouds
42288,85,1553562000,0,35,35,Clouds
42289,86,1553562000,0,38,38,Clouds
42290,87,1553562000,1,37,38,Clouds
42291,88,1553562000,0,30,30,Clouds
42292,89,1553562000,40,0,40,Clouds
42293,90,1553562000,40,0,40,Clouds
42294,91,1553562000,2,28,30,Clouds
42295,92,1553562000,4,36,40,Clouds
42296,93,1553562000,0,40,40,Clouds
42297,94,1553562000,6,34,40,Clouds
42298,95,1553562000,0,40,40,Clouds
42299,96,1553562000,8,22,30,Clouds
42300,97,1553562000,8,32,40,Clouds
42301,98,1553562000,40,0,40,Clouds
42302,99,1553562000,30,0,30,Clouds
42303,100,1553562000,10,15,25,Clouds
42304,101,1553562000,13,17,30,Clouds
42305,102,1553562000,24,16,40,Clouds
42306,103,1553562000,33,7,40,Clouds
42307,104,1553562000,34,6,40,Clouds
42308,105,1553562000,34,2,36,Clouds
42309,106,1553562000,26,14,40,Clouds
42310,107,1553562000,3,37,40,Clouds
42311,108,1553562000,16,24,40,Clouds
42312,109,1553562000,9,20,29,Clouds
42313,110,1553562000,31,9,40,Clouds
42314,111,1553562000,1,39,40,Clouds
42315,112,1553562000,10,20,30,Clouds
42316,113,1553562000,40,0,40,Clouds
42317,114,1553562000,40,0,40,Clouds
42318,115,1553562000,4,26,30,Clouds
42319,2,1553565600,4,16,20,Clouds
42320,3,1553565600,20,0,20,Clouds
42321,4,1553565600,20,0,20,Clouds
42322,5,1553565600,6,34,40,Clouds
42323,6,1553565600,19,1,20,Clouds
42324,7,1553565600,18,11,29,Clouds
42325,8,1553565600,29,1,30,Clouds
42326,9,1553565600,24,0,24,Clouds
42327,10,1553565600,16,0,16,Clouds
42328,11,1553565600,30,0,30,Clouds
42329,12,1553565600,6,14,20,Clouds
42330,13,1553565600,30,0,30,Clouds
42331,14,1553565600,30,0,30,Clouds
42332,15,1553565600,10,6,16,Clouds
42333,16,1553565600,18,2,20,Clouds
42334,17,1553565600,20,0,20,Clouds
42335,18,1553565600,22,8,30,Clouds
42336,19,1553565600,28,2,30,Clouds
42337,21,1553565600,30,0,30,Clouds
42338,22,1553565600,17,3,20,Clouds
42339,23,1553565600,23,7,30,Clouds
42340,24,1553565600,19,1,20,Clouds
42341,25,1553565600,30,0,30,Clouds
42342,26,1553565600,20,0,20,Clouds
42343,27,1553565600,20,0,20,Clouds
42344,28,1553565600,15,15,30,Clouds
42345,29,1553565600,29,0,29,Clouds
42346,30,1553565600,20,0,20,Clouds
42347,31,1553565600,20,0,20,Clouds
42348,32,1553565600,30,0,30,Clouds
42349,33,1553565600,23,0,23,Clouds
42350,34,1553565600,10,20,30,Clouds
42351,35,1553565600,14,16,30,Clouds
42352,36,1553565600,38,2,40,Clouds
42353,37,1553565600,30,0,30,Clouds
42354,38,1553565600,40,0,40,Clouds
42355,39,1553565600,19,1,20,Clouds
42356,40,1553565600,21,0,21,Clouds
42357,41,1553565600,18,2,20,Clouds
42358,42,1553565600,3,27,30,Clouds
42359,43,1553565600,1,29,30,Clouds
42360,44,1553565600,0,30,30,Clouds
42361,45,1553565600,17,13,30,Clouds
42362,46,1553565600,20,0,20,Clouds
42363,47,1553565600,39,1,40,Clouds
42364,48,1553565600,39,1,40,Clouds
42365,49,1553565600,40,0,40,Clouds
42366,50,1553565600,0,40,40,Clouds
42367,51,1553565600,40,0,40,Clouds
42368,52,1553565600,32,0,32,Clouds
42369,53,1553565600,40,0,40,Clouds
42370,54,1553565600,31,2,33,Clouds
42371,55,1553565600,36,0,36,Clouds
42372,56,1553565600,26,14,40,Clouds
42373,57,1553565600,22,1,23,Clouds
42374,58,1553565600,38,2,40,Clouds
42375,59,1553565600,11,9,20,Clouds
42376,60,1553565600,6,24,30,Clouds
42377,61,1553565600,25,0,25,Clouds
42378,62,1553565600,38,2,40,Clouds
42379,63,1553565600,35,0,35,Clouds
42380,64,1553565600,39,1,40,Clouds
42381,65,1553565600,40,0,40,Clouds
42382,66,1553565600,27,13,40,Clouds
42383,67,1553565600,36,4,40,Clouds
42384,68,1553565600,39,1,40,Clouds
42385,69,1553565600,36,4,40,Clouds
42386,70,1553565600,17,11,28,Clouds
42387,71,1553565600,40,0,40,Clouds
42388,72,1553565600,5,26,31,Clouds
42389,73,1553565600,10,20,30,Clouds
42390,74,1553565600,4,26,30,Clouds
42391,75,1553565600,17,23,40,Clouds
42392,76,1553565600,5,33,38,Clouds
42393,77,1553565600,25,4,29,Clouds
42394,78,1553565600,4,36,40,Clouds
42395,79,1553565600,20,7,27,Clouds
42396,80,1553565600,25,15,40,Clouds
42397,81,1553565600,36,4,40,Clouds
42398,82,1553565600,6,16,22,Clouds
42399,83,1553565600,0,40,40,Clouds
42400,84,1553565600,0,30,30,Clouds
42401,85,1553565600,0,35,35,Clouds
42402,86,1553565600,2,36,38,Clouds
42403,87,1553565600,0,38,38,Clouds
42404,88,1553565600,0,30,30,Clouds
42405,89,1553565600,40,0,40,Clouds
42406,90,1553565600,40,0,40,Clouds
42407,91,1553565600,1,29,30,Clouds
42408,92,1553565600,4,36,40,Clouds
42409,93,1553565600,0,40,40,Clouds
42410,94,1553565600,6,34,40,Clouds
42411,95,1553565600,0,40,40,Clouds
42412,96,1553565600,7,23,30,Clouds
42413,97,1553565600,8,32,40,Clouds
42414,98,1553565600,39,1,40,Clouds
42415,99,1553565600,30,0,30,Clouds
42416,100,1553565600,11,14,25,Clouds
42417,101,1553565600,14,16,30,Clouds
42418,102,1553565600,24,16,40,Clouds
42419,103,1553565600,33,7,40,Clouds
42420,104,1553565600,34,6,40,Clouds
42421,105,1553565600,34,2,36,Clouds
42422,106,1553565600,26,14,40,Clouds
42423,107,1553565600,3,37,40,Clouds
42424,108,1553565600,16,24,40,Clouds
42425,109,1553565600,10,19,29,Clouds
42426,110,1553565600,31,9,40,Clouds
42427,111,1553565600,1,39,40,Clouds
42428,112,1553565600,7,23,30,Clouds
42429,113,1553565600,40,0,40,Clouds
42430,114,1553565600,40,0,40,Clouds
42431,115,1553565600,5,25,30,Clouds
42432,2,1553569200,4,16,20,Clouds
42433,3,1553569200,20,0,20,Clouds
42434,4,1553569200,20,0,20,Clouds
42435,5,1553569200,6,34,40,Clouds
42436,6,1553569200,19,1,20,Clouds
42437,7,1553569200,18,11,29,Clouds
42438,8,1553569200,29,1,30,Clouds
42439,9,1553569200,24,0,24,Clouds
42440,10,1553569200,16,0,16,Clouds
42441,11,1553569200,30,0,30,Clouds
42442,12,1553569200,6,14,20,Clouds
42443,13,1553569200,30,0,30,Clouds
42444,14,1553569200,30,0,30,Clouds
42445,15,1553569200,10,6,16,Clouds
42446,16,1553569200,18,2,20,Clouds
42447,17,1553569200,20,0,20,Clouds
42448,18,1553569200,22,8,30,Clouds
42449,19,1553569200,28,2,30,Clouds
42450,21,1553569200,30,0,30,Clouds
42451,22,1553569200,17,3,20,Clouds
42452,23,1553569200,23,7,30,Clouds
42453,24,1553569200,19,1,20,Clouds
42454,25,1553569200,30,0,30,Clouds
42455,26,1553569200,20,0,20,Clouds
42456,27,1553569200,20,0,20,Clouds
42457,28,1553569200,13,17,30,Clouds
42458,29,1553569200,29,0,29,Clouds
42459,30,1553569200,20,0,20,Clouds
42460,31,1553569200,20,0,20,Clouds
42461,32,1553569200,30,0,30,Clouds
42462,33,1553569200,23,0,23,Clouds
42463,34,1553569200,10,20,30,Clouds
42464,35,1553569200,14,16,30,Clouds
42465,36,1553569200,38,2,40,Clouds
42466,37,1553569200,30,0,30,Clouds
42467,38,1553569200,40,0,40,Clouds
42468,39,1553569200,19,1,20,Clouds
42469,40,1553569200,21,0,21,Clouds
42470,41,1553569200,18,2,20,Clouds
42471,42,1553569200,2,28,30,Clouds
42472,43,1553569200,1,29,30,Clouds
42473,44,1553569200,0,30,30,Clouds
42474,45,1553569200,17,13,30,Clouds
42475,46,1553569200,20,0,20,Clouds
42476,47,1553569200,39,1,40,Clouds
42477,48,1553569200,39,1,40,Clouds
42478,49,1553569200,39,1,40,Clouds
42479,50,1553569200,0,40,40,Clouds
42480,51,1553569200,40,0,40,Clouds
42481,52,1553569200,32,0,32,Clouds
42482,53,1553569200,40,0,40,Clouds
42483,54,1553569200,31,2,33,Clouds
42484,55,1553569200,36,0,36,Clouds
42485,56,1553569200,26,14,40,Clouds
42486,57,1553569200,22,1,23,Clouds
42487,58,1553569200,38,2,40,Clouds
42488,59,1553569200,11,9,20,Clouds
42489,60,1553569200,6,24,30,Clouds
42490,61,1553569200,25,0,25,Clouds
42491,62,1553569200,38,2,40,Clouds
42492,63,1553569200,35,0,35,Clouds
42493,64,1553569200,39,1,40,Clouds
42494,65,1553569200,40,0,40,Clouds
42495,66,1553569200,27,13,40,Clouds
42496,67,1553569200,36,4,40,Clouds
42497,68,1553569200,39,1,40,Clouds
42498,69,1553569200,36,4,40,Clouds
42499,70,1553569200,17,11,28,Clouds
42500,71,1553569200,40,0,40,Clouds
42501,72,1553569200,5,26,31,Clouds
42502,73,1553569200,10,20,30,Clouds
42503,74,1553569200,4,26,30,Clouds
42504,75,1553569200,17,23,40,Clouds
42505,76,1553569200,5,33,38,Clouds
42506,77,1553569200,25,4,29,Clouds
42507,78,1553569200,4,36,40,Clouds
42508,79,1553569200,20,7,27,Clouds
42509,80,1553569200,25,15,40,Clouds
42510,81,1553569200,36,4,40,Clouds
42511,82,1553569200,6,16,22,Clouds
42512,83,1553569200,0,40,40,Clouds
42513,84,1553569200,0,30,30,Clouds
42514,85,1553569200,0,35,35,Clouds
42515,86,1553569200,2,36,38,Clouds
42516,87,1553569200,0,38,38,Clouds
42517,88,1553569200,0,30,30,Clouds
42518,89,1553569200,40,0,40,Clouds
42519,90,1553569200,40,0,40,Clouds
42520,91,1553569200,1,29,30,Clouds
42521,92,1553569200,4,36,40,Clouds
42522,93,1553569200,0,40,40,Clouds
42523,94,1553569200,6,34,40,Clouds
42524,95,1553569200,0,40,40,Clouds
42525,96,1553569200,7,23,30,Clouds
42526,97,1553569200,8,32,40,Clouds
42527,98,1553569200,39,1,40,Clouds
42528,99,1553569200,30,0,30,Clouds
42529,100,1553569200,11,14,25,Clouds
42530,101,1553569200,14,16,30,Clouds
42531,102,1553569200,24,16,40,Clouds
42532,103,1553569200,33,7,40,Clouds
42533,104,1553569200,34,6,40,Clouds
42534,105,1553569200,34,2,36,Clouds
42535,106,1553569200,26,14,40,Clouds
42536,107,1553569200,3,37,40,Clouds
42537,108,1553569200,16,24,40,Clouds
42538,109,1553569200,10,19,29,Clouds
42539,110,1553569200,31,9,40,Clouds
42540,111,1553569200,1,39,40,Clouds
42541,112,1553569200,6,24,30,Clouds
42542,113,1553569200,40,0,40,Clouds
42543,114,1553569200,40,0,40,Clouds
42544,115,1553569200,5,25,30,Clouds
42545,2,1553572800,4,16,20,Clouds
42546,3,1553572800,20,0,20,Clouds
42547,4,1553572800,20,0,20,Clouds
42548,5,1553572800,6,34,40,Clouds
42549,6,1553572800,19,1,20,Clouds
42550,7,1553572800,18,11,29,Clouds
42551,8,1553572800,29,1,30,Clouds
42552,9,1553572800,24,0,24,Clouds
42553,10,1553572800,16,0,16,Clouds
42554,11,1553572800,30,0,30,Clouds
42555,12,1553572800,6,14,20,Clouds
42556,13,1553572800,30,0,30,Clouds
42557,14,1553572800,30,0,30,Clouds
42558,15,1553572800,10,6,16,Clouds
42559,16,1553572800,18,2,20,Clouds
42560,17,1553572800,20,0,20,Clouds
42561,18,1553572800,22,8,30,Clouds
42562,19,1553572800,28,2,30,Clouds
42563,21,1553572800,30,0,30,Clouds
42564,22,1553572800,17,3,20,Clouds
42565,23,1553572800,23,7,30,Clouds
42566,24,1553572800,19,1,20,Clouds
42567,25,1553572800,30,0,30,Clouds
42568,26,1553572800,20,0,20,Clouds
42569,27,1553572800,20,0,20,Clouds
42570,28,1553572800,13,17,30,Clouds
42571,29,1553572800,29,0,29,Clouds
42572,30,1553572800,20,0,20,Clouds
42573,31,1553572800,20,0,20,Clouds
42574,32,1553572800,30,0,30,Clouds
42575,33,1553572800,23,0,23,Clouds
42576,34,1553572800,10,20,30,Clouds
42577,35,1553572800,14,16,30,Clouds
42578,36,1553572800,38,2,40,Clouds
42579,37,1553572800,30,0,30,Clouds
42580,38,1553572800,40,0,40,Clouds
42581,39,1553572800,19,1,20,Clouds
42582,40,1553572800,21,0,21,Clouds
42583,41,1553572800,18,2,20,Clouds
42584,42,1553572800,2,28,30,Clouds
42585,43,1553572800,1,29,30,Clouds
42586,44,1553572800,0,30,30,Clouds
42587,45,1553572800,17,13,30,Clouds
42588,46,1553572800,20,0,20,Clouds
42589,47,1553572800,39,1,40,Clouds
42590,48,1553572800,39,1,40,Clouds
42591,49,1553572800,39,1,40,Clouds
42592,50,1553572800,0,40,40,Clouds
42593,51,1553572800,40,0,40,Clouds
42594,52,1553572800,32,0,32,Clouds
42595,53,1553572800,40,0,40,Clouds
42596,54,1553572800,31,2,33,Clouds
42597,55,1553572800,36,0,36,Clouds
42598,56,1553572800,26,14,40,Clouds
42599,57,1553572800,22,1,23,Clouds
42600,58,1553572800,38,2,40,Clouds
42601,59,1553572800,11,9,20,Clouds
42602,60,1553572800,6,24,30,Clouds
42603,61,1553572800,25,0,25,Clouds
42604,62,1553572800,38,2,40,Clouds
42605,63,1553572800,35,0,35,Clouds
42606,64,1553572800,39,1,40,Clouds
42607,65,1553572800,40,0,40,Clouds
42608,66,1553572800,27,13,40,Clouds
42609,67,1553572800,36,4,40,Clouds
42610,68,1553572800,39,1,40,Clouds
42611,69,1553572800,36,4,40,Clouds
42612,70,1553572800,17,11,28,Clouds
42613,71,1553572800,40,0,40,Clouds
42614,72,1553572800,5,26,31,Clouds
42615,73,1553572800,10,20,30,Clouds
42616,74,1553572800,4,26,30,Clouds
42617,75,1553572800,17,23,40,Clouds
42618,76,1553572800,5,33,38,Clouds
42619,77,1553572800,25,4,29,Clouds
42620,78,1553572800,4,36,40,Clouds
42621,79,1553572800,20,7,27,Clouds
42622,80,1553572800,25,15,40,Clouds
42623,81,1553572800,36,4,40,Clouds
42624,82,1553572800,6,16,22,Clouds
42625,83,1553572800,0,40,40,Clouds
42626,84,1553572800,0,30,30,Clouds
42627,85,1553572800,0,35,35,Clouds
42628,86,1553572800,2,36,38,Clouds
42629,87,1553572800,0,38,38,Clouds
42630,88,1553572800,0,30,30,Clouds
42631,89,1553572800,40,0,40,Clouds
42632,90,1553572800,40,0,40,Clouds
42633,91,1553572800,1,29,30,Clouds
42634,92,1553572800,4,36,40,Clouds
42635,93,1553572800,0,40,40,Clouds
42636,94,1553572800,6,34,40,Clouds
42637,95,1553572800,0,40,40,Clouds
42638,96,1553572800,7,23,30,Clouds
42639,97,1553572800,8,32,40,Clouds
42640,98,1553572800,39,1,40,Clouds
42641,99,1553572800,30,0,30,Clouds
42642,100,1553572800,11,14,25,Clouds
42643,101,1553572800,14,16,30,Clouds
42644,102,1553572800,24,16,40,Clouds
42645,103,1553572800,33,7,40,Clouds
42646,104,1553572800,34,6,40,Clouds
42647,105,1553572800,34,2,36,Clouds
42648,106,1553572800,26,14,40,Clouds
42649,107,1553572800,3,37,40,Clouds
42650,108,1553572800,16,24,40,Clouds
42651,109,1553572800,10,19,29,Clouds
42652,110,1553572800,31,9,40,Clouds
42653,111,1553572800,1,39,40,Clouds
42654,112,1553572800,6,24,30,Clouds
42655,113,1553572800,40,0,40,Clouds
42656,114,1553572800,40,0,40,Clouds
42657,115,1553572800,5,25,30,Clouds
42658,2,1553576400,4,16,20,Clouds
42659,3,1553576400,20,0,20,Clouds
42660,4,1553576400,20,0,20,Clouds
42661,5,1553576400,6,34,40,Clouds
42662,6,1553576400,19,1,20,Clouds
42663,7,1553576400,18,11,29,Clouds
42664,8,1553576400,29,1,30,Clouds
42665,9,1553576400,24,0,24,Clouds
42666,10,1553576400,16,0,16,Clouds
42667,11,1553576400,30,0,30,Clouds
42668,12,1553576400,6,14,20,Clouds
42669,13,1553576400,30,0,30,Clouds
42670,14,1553576400,30,0,30,Clouds
42671,15,1553576400,10,6,16,Clouds
42672,16,1553576400,18,2,20,Clouds
42673,17,1553576400,20,0,20,Clouds
42674,18,1553576400,22,8,30,Clouds
42675,19,1553576400,28,2,30,Clouds
42676,21,1553576400,30,0,30,Clouds
42677,22,1553576400,17,3,20,Clouds
42678,23,1553576400,23,7,30,Clouds
42679,24,1553576400,19,1,20,Clouds
42680,25,1553576400,30,0,30,Clouds
42681,26,1553576400,20,0,20,Clouds
42682,27,1553576400,20,0,20,Clouds
42683,28,1553576400,13,17,30,Clouds
42684,29,1553576400,29,0,29,Clouds
42685,30,1553576400,20,0,20,Clouds
42686,31,1553576400,20,0,20,Clouds
42687,32,1553576400,30,0,30,Clouds
42688,33,1553576400,23,0,23,Clouds
42689,34,1553576400,10,20,30,Clouds
42690,35,1553576400,14,16,30,Clouds
42691,36,1553576400,38,2,40,Clouds
42692,37,1553576400,30,0,30,Clouds
42693,38,1553576400,40,0,40,Clouds
42694,39,1553576400,19,1,20,Clouds
42695,40,1553576400,21,0,21,Clouds
42696,41,1553576400,18,2,20,Clouds
42697,42,1553576400,2,28,30,Clouds
42698,43,1553576400,1,29,30,Clouds
42699,44,1553576400,0,30,30,Clouds
42700,45,1553576400,17,13,30,Clouds
42701,46,1553576400,20,0,20,Clouds
42702,47,1553576400,39,1,40,Clouds
42703,48,1553576400,39,1,40,Clouds
42704,49,1553576400,39,1,40,Clouds
42705,50,1553576400,0,40,40,Clouds
42706,51,1553576400,40,0,40,Clouds
42707,52,1553576400,32,0,32,Clouds
42708,53,1553576400,40,0,40,Clouds
42709,54,1553576400,31,2,33,Clouds
42710,55,1553576400,36,0,36,Clouds
42711,56,1553576400,26,14,40,Clouds
42712,57,1553576400,22,1,23,Clouds
42713,58,1553576400,38,2,40,Clouds
42714,59,1553576400,11,9,20,Clouds
42715,60,1553576400,6,24,30,Clouds
42716,61,1553576400,25,0,25,Clouds
42717,62,1553576400,38,2,40,Clouds
42718,63,1553576400,35,0,35,Clouds
42719,64,1553576400,39,1,40,Clouds
42720,65,1553576400,40,0,40,Clouds
42721,66,1553576400,27,13,40,Clouds
42722,67,1553576400,36,4,40,Clouds
42723,68,1553576400,39,1,40,Clouds
42724,69,1553576400,36,4,40,Clouds
42725,70,1553576400,17,11,28,Clouds
42726,71,1553576400,40,0,40,Clouds
42727,72,1553576400,5,26,31,Clouds
42728,73,1553576400,10,20,30,Clouds
42729,74,1553576400,4,26,30,Clouds
42730,75,1553576400,17,23,40,Clouds
42731,76,1553576400,5,33,38,Clouds
42732,77,1553576400,25,4,29,Clouds
42733,78,1553576400,4,36,40,Clouds
42734,79,1553576400,20,7,27,Clouds
42735,80,1553576400,25,15,40,Clouds
42736,81,1553576400,36,4,40,Clouds
42737,82,1553576400,6,16,22,Clouds
42738,83,1553576400,0,40,40,Clouds
42739,84,1553576400,0,30,30,Clouds
42740,85,1553576400,0,35,35,Clouds
42741,86,1553576400,2,36,38,Clouds
42742,87,1553576400,0,38,38,Clouds
42743,88,1553576400,0,30,30,Clouds
42744,89,1553576400,40,0,40,Clouds
42745,90,1553576400,40,0,40,Clouds
42746,91,1553576400,1,29,30,Clouds
42747,92,1553576400,4,36,40,Clouds
42748,93,1553576400,0,40,40,Clouds
42749,94,1553576400,6,34,40,Clouds
42750,95,1553576400,0,40,40,Clouds
42751,96,1553576400,7,23,30,Clouds
42752,97,1553576400,8,32,40,Clouds
42753,98,1553576400,39,1,40,Clouds
42754,99,1553576400,30,0,30,Clouds
42755,100,1553576400,11,14,25,Clouds
42756,101,1553576400,14,16,30,Clouds
42757,102,1553576400,24,16,40,Clouds
42758,103,1553576400,33,7,40,Clouds
42759,104,1553576400,34,6,40,Clouds
42760,105,1553576400,34,2,36,Clouds
42761,106,1553576400,26,14,40,Clouds
42762,107,1553576400,3,37,40,Clouds
42763,108,1553576400,16,24,40,Clouds
42764,109,1553576400,10,19,29,Clouds
42765,110,1553576400,31,9,40,Clouds
42766,111,1553576400,1,39,40,Clouds
42767,112,1553576400,6,24,30,Clouds
42768,113,1553576400,40,0,40,Clouds
42769,114,1553576400,40,0,40,Clouds
42770,115,1553576400,5,25,30,Clouds
42771,2,1553580000,4,16,20,Clouds
42772,3,1553580000,20,0,20,Clouds
42773,4,1553580000,20,0,20,Clouds
42774,5,1553580000,6,34,40,Clouds
42775,6,1553580000,20,0,20,Clouds
42776,7,1553580000,18,11,29,Clouds
42777,8,1553580000,29,1,30,Clouds
42778,9,1553580000,24,0,24,Clouds
42779,10,1553580000,16,0,16,Clouds
42780,11,1553580000,30,0,30,Clouds
42781,12,1553580000,6,14,20,Clouds
42782,13,1553580000,30,0,30,Clouds
42783,14,1553580000,30,0,30,Clouds
42784,15,1553580000,10,6,16,Clouds
42785,16,1553580000,18,2,20,Clouds
42786,17,1553580000,20,0,20,Clouds
42787,18,1553580000,22,8,30,Clouds
42788,19,1553580000,28,2,30,Clouds
42789,21,1553580000,30,0,30,Clouds
42790,22,1553580000,17,3,20,Clouds
42791,23,1553580000,23,7,30,Clouds
42792,24,1553580000,20,0,20,Clouds
42793,25,1553580000,30,0,30,Clouds
42794,26,1553580000,20,0,20,Clouds
42795,27,1553580000,20,0,20,Clouds
42796,28,1553580000,13,17,30,Clouds
42797,29,1553580000,29,0,29,Clouds
42798,30,1553580000,20,0,20,Clouds
42799,31,1553580000,20,0,20,Clouds
42800,32,1553580000,30,0,30,Clouds
42801,33,1553580000,23,0,23,Clouds
42802,34,1553580000,10,20,30,Clouds
42803,35,1553580000,14,16,30,Clouds
42804,36,1553580000,38,2,40,Clouds
42805,37,1553580000,30,0,30,Clouds
42806,38,1553580000,40,0,40,Clouds
42807,39,1553580000,19,1,20,Clouds
42808,40,1553580000,21,0,21,Clouds
42809,41,1553580000,18,2,20,Clouds
42810,42,1553580000,3,27,30,Clouds
42811,43,1553580000,1,29,30,Clouds
42812,44,1553580000,0,30,30,Clouds
42813,45,1553580000,17,13,30,Clouds
42814,46,1553580000,20,0,20,Clouds
42815,47,1553580000,39,1,40,Clouds
42816,48,1553580000,39,1,40,Clouds
42817,49,1553580000,39,1,40,Clouds
42818,50,1553580000,0,40,40,Clouds
42819,51,1553580000,40,0,40,Clouds
42820,52,1553580000,32,0,32,Clouds
42821,53,1553580000,40,0,40,Clouds
42822,54,1553580000,31,2,33,Clouds
42823,55,1553580000,36,0,36,Clouds
42824,56,1553580000,26,14,40,Clouds
42825,57,1553580000,22,1,23,Clouds
42826,58,1553580000,38,2,40,Clouds
42827,59,1553580000,11,9,20,Clouds
42828,60,1553580000,6,24,30,Clouds
42829,61,1553580000,25,0,25,Clouds
42830,62,1553580000,38,2,40,Clouds
42831,63,1553580000,35,0,35,Clouds
42832,64,1553580000,39,1,40,Clouds
42833,65,1553580000,40,0,40,Clouds
42834,66,1553580000,27,13,40,Clouds
42835,67,1553580000,36,4,40,Clouds
42836,68,1553580000,39,1,40,Clouds
42837,69,1553580000,36,4,40,Clouds
42838,70,1553580000,17,11,28,Clouds
42839,71,1553580000,40,0,40,Clouds
42840,72,1553580000,5,26,31,Clouds
42841,73,1553580000,10,20,30,Clouds
42842,74,1553580000,4,26,30,Clouds
42843,75,1553580000,17,23,40,Clouds
42844,76,1553580000,5,33,38,Clouds
42845,77,1553580000,25,4,29,Clouds
42846,78,1553580000,4,36,40,Clouds
42847,79,1553580000,20,7,27,Clouds
42848,80,1553580000,25,15,40,Clouds
42849,81,1553580000,36,4,40,Clouds
42850,82,1553580000,6,16,22,Clouds
42851,83,1553580000,0,40,40,Clouds
42852,84,1553580000,0,30,30,Clouds
42853,85,1553580000,0,35,35,Clouds
42854,86,1553580000,2,36,38,Clouds
42855,87,1553580000,0,38,38,Clouds
42856,88,1553580000,0,30,30,Clouds
42857,89,1553580000,40,0,40,Clouds
42858,90,1553580000,40,0,40,Clouds
42859,91,1553580000,1,29,30,Clouds
42860,92,1553580000,4,36,40,Clouds
42861,93,1553580000,0,40,40,Clouds
42862,94,1553580000,6,34,40,Clouds
42863,95,1553580000,0,40,40,Clouds
42864,96,1553580000,7,23,30,Clouds
42865,97,1553580000,8,32,40,Clouds
42866,98,1553580000,39,1,40,Clouds
42867,99,1553580000,30,0,30,Clouds
42868,100,1553580000,11,14,25,Clouds
42869,101,1553580000,14,16,30,Clouds
42870,102,1553580000,24,16,40,Clouds
42871,103,1553580000,33,7,40,Clouds
42872,104,1553580000,34,6,40,Clouds
42873,105,1553580000,34,2,36,Clouds
42874,106,1553580000,26,14,40,Clouds
42875,107,1553580000,3,37,40,Clouds
42876,108,1553580000,16,24,40,Clouds
42877,109,1553580000,10,19,29,Clouds
42878,110,1553580000,31,9,40,Clouds
42879,111,1553580000,1,39,40,Clouds
42880,112,1553580000,6,24,30,Clouds
42881,113,1553580000,40,0,40,Clouds
42882,114,1553580000,40,0,40,Clouds
42883,115,1553580000,5,25,30,Clouds
42884,2,1553583600,4,16,20,Clouds
42885,3,1553583600,19,1,20,Clouds
42886,4,1553583600,20,0,20,Clouds
42887,5,1553583600,6,34,40,Clouds
42888,6,1553583600,20,0,20,Clouds
42889,7,1553583600,22,7,29,Clouds
42890,8,1553583600,25,5,30,Clouds
42891,9,1553583600,23,1,24,Clouds
42892,10,1553583600,16,0,16,Clouds
42893,11,1553583600,30,0,30,Clouds
42894,12,1553583600,9,11,20,Clouds
42895,13,1553583600,30,0,30,Clouds
42896,14,1553583600,23,7,30,Clouds
42897,15,1553583600,11,5,16,Clouds
42898,16,1553583600,18,2,20,Clouds
42899,17,1553583600,20,0,20,Clouds
42900,18,1553583600,22,8,30,Clouds
42901,19,1553583600,26,4,30,Clouds
42902,21,1553583600,29,1,30,Clouds
42903,22,1553583600,14,6,20,Clouds
42904,23,1553583600,27,3,30,Clouds
42905,24,1553583600,16,4,20,Clouds
42906,25,1553583600,29,1,30,Clouds
42907,26,1553583600,17,3,20,Clouds
42908,27,1553583600,19,1,20,Clouds
42909,28,1553583600,4,26,30,Clouds
42910,29,1553583600,27,2,29,Clouds
42911,30,1553583600,1,19,20,Clouds
42912,31,1553583600,19,1,20,Clouds
42913,32,1553583600,26,4,30,Clouds
42914,33,1553583600,18,5,23,Clouds
42915,34,1553583600,15,15,30,Clouds
42916,35,1553583600,20,10,30,Clouds
42917,36,1553583600,38,2,40,Clouds
42918,37,1553583600,30,0,30,Clouds
42919,38,1553583600,39,1,40,Clouds
42920,39,1553583600,19,1,20,Clouds
42921,40,1553583600,20,1,21,Clouds
42922,41,1553583600,18,2,20,Clouds
42923,42,1553583600,3,27,30,Clouds
42924,43,1553583600,9,21,30,Clouds
42925,44,1553583600,10,20,30,Clouds
42926,45,1553583600,19,11,30,Clouds
42927,46,1553583600,20,0,20,Clouds
42928,47,1553583600,40,0,40,Clouds
42929,48,1553583600,38,2,40,Clouds
42930,49,1553583600,33,7,40,Clouds
42931,50,1553583600,0,40,40,Clouds
42932,51,1553583600,39,1,40,Clouds
42933,52,1553583600,28,4,32,Clouds
42934,53,1553583600,40,0,40,Clouds
42935,54,1553583600,31,2,33,Clouds
42936,55,1553583600,36,0,36,Clouds
42937,56,1553583600,39,1,40,Clouds
42938,57,1553583600,21,2,23,Clouds
42939,58,1553583600,36,4,40,Clouds
42940,59,1553583600,12,8,20,Clouds
42941,60,1553583600,8,22,30,Clouds
42942,61,1553583600,20,5,25,Clouds
42943,62,1553583600,35,5,40,Clouds
42944,63,1553583600,34,1,35,Clouds
42945,64,1553583600,38,2,40,Clouds
42946,65,1553583600,39,1,40,Clouds
42947,66,1553583600,34,6,40,Clouds
42948,67,1553583600,37,3,40,Clouds
42949,68,1553583600,36,4,40,Clouds
42950,69,1553583600,32,8,40,Clouds
42951,70,1553583600,17,11,28,Clouds
42952,71,1553583600,38,2,40,Clouds
42953,72,1553583600,5,26,31,Clouds
42954,73,1553583600,10,20,30,Clouds
42955,74,1553583600,8,22,30,Clouds
42956,75,1553583600,17,23,40,Clouds
42957,76,1553583600,6,32,38,Clouds
42958,77,1553583600,25,4,29,Clouds
42959,78,1553583600,7,33,40,Clouds
42960,79,1553583600,20,7,27,Clouds
42961,80,1553583600,27,13,40,Clouds
42962,81,1553583600,36,4,40,Clouds
42963,82,1553583600,6,16,22,Clouds
42964,83,1553583600,4,36,40,Clouds
42965,84,1553583600,0,30,30,Clouds
42966,85,1553583600,0,35,35,Clouds
42967,86,1553583600,5,33,38,Clouds
42968,87,1553583600,2,36,38,Clouds
42969,88,1553583600,1,29,30,Clouds
42970,89,1553583600,40,0,40,Clouds
42971,90,1553583600,38,2,40,Clouds
42972,91,1553583600,19,11,30,Clouds
42973,92,1553583600,3,37,40,Clouds
42974,93,1553583600,0,40,40,Clouds
42975,94,1553583600,0,40,40,Clouds
42976,95,1553583600,1,39,40,Clouds
42977,96,1553583600,7,23,30,Clouds
42978,97,1553583600,11,29,40,Clouds
42979,98,1553583600,40,0,40,Clouds
42980,99,1553583600,28,2,30,Clouds
42981,100,1553583600,0,24,24,Clouds
42982,101,1553583600,21,9,30,Clouds
42983,102,1553583600,24,16,40,Clouds
42984,103,1553583600,33,7,40,Clouds
42985,104,1553583600,34,6,40,Clouds
42986,105,1553583600,35,1,36,Clouds
42987,106,1553583600,27,13,40,Clouds
42988,107,1553583600,7,33,40,Clouds
42989,108,1553583600,16,24,40,Clouds
42990,109,1553583600,17,12,29,Clouds
42991,110,1553583600,31,9,40,Clouds
42992,111,1553583600,1,39,40,Clouds
42993,112,1553583600,9,21,30,Clouds
42994,113,1553583600,38,2,40,Clouds
42995,114,1553583600,39,1,40,Clouds
42996,115,1553583600,6,24,30,Clouds
42997,2,1553587200,15,5,20,Clouds
42998,3,1553587200,17,3,20,Clouds
42999,4,1553587200,18,2,20,Clouds
43000,5,1553587200,24,16,40,Clouds
43001,6,1553587200,20,0,20,Clouds
43002,7,1553587200,19,10,29,Clouds
43003,8,1553587200,22,8,30,Clouds
43004,9,1553587200,21,3,24,Clouds
43005,10,1553587200,15,1,16,Clouds
43006,11,1553587200,28,2,30,Clouds
43007,12,1553587200,18,2,20,Clouds
43008,13,1553587200,30,0,30,Clouds
43009,14,1553587200,26,4,30,Clouds
43010,15,1553587200,15,1,16,Clouds
43011,16,1553587200,19,1,20,Clouds
43012,17,1553587200,18,2,20,Clouds
43013,18,1553587200,24,6,30,Clouds
43014,19,1553587200,23,7,30,Clouds
43015,21,1553587200,27,3,30,Clouds
43016,22,1553587200,14,6,20,Clouds
43017,23,1553587200,27,3,30,Clouds
43018,24,1553587200,16,4,20,Clouds
43019,25,1553587200,21,9,30,Clouds
43020,26,1553587200,14,6,20,Clouds
43021,27,1553587200,15,5,20,Clouds
43022,28,1553587200,16,14,30,Clouds
43023,29,1553587200,23,6,29,Clouds
43024,30,1553587200,0,20,20,Clouds
43025,31,1553587200,17,3,20,Clouds
43026,32,1553587200,22,8,30,Clouds
43027,33,1553587200,14,9,23,Clouds
43028,34,1553587200,18,12,30,Clouds
43029,35,1553587200,30,0,30,Clouds
43030,36,1553587200,38,2,40,Clouds
43031,37,1553587200,30,0,30,Clouds
43032,38,1553587200,32,8,40,Clouds
43033,39,1553587200,17,3,20,Clouds
43034,40,1553587200,20,1,21,Clouds
43035,41,1553587200,18,2,20,Clouds
43036,42,1553587200,10,20,30,Clouds
43037,43,1553587200,20,10,30,Clouds
43038,44,1553587200,21,9,30,Clouds
43039,45,1553587200,24,6,30,Clouds
43040,46,1553587200,19,1,20,Clouds
43041,47,1553587200,38,2,40,Clouds
43042,48,1553587200,34,6,40,Clouds
43043,49,1553587200,34,6,40,Clouds
43044,50,1553587200,3,37,40,Clouds
43045,51,1553587200,31,9,40,Clouds
43046,52,1553587200,28,4,32,Clouds
43047,53,1553587200,38,2,40,Clouds
43048,54,1553587200,29,4,33,Clouds
43049,55,1553587200,31,5,36,Clouds
43050,56,1553587200,40,0,40,Clouds
43051,57,1553587200,23,0,23,Clouds
43052,58,1553587200,33,7,40,Clouds
43053,59,1553587200,12,8,20,Clouds
43054,60,1553587200,23,7,30,Clouds
43055,61,1553587200,23,2,25,Clouds
43056,62,1553587200,29,11,40,Clouds
43057,63,1553587200,33,2,35,Clouds
43058,64,1553587200,36,4,40,Clouds
43059,65,1553587200,31,9,40,Clouds
43060,66,1553587200,20,20,40,Clouds
43061,67,1553587200,35,5,40,Clouds
43062,68,1553587200,35,5,40,Clouds
43063,69,1553587200,25,15,40,Clouds
43064,70,1553587200,22,6,28,Clouds
43065,71,1553587200,39,1,40,Clouds
43066,72,1553587200,9,22,31,Clouds
43067,73,1553587200,15,15,30,Clouds
43068,74,1553587200,13,17,30,Clouds
43069,75,1553587200,3,37,40,Clouds
43070,76,1553587200,14,24,38,Clouds
43071,77,1553587200,28,1,29,Clouds
43072,78,1553587200,9,31,40,Clouds
43073,79,1553587200,21,6,27,Clouds
43074,80,1553587200,28,12,40,Clouds
43075,81,1553587200,35,5,40,Clouds
43076,82,1553587200,9,13,22,Clouds
43077,83,1553587200,6,34,40,Clouds
43078,84,1553587200,1,29,30,Clouds
43079,85,1553587200,5,30,35,Clouds
43080,86,1553587200,11,27,38,Clouds
43081,87,1553587200,6,32,38,Clouds
43082,88,1553587200,10,20,30,Clouds
43083,89,1553587200,39,1,40,Clouds
43084,90,1553587200,28,12,40,Clouds
43085,91,1553587200,20,10,30,Clouds
43086,92,1553587200,5,35,40,Clouds
43087,93,1553587200,7,33,40,Clouds
43088,94,1553587200,0,40,40,Clouds
43089,95,1553587200,4,36,40,Clouds
43090,96,1553587200,9,21,30,Clouds
43091,97,1553587200,21,19,40,Clouds
43092,98,1553587200,39,1,40,Clouds
43093,99,1553587200,26,4,30,Clouds
43094,100,1553587200,16,8,24,Clouds
43095,101,1553587200,30,0,30,Clouds
43096,102,1553587200,28,12,40,Clouds
43097,103,1553587200,24,16,40,Clouds
43098,104,1553587200,33,7,40,Clouds
43099,105,1553587200,34,2,36,Clouds
43100,106,1553587200,28,12,40,Clouds
43101,107,1553587200,11,29,40,Clouds
43102,108,1553587200,21,19,40,Clouds
43103,109,1553587200,23,6,29,Clouds
43104,110,1553587200,26,14,40,Clouds
43105,111,1553587200,8,32,40,Clouds
43106,112,1553587200,16,14,30,Clouds
43107,113,1553587200,38,2,40,Clouds
43108,114,1553587200,33,7,40,Clouds
43109,115,1553587200,10,20,30,Clouds
43110,2,1553594400,20,0,20,Clouds
43111,3,1553594400,17,3,20,Clouds
43112,4,1553594400,20,0,20,Clouds
43113,5,1553594400,39,1,40,Clouds
43114,6,1553594400,20,0,20,Clouds
43115,7,1553594400,29,0,29,Clouds
43116,8,1553594400,16,14,30,Clouds
43117,9,1553594400,12,12,24,Clouds
43118,10,1553594400,14,2,16,Clouds
43119,11,1553594400,2,28,30,Clouds
43120,12,1553594400,20,0,20,Clouds
43121,13,1553594400,13,17,30,Clouds
43122,14,1553594400,19,11,30,Clouds
43123,15,1553594400,16,0,16,Clouds
43124,16,1553594400,15,5,20,Clouds
43125,17,1553594400,17,3,20,Clouds
43126,18,1553594400,30,0,30,Clouds
43127,19,1553594400,0,25,25,Clouds
43128,21,1553594400,19,11,30,Clouds
43129,22,1553594400,12,8,20,Clouds
43130,23,1553594400,16,14,30,Clouds
43131,24,1553594400,17,3,20,Clouds
43132,25,1553594400,1,29,30,Clouds
43133,26,1553594400,3,17,20,Clouds
43134,27,1553594400,12,8,20,Clouds
43135,28,1553594400,29,1,30,Clouds
43136,29,1553594400,27,2,29,Clouds
43137,30,1553594400,14,6,20,Clouds
43138,31,1553594400,17,3,20,Clouds
43139,32,1553594400,20,10,30,Clouds
43140,33,1553594400,16,7,23,Clouds
43141,34,1553594400,30,0,30,Clouds
43142,35,1553594400,30,0,30,Clouds
43143,36,1553594400,0,40,40,Clouds
43144,37,1553594400,27,3,30,Clouds
43145,38,1553594400,39,1,40,Clouds
43146,39,1553594400,17,3,20,Clouds
43147,40,1553594400,16,5,21,Clouds
43148,41,1553594400,20,0,20,Clouds
43149,42,1553594400,30,0,30,Clouds
43150,43,1553594400,21,9,30,Clouds
43151,44,1553594400,30,0,30,Clouds
43152,45,1553594400,30,0,30,Clouds
43153,46,1553594400,20,0,20,Clouds
43154,47,1553594400,2,38,40,Clouds
43155,48,1553594400,15,25,40,Clouds
43156,49,1553594400,15,25,40,Clouds
43157,50,1553594400,38,2,40,Clouds
43158,51,1553594400,30,10,40,Clouds
43159,52,1553594400,17,13,30,Clouds
43160,53,1553594400,33,6,39,Clouds
43161,54,1553594400,19,14,33,Clouds
43162,55,1553594400,18,18,36,Clouds
43163,56,1553594400,25,15,40,Clouds
43164,57,1553594400,3,19,22,Clouds
43165,58,1553594400,20,19,39,Clouds
43166,59,1553594400,20,0,20,Clouds
43167,60,1553594400,30,0,30,Clouds
43168,61,1553594400,25,0,25,Clouds
43169,62,1553594400,0,40,40,Clouds
43170,63,1553594400,0,35,35,Clouds
43171,64,1553594400,4,36,40,Clouds
43172,65,1553594400,5,35,40,Clouds
43173,66,1553594400,1,37,38,Clouds
43174,67,1553594400,8,32,40,Clouds
43175,68,1553594400,18,22,40,Clouds
43176,69,1553594400,3,36,39,Clouds
43177,70,1553594400,20,8,28,Clouds
43178,71,1553594400,40,0,40,Clouds
43179,72,1553594400,31,0,31,Clouds
43180,73,1553594400,29,1,30,Clouds
43181,74,1553594400,30,0,30,Clouds
43182,75,1553594400,40,0,40,Clouds
43183,76,1553594400,38,0,38,Clouds
43184,77,1553594400,27,2,29,Clouds
43185,78,1553594400,40,0,40,Clouds
43186,79,1553594400,27,0,27,Clouds
43187,80,1553594400,40,0,40,Clouds
43188,81,1553594400,39,1,40,Clouds
43189,82,1553594400,22,0,22,Clouds
43190,83,1553594400,40,0,40,Clouds
43191,84,1553594400,30,0,30,Clouds
43192,85,1553594400,35,0,35,Clouds
43193,86,1553594400,38,0,38,Clouds
43194,87,1553594400,38,0,38,Clouds
43195,88,1553594400,29,1,30,Clouds
43196,89,1553594400,34,6,40,Clouds
43197,90,1553594400,1,36,37,Clouds
43198,91,1553594400,28,1,29,Clouds
43199,92,1553594400,40,0,40,Clouds
43200,93,1553594400,40,0,40,Clouds
43201,94,1553594400,40,0,40,Clouds
43202,95,1553594400,39,1,40,Clouds
43203,96,1553594400,30,0,30,Clouds
43204,97,1553594400,39,0,39,Clouds
43205,98,1553594400,36,4,40,Clouds
43206,99,1553594400,5,24,29,Clouds
43207,100,1553594400,23,1,24,Clouds
43208,101,1553594400,28,2,30,Clouds
43209,102,1553594400,40,0,40,Clouds
43210,103,1553594400,26,14,40,Clouds
43211,104,1553594400,33,7,40,Clouds
43212,105,1553594400,36,0,36,Clouds
43213,106,1553594400,40,0,40,Clouds
43214,107,1553594400,33,7,40,Clouds
43215,108,1553594400,36,4,40,Clouds
43216,109,1553594400,28,1,29,Clouds
43217,110,1553594400,40,0,40,Clouds
43218,111,1553594400,40,0,40,Clouds
43219,112,1553594400,30,0,30,Clouds
43220,113,1553594400,23,17,40,Clouds
43221,114,1553594400,6,34,40,Clouds
43222,115,1553594400,30,0,30,Clouds
43223,2,1553598000,20,0,20,Clouds
43224,3,1553598000,20,0,20,Clouds
43225,4,1553598000,17,3,20,Clouds
43226,5,1553598000,35,5,40,Clouds
43227,6,1553598000,17,3,20,Clouds
43228,7,1553598000,29,0,29,Clouds
43229,8,1553598000,2,28,30,Clouds
43230,9,1553598000,14,10,24,Clouds
43231,10,1553598000,14,2,16,Clouds
43232,11,1553598000,0,29,29,Clouds
43233,12,1553598000,19,1,20,Clouds
43234,13,1553598000,6,24,30,Clouds
43235,14,1553598000,11,18,29,Clouds
43236,15,1553598000,16,0,16,Clouds
43237,16,1553598000,11,9,20,Clouds
43238,17,1553598000,20,0,20,Clouds
43239,18,1553598000,28,2,30,Clouds
43240,19,1553598000,16,11,27,Clouds
43241,21,1553598000,8,22,30,Clouds
43242,22,1553598000,12,8,20,Clouds
43243,23,1553598000,14,16,30,Clouds
43244,24,1553598000,20,0,20,Clouds
43245,25,1553598000,5,25,30,Clouds
43246,26,1553598000,0,20,20,Clouds
43247,27,1553598000,7,13,20,Clouds
43248,28,1553598000,30,0,30,Clouds
43249,29,1553598000,29,0,29,Clouds
43250,30,1553598000,20,0,20,Clouds
43251,31,1553598000,17,3,20,Clouds
43252,32,1553598000,6,24,30,Clouds
43253,33,1553598000,10,13,23,Clouds
43254,34,1553598000,21,9,30,Clouds
43255,35,1553598000,30,0,30,Clouds
43256,36,1553598000,1,39,40,Clouds
43257,37,1553598000,29,1,30,Clouds
43258,38,1553598000,37,3,40,Clouds
43259,39,1553598000,10,9,19,Clouds
43260,40,1553598000,7,14,21,Clouds
43261,41,1553598000,9,11,20,Clouds
43262,42,1553598000,28,2,30,Clouds
43263,43,1553598000,30,0,30,Clouds
43264,44,1553598000,30,0,30,Clouds
43265,45,1553598000,29,1,30,Clouds
43266,46,1553598000,18,2,20,Clouds
43267,47,1553598000,3,37,40,Clouds
43268,48,1553598000,0,40,40,Clouds
43269,49,1553598000,1,39,40,Clouds
43270,50,1553598000,40,0,40,Clouds
43271,51,1553598000,31,9,40,Clouds
43272,52,1553598000,11,19,30,Clouds
43273,53,1553598000,27,12,39,Clouds
43274,54,1553598000,11,22,33,Clouds
43275,55,1553598000,9,27,36,Clouds
43276,56,1553598000,4,36,40,Clouds
43277,57,1553598000,0,22,22,Clouds
43278,58,1553598000,9,30,39,Clouds
43279,59,1553598000,20,0,20,Clouds
43280,60,1553598000,11,19,30,Clouds
43281,61,1553598000,25,0,25,Clouds
43282,62,1553598000,0,40,40,Clouds
43283,63,1553598000,0,35,35,Clouds
43284,64,1553598000,6,33,39,Clouds
43285,65,1553598000,0,40,40,Clouds
43286,66,1553598000,0,38,38,Clouds
43287,67,1553598000,2,38,40,Clouds
43288,68,1553598000,17,22,39,Clouds
43289,69,1553598000,0,39,39,Clouds
43290,70,1553598000,21,7,28,Clouds
43291,71,1553598000,34,6,40,Clouds
43292,72,1553598000,31,0,31,Clouds
43293,73,1553598000,30,0,30,Clouds
43294,74,1553598000,30,0,30,Clouds
43295,75,1553598000,40,0,40,Clouds
43296,76,1553598000,38,0,38,Clouds
43297,77,1553598000,25,4,29,Clouds
43298,78,1553598000,40,0,40,Clouds
43299,79,1553598000,27,0,27,Clouds
43300,80,1553598000,38,2,40,Clouds
43301,81,1553598000,39,1,40,Clouds
43302,82,1553598000,22,0,22,Clouds
43303,83,1553598000,39,1,40,Clouds
43304,84,1553598000,30,0,30,Clouds
43305,85,1553598000,35,0,35,Clouds
43306,86,1553598000,38,0,38,Clouds
43307,87,1553598000,38,0,38,Clouds
43308,88,1553598000,29,1,30,Clouds
43309,89,1553598000,29,11,40,Clouds
43310,90,1553598000,2,35,37,Clouds
43311,91,1553598000,24,5,29,Clouds
43312,92,1553598000,40,0,40,Clouds
43313,93,1553598000,40,0,40,Clouds
43314,94,1553598000,40,0,40,Clouds
43315,95,1553598000,40,0,40,Clouds
43316,96,1553598000,30,0,30,Clouds
43317,97,1553598000,39,0,39,Clouds
43318,98,1553598000,29,11,40,Clouds
43319,99,1553598000,0,29,29,Clouds
43320,100,1553598000,24,0,24,Clouds
43321,101,1553598000,30,0,30,Clouds
43322,102,1553598000,37,3,40,Clouds
43323,103,1553598000,27,13,40,Clouds
43324,104,1553598000,34,6,40,Clouds
43325,105,1553598000,36,0,36,Clouds
43326,106,1553598000,40,0,40,Clouds
43327,107,1553598000,39,1,40,Clouds
43328,108,1553598000,37,3,40,Clouds
43329,109,1553598000,29,0,29,Clouds
43330,110,1553598000,40,0,40,Clouds
43331,111,1553598000,36,4,40,Clouds
43332,112,1553598000,29,1,30,Clouds
43333,113,1553598000,0,40,40,Clouds
43334,114,1553598000,6,34,40,Clouds
43335,115,1553598000,30,0,30,Clouds
43336,2,1553601600,19,1,20,Clouds
43337,3,1553601600,20,0,20,Clouds
43338,4,1553601600,19,1,20,Clouds
43339,5,1553601600,30,10,40,Clouds
43340,6,1553601600,20,0,20,Clouds
43341,7,1553601600,29,0,29,Clouds
43342,8,1553601600,0,30,30,Clouds
43343,9,1553601600,9,15,24,Clouds
43344,10,1553601600,13,3,16,Clouds
43345,11,1553601600,13,17,30,Clouds
43346,12,1553601600,20,0,20,Clouds
43347,13,1553601600,5,25,30,Clouds
43348,14,1553601600,10,19,29,Clouds
43349,15,1553601600,16,0,16,Clouds
43350,16,1553601600,10,10,20,Clouds
43351,17,1553601600,19,1,20,Clouds
43352,18,1553601600,27,3,30,Clouds
43353,19,1553601600,15,12,27,Clouds
43354,21,1553601600,16,14,30,Clouds
43355,22,1553601600,10,10,20,Clouds
43356,23,1553601600,14,16,30,Clouds
43357,24,1553601600,20,0,20,Clouds
43358,25,1553601600,2,28,30,Clouds
43359,26,1553601600,2,18,20,Clouds
43360,27,1553601600,3,17,20,Clouds
43361,28,1553601600,30,0,30,Clouds
43362,29,1553601600,28,1,29,Clouds
43363,30,1553601600,20,0,20,Clouds
43364,31,1553601600,17,3,20,Clouds
43365,32,1553601600,15,15,30,Clouds
43366,33,1553601600,17,6,23,Clouds
43367,34,1553601600,26,4,30,Clouds
43368,35,1553601600,29,1,30,Clouds
43369,36,1553601600,0,40,40,Clouds
43370,37,1553601600,30,0,30,Clouds
43371,38,1553601600,38,2,40,Clouds
43372,39,1553601600,10,9,19,Clouds
43373,40,1553601600,9,11,20,Clouds
43374,41,1553601600,6,14,20,Clouds
43375,42,1553601600,30,0,30,Clouds
43376,43,1553601600,27,3,30,Clouds
43377,44,1553601600,30,0,30,Clouds
43378,45,1553601600,29,1,30,Clouds
43379,46,1553601600,16,4,20,Clouds
43380,47,1553601600,4,36,40,Clouds
43381,48,1553601600,9,31,40,Clouds
43382,49,1553601600,9,31,40,Clouds
43383,50,1553601600,40,0,40,Clouds
43384,51,1553601600,32,8,40,Clouds
43385,52,1553601600,6,24,30,Clouds
43386,53,1553601600,25,14,39,Clouds
43387,54,1553601600,10,23,33,Clouds
43388,55,1553601600,8,28,36,Clouds
43389,56,1553601600,5,35,40,Clouds
43390,57,1553601600,0,22,22,Clouds
43391,58,1553601600,10,29,39,Clouds
43392,59,1553601600,20,0,20,Clouds
43393,60,1553601600,28,2,30,Clouds
43394,61,1553601600,25,0,25,Clouds
43395,62,1553601600,1,39,40,Clouds
43396,63,1553601600,1,34,35,Clouds
43397,64,1553601600,1,39,40,Clouds
43398,65,1553601600,2,38,40,Clouds
43399,66,1553601600,9,31,40,Clouds
43400,67,1553601600,5,35,40,Clouds
43401,68,1553601600,8,31,39,Clouds
43402,69,1553601600,1,37,38,Clouds
43403,70,1553601600,20,8,28,Clouds
43404,71,1553601600,30,10,40,Clouds
43405,72,1553601600,29,2,31,Clouds
43406,73,1553601600,29,1,30,Clouds
43407,74,1553601600,30,0,30,Clouds
43408,75,1553601600,40,0,40,Clouds
43409,76,1553601600,37,1,38,Clouds
43410,77,1553601600,24,5,29,Clouds
43411,78,1553601600,40,0,40,Clouds
43412,79,1553601600,27,0,27,Clouds
43413,80,1553601600,40,0,40,Clouds
43414,81,1553601600,40,0,40,Clouds
43415,82,1553601600,22,0,22,Clouds
43416,83,1553601600,40,0,40,Clouds
43417,84,1553601600,30,0,30,Clouds
43418,85,1553601600,35,0,35,Clouds
43419,86,1553601600,38,0,38,Clouds
43420,87,1553601600,37,1,38,Clouds
43421,88,1553601600,29,0,29,Clouds
43422,89,1553601600,0,39,39,Clouds
43423,90,1553601600,4,33,37,Clouds
43424,91,1553601600,23,6,29,Clouds
43425,92,1553601600,40,0,40,Clouds
43426,93,1553601600,40,0,40,Clouds
43427,94,1553601600,40,0,40,Clouds
43428,95,1553601600,40,0,40,Clouds
43429,96,1553601600,30,0,30,Clouds
43430,97,1553601600,39,0,39,Clouds
43431,98,1553601600,28,12,40,Clouds
43432,99,1553601600,1,29,30,Clouds
43433,100,1553601600,24,0,24,Clouds
43434,101,1553601600,29,1,30,Clouds
43435,102,1553601600,22,18,40,Clouds
43436,103,1553601600,26,14,40,Clouds
43437,104,1553601600,36,4,40,Clouds
43438,105,1553601600,36,0,36,Clouds
43439,106,1553601600,31,9,40,Clouds
43440,107,1553601600,31,9,40,Clouds
43441,108,1553601600,39,1,40,Clouds
43442,109,1553601600,28,1,29,Clouds
43443,110,1553601600,40,0,40,Clouds
43444,111,1553601600,40,0,40,Clouds
43445,112,1553601600,30,0,30,Clouds
43446,113,1553601600,4,36,40,Clouds
43447,114,1553601600,7,33,40,Clouds
43448,115,1553601600,29,1,30,Clouds
43449,2,1553605200,20,0,20,Clouds
43450,3,1553605200,20,0,20,Clouds
43451,4,1553605200,19,1,20,Clouds
43452,5,1553605200,32,8,40,Clouds
43453,6,1553605200,20,0,20,Clouds
43454,7,1553605200,29,0,29,Clouds
43455,8,1553605200,4,26,30,Clouds
43456,9,1553605200,1,23,24,Clouds
43457,10,1553605200,16,0,16,Clouds
43458,11,1553605200,15,15,30,Clouds
43459,12,1553605200,17,3,20,Clouds
43460,13,1553605200,5,25,30,Clouds
43461,14,1553605200,15,14,29,Clouds
43462,15,1553605200,15,1,16,Clouds
43463,16,1553605200,9,11,20,Clouds
43464,17,1553605200,19,1,20,Clouds
43465,18,1553605200,28,2,30,Clouds
43466,19,1553605200,18,12,30,Clouds
43467,21,1553605200,13,17,30,Clouds
43468,22,1553605200,9,11,20,Clouds
43469,23,1553605200,15,15,30,Clouds
43470,24,1553605200,20,0,20,Clouds
43471,25,1553605200,0,30,30,Clouds
43472,26,1553605200,0,20,20,Clouds
43473,27,1553605200,5,15,20,Clouds
43474,28,1553605200,22,8,30,Clouds
43475,29,1553605200,29,0,29,Clouds
43476,30,1553605200,19,1,20,Clouds
43477,31,1553605200,15,5,20,Clouds
43478,32,1553605200,7,23,30,Clouds
43479,33,1553605200,19,4,23,Clouds
43480,34,1553605200,28,2,30,Clouds
43481,35,1553605200,28,2,30,Clouds
43482,36,1553605200,4,36,40,Clouds
43483,37,1553605200,30,0,30,Clouds
43484,38,1553605200,37,3,40,Clouds
43485,39,1553605200,9,10,19,Clouds
43486,40,1553605200,9,11,20,Clouds
43487,41,1553605200,2,18,20,Clouds
43488,42,1553605200,30,0,30,Clouds
43489,43,1553605200,30,0,30,Clouds
43490,44,1553605200,30,0,30,Clouds
43491,45,1553605200,30,0,30,Clouds
43492,46,1553605200,16,4,20,Clouds
43493,47,1553605200,2,38,40,Clouds
43494,48,1553605200,8,32,40,Clouds
43495,49,1553605200,8,32,40,Clouds
43496,50,1553605200,39,1,40,Clouds
43497,51,1553605200,34,6,40,Clouds
43498,52,1553605200,8,22,30,Clouds
43499,53,1553605200,28,11,39,Clouds
43500,54,1553605200,14,19,33,Clouds
43501,55,1553605200,11,25,36,Clouds
43502,56,1553605200,9,31,40,Clouds
43503,57,1553605200,2,21,23,Clouds
43504,58,1553605200,9,31,40,Clouds
43505,59,1553605200,20,0,20,Clouds
43506,60,1553605200,27,3,30,Clouds
43507,61,1553605200,25,0,25,Clouds
43508,62,1553605200,1,39,40,Clouds
43509,63,1553605200,0,35,35,Clouds
43510,64,1553605200,0,40,40,Clouds
43511,65,1553605200,0,40,40,Clouds
43512,66,1553605200,12,28,40,Clouds
43513,67,1553605200,7,33,40,Clouds
43514,68,1553605200,9,31,40,Clouds
43515,69,1553605200,0,40,40,Clouds
43516,70,1553605200,21,7,28,Clouds
43517,71,1553605200,38,2,40,Clouds
43518,72,1553605200,31,0,31,Clouds
43519,73,1553605200,30,0,30,Clouds
43520,74,1553605200,30,0,30,Clouds
43521,75,1553605200,40,0,40,Clouds
43522,76,1553605200,37,1,38,Clouds
43523,77,1553605200,27,2,29,Clouds
43524,78,1553605200,39,1,40,Clouds
43525,79,1553605200,27,0,27,Clouds
43526,80,1553605200,39,1,40,Clouds
43527,81,1553605200,39,1,40,Clouds
43528,82,1553605200,22,0,22,Clouds
43529,83,1553605200,40,0,40,Clouds
43530,84,1553605200,30,0,30,Clouds
43531,85,1553605200,34,1,35,Clouds
43532,86,1553605200,37,1,38,Clouds
43533,87,1553605200,38,0,38,Clouds
43534,88,1553605200,28,1,29,Clouds
43535,89,1553605200,3,37,40,Clouds
43536,90,1553605200,8,32,40,Clouds
43537,91,1553605200,21,9,30,Clouds
43538,92,1553605200,40,0,40,Clouds
43539,93,1553605200,40,0,40,Clouds
43540,94,1553605200,40,0,40,Clouds
43541,95,1553605200,39,1,40,Clouds
43542,96,1553605200,30,0,30,Clouds
43543,97,1553605200,38,1,39,Clouds
43544,98,1553605200,29,11,40,Clouds
43545,99,1553605200,0,30,30,Clouds
43546,100,1553605200,24,0,24,Clouds
43547,101,1553605200,30,0,30,Clouds
43548,102,1553605200,28,12,40,Clouds
43549,103,1553605200,26,14,40,Clouds
43550,104,1553605200,36,4,40,Clouds
43551,105,1553605200,36,0,36,Clouds
43552,106,1553605200,31,9,40,Clouds
43553,107,1553605200,33,7,40,Clouds
43554,108,1553605200,40,0,40,Clouds
43555,109,1553605200,29,0,29,Clouds
43556,110,1553605200,40,0,40,Clouds
43557,111,1553605200,37,3,40,Clouds
43558,112,1553605200,30,0,30,Clouds
43559,113,1553605200,9,31,40,Clouds
43560,114,1553605200,6,34,40,Clouds
43561,115,1553605200,29,1,30,Clouds
43562,2,1553608800,18,2,20,Clouds
43563,3,1553608800,20,0,20,Clouds
43564,4,1553608800,20,0,20,Clouds
43565,5,1553608800,40,0,40,Clouds
43566,6,1553608800,18,2,20,Clouds
43567,7,1553608800,29,0,29,Clouds
43568,8,1553608800,10,20,30,Clouds
43569,9,1553608800,0,24,24,Clouds
43570,10,1553608800,12,4,16,Clouds
43571,11,1553608800,24,6,30,Clouds
43572,12,1553608800,20,0,20,Clouds
43573,13,1553608800,6,24,30,Clouds
43574,14,1553608800,8,21,29,Clouds
43575,15,1553608800,15,1,16,Clouds
43576,16,1553608800,13,7,20,Clouds
43577,17,1553608800,18,2,20,Clouds
43578,18,1553608800,30,0,30,Clouds
43579,19,1553608800,19,11,30,Clouds
43580,21,1553608800,11,19,30,Clouds
43581,22,1553608800,15,5,20,Clouds
43582,23,1553608800,21,9,30,Clouds
43583,24,1553608800,19,1,20,Clouds
43584,25,1553608800,2,28,30,Clouds
43585,26,1553608800,1,19,20,Clouds
43586,27,1553608800,4,16,20,Clouds
43587,28,1553608800,30,0,30,Clouds
43588,29,1553608800,29,0,29,Clouds
43589,30,1553608800,20,0,20,Clouds
43590,31,1553608800,18,2,20,Clouds
43591,32,1553608800,26,4,30,Clouds
43592,33,1553608800,14,9,23,Clouds
43593,34,1553608800,30,0,30,Clouds
43594,35,1553608800,30,0,30,Clouds
43595,36,1553608800,1,39,40,Clouds
43596,37,1553608800,29,1,30,Clouds
43597,38,1553608800,39,1,40,Clouds
43598,39,1553608800,9,11,20,Clouds
43599,40,1553608800,10,10,20,Clouds
43600,41,1553608800,8,12,20,Clouds
43601,42,1553608800,28,2,30,Clouds
43602,43,1553608800,30,0,30,Clouds
43603,44,1553608800,30,0,30,Clouds
43604,45,1553608800,30,0,30,Clouds
43605,46,1553608800,9,11,20,Clouds
43606,47,1553608800,4,36,40,Clouds
43607,48,1553608800,5,35,40,Clouds
43608,49,1553608800,7,33,40,Clouds
43609,50,1553608800,39,1,40,Clouds
43610,51,1553608800,36,4,40,Clouds
43611,52,1553608800,5,25,30,Clouds
43612,53,1553608800,29,10,39,Clouds
43613,54,1553608800,18,15,33,Clouds
43614,55,1553608800,22,14,36,Clouds
43615,56,1553608800,21,19,40,Clouds
43616,57,1553608800,5,18,23,Clouds
43617,58,1553608800,23,17,40,Clouds
43618,59,1553608800,20,0,20,Clouds
43619,60,1553608800,30,0,30,Clouds
43620,61,1553608800,25,0,25,Clouds
43621,62,1553608800,8,32,40,Clouds
43622,63,1553608800,9,26,35,Clouds
43623,64,1553608800,14,26,40,Clouds
43624,65,1553608800,5,35,40,Clouds
43625,66,1553608800,18,22,40,Clouds
43626,67,1553608800,10,30,40,Clouds
43627,68,1553608800,3,37,40,Clouds
43628,69,1553608800,2,38,40,Clouds
43629,70,1553608800,14,14,28,Clouds
43630,71,1553608800,40,0,40,Clouds
43631,72,1553608800,29,2,31,Clouds
43632,73,1553608800,29,1,30,Clouds
43633,74,1553608800,29,1,30,Clouds
43634,75,1553608800,40,0,40,Clouds
43635,76,1553608800,37,1,38,Clouds
43636,77,1553608800,15,14,29,Clouds
43637,78,1553608800,39,1,40,Clouds
43638,79,1553608800,26,1,27,Clouds
43639,80,1553608800,40,0,40,Clouds
43640,81,1553608800,40,0,40,Clouds
43641,82,1553608800,22,0,22,Clouds
43642,83,1553608800,35,5,40,Clouds
43643,84,1553608800,29,1,30,Clouds
43644,85,1553608800,27,8,35,Clouds
43645,86,1553608800,38,0,38,Clouds
43646,87,1553608800,37,1,38,Clouds
43647,88,1553608800,29,0,29,Clouds
43648,89,1553608800,6,34,40,Clouds
43649,90,1553608800,15,25,40,Clouds
43650,91,1553608800,23,7,30,Clouds
43651,92,1553608800,39,1,40,Clouds
43652,93,1553608800,40,0,40,Clouds
43653,94,1553608800,40,0,40,Clouds
43654,95,1553608800,36,4,40,Clouds
43655,96,1553608800,30,0,30,Clouds
43656,97,1553608800,35,4,39,Clouds
43657,98,1553608800,29,11,40,Clouds
43658,99,1553608800,1,29,30,Clouds
43659,100,1553608800,23,1,24,Clouds
43660,101,1553608800,30,0,30,Clouds
43661,102,1553608800,32,8,40,Clouds
43662,103,1553608800,30,10,40,Clouds
43663,104,1553608800,38,2,40,Clouds
43664,105,1553608800,36,0,36,Clouds
43665,106,1553608800,32,8,40,Clouds
43666,107,1553608800,36,4,40,Clouds
43667,108,1553608800,40,0,40,Clouds
43668,109,1553608800,26,3,29,Clouds
43669,110,1553608800,40,0,40,Clouds
43670,111,1553608800,40,0,40,Clouds
43671,112,1553608800,28,2,30,Clouds
43672,113,1553608800,7,33,40,Clouds
43673,114,1553608800,6,34,40,Clouds
43674,115,1553608800,24,6,30,Clouds
43675,2,1553612400,20,0,20,Clouds
43676,3,1553612400,13,7,20,Clouds
43677,4,1553612400,19,1,20,Clouds
43678,5,1553612400,28,12,40,Clouds
43679,6,1553612400,20,0,20,Clouds
43680,7,1553612400,28,1,29,Clouds
43681,8,1553612400,12,18,30,Clouds
43682,9,1553612400,15,9,24,Clouds
43683,10,1553612400,11,5,16,Clouds
43684,11,1553612400,24,6,30,Clouds
43685,12,1553612400,19,1,20,Clouds
43686,13,1553612400,9,21,30,Clouds
43687,14,1553612400,14,15,29,Clouds
43688,15,1553612400,16,0,16,Clouds
43689,16,1553612400,10,10,20,Clouds
43690,17,1553612400,20,0,20,Clouds
43691,18,1553612400,27,3,30,Clouds
43692,19,1553612400,8,22,30,Clouds
43693,21,1553612400,11,19,30,Clouds
43694,22,1553612400,15,5,20,Clouds
43695,23,1553612400,20,10,30,Clouds
43696,24,1553612400,7,13,20,Clouds
43697,25,1553612400,0,30,30,Clouds
43698,26,1553612400,1,19,20,Clouds
43699,27,1553612400,2,18,20,Clouds
43700,28,1553612400,29,1,30,Clouds
43701,29,1553612400,27,2,29,Clouds
43702,30,1553612400,18,2,20,Clouds
43703,31,1553612400,14,6,20,Clouds
43704,32,1553612400,29,1,30,Clouds
43705,33,1553612400,22,1,23,Clouds
43706,34,1553612400,30,0,30,Clouds
43707,35,1553612400,28,2,30,Clouds
43708,36,1553612400,2,38,40,Clouds
43709,37,1553612400,27,3,30,Clouds
43710,38,1553612400,37,3,40,Clouds
43711,39,1553612400,13,7,20,Clouds
43712,40,1553612400,20,0,20,Clouds
43713,41,1553612400,7,13,20,Clouds
43714,42,1553612400,29,1,30,Clouds
43715,43,1553612400,27,3,30,Clouds
43716,44,1553612400,30,0,30,Clouds
43717,45,1553612400,30,0,30,Clouds
43718,46,1553612400,16,4,20,Clouds
43719,47,1553612400,2,38,40,Clouds
43720,48,1553612400,1,39,40,Clouds
43721,49,1553612400,3,37,40,Clouds
43722,50,1553612400,38,2,40,Clouds
43723,51,1553612400,38,2,40,Clouds
43724,52,1553612400,0,30,30,Clouds
43725,53,1553612400,25,14,39,Clouds
43726,54,1553612400,19,14,33,Clouds
43727,55,1553612400,24,12,36,Clouds
43728,56,1553612400,18,22,40,Clouds
43729,57,1553612400,2,21,23,Clouds
43730,58,1553612400,18,22,40,Clouds
43731,59,1553612400,18,2,20,Clouds
43732,60,1553612400,29,1,30,Clouds
43733,61,1553612400,25,0,25,Clouds
43734,62,1553612400,2,38,40,Clouds
43735,63,1553612400,1,34,35,Clouds
43736,64,1553612400,10,30,40,Clouds
43737,65,1553612400,4,36,40,Clouds
43738,66,1553612400,21,19,40,Clouds
43739,67,1553612400,15,25,40,Clouds
43740,68,1553612400,0,40,40,Clouds
43741,69,1553612400,6,34,40,Clouds
43742,70,1553612400,15,13,28,Clouds
43743,71,1553612400,36,4,40,Clouds
43744,72,1553612400,28,3,31,Clouds
43745,73,1553612400,26,4,30,Clouds
43746,74,1553612400,30,0,30,Clouds
43747,75,1553612400,40,0,40,Clouds
43748,76,1553612400,36,2,38,Clouds
43749,77,1553612400,18,11,29,Clouds
43750,78,1553612400,40,0,40,Clouds
43751,79,1553612400,24,3,27,Clouds
43752,80,1553612400,27,13,40,Clouds
43753,81,1553612400,38,2,40,Clouds
43754,82,1553612400,20,2,22,Clouds
43755,83,1553612400,34,6,40,Clouds
43756,84,1553612400,29,1,30,Clouds
43757,85,1553612400,29,6,35,Clouds
43758,86,1553612400,36,2,38,Clouds
43759,87,1553612400,37,1,38,Clouds
43760,88,1553612400,26,3,29,Clouds
43761,89,1553612400,8,32,40,Clouds
43762,90,1553612400,7,33,40,Clouds
43763,91,1553612400,23,7,30,Clouds
43764,92,1553612400,39,1,40,Clouds
43765,93,1553612400,40,0,40,Clouds
43766,94,1553612400,39,1,40,Clouds
43767,95,1553612400,37,3,40,Clouds
43768,96,1553612400,29,1,30,Clouds
43769,97,1553612400,34,5,39,Clouds
43770,98,1553612400,23,17,40,Clouds
43771,99,1553612400,3,27,30,Clouds
43772,100,1553612400,23,1,24,Clouds
43773,101,1553612400,29,1,30,Clouds
43774,102,1553612400,16,24,40,Clouds
43775,103,1553612400,31,9,40,Clouds
43776,104,1553612400,37,3,40,Clouds
43777,105,1553612400,36,0,36,Clouds
43778,106,1553612400,38,2,40,Clouds
43779,107,1553612400,39,1,40,Clouds
43780,108,1553612400,38,2,40,Clouds
43781,109,1553612400,26,3,29,Clouds
43782,110,1553612400,40,0,40,Clouds
43783,111,1553612400,40,0,40,Clouds
43784,112,1553612400,29,1,30,Clouds
43785,113,1553612400,4,36,40,Clouds
43786,114,1553612400,11,29,40,Clouds
43787,115,1553612400,29,1,30,Clouds
43788,2,1553616000,20,0,20,Clouds
43789,3,1553616000,19,1,20,Clouds
43790,4,1553616000,19,1,20,Clouds
43791,5,1553616000,27,13,40,Clouds
43792,6,1553616000,18,2,20,Clouds
43793,7,1553616000,29,0,29,Clouds
43794,8,1553616000,6,24,30,Clouds
43795,9,1553616000,13,11,24,Clouds
43796,10,1553616000,9,7,16,Clouds
43797,11,1553616000,27,3,30,Clouds
43798,12,1553616000,20,0,20,Clouds
43799,13,1553616000,6,24,30,Clouds
43800,14,1553616000,16,13,29,Clouds
43801,15,1553616000,16,0,16,Clouds
43802,16,1553616000,13,7,20,Clouds
43803,17,1553616000,18,2,20,Clouds
43804,18,1553616000,28,2,30,Clouds
43805,19,1553616000,0,30,30,Clouds
43806,21,1553616000,10,20,30,Clouds
43807,22,1553616000,13,7,20,Clouds
43808,23,1553616000,13,17,30,Clouds
43809,24,1553616000,9,11,20,Clouds
43810,25,1553616000,2,28,30,Clouds
43811,26,1553616000,5,15,20,Clouds
43812,27,1553616000,7,13,20,Clouds
43813,28,1553616000,30,0,30,Clouds
43814,29,1553616000,29,0,29,Clouds
43815,30,1553616000,19,1,20,Clouds
43816,31,1553616000,19,1,20,Clouds
43817,32,1553616000,28,2,30,Clouds
43818,33,1553616000,17,6,23,Clouds
43819,34,1553616000,23,7,30,Clouds
43820,35,1553616000,28,2,30,Clouds
43821,36,1553616000,1,39,40,Clouds
43822,37,1553616000,30,0,30,Clouds
43823,38,1553616000,25,15,40,Clouds
43824,39,1553616000,16,4,20,Clouds
43825,40,1553616000,17,4,21,Clouds
43826,41,1553616000,4,16,20,Clouds
43827,42,1553616000,30,0,30,Clouds
43828,43,1553616000,29,1,30,Clouds
43829,44,1553616000,30,0,30,Clouds
43830,45,1553616000,29,1,30,Clouds
43831,46,1553616000,18,2,20,Clouds
43832,47,1553616000,1,39,40,Clouds
43833,48,1553616000,0,40,40,Clouds
43834,49,1553616000,7,33,40,Clouds
43835,50,1553616000,38,2,40,Clouds
43836,51,1553616000,37,3,40,Clouds
43837,52,1553616000,1,29,30,Clouds
43838,53,1553616000,25,14,39,Clouds
43839,54,1553616000,17,16,33,Clouds
43840,55,1553616000,28,8,36,Clouds
43841,56,1553616000,11,29,40,Clouds
43842,57,1553616000,2,21,23,Clouds
43843,58,1553616000,0,40,40,Clouds
43844,59,1553616000,15,5,20,Clouds
43845,60,1553616000,20,10,30,Clouds
43846,61,1553616000,24,1,25,Clouds
43847,62,1553616000,3,37,40,Clouds
43848,63,1553616000,2,33,35,Clouds
43849,64,1553616000,14,26,40,Clouds
43850,65,1553616000,3,37,40,Clouds
43851,66,1553616000,10,30,40,Clouds
43852,67,1553616000,15,25,40,Clouds
43853,68,1553616000,1,39,40,Clouds
43854,69,1553616000,0,40,40,Clouds
43855,70,1553616000,13,15,28,Clouds
43856,71,1553616000,36,4,40,Clouds
43857,72,1553616000,30,1,31,Clouds
43858,73,1553616000,29,1,30,Clouds
43859,74,1553616000,26,4,30,Clouds
43860,75,1553616000,39,1,40,Clouds
43861,76,1553616000,37,1,38,Clouds
43862,77,1553616000,21,8,29,Clouds
43863,78,1553616000,32,8,40,Clouds
43864,79,1553616000,27,0,27,Clouds
43865,80,1553616000,28,12,40,Clouds
43866,81,1553616000,37,3,40,Clouds
43867,82,1553616000,22,0,22,Clouds
43868,83,1553616000,35,5,40,Clouds
43869,84,1553616000,30,0,30,Clouds
43870,85,1553616000,32,3,35,Clouds
43871,86,1553616000,32,6,38,Clouds
43872,87,1553616000,37,1,38,Clouds
43873,88,1553616000,26,4,30,Clouds
43874,89,1553616000,8,32,40,Clouds
43875,90,1553616000,12,28,40,Clouds
43876,91,1553616000,22,8,30,Clouds
43877,92,1553616000,35,5,40,Clouds
43878,93,1553616000,40,0,40,Clouds
43879,94,1553616000,39,1,40,Clouds
43880,95,1553616000,38,2,40,Clouds
43881,96,1553616000,30,0,30,Clouds
43882,97,1553616000,32,8,40,Clouds
43883,98,1553616000,24,16,40,Clouds
43884,99,1553616000,4,26,30,Clouds
43885,100,1553616000,11,14,25,Clouds
43886,101,1553616000,27,3,30,Clouds
43887,102,1553616000,19,21,40,Clouds
43888,103,1553616000,32,8,40,Clouds
43889,104,1553616000,38,2,40,Clouds
43890,105,1553616000,36,0,36,Clouds
43891,106,1553616000,36,4,40,Clouds
43892,107,1553616000,38,2,40,Clouds
43893,108,1553616000,40,0,40,Clouds
43894,109,1553616000,27,2,29,Clouds
43895,110,1553616000,39,0,39,Clouds
43896,111,1553616000,39,1,40,Clouds
43897,112,1553616000,25,5,30,Clouds
43898,113,1553616000,1,39,40,Clouds
43899,114,1553616000,13,27,40,Clouds
43900,115,1553616000,29,1,30,Clouds
43901,2,1553619600,20,0,20,Clouds
43902,3,1553619600,15,5,20,Clouds
43903,4,1553619600,18,2,20,Clouds
43904,5,1553619600,33,7,40,Clouds
43905,6,1553619600,19,1,20,Clouds
43906,7,1553619600,29,0,29,Clouds
43907,8,1553619600,1,29,30,Clouds
43908,9,1553619600,17,7,24,Clouds
43909,10,1553619600,11,5,16,Clouds
43910,11,1553619600,28,2,30,Clouds
43911,12,1553619600,20,0,20,Clouds
43912,13,1553619600,6,24,30,Clouds
43913,14,1553619600,15,14,29,Clouds
43914,15,1553619600,16,0,16,Clouds
43915,16,1553619600,12,8,20,Clouds
43916,17,1553619600,17,3,20,Clouds
43917,18,1553619600,30,0,30,Clouds
43918,19,1553619600,2,28,30,Clouds
43919,21,1553619600,19,11,30,Clouds
43920,22,1553619600,16,4,20,Clouds
43921,23,1553619600,27,3,30,Clouds
43922,24,1553619600,13,7,20,Clouds
43923,25,1553619600,15,15,30,Clouds
43924,26,1553619600,0,20,20,Clouds
43925,27,1553619600,17,3,20,Clouds
43926,28,1553619600,30,0,30,Clouds
43927,29,1553619600,11,18,29,Clouds
43928,30,1553619600,19,1,20,Clouds
43929,31,1553619600,13,7,20,Clouds
43930,32,1553619600,25,5,30,Clouds
43931,33,1553619600,22,1,23,Clouds
43932,34,1553619600,22,8,30,Clouds
43933,35,1553619600,23,7,30,Clouds
43934,36,1553619600,4,36,40,Clouds
43935,37,1553619600,29,1,30,Clouds
43936,38,1553619600,31,9,40,Clouds
43937,39,1553619600,20,0,20,Clouds
43938,40,1553619600,21,0,21,Clouds
43939,41,1553619600,7,13,20,Clouds
43940,42,1553619600,26,4,30,Clouds
43941,43,1553619600,26,4,30,Clouds
43942,44,1553619600,25,5,30,Clouds
43943,45,1553619600,25,5,30,Clouds
43944,46,1553619600,20,0,20,Clouds
43945,47,1553619600,0,40,40,Clouds
43946,48,1553619600,4,36,40,Clouds
43947,49,1553619600,4,36,40,Clouds
43948,50,1553619600,33,7,40,Clouds
43949,51,1553619600,40,0,40,Clouds
43950,52,1553619600,5,27,32,Clouds
43951,53,1553619600,27,13,40,Clouds
43952,54,1553619600,19,14,33,Clouds
43953,55,1553619600,30,6,36,Clouds
43954,56,1553619600,3,37,40,Clouds
43955,57,1553619600,2,21,23,Clouds
43956,58,1553619600,7,33,40,Clouds
43957,59,1553619600,18,2,20,Clouds
43958,60,1553619600,18,12,30,Clouds
43959,61,1553619600,25,0,25,Clouds
43960,62,1553619600,7,33,40,Clouds
43961,63,1553619600,5,30,35,Clouds
43962,64,1553619600,17,23,40,Clouds
43963,65,1553619600,3,37,40,Clouds
43964,66,1553619600,16,24,40,Clouds
43965,67,1553619600,16,24,40,Clouds
43966,68,1553619600,9,31,40,Clouds
43967,69,1553619600,5,35,40,Clouds
43968,70,1553619600,15,13,28,Clouds
43969,71,1553619600,40,0,40,Clouds
43970,72,1553619600,31,0,31,Clouds
43971,73,1553619600,28,2,30,Clouds
43972,74,1553619600,27,3,30,Clouds
43973,75,1553619600,40,0,40,Clouds
43974,76,1553619600,34,4,38,Clouds
43975,77,1553619600,29,0,29,Clouds
43976,78,1553619600,31,9,40,Clouds
43977,79,1553619600,27,0,27,Clouds
43978,80,1553619600,33,7,40,Clouds
43979,81,1553619600,39,1,40,Clouds
43980,82,1553619600,22,0,22,Clouds
43981,83,1553619600,33,7,40,Clouds
43982,84,1553619600,30,0,30,Clouds
43983,85,1553619600,30,5,35,Clouds
43984,86,1553619600,31,7,38,Clouds
43985,87,1553619600,38,0,38,Clouds
43986,88,1553619600,24,6,30,Clouds
43987,89,1553619600,9,31,40,Clouds
43988,90,1553619600,19,21,40,Clouds
43989,91,1553619600,20,10,30,Clouds
43990,92,1553619600,29,11,40,Clouds
43991,93,1553619600,38,2,40,Clouds
43992,94,1553619600,39,1,40,Clouds
43993,95,1553619600,34,6,40,Clouds
43994,96,1553619600,29,1,30,Clouds
43995,97,1553619600,32,8,40,Clouds
43996,98,1553619600,30,10,40,Clouds
43997,99,1553619600,4,26,30,Clouds
43998,100,1553619600,0,25,25,Clouds
43999,101,1553619600,28,2,30,Clouds
44000,102,1553619600,23,17,40,Clouds
44001,103,1553619600,33,7,40,Clouds
44002,104,1553619600,38,2,40,Clouds
44003,105,1553619600,36,0,36,Clouds
44004,106,1553619600,38,2,40,Clouds
44005,107,1553619600,39,1,40,Clouds
44006,108,1553619600,38,2,40,Clouds
44007,109,1553619600,27,2,29,Clouds
44008,110,1553619600,37,2,39,Clouds
44009,111,1553619600,38,2,40,Clouds
44010,112,1553619600,22,8,30,Clouds
44011,113,1553619600,1,39,40,Clouds
44012,114,1553619600,10,30,40,Clouds
44013,115,1553619600,29,1,30,Clouds
44014,2,1553623200,18,2,20,Clouds
44015,3,1553623200,19,1,20,Clouds
44016,4,1553623200,19,1,20,Clouds
44017,5,1553623200,20,20,40,Clouds
44018,6,1553623200,19,1,20,Clouds
44019,7,1553623200,29,0,29,Clouds
44020,8,1553623200,0,30,30,Clouds
44021,9,1553623200,21,3,24,Clouds
44022,10,1553623200,14,2,16,Clouds
44023,11,1553623200,30,0,30,Clouds
44024,12,1553623200,17,3,20,Clouds
44025,13,1553623200,14,15,29,Clouds
44026,14,1553623200,16,13,29,Clouds
44027,15,1553623200,16,0,16,Clouds
44028,16,1553623200,0,20,20,Clouds
44029,17,1553623200,20,0,20,Clouds
44030,18,1553623200,28,2,30,Clouds
44031,19,1553623200,7,23,30,Clouds
44032,21,1553623200,12,18,30,Clouds
44033,22,1553623200,16,4,20,Clouds
44034,23,1553623200,12,18,30,Clouds
44035,24,1553623200,18,2,20,Clouds
44036,25,1553623200,18,12,30,Clouds
44037,26,1553623200,3,17,20,Clouds
44038,27,1553623200,18,2,20,Clouds
44039,28,1553623200,30,0,30,Clouds
44040,29,1553623200,20,9,29,Clouds
44041,30,1553623200,20,0,20,Clouds
44042,31,1553623200,18,2,20,Clouds
44043,32,1553623200,23,7,30,Clouds
44044,33,1553623200,16,6,22,Clouds
44045,34,1553623200,21,9,30,Clouds
44046,35,1553623200,27,3,30,Clouds
44047,36,1553623200,26,14,40,Clouds
44048,37,1553623200,30,0,30,Clouds
44049,38,1553623200,26,14,40,Clouds
44050,39,1553623200,17,3,20,Clouds
44051,40,1553623200,20,1,21,Clouds
44052,41,1553623200,8,12,20,Clouds
44053,42,1553623200,14,16,30,Clouds
44054,43,1553623200,11,19,30,Clouds
44055,44,1553623200,23,7,30,Clouds
44056,45,1553623200,23,7,30,Clouds
44057,46,1553623200,18,2,20,Clouds
44058,47,1553623200,5,35,40,Clouds
44059,48,1553623200,1,39,40,Clouds
44060,49,1553623200,3,37,40,Clouds
44061,50,1553623200,33,7,40,Clouds
44062,51,1553623200,40,0,40,Clouds
44063,52,1553623200,16,16,32,Clouds
44064,53,1553623200,40,0,40,Clouds
44065,54,1553623200,26,7,33,Clouds
44066,55,1553623200,36,0,36,Clouds
44067,56,1553623200,23,17,40,Clouds
44068,57,1553623200,12,11,23,Clouds
44069,58,1553623200,15,25,40,Clouds
44070,59,1553623200,20,0,20,Clouds
44071,60,1553623200,9,20,29,Clouds
44072,61,1553623200,25,0,25,Clouds
44073,62,1553623200,20,20,40,Clouds
44074,63,1553623200,17,18,35,Clouds
44075,64,1553623200,24,16,40,Clouds
44076,65,1553623200,4,36,40,Clouds
44077,66,1553623200,40,0,40,Clouds
44078,67,1553623200,11,29,40,Clouds
44079,68,1553623200,21,19,40,Clouds
44080,69,1553623200,12,28,40,Clouds
44081,70,1553623200,10,18,28,Clouds
44082,71,1553623200,40,0,40,Clouds
44083,72,1553623200,19,12,31,Clouds
44084,73,1553623200,28,2,30,Clouds
44085,74,1553623200,15,15,30,Clouds
44086,75,1553623200,39,1,40,Clouds
44087,76,1553623200,34,4,38,Clouds
44088,77,1553623200,29,0,29,Clouds
44089,78,1553623200,32,8,40,Clouds
44090,79,1553623200,27,0,27,Clouds
44091,80,1553623200,37,3,40,Clouds
44092,81,1553623200,40,0,40,Clouds
44093,82,1553623200,22,0,22,Clouds
44094,83,1553623200,34,6,40,Clouds
44095,84,1553623200,25,5,30,Clouds
44096,85,1553623200,28,7,35,Clouds
44097,86,1553623200,28,10,38,Clouds
44098,87,1553623200,35,3,38,Clouds
44099,88,1553623200,23,7,30,Clouds
44100,89,1553623200,19,21,40,Clouds
44101,90,1553623200,40,0,40,Clouds
44102,91,1553623200,18,12,30,Clouds
44103,92,1553623200,19,21,40,Clouds
44104,93,1553623200,22,18,40,Clouds
44105,94,1553623200,38,2,40,Clouds
44106,95,1553623200,28,12,40,Clouds
44107,96,1553623200,26,4,30,Clouds
44108,97,1553623200,31,9,40,Clouds
44109,98,1553623200,34,6,40,Clouds
44110,99,1553623200,2,28,30,Clouds
44111,100,1553623200,0,25,25,Clouds
44112,101,1553623200,30,0,30,Clouds
44113,102,1553623200,26,14,40,Clouds
44114,103,1553623200,36,4,40,Clouds
44115,104,1553623200,40,0,40,Clouds
44116,105,1553623200,36,0,36,Clouds
44117,106,1553623200,40,0,40,Clouds
44118,107,1553623200,40,0,40,Clouds
44119,108,1553623200,40,0,40,Clouds
44120,109,1553623200,26,3,29,Clouds
44121,110,1553623200,40,0,40,Clouds
44122,111,1553623200,39,1,40,Clouds
44123,112,1553623200,22,8,30,Clouds
44124,113,1553623200,11,29,40,Clouds
44125,114,1553623200,27,13,40,Clouds
44126,115,1553623200,22,8,30,Clouds
44127,2,1553626800,20,0,20,Clouds
44128,3,1553626800,17,3,20,Clouds
44129,4,1553626800,19,1,20,Clouds
44130,5,1553626800,36,4,40,Clouds
44131,6,1553626800,19,1,20,Clouds
44132,7,1553626800,27,2,29,Clouds
44133,8,1553626800,18,12,30,Clouds
44134,9,1553626800,19,5,24,Clouds
44135,10,1553626800,14,2,16,Clouds
44136,11,1553626800,30,0,30,Clouds
44137,12,1553626800,15,5,20,Clouds
44138,13,1553626800,29,0,29,Clouds
44139,14,1553626800,15,15,30,Clouds
44140,15,1553626800,16,0,16,Clouds
44141,16,1553626800,2,18,20,Clouds
44142,17,1553626800,19,1,20,Clouds
44143,18,1553626800,26,4,30,Clouds
44144,19,1553626800,21,9,30,Clouds
44145,21,1553626800,12,18,30,Clouds
44146,22,1553626800,0,20,20,Clouds
44147,23,1553626800,0,30,30,Clouds
44148,24,1553626800,19,1,20,Clouds
44149,25,1553626800,26,4,30,Clouds
44150,26,1553626800,12,8,20,Clouds
44151,27,1553626800,19,1,20,Clouds
44152,28,1553626800,29,1,30,Clouds
44153,29,1553626800,27,2,29,Clouds
44154,30,1553626800,19,1,20,Clouds
44155,31,1553626800,13,7,20,Clouds
44156,32,1553626800,5,25,30,Clouds
44157,33,1553626800,17,5,22,Clouds
44158,34,1553626800,5,25,30,Clouds
44159,35,1553626800,30,0,30,Clouds
44160,36,1553626800,39,1,40,Clouds
44161,37,1553626800,30,0,30,Clouds
44162,38,1553626800,28,12,40,Clouds
44163,39,1553626800,17,3,20,Clouds
44164,40,1553626800,16,5,21,Clouds
44165,41,1553626800,19,1,20,Clouds
44166,42,1553626800,11,19,30,Clouds
44167,43,1553626800,3,27,30,Clouds
44168,44,1553626800,23,7,30,Clouds
44169,45,1553626800,21,9,30,Clouds
44170,46,1553626800,18,2,20,Clouds
44171,47,1553626800,34,6,40,Clouds
44172,48,1553626800,4,36,40,Clouds
44173,49,1553626800,23,17,40,Clouds
44174,50,1553626800,33,7,40,Clouds
44175,51,1553626800,36,4,40,Clouds
44176,52,1553626800,30,2,32,Clouds
44177,53,1553626800,40,0,40,Clouds
44178,54,1553626800,32,1,33,Clouds
44179,55,1553626800,35,1,36,Clouds
44180,56,1553626800,10,30,40,Clouds
44181,57,1553626800,21,2,23,Clouds
44182,58,1553626800,25,15,40,Clouds
44183,59,1553626800,18,2,20,Clouds
44184,60,1553626800,2,28,30,Clouds
44185,61,1553626800,25,0,25,Clouds
44186,62,1553626800,40,0,40,Clouds
44187,63,1553626800,22,13,35,Clouds
44188,64,1553626800,23,17,40,Clouds
44189,65,1553626800,40,0,40,Clouds
44190,66,1553626800,38,2,40,Clouds
44191,67,1553626800,29,11,40,Clouds
44192,68,1553626800,39,1,40,Clouds
44193,69,1553626800,40,0,40,Clouds
44194,70,1553626800,10,18,28,Clouds
44195,71,1553626800,38,2,40,Clouds
44196,72,1553626800,16,15,31,Clouds
44197,73,1553626800,28,2,30,Clouds
44198,74,1553626800,19,11,30,Clouds
44199,75,1553626800,33,7,40,Clouds
44200,76,1553626800,29,9,38,Clouds
44201,77,1553626800,28,1,29,Clouds
44202,78,1553626800,27,13,40,Clouds
44203,79,1553626800,26,1,27,Clouds
44204,80,1553626800,17,23,40,Clouds
44205,81,1553626800,40,0,40,Clouds
44206,82,1553626800,16,6,22,Clouds
44207,83,1553626800,23,17,40,Clouds
44208,84,1553626800,23,7,30,Clouds
44209,85,1553626800,28,7,35,Clouds
44210,86,1553626800,9,29,38,Clouds
44211,87,1553626800,30,8,38,Clouds
44212,88,1553626800,26,4,30,Clouds
44213,89,1553626800,36,4,40,Clouds
44214,90,1553626800,40,0,40,Clouds
44215,91,1553626800,14,16,30,Clouds
44216,92,1553626800,2,38,40,Clouds
44217,93,1553626800,0,40,40,Clouds
44218,94,1553626800,16,24,40,Clouds
44219,95,1553626800,18,22,40,Clouds
44220,96,1553626800,23,7,30,Clouds
44221,97,1553626800,28,12,40,Clouds
44222,98,1553626800,40,0,40,Clouds
44223,99,1553626800,3,27,30,Clouds
44224,100,1553626800,3,22,25,Clouds
44225,101,1553626800,28,2,30,Clouds
44226,102,1553626800,26,14,40,Clouds
44227,103,1553626800,40,0,40,Clouds
44228,104,1553626800,40,0,40,Clouds
44229,105,1553626800,36,0,36,Clouds
44230,106,1553626800,39,1,40,Clouds
44231,107,1553626800,38,2,40,Clouds
44232,108,1553626800,30,10,40,Clouds
44233,109,1553626800,24,5,29,Clouds
44234,110,1553626800,37,3,40,Clouds
44235,111,1553626800,35,5,40,Clouds
44236,112,1553626800,15,15,30,Clouds
44237,113,1553626800,24,16,40,Clouds
44238,114,1553626800,40,0,40,Clouds
44239,115,1553626800,18,12,30,Clouds
44240,2,1553630400,18,2,20,Clouds
44241,3,1553630400,17,3,20,Clouds
44242,4,1553630400,18,2,20,Clouds
44243,5,1553630400,37,3,40,Clouds
44244,6,1553630400,19,1,20,Clouds
44245,7,1553630400,10,19,29,Clouds
44246,8,1553630400,24,6,30,Clouds
44247,9,1553630400,24,0,24,Clouds
44248,10,1553630400,10,6,16,Clouds
44249,11,1553630400,29,1,30,Clouds
44250,12,1553630400,13,7,20,Clouds
44251,13,1553630400,28,1,29,Clouds
44252,14,1553630400,24,6,30,Clouds
44253,15,1553630400,13,3,16,Clouds
44254,16,1553630400,2,18,20,Clouds
44255,17,1553630400,18,2,20,Clouds
44256,18,1553630400,17,13,30,Clouds
44257,19,1553630400,2,27,29,Clouds
44258,21,1553630400,28,2,30,Clouds
44259,22,1553630400,0,20,20,Clouds
44260,23,1553630400,4,26,30,Clouds
44261,24,1553630400,15,5,20,Clouds
44262,25,1553630400,30,0,30,Clouds
44263,26,1553630400,12,8,20,Clouds
44264,27,1553630400,20,0,20,Clouds
44265,28,1553630400,29,1,30,Clouds
44266,29,1553630400,27,2,29,Clouds
44267,30,1553630400,18,2,20,Clouds
44268,31,1553630400,17,3,20,Clouds
44269,32,1553630400,2,28,30,Clouds
44270,33,1553630400,15,7,22,Clouds
44271,34,1553630400,12,18,30,Clouds
44272,35,1553630400,26,4,30,Clouds
44273,36,1553630400,39,1,40,Clouds
44274,37,1553630400,30,0,30,Clouds
44275,38,1553630400,29,11,40,Clouds
44276,39,1553630400,15,5,20,Clouds
44277,40,1553630400,19,2,21,Clouds
44278,41,1553630400,19,1,20,Clouds
44279,42,1553630400,2,28,30,Clouds
44280,43,1553630400,7,23,30,Clouds
44281,44,1553630400,15,15,30,Clouds
44282,45,1553630400,26,4,30,Clouds
44283,46,1553630400,20,0,20,Clouds
44284,47,1553630400,39,1,40,Clouds
44285,48,1553630400,13,27,40,Clouds
44286,49,1553630400,38,2,40,Clouds
44287,50,1553630400,30,10,40,Clouds
44288,51,1553630400,37,3,40,Clouds
44289,52,1553630400,30,2,32,Clouds
44290,53,1553630400,40,0,40,Clouds
44291,54,1553630400,32,1,33,Clouds
44292,55,1553630400,36,0,36,Clouds
44293,56,1553630400,0,40,40,Clouds
44294,57,1553630400,21,2,23,Clouds
44295,58,1553630400,0,40,40,Clouds
44296,59,1553630400,15,5,20,Clouds
44297,60,1553630400,1,29,30,Clouds
44298,61,1553630400,24,1,25,Clouds
44299,62,1553630400,40,0,40,Clouds
44300,63,1553630400,30,5,35,Clouds
44301,64,1553630400,23,17,40,Clouds
44302,65,1553630400,40,0,40,Clouds
44303,66,1553630400,37,3,40,Clouds
44304,67,1553630400,36,4,40,Clouds
44305,68,1553630400,37,3,40,Clouds
44306,69,1553630400,33,7,40,Clouds
44307,70,1553630400,10,18,28,Clouds
44308,71,1553630400,36,4,40,Clouds
44309,72,1553630400,5,26,31,Clouds
44310,73,1553630400,18,12,30,Clouds
44311,74,1553630400,14,16,30,Clouds
44312,75,1553630400,27,13,40,Clouds
44313,76,1553630400,29,9,38,Clouds
44314,77,1553630400,29,0,29,Clouds
44315,78,1553630400,21,19,40,Clouds
44316,79,1553630400,24,3,27,Clouds
44317,80,1553630400,18,22,40,Clouds
44318,81,1553630400,38,2,40,Clouds
44319,82,1553630400,13,9,22,Clouds
44320,83,1553630400,12,28,40,Clouds
44321,84,1553630400,12,18,30,Clouds
44322,85,1553630400,19,16,35,Clouds
44323,86,1553630400,0,38,38,Clouds
44324,87,1553630400,20,18,38,Clouds
44325,88,1553630400,16,14,30,Clouds
44326,89,1553630400,39,1,40,Clouds
44327,90,1553630400,40,0,40,Clouds
44328,91,1553630400,0,30,30,Clouds
44329,92,1553630400,1,39,40,Clouds
44330,93,1553630400,0,40,40,Clouds
44331,94,1553630400,4,36,40,Clouds
44332,95,1553630400,14,26,40,Clouds
44333,96,1553630400,26,4,30,Clouds
44334,97,1553630400,12,28,40,Clouds
44335,98,1553630400,40,0,40,Clouds
44336,99,1553630400,22,8,30,Clouds
44337,100,1553630400,8,17,25,Clouds
44338,101,1553630400,23,7,30,Clouds
44339,102,1553630400,24,16,40,Clouds
44340,103,1553630400,37,3,40,Clouds
44341,104,1553630400,40,0,40,Clouds
44342,105,1553630400,35,1,36,Clouds
44343,106,1553630400,35,5,40,Clouds
44344,107,1553630400,33,7,40,Clouds
44345,108,1553630400,32,8,40,Clouds
44346,109,1553630400,24,5,29,Clouds
44347,110,1553630400,33,7,40,Clouds
44348,111,1553630400,31,9,40,Clouds
44349,112,1553630400,4,26,30,Clouds
44350,113,1553630400,40,0,40,Clouds
44351,114,1553630400,40,0,40,Clouds
44352,115,1553630400,2,28,30,Clouds
44353,2,1553634000,16,4,20,Clouds
44354,3,1553634000,14,6,20,Clouds
44355,4,1553634000,16,4,20,Clouds
44356,5,1553634000,27,13,40,Clouds
44357,6,1553634000,17,3,20,Clouds
44358,7,1553634000,8,21,29,Clouds
44359,8,1553634000,30,0,30,Clouds
44360,9,1553634000,24,0,24,Clouds
44361,10,1553634000,0,16,16,Clouds
44362,11,1553634000,30,0,30,Clouds
44363,12,1553634000,10,10,20,Clouds
44364,13,1553634000,28,1,29,Clouds
44365,14,1553634000,27,3,30,Clouds
44366,15,1553634000,16,0,16,Clouds
44367,16,1553634000,8,12,20,Clouds
44368,17,1553634000,16,4,20,Clouds
44369,18,1553634000,20,10,30,Clouds
44370,19,1553634000,14,16,30,Clouds
44371,21,1553634000,28,2,30,Clouds
44372,22,1553634000,7,13,20,Clouds
44373,23,1553634000,14,16,30,Clouds
44374,24,1553634000,20,0,20,Clouds
44375,25,1553634000,30,0,30,Clouds
44376,26,1553634000,18,2,20,Clouds
44377,27,1553634000,17,3,20,Clouds
44378,28,1553634000,25,5,30,Clouds
44379,29,1553634000,28,1,29,Clouds
44380,30,1553634000,20,0,20,Clouds
44381,31,1553634000,20,0,20,Clouds
44382,32,1553634000,5,25,30,Clouds
44383,33,1553634000,18,4,22,Clouds
44384,34,1553634000,5,25,30,Clouds
44385,35,1553634000,19,11,30,Clouds
44386,36,1553634000,30,10,40,Clouds
44387,37,1553634000,29,1,30,Clouds
44388,38,1553634000,27,13,40,Clouds
44389,39,1553634000,17,3,20,Clouds
44390,40,1553634000,21,0,21,Clouds
44391,41,1553634000,20,0,20,Clouds
44392,42,1553634000,1,29,30,Clouds
44393,43,1553634000,16,14,30,Clouds
44394,44,1553634000,4,26,30,Clouds
44395,45,1553634000,28,2,30,Clouds
44396,46,1553634000,19,1,20,Clouds
44397,47,1553634000,37,3,40,Clouds
44398,48,1553634000,30,10,40,Clouds
44399,49,1553634000,38,2,40,Clouds
44400,50,1553634000,25,15,40,Clouds
44401,51,1553634000,40,0,40,Clouds
44402,52,1553634000,30,2,32,Clouds
44403,53,1553634000,35,5,40,Clouds
44404,54,1553634000,32,1,33,Clouds
44405,55,1553634000,36,0,36,Clouds
44406,56,1553634000,0,40,40,Clouds
44407,57,1553634000,17,6,23,Clouds
44408,58,1553634000,4,36,40,Clouds
44409,59,1553634000,12,8,20,Clouds
44410,60,1553634000,0,30,30,Clouds
44411,61,1553634000,24,1,25,Clouds
44412,62,1553634000,37,3,40,Clouds
44413,63,1553634000,35,0,35,Clouds
44414,64,1553634000,23,17,40,Clouds
44415,65,1553634000,40,0,40,Clouds
44416,66,1553634000,39,1,40,Clouds
44417,67,1553634000,33,7,40,Clouds
44418,68,1553634000,36,4,40,Clouds
44419,69,1553634000,36,4,40,Clouds
44420,70,1553634000,7,21,28,Clouds
44421,71,1553634000,40,0,40,Clouds
44422,72,1553634000,0,31,31,Clouds
44423,73,1553634000,18,12,30,Clouds
44424,74,1553634000,13,17,30,Clouds
44425,75,1553634000,28,12,40,Clouds
44426,76,1553634000,28,10,38,Clouds
44427,77,1553634000,28,1,29,Clouds
44428,78,1553634000,19,21,40,Clouds
44429,79,1553634000,23,4,27,Clouds
44430,80,1553634000,19,21,40,Clouds
44431,81,1553634000,37,3,40,Clouds
44432,82,1553634000,12,10,22,Clouds
44433,83,1553634000,9,31,40,Clouds
44434,84,1553634000,19,11,30,Clouds
44435,85,1553634000,26,9,35,Clouds
44436,86,1553634000,3,35,38,Clouds
44437,87,1553634000,19,19,38,Clouds
44438,88,1553634000,16,14,30,Clouds
44439,89,1553634000,40,0,40,Clouds
44440,90,1553634000,40,0,40,Clouds
44441,91,1553634000,0,30,30,Clouds
44442,92,1553634000,8,32,40,Clouds
44443,93,1553634000,9,31,40,Clouds
44444,94,1553634000,4,36,40,Clouds
44445,95,1553634000,14,26,40,Clouds
44446,96,1553634000,22,8,30,Clouds
44447,97,1553634000,7,33,40,Clouds
44448,98,1553634000,40,0,40,Clouds
44449,99,1553634000,27,3,30,Clouds
44450,100,1553634000,0,25,25,Clouds
44451,101,1553634000,11,19,30,Clouds
44452,102,1553634000,20,20,40,Clouds
44453,103,1553634000,37,3,40,Clouds
44454,104,1553634000,40,0,40,Clouds
44455,105,1553634000,34,2,36,Clouds
44456,106,1553634000,16,24,40,Clouds
44457,107,1553634000,30,10,40,Clouds
44458,108,1553634000,27,13,40,Clouds
44459,109,1553634000,24,5,29,Clouds
44460,110,1553634000,33,7,40,Clouds
44461,111,1553634000,25,15,40,Clouds
44462,112,1553634000,0,30,30,Clouds
44463,113,1553634000,40,0,40,Clouds
44464,114,1553634000,40,0,40,Clouds
44465,115,1553634000,0,30,30,Clouds
44466,2,1553637600,14,6,20,Clouds
44467,3,1553637600,18,2,20,Clouds
44468,4,1553637600,17,3,20,Clouds
44469,5,1553637600,29,11,40,Clouds
44470,6,1553637600,18,2,20,Clouds
44471,7,1553637600,6,23,29,Clouds
44472,8,1553637600,29,1,30,Clouds
44473,9,1553637600,22,2,24,Clouds
44474,10,1553637600,10,6,16,Clouds
44475,11,1553637600,30,0,30,Clouds
44476,12,1553637600,7,13,20,Clouds
44477,13,1553637600,29,0,29,Clouds
44478,14,1553637600,26,4,30,Clouds
44479,15,1553637600,16,0,16,Clouds
44480,16,1553637600,13,7,20,Clouds
44481,17,1553637600,20,0,20,Clouds
44482,18,1553637600,24,6,30,Clouds
44483,19,1553637600,10,20,30,Clouds
44484,21,1553637600,30,0,30,Clouds
44485,22,1553637600,9,11,20,Clouds
44486,23,1553637600,14,16,30,Clouds
44487,24,1553637600,18,2,20,Clouds
44488,25,1553637600,29,1,30,Clouds
44489,26,1553637600,18,2,20,Clouds
44490,27,1553637600,19,1,20,Clouds
44491,28,1553637600,23,7,30,Clouds
44492,29,1553637600,27,2,29,Clouds
44493,30,1553637600,20,0,20,Clouds
44494,31,1553637600,14,6,20,Clouds
44495,32,1553637600,27,3,30,Clouds
44496,33,1553637600,21,1,22,Clouds
44497,34,1553637600,10,20,30,Clouds
44498,35,1553637600,15,15,30,Clouds
44499,36,1553637600,37,3,40,Clouds
44500,37,1553637600,29,1,30,Clouds
44501,38,1553637600,40,0,40,Clouds
44502,39,1553637600,15,5,20,Clouds
44503,40,1553637600,20,1,21,Clouds
44504,41,1553637600,20,0,20,Clouds
44505,42,1553637600,0,30,30,Clouds
44506,43,1553637600,12,18,30,Clouds
44507,44,1553637600,1,29,30,Clouds
44508,45,1553637600,30,0,30,Clouds
44509,46,1553637600,19,1,20,Clouds
44510,47,1553637600,37,3,40,Clouds
44511,48,1553637600,40,0,40,Clouds
44512,49,1553637600,38,2,40,Clouds
44513,50,1553637600,15,25,40,Clouds
44514,51,1553637600,40,0,40,Clouds
44515,52,1553637600,32,0,32,Clouds
44516,53,1553637600,38,2,40,Clouds
44517,54,1553637600,31,2,33,Clouds
44518,55,1553637600,36,0,36,Clouds
44519,56,1553637600,4,36,40,Clouds
44520,57,1553637600,20,3,23,Clouds
44521,58,1553637600,3,37,40,Clouds
44522,59,1553637600,14,6,20,Clouds
44523,60,1553637600,0,30,30,Clouds
44524,61,1553637600,16,9,25,Clouds
44525,62,1553637600,40,0,40,Clouds
44526,63,1553637600,35,0,35,Clouds
44527,64,1553637600,33,7,40,Clouds
44528,65,1553637600,40,0,40,Clouds
44529,66,1553637600,35,5,40,Clouds
44530,67,1553637600,29,11,40,Clouds
44531,68,1553637600,35,5,40,Clouds
44532,69,1553637600,36,4,40,Clouds
44533,70,1553637600,8,20,28,Clouds
44534,71,1553637600,38,2,40,Clouds
44535,72,1553637600,1,30,31,Clouds
44536,73,1553637600,13,17,30,Clouds
44537,74,1553637600,9,21,30,Clouds
44538,75,1553637600,27,13,40,Clouds
44539,76,1553637600,23,15,38,Clouds
44540,77,1553637600,27,2,29,Clouds
44541,78,1553637600,16,24,40,Clouds
44542,79,1553637600,16,11,27,Clouds
44543,80,1553637600,20,20,40,Clouds
44544,81,1553637600,40,0,40,Clouds
44545,82,1553637600,11,11,22,Clouds
44546,83,1553637600,7,33,40,Clouds
44547,84,1553637600,14,16,30,Clouds
44548,85,1553637600,18,17,35,Clouds
44549,86,1553637600,0,38,38,Clouds
44550,87,1553637600,14,24,38,Clouds
44551,88,1553637600,13,17,30,Clouds
44552,89,1553637600,40,0,40,Clouds
44553,90,1553637600,39,1,40,Clouds
44554,91,1553637600,1,29,30,Clouds
44555,92,1553637600,0,40,40,Clouds
44556,93,1553637600,9,31,40,Clouds
44557,94,1553637600,4,36,40,Clouds
44558,95,1553637600,11,29,40,Clouds
44559,96,1553637600,19,11,30,Clouds
44560,97,1553637600,4,36,40,Clouds
44561,98,1553637600,40,0,40,Clouds
44562,99,1553637600,30,0,30,Clouds
44563,100,1553637600,0,25,25,Clouds
44564,101,1553637600,7,23,30,Clouds
44565,102,1553637600,21,19,40,Clouds
44566,103,1553637600,39,1,40,Clouds
44567,104,1553637600,40,0,40,Clouds
44568,105,1553637600,34,2,36,Clouds
44569,106,1553637600,16,24,40,Clouds
44570,107,1553637600,30,10,40,Clouds
44571,108,1553637600,26,14,40,Clouds
44572,109,1553637600,14,15,29,Clouds
44573,110,1553637600,32,8,40,Clouds
44574,111,1553637600,12,28,40,Clouds
44575,112,1553637600,0,30,30,Clouds
44576,113,1553637600,40,0,40,Clouds
44577,114,1553637600,38,2,40,Clouds
44578,115,1553637600,0,30,30,Clouds
44579,2,1553641200,7,13,20,Clouds
44580,3,1553641200,19,1,20,Clouds
44581,4,1553641200,17,3,20,Clouds
44582,5,1553641200,33,7,40,Clouds
44583,6,1553641200,20,0,20,Clouds
44584,7,1553641200,8,21,29,Clouds
44585,8,1553641200,29,1,30,Clouds
44586,9,1553641200,24,0,24,Clouds
44587,10,1553641200,15,1,16,Clouds
44588,11,1553641200,30,0,30,Clouds
44589,12,1553641200,7,13,20,Clouds
44590,13,1553641200,28,1,29,Clouds
44591,14,1553641200,29,1,30,Clouds
44592,15,1553641200,12,4,16,Clouds
44593,16,1553641200,20,0,20,Clouds
44594,17,1553641200,19,1,20,Clouds
44595,18,1553641200,29,1,30,Clouds
44596,19,1553641200,24,6,30,Clouds
44597,21,1553641200,28,2,30,Clouds
44598,22,1553641200,20,0,20,Clouds
44599,23,1553641200,19,11,30,Clouds
44600,24,1553641200,20,0,20,Clouds
44601,25,1553641200,29,1,30,Clouds
44602,26,1553641200,20,0,20,Clouds
44603,27,1553641200,20,0,20,Clouds
44604,28,1553641200,18,12,30,Clouds
44605,29,1553641200,27,2,29,Clouds
44606,30,1553641200,20,0,20,Clouds
44607,31,1553641200,18,2,20,Clouds
44608,32,1553641200,28,2,30,Clouds
44609,33,1553641200,22,1,23,Clouds
44610,34,1553641200,5,25,30,Clouds
44611,35,1553641200,15,15,30,Clouds
44612,36,1553641200,40,0,40,Clouds
44613,37,1553641200,30,0,30,Clouds
44614,38,1553641200,38,2,40,Clouds
44615,39,1553641200,20,0,20,Clouds
44616,40,1553641200,21,0,21,Clouds
44617,41,1553641200,20,0,20,Clouds
44618,42,1553641200,1,29,30,Clouds
44619,43,1553641200,8,22,30,Clouds
44620,44,1553641200,9,21,30,Clouds
44621,45,1553641200,28,2,30,Clouds
44622,46,1553641200,20,0,20,Clouds
44623,47,1553641200,36,4,40,Clouds
44624,48,1553641200,38,2,40,Clouds
44625,49,1553641200,36,4,40,Clouds
44626,50,1553641200,4,36,40,Clouds
44627,51,1553641200,40,0,40,Clouds
44628,52,1553641200,32,0,32,Clouds
44629,53,1553641200,39,1,40,Clouds
44630,54,1553641200,30,3,33,Clouds
44631,55,1553641200,36,0,36,Clouds
44632,56,1553641200,12,28,40,Clouds
44633,57,1553641200,21,2,23,Clouds
44634,58,1553641200,22,18,40,Clouds
44635,59,1553641200,17,3,20,Clouds
44636,60,1553641200,8,22,30,Clouds
44637,61,1553641200,15,10,25,Clouds
44638,62,1553641200,38,2,40,Clouds
44639,63,1553641200,35,0,35,Clouds
44640,64,1553641200,39,1,40,Clouds
44641,65,1553641200,38,2,40,Clouds
44642,66,1553641200,34,6,40,Clouds
44643,67,1553641200,26,14,40,Clouds
44644,68,1553641200,37,3,40,Clouds
44645,69,1553641200,37,3,40,Clouds
44646,70,1553641200,12,16,28,Clouds
44647,71,1553641200,40,0,40,Clouds
44648,72,1553641200,2,29,31,Clouds
44649,73,1553641200,11,19,30,Clouds
44650,74,1553641200,5,25,30,Clouds
44651,75,1553641200,25,15,40,Clouds
44652,76,1553641200,22,16,38,Clouds
44653,77,1553641200,29,0,29,Clouds
44654,78,1553641200,10,30,40,Clouds
44655,79,1553641200,14,13,27,Clouds
44656,80,1553641200,20,20,40,Clouds
44657,81,1553641200,40,0,40,Clouds
44658,82,1553641200,11,11,22,Clouds
44659,83,1553641200,3,37,40,Clouds
44660,84,1553641200,13,17,30,Clouds
44661,85,1553641200,14,21,35,Clouds
44662,86,1553641200,8,30,38,Clouds
44663,87,1553641200,7,31,38,Clouds
44664,88,1553641200,12,18,30,Clouds
44665,89,1553641200,40,0,40,Clouds
44666,90,1553641200,40,0,40,Clouds
44667,91,1553641200,5,25,30,Clouds
44668,92,1553641200,1,39,40,Clouds
44669,93,1553641200,7,33,40,Clouds
44670,94,1553641200,4,36,40,Clouds
44671,95,1553641200,6,34,40,Clouds
44672,96,1553641200,17,13,30,Clouds
44673,97,1553641200,1,39,40,Clouds
44674,98,1553641200,40,0,40,Clouds
44675,99,1553641200,30,0,30,Clouds
44676,100,1553641200,1,24,25,Clouds
44677,101,1553641200,8,22,30,Clouds
44678,102,1553641200,21,19,40,Clouds
44679,103,1553641200,31,9,40,Clouds
44680,104,1553641200,31,9,40,Clouds
44681,105,1553641200,34,2,36,Clouds
44682,106,1553641200,16,24,40,Clouds
44683,107,1553641200,25,15,40,Clouds
44684,108,1553641200,25,15,40,Clouds
44685,109,1553641200,6,23,29,Clouds
44686,110,1553641200,32,8,40,Clouds
44687,111,1553641200,1,39,40,Clouds
44688,112,1553641200,0,30,30,Clouds
44689,113,1553641200,40,0,40,Clouds
44690,114,1553641200,40,0,40,Clouds
44691,115,1553641200,1,29,30,Clouds
44692,2,1553644800,2,18,20,Clouds
44693,3,1553644800,17,3,20,Clouds
44694,4,1553644800,19,1,20,Clouds
44695,5,1553644800,28,12,40,Clouds
44696,6,1553644800,20,0,20,Clouds
44697,7,1553644800,11,18,29,Clouds
44698,8,1553644800,28,2,30,Clouds
44699,9,1553644800,20,4,24,Clouds
44700,10,1553644800,15,1,16,Clouds
44701,11,1553644800,30,0,30,Clouds
44702,12,1553644800,8,12,20,Clouds
44703,13,1553644800,29,0,29,Clouds
44704,14,1553644800,30,0,30,Clouds
44705,15,1553644800,11,5,16,Clouds
44706,16,1553644800,20,0,20,Clouds
44707,17,1553644800,20,0,20,Clouds
44708,18,1553644800,24,6,30,Clouds
44709,19,1553644800,29,1,30,Clouds
44710,21,1553644800,30,0,30,Clouds
44711,22,1553644800,18,2,20,Clouds
44712,23,1553644800,22,8,30,Clouds
44713,24,1553644800,18,2,20,Clouds
44714,25,1553644800,30,0,30,Clouds
44715,26,1553644800,20,0,20,Clouds
44716,27,1553644800,20,0,20,Clouds
44717,28,1553644800,11,19,30,Clouds
44718,29,1553644800,28,1,29,Clouds
44719,30,1553644800,17,3,20,Clouds
44720,31,1553644800,20,0,20,Clouds
44721,32,1553644800,30,0,30,Clouds
44722,33,1553644800,23,0,23,Clouds
44723,34,1553644800,2,28,30,Clouds
44724,35,1553644800,16,14,30,Clouds
44725,36,1553644800,40,0,40,Clouds
44726,37,1553644800,30,0,30,Clouds
44727,38,1553644800,37,3,40,Clouds
44728,39,1553644800,17,3,20,Clouds
44729,40,1553644800,20,1,21,Clouds
44730,41,1553644800,20,0,20,Clouds
44731,42,1553644800,1,29,30,Clouds
44732,43,1553644800,1,29,30,Clouds
44733,44,1553644800,8,22,30,Clouds
44734,45,1553644800,28,2,30,Clouds
44735,46,1553644800,20,0,20,Clouds
44736,47,1553644800,37,3,40,Clouds
44737,48,1553644800,38,2,40,Clouds
44738,49,1553644800,35,5,40,Clouds
44739,50,1553644800,0,40,40,Clouds
44740,51,1553644800,40,0,40,Clouds
44741,52,1553644800,31,1,32,Clouds
44742,53,1553644800,40,0,40,Clouds
44743,54,1553644800,30,2,32,Clouds
44744,55,1553644800,35,0,35,Clouds
44745,56,1553644800,25,15,40,Clouds
44746,57,1553644800,20,3,23,Clouds
44747,58,1553644800,40,0,40,Clouds
44748,59,1553644800,18,2,20,Clouds
44749,60,1553644800,9,21,30,Clouds
44750,61,1553644800,8,17,25,Clouds
44751,62,1553644800,39,1,40,Clouds
44752,63,1553644800,35,0,35,Clouds
44753,64,1553644800,38,2,40,Clouds
44754,65,1553644800,40,0,40,Clouds
44755,66,1553644800,30,10,40,Clouds
44756,67,1553644800,28,12,40,Clouds
44757,68,1553644800,40,0,40,Clouds
44758,69,1553644800,40,0,40,Clouds
44759,70,1553644800,18,10,28,Clouds
44760,71,1553644800,38,2,40,Clouds
44761,72,1553644800,1,30,31,Clouds
44762,73,1553644800,12,18,30,Clouds
44763,74,1553644800,6,24,30,Clouds
44764,75,1553644800,21,19,40,Clouds
44765,76,1553644800,19,19,38,Clouds
44766,77,1553644800,28,1,29,Clouds
44767,78,1553644800,4,36,40,Clouds
44768,79,1553644800,6,21,27,Clouds
44769,80,1553644800,15,25,40,Clouds
44770,81,1553644800,40,0,40,Clouds
44771,82,1553644800,6,16,22,Clouds
44772,83,1553644800,2,38,40,Clouds
44773,84,1553644800,8,22,30,Clouds
44774,85,1553644800,8,27,35,Clouds
44775,86,1553644800,6,32,38,Clouds
44776,87,1553644800,9,29,38,Clouds
44777,88,1553644800,7,23,30,Clouds
44778,89,1553644800,40,0,40,Clouds
44779,90,1553644800,38,2,40,Clouds
44780,91,1553644800,13,17,30,Clouds
44781,92,1553644800,9,31,40,Clouds
44782,93,1553644800,7,33,40,Clouds
44783,94,1553644800,4,36,40,Clouds
44784,95,1553644800,0,40,40,Clouds
44785,96,1553644800,12,18,30,Clouds
44786,97,1553644800,0,40,40,Clouds
44787,98,1553644800,40,0,40,Clouds
44788,99,1553644800,30,0,30,Clouds
44789,100,1553644800,0,25,25,Clouds
44790,101,1553644800,7,23,30,Clouds
44791,102,1553644800,19,21,40,Clouds
44792,103,1553644800,31,9,40,Clouds
44793,104,1553644800,32,8,40,Clouds
44794,105,1553644800,34,2,36,Clouds
44795,106,1553644800,16,24,40,Clouds
44796,107,1553644800,5,35,40,Clouds
44797,108,1553644800,19,21,40,Clouds
44798,109,1553644800,2,27,29,Clouds
44799,110,1553644800,31,9,40,Clouds
44800,111,1553644800,0,40,40,Clouds
44801,112,1553644800,10,20,30,Clouds
44802,113,1553644800,40,0,40,Clouds
44803,114,1553644800,37,3,40,Clouds
44804,115,1553644800,3,27,30,Clouds
44805,2,1553648400,3,17,20,Clouds
44806,3,1553648400,18,2,20,Clouds
44807,4,1553648400,20,0,20,Clouds
44808,5,1553648400,26,14,40,Clouds
44809,6,1553648400,20,0,20,Clouds
44810,7,1553648400,13,16,29,Clouds
44811,8,1553648400,30,0,30,Clouds
44812,9,1553648400,24,0,24,Clouds
44813,10,1553648400,15,1,16,Clouds
44814,11,1553648400,30,0,30,Clouds
44815,12,1553648400,8,12,20,Clouds
44816,13,1553648400,29,0,29,Clouds
44817,14,1553648400,30,0,30,Clouds
44818,15,1553648400,8,8,16,Clouds
44819,16,1553648400,20,0,20,Clouds
44820,17,1553648400,19,1,20,Clouds
44821,18,1553648400,24,6,30,Clouds
44822,19,1553648400,30,0,30,Clouds
44823,21,1553648400,30,0,30,Clouds
44824,22,1553648400,20,0,20,Clouds
44825,23,1553648400,30,0,30,Clouds
44826,24,1553648400,20,0,20,Clouds
44827,25,1553648400,30,0,30,Clouds
44828,26,1553648400,20,0,20,Clouds
44829,27,1553648400,20,0,20,Clouds
44830,28,1553648400,10,20,30,Clouds
44831,29,1553648400,29,0,29,Clouds
44832,30,1553648400,18,2,20,Clouds
44833,31,1553648400,20,0,20,Clouds
44834,32,1553648400,30,0,30,Clouds
44835,33,1553648400,23,0,23,Clouds
44836,34,1553648400,1,29,30,Clouds
44837,35,1553648400,10,20,30,Clouds
44838,36,1553648400,40,0,40,Clouds
44839,37,1553648400,30,0,30,Clouds
44840,38,1553648400,40,0,40,Clouds
44841,39,1553648400,19,1,20,Clouds
44842,40,1553648400,20,1,21,Clouds
44843,41,1553648400,20,0,20,Clouds
44844,42,1553648400,0,30,30,Clouds
44845,43,1553648400,2,28,30,Clouds
44846,44,1553648400,7,23,30,Clouds
44847,45,1553648400,30,0,30,Clouds
44848,46,1553648400,20,0,20,Clouds
44849,47,1553648400,40,0,40,Clouds
44850,48,1553648400,40,0,40,Clouds
44851,49,1553648400,37,3,40,Clouds
44852,50,1553648400,1,39,40,Clouds
44853,51,1553648400,40,0,40,Clouds
44854,52,1553648400,31,1,32,Clouds
44855,53,1553648400,40,0,40,Clouds
44856,54,1553648400,30,3,33,Clouds
44857,55,1553648400,35,0,35,Clouds
44858,56,1553648400,35,5,40,Clouds
44859,57,1553648400,20,3,23,Clouds
44860,58,1553648400,40,0,40,Clouds
44861,59,1553648400,18,2,20,Clouds
44862,60,1553648400,3,27,30,Clouds
44863,61,1553648400,8,17,25,Clouds
44864,62,1553648400,40,0,40,Clouds
44865,63,1553648400,35,0,35,Clouds
44866,64,1553648400,39,1,40,Clouds
44867,65,1553648400,40,0,40,Clouds
44868,66,1553648400,25,15,40,Clouds
44869,67,1553648400,26,14,40,Clouds
44870,68,1553648400,40,0,40,Clouds
44871,69,1553648400,40,0,40,Clouds
44872,70,1553648400,18,10,28,Clouds
44873,71,1553648400,40,0,40,Clouds
44874,72,1553648400,3,28,31,Clouds
44875,73,1553648400,10,20,30,Clouds
44876,74,1553648400,7,23,30,Clouds
44877,75,1553648400,22,18,40,Clouds
44878,76,1553648400,18,20,38,Clouds
44879,77,1553648400,27,2,29,Clouds
44880,78,1553648400,1,39,40,Clouds
44881,79,1553648400,6,21,27,Clouds
44882,80,1553648400,16,24,40,Clouds
44883,81,1553648400,40,0,40,Clouds
44884,82,1553648400,3,19,22,Clouds
44885,83,1553648400,1,39,40,Clouds
44886,84,1553648400,7,23,30,Clouds
44887,85,1553648400,6,29,35,Clouds
44888,86,1553648400,6,32,38,Clouds
44889,87,1553648400,8,30,38,Clouds
44890,88,1553648400,0,30,30,Clouds
44891,89,1553648400,40,0,40,Clouds
44892,90,1553648400,38,2,40,Clouds
44893,91,1553648400,13,17,30,Clouds
44894,92,1553648400,4,36,40,Clouds
44895,93,1553648400,7,33,40,Clouds
44896,94,1553648400,4,36,40,Clouds
44897,95,1553648400,0,40,40,Clouds
44898,96,1553648400,10,20,30,Clouds
44899,97,1553648400,0,40,40,Clouds
44900,98,1553648400,40,0,40,Clouds
44901,99,1553648400,30,0,30,Clouds
44902,100,1553648400,1,24,25,Clouds
44903,101,1553648400,5,25,30,Clouds
44904,102,1553648400,15,25,40,Clouds
44905,103,1553648400,30,10,40,Clouds
44906,104,1553648400,32,8,40,Clouds
44907,105,1553648400,33,3,36,Clouds
44908,106,1553648400,16,24,40,Clouds
44909,107,1553648400,5,35,40,Clouds
44910,108,1553648400,14,26,40,Clouds
44911,109,1553648400,11,18,29,Clouds
44912,110,1553648400,31,9,40,Clouds
44913,111,1553648400,7,33,40,Clouds
44914,112,1553648400,2,28,30,Clouds
44915,113,1553648400,40,0,40,Clouds
44916,114,1553648400,40,0,40,Clouds
44917,115,1553648400,1,29,30,Clouds
44918,2,1553652000,3,17,20,Clouds
44919,3,1553652000,17,3,20,Clouds
44920,4,1553652000,20,0,20,Clouds
44921,5,1553652000,25,15,40,Clouds
44922,6,1553652000,20,0,20,Clouds
44923,7,1553652000,14,15,29,Clouds
44924,8,1553652000,30,0,30,Clouds
44925,9,1553652000,24,0,24,Clouds
44926,10,1553652000,15,1,16,Clouds
44927,11,1553652000,30,0,30,Clouds
44928,12,1553652000,8,12,20,Clouds
44929,13,1553652000,29,0,29,Clouds
44930,14,1553652000,30,0,30,Clouds
44931,15,1553652000,9,7,16,Clouds
44932,16,1553652000,20,0,20,Clouds
44933,17,1553652000,19,1,20,Clouds
44934,18,1553652000,24,6,30,Clouds
44935,19,1553652000,30,0,30,Clouds
44936,21,1553652000,30,0,30,Clouds
44937,22,1553652000,20,0,20,Clouds
44938,23,1553652000,30,0,30,Clouds
44939,24,1553652000,20,0,20,Clouds
44940,25,1553652000,30,0,30,Clouds
44941,26,1553652000,20,0,20,Clouds
44942,27,1553652000,20,0,20,Clouds
44943,28,1553652000,10,20,30,Clouds
44944,29,1553652000,29,0,29,Clouds
44945,30,1553652000,18,2,20,Clouds
44946,31,1553652000,19,1,20,Clouds
44947,32,1553652000,30,0,30,Clouds
44948,33,1553652000,23,0,23,Clouds
44949,34,1553652000,1,29,30,Clouds
44950,35,1553652000,9,21,30,Clouds
44951,36,1553652000,40,0,40,Clouds
44952,37,1553652000,30,0,30,Clouds
44953,38,1553652000,38,2,40,Clouds
44954,39,1553652000,20,0,20,Clouds
44955,40,1553652000,21,0,21,Clouds
44956,41,1553652000,20,0,20,Clouds
44957,42,1553652000,0,30,30,Clouds
44958,43,1553652000,2,28,30,Clouds
44959,44,1553652000,5,25,30,Clouds
44960,45,1553652000,28,2,30,Clouds
44961,46,1553652000,20,0,20,Clouds
44962,47,1553652000,40,0,40,Clouds
44963,48,1553652000,40,0,40,Clouds
44964,49,1553652000,40,0,40,Clouds
44965,50,1553652000,1,39,40,Clouds
44966,51,1553652000,40,0,40,Clouds
44967,52,1553652000,32,0,32,Clouds
44968,53,1553652000,40,0,40,Clouds
44969,54,1553652000,33,0,33,Clouds
44970,55,1553652000,35,0,35,Clouds
44971,56,1553652000,37,3,40,Clouds
44972,57,1553652000,20,3,23,Clouds
44973,58,1553652000,40,0,40,Clouds
44974,59,1553652000,18,2,20,Clouds
44975,60,1553652000,3,27,30,Clouds
44976,61,1553652000,9,16,25,Clouds
44977,62,1553652000,40,0,40,Clouds
44978,63,1553652000,35,0,35,Clouds
44979,64,1553652000,39,1,40,Clouds
44980,65,1553652000,40,0,40,Clouds
44981,66,1553652000,25,15,40,Clouds
44982,67,1553652000,26,14,40,Clouds
44983,68,1553652000,40,0,40,Clouds
44984,69,1553652000,39,1,40,Clouds
44985,70,1553652000,19,9,28,Clouds
44986,71,1553652000,40,0,40,Clouds
44987,72,1553652000,3,28,31,Clouds
44988,73,1553652000,10,20,30,Clouds
44989,74,1553652000,7,23,30,Clouds
44990,75,1553652000,22,18,40,Clouds
44991,76,1553652000,17,21,38,Clouds
44992,77,1553652000,26,3,29,Clouds
44993,78,1553652000,0,40,40,Clouds
44994,79,1553652000,6,21,27,Clouds
44995,80,1553652000,16,24,40,Clouds
44996,81,1553652000,40,0,40,Clouds
44997,82,1553652000,3,19,22,Clouds
44998,83,1553652000,0,40,40,Clouds
44999,84,1553652000,4,26,30,Clouds
45000,85,1553652000,5,30,35,Clouds
45001,86,1553652000,8,30,38,Clouds
45002,87,1553652000,8,30,38,Clouds
45003,88,1553652000,0,30,30,Clouds
45004,89,1553652000,40,0,40,Clouds
45005,90,1553652000,38,2,40,Clouds
45006,91,1553652000,14,16,30,Clouds
45007,92,1553652000,4,36,40,Clouds
45008,93,1553652000,7,33,40,Clouds
45009,94,1553652000,4,36,40,Clouds
45010,95,1553652000,0,40,40,Clouds
45011,96,1553652000,10,20,30,Clouds
45012,97,1553652000,0,40,40,Clouds
45013,98,1553652000,40,0,40,Clouds
45014,99,1553652000,30,0,30,Clouds
45015,100,1553652000,1,24,25,Clouds
45016,101,1553652000,6,24,30,Clouds
45017,102,1553652000,15,25,40,Clouds
45018,103,1553652000,30,10,40,Clouds
45019,104,1553652000,32,8,40,Clouds
45020,105,1553652000,33,3,36,Clouds
45021,106,1553652000,16,24,40,Clouds
45022,107,1553652000,3,37,40,Clouds
45023,108,1553652000,13,27,40,Clouds
45024,109,1553652000,12,17,29,Clouds
45025,110,1553652000,31,9,40,Clouds
45026,111,1553652000,7,33,40,Clouds
45027,112,1553652000,0,30,30,Clouds
45028,113,1553652000,40,0,40,Clouds
45029,114,1553652000,40,0,40,Clouds
45030,115,1553652000,0,30,30,Clouds
45031,2,1553659200,3,17,20,Clouds
45032,3,1553659200,17,3,20,Clouds
45033,4,1553659200,20,0,20,Clouds
45034,5,1553659200,25,15,40,Clouds
45035,6,1553659200,20,0,20,Clouds
45036,7,1553659200,14,15,29,Clouds
45037,8,1553659200,29,1,30,Clouds
45038,9,1553659200,24,0,24,Clouds
45039,10,1553659200,15,1,16,Clouds
45040,11,1553659200,30,0,30,Clouds
45041,12,1553659200,8,12,20,Clouds
45042,13,1553659200,29,0,29,Clouds
45043,14,1553659200,30,0,30,Clouds
45044,15,1553659200,9,7,16,Clouds
45045,16,1553659200,20,0,20,Clouds
45046,17,1553659200,19,1,20,Clouds
45047,18,1553659200,24,6,30,Clouds
45048,19,1553659200,30,0,30,Clouds
45049,21,1553659200,30,0,30,Clouds
45050,22,1553659200,20,0,20,Clouds
45051,23,1553659200,30,0,30,Clouds
45052,24,1553659200,20,0,20,Clouds
45053,25,1553659200,30,0,30,Clouds
45054,26,1553659200,20,0,20,Clouds
45055,27,1553659200,20,0,20,Clouds
45056,28,1553659200,8,22,30,Clouds
45057,29,1553659200,29,0,29,Clouds
45058,30,1553659200,18,2,20,Clouds
45059,31,1553659200,19,1,20,Clouds
45060,32,1553659200,30,0,30,Clouds
45061,33,1553659200,23,0,23,Clouds
45062,34,1553659200,1,29,30,Clouds
45063,35,1553659200,9,21,30,Clouds
45064,36,1553659200,40,0,40,Clouds
45065,37,1553659200,30,0,30,Clouds
45066,38,1553659200,38,2,40,Clouds
45067,39,1553659200,20,0,20,Clouds
45068,40,1553659200,21,0,21,Clouds
45069,41,1553659200,20,0,20,Clouds
45070,42,1553659200,0,30,30,Clouds
45071,43,1553659200,2,28,30,Clouds
45072,44,1553659200,5,25,30,Clouds
45073,45,1553659200,28,2,30,Clouds
45074,46,1553659200,20,0,20,Clouds
45075,47,1553659200,40,0,40,Clouds
45076,48,1553659200,40,0,40,Clouds
45077,49,1553659200,40,0,40,Clouds
45078,50,1553659200,0,40,40,Clouds
45079,51,1553659200,40,0,40,Clouds
45080,52,1553659200,32,0,32,Clouds
45081,53,1553659200,40,0,40,Clouds
45082,54,1553659200,33,0,33,Clouds
45083,55,1553659200,35,0,35,Clouds
45084,56,1553659200,37,3,40,Clouds
45085,57,1553659200,20,3,23,Clouds
45086,58,1553659200,40,0,40,Clouds
45087,59,1553659200,18,2,20,Clouds
45088,60,1553659200,3,27,30,Clouds
45089,61,1553659200,9,16,25,Clouds
45090,62,1553659200,40,0,40,Clouds
45091,63,1553659200,35,0,35,Clouds
45092,64,1553659200,39,1,40,Clouds
45093,65,1553659200,40,0,40,Clouds
45094,66,1553659200,25,15,40,Clouds
45095,67,1553659200,26,14,40,Clouds
45096,68,1553659200,40,0,40,Clouds
45097,69,1553659200,39,1,40,Clouds
45098,70,1553659200,19,9,28,Clouds
45099,71,1553659200,40,0,40,Clouds
45100,72,1553659200,3,28,31,Clouds
45101,73,1553659200,10,20,30,Clouds
45102,74,1553659200,7,23,30,Clouds
45103,75,1553659200,22,18,40,Clouds
45104,76,1553659200,17,21,38,Clouds
45105,77,1553659200,26,3,29,Clouds
45106,78,1553659200,0,40,40,Clouds
45107,79,1553659200,6,21,27,Clouds
45108,80,1553659200,16,24,40,Clouds
45109,81,1553659200,40,0,40,Clouds
45110,82,1553659200,3,19,22,Clouds
45111,83,1553659200,0,40,40,Clouds
45112,84,1553659200,4,26,30,Clouds
45113,85,1553659200,5,30,35,Clouds
45114,86,1553659200,8,30,38,Clouds
45115,87,1553659200,8,30,38,Clouds
45116,88,1553659200,0,30,30,Clouds
45117,89,1553659200,40,0,40,Clouds
45118,90,1553659200,38,2,40,Clouds
45119,91,1553659200,14,16,30,Clouds
45120,92,1553659200,4,36,40,Clouds
45121,93,1553659200,7,33,40,Clouds
45122,94,1553659200,4,36,40,Clouds
45123,95,1553659200,0,40,40,Clouds
45124,96,1553659200,10,20,30,Clouds
45125,97,1553659200,0,40,40,Clouds
45126,98,1553659200,40,0,40,Clouds
45127,99,1553659200,30,0,30,Clouds
45128,100,1553659200,1,24,25,Clouds
45129,101,1553659200,6,24,30,Clouds
45130,102,1553659200,15,25,40,Clouds
45131,103,1553659200,30,10,40,Clouds
45132,104,1553659200,32,8,40,Clouds
45133,105,1553659200,33,3,36,Clouds
45134,106,1553659200,16,24,40,Clouds
45135,107,1553659200,3,37,40,Clouds
45136,108,1553659200,13,27,40,Clouds
45137,109,1553659200,12,17,29,Clouds
45138,110,1553659200,31,9,40,Clouds
45139,111,1553659200,7,33,40,Clouds
45140,112,1553659200,0,30,30,Clouds
45141,113,1553659200,40,0,40,Clouds
45142,114,1553659200,40,0,40,Clouds
45143,115,1553659200,0,30,30,Clouds
45144,2,1553662800,3,17,20,Clouds
45145,3,1553662800,17,3,20,Clouds
45146,4,1553662800,20,0,20,Clouds
45147,5,1553662800,25,15,40,Clouds
45148,6,1553662800,20,0,20,Clouds
45149,7,1553662800,14,15,29,Clouds
45150,8,1553662800,29,1,30,Clouds
45151,9,1553662800,24,0,24,Clouds
45152,10,1553662800,15,1,16,Clouds
45153,11,1553662800,30,0,30,Clouds
45154,12,1553662800,8,12,20,Clouds
45155,13,1553662800,29,0,29,Clouds
45156,14,1553662800,30,0,30,Clouds
45157,15,1553662800,9,7,16,Clouds
45158,16,1553662800,20,0,20,Clouds
45159,17,1553662800,19,1,20,Clouds
45160,18,1553662800,24,6,30,Clouds
45161,19,1553662800,30,0,30,Clouds
45162,21,1553662800,30,0,30,Clouds
45163,22,1553662800,20,0,20,Clouds
45164,23,1553662800,30,0,30,Clouds
45165,24,1553662800,20,0,20,Clouds
45166,25,1553662800,30,0,30,Clouds
45167,26,1553662800,20,0,20,Clouds
45168,27,1553662800,20,0,20,Clouds
45169,28,1553662800,8,22,30,Clouds
45170,29,1553662800,29,0,29,Clouds
45171,30,1553662800,18,2,20,Clouds
45172,31,1553662800,19,1,20,Clouds
45173,32,1553662800,30,0,30,Clouds
45174,33,1553662800,23,0,23,Clouds
45175,34,1553662800,1,29,30,Clouds
45176,35,1553662800,9,21,30,Clouds
45177,36,1553662800,40,0,40,Clouds
45178,37,1553662800,30,0,30,Clouds
45179,38,1553662800,38,2,40,Clouds
45180,39,1553662800,20,0,20,Clouds
45181,40,1553662800,21,0,21,Clouds
45182,41,1553662800,20,0,20,Clouds
45183,42,1553662800,0,30,30,Clouds
45184,43,1553662800,2,28,30,Clouds
45185,44,1553662800,5,25,30,Clouds
45186,45,1553662800,28,2,30,Clouds
45187,46,1553662800,20,0,20,Clouds
45188,47,1553662800,40,0,40,Clouds
45189,48,1553662800,40,0,40,Clouds
45190,49,1553662800,40,0,40,Clouds
45191,50,1553662800,0,40,40,Clouds
45192,51,1553662800,40,0,40,Clouds
45193,52,1553662800,32,0,32,Clouds
45194,53,1553662800,40,0,40,Clouds
45195,54,1553662800,33,0,33,Clouds
45196,55,1553662800,35,0,35,Clouds
45197,56,1553662800,37,3,40,Clouds
45198,57,1553662800,20,3,23,Clouds
45199,58,1553662800,40,0,40,Clouds
45200,59,1553662800,18,2,20,Clouds
45201,60,1553662800,3,27,30,Clouds
45202,61,1553662800,9,16,25,Clouds
45203,62,1553662800,40,0,40,Clouds
45204,63,1553662800,35,0,35,Clouds
45205,64,1553662800,39,1,40,Clouds
45206,65,1553662800,40,0,40,Clouds
45207,66,1553662800,25,15,40,Clouds
45208,67,1553662800,26,14,40,Clouds
45209,68,1553662800,40,0,40,Clouds
45210,69,1553662800,39,1,40,Clouds
45211,70,1553662800,19,9,28,Clouds
45212,71,1553662800,40,0,40,Clouds
45213,72,1553662800,3,28,31,Clouds
45214,73,1553662800,10,20,30,Clouds
45215,74,1553662800,7,23,30,Clouds
45216,75,1553662800,22,18,40,Clouds
45217,76,1553662800,17,21,38,Clouds
45218,77,1553662800,26,3,29,Clouds
45219,78,1553662800,0,40,40,Clouds
45220,79,1553662800,6,21,27,Clouds
45221,80,1553662800,16,24,40,Clouds
45222,81,1553662800,40,0,40,Clouds
45223,82,1553662800,3,19,22,Clouds
45224,83,1553662800,0,40,40,Clouds
45225,84,1553662800,4,26,30,Clouds
45226,85,1553662800,5,30,35,Clouds
45227,86,1553662800,8,30,38,Clouds
45228,87,1553662800,8,30,38,Clouds
45229,88,1553662800,0,30,30,Clouds
45230,89,1553662800,40,0,40,Clouds
45231,90,1553662800,38,2,40,Clouds
45232,91,1553662800,14,16,30,Clouds
45233,92,1553662800,4,36,40,Clouds
45234,93,1553662800,7,33,40,Clouds
45235,94,1553662800,4,36,40,Clouds
45236,95,1553662800,0,40,40,Clouds
45237,96,1553662800,10,20,30,Clouds
45238,97,1553662800,0,40,40,Clouds
45239,98,1553662800,40,0,40,Clouds
45240,99,1553662800,30,0,30,Clouds
45241,100,1553662800,1,24,25,Clouds
45242,101,1553662800,6,24,30,Clouds
45243,102,1553662800,15,25,40,Clouds
45244,103,1553662800,30,10,40,Clouds
45245,104,1553662800,32,8,40,Clouds
45246,105,1553662800,33,3,36,Clouds
45247,106,1553662800,16,24,40,Clouds
45248,107,1553662800,3,37,40,Clouds
45249,108,1553662800,13,27,40,Clouds
45250,109,1553662800,12,17,29,Clouds
45251,110,1553662800,31,9,40,Clouds
45252,111,1553662800,7,33,40,Clouds
45253,112,1553662800,0,30,30,Clouds
45254,113,1553662800,40,0,40,Clouds
45255,114,1553662800,40,0,40,Clouds
45256,115,1553662800,0,30,30,Clouds
45257,2,1553666400,3,17,20,Clouds
45258,3,1553666400,17,3,20,Clouds
45259,4,1553666400,20,0,20,Clouds
45260,5,1553666400,25,15,40,Clouds
45261,6,1553666400,20,0,20,Clouds
45262,7,1553666400,15,14,29,Clouds
45263,8,1553666400,29,1,30,Clouds
45264,9,1553666400,24,0,24,Clouds
45265,10,1553666400,15,1,16,Clouds
45266,11,1553666400,30,0,30,Clouds
45267,12,1553666400,8,12,20,Clouds
45268,13,1553666400,29,0,29,Clouds
45269,14,1553666400,30,0,30,Clouds
45270,15,1553666400,9,7,16,Clouds
45271,16,1553666400,20,0,20,Clouds
45272,17,1553666400,19,1,20,Clouds
45273,18,1553666400,24,6,30,Clouds
45274,19,1553666400,30,0,30,Clouds
45275,21,1553666400,30,0,30,Clouds
45276,22,1553666400,20,0,20,Clouds
45277,23,1553666400,30,0,30,Clouds
45278,24,1553666400,20,0,20,Clouds
45279,25,1553666400,30,0,30,Clouds
45280,26,1553666400,20,0,20,Clouds
45281,27,1553666400,20,0,20,Clouds
45282,28,1553666400,8,22,30,Clouds
45283,29,1553666400,29,0,29,Clouds
45284,30,1553666400,18,2,20,Clouds
45285,31,1553666400,19,1,20,Clouds
45286,32,1553666400,30,0,30,Clouds
45287,33,1553666400,23,0,23,Clouds
45288,34,1553666400,1,29,30,Clouds
45289,35,1553666400,9,21,30,Clouds
45290,36,1553666400,40,0,40,Clouds
45291,37,1553666400,30,0,30,Clouds
45292,38,1553666400,38,2,40,Clouds
45293,39,1553666400,20,0,20,Clouds
45294,40,1553666400,21,0,21,Clouds
45295,41,1553666400,20,0,20,Clouds
45296,42,1553666400,0,30,30,Clouds
45297,43,1553666400,2,28,30,Clouds
45298,44,1553666400,6,24,30,Clouds
45299,45,1553666400,28,2,30,Clouds
45300,46,1553666400,20,0,20,Clouds
45301,47,1553666400,40,0,40,Clouds
45302,48,1553666400,40,0,40,Clouds
45303,49,1553666400,40,0,40,Clouds
45304,50,1553666400,0,40,40,Clouds
45305,51,1553666400,40,0,40,Clouds
45306,52,1553666400,32,0,32,Clouds
45307,53,1553666400,40,0,40,Clouds
45308,54,1553666400,33,0,33,Clouds
45309,55,1553666400,35,0,35,Clouds
45310,56,1553666400,37,3,40,Clouds
45311,57,1553666400,20,3,23,Clouds
45312,58,1553666400,40,0,40,Clouds
45313,59,1553666400,18,2,20,Clouds
45314,60,1553666400,3,27,30,Clouds
45315,61,1553666400,9,16,25,Clouds
45316,62,1553666400,40,0,40,Clouds
45317,63,1553666400,35,0,35,Clouds
45318,64,1553666400,39,1,40,Clouds
45319,65,1553666400,40,0,40,Clouds
45320,66,1553666400,25,15,40,Clouds
45321,67,1553666400,26,14,40,Clouds
45322,68,1553666400,40,0,40,Clouds
45323,69,1553666400,39,1,40,Clouds
45324,70,1553666400,19,9,28,Clouds
45325,71,1553666400,40,0,40,Clouds
45326,72,1553666400,3,28,31,Clouds
45327,73,1553666400,10,20,30,Clouds
45328,74,1553666400,7,23,30,Clouds
45329,75,1553666400,22,18,40,Clouds
45330,76,1553666400,17,21,38,Clouds
45331,77,1553666400,26,3,29,Clouds
45332,78,1553666400,0,40,40,Clouds
45333,79,1553666400,6,21,27,Clouds
45334,80,1553666400,19,21,40,Clouds
45335,81,1553666400,40,0,40,Clouds
45336,82,1553666400,3,19,22,Clouds
45337,83,1553666400,0,40,40,Clouds
45338,84,1553666400,4,26,30,Clouds
45339,85,1553666400,5,30,35,Clouds
45340,86,1553666400,8,30,38,Clouds
45341,87,1553666400,8,30,38,Clouds
45342,88,1553666400,0,30,30,Clouds
45343,89,1553666400,40,0,40,Clouds
45344,90,1553666400,38,2,40,Clouds
45345,91,1553666400,14,16,30,Clouds
45346,92,1553666400,4,36,40,Clouds
45347,93,1553666400,7,33,40,Clouds
45348,94,1553666400,4,36,40,Clouds
45349,95,1553666400,0,40,40,Clouds
45350,96,1553666400,10,20,30,Clouds
45351,97,1553666400,0,40,40,Clouds
45352,98,1553666400,40,0,40,Clouds
45353,99,1553666400,30,0,30,Clouds
45354,100,1553666400,1,24,25,Clouds
45355,101,1553666400,6,24,30,Clouds
45356,102,1553666400,15,25,40,Clouds
45357,103,1553666400,30,10,40,Clouds
45358,105,1553666400,33,3,36,Clouds
45359,106,1553666400,16,24,40,Clouds
45360,107,1553666400,3,37,40,Clouds
45361,108,1553666400,13,27,40,Clouds
45362,109,1553666400,12,17,29,Clouds
45363,110,1553666400,31,9,40,Clouds
45364,111,1553666400,7,33,40,Clouds
45365,112,1553666400,0,30,30,Clouds
45366,113,1553666400,40,0,40,Clouds
45367,114,1553666400,40,0,40,Clouds
45368,115,1553666400,1,29,30,Clouds
45369,2,1553670000,4,16,20,Clouds
45370,3,1553670000,17,3,20,Clouds
45371,4,1553670000,20,0,20,Clouds
45372,5,1553670000,26,14,40,Clouds
45373,6,1553670000,19,1,20,Clouds
45374,7,1553670000,13,16,29,Clouds
45375,8,1553670000,25,5,30,Clouds
45376,9,1553670000,22,2,24,Clouds
45377,10,1553670000,12,4,16,Clouds
45378,11,1553670000,29,1,30,Clouds
45379,12,1553670000,2,18,20,Clouds
45380,13,1553670000,29,0,29,Clouds
45381,14,1553670000,22,8,30,Clouds
45382,15,1553670000,10,6,16,Clouds
45383,16,1553670000,19,1,20,Clouds
45384,17,1553670000,19,1,20,Clouds
45385,18,1553670000,21,9,30,Clouds
45386,19,1553670000,28,2,30,Clouds
45387,21,1553670000,29,1,30,Clouds
45388,22,1553670000,19,1,20,Clouds
45389,23,1553670000,28,2,30,Clouds
45390,24,1553670000,17,3,20,Clouds
45391,25,1553670000,29,1,30,Clouds
45392,26,1553670000,20,0,20,Clouds
45393,27,1553670000,16,4,20,Clouds
45394,28,1553670000,10,20,30,Clouds
45395,29,1553670000,27,2,29,Clouds
45396,30,1553670000,17,3,20,Clouds
45397,31,1553670000,6,14,20,Clouds
45398,32,1553670000,26,4,30,Clouds
45399,33,1553670000,17,6,23,Clouds
45400,34,1553670000,8,22,30,Clouds
45401,35,1553670000,16,14,30,Clouds
45402,36,1553670000,38,2,40,Clouds
45403,37,1553670000,30,0,30,Clouds
45404,38,1553670000,39,1,40,Clouds
45405,39,1553670000,20,0,20,Clouds
45406,40,1553670000,20,1,21,Clouds
45407,41,1553670000,20,0,20,Clouds
45408,42,1553670000,3,27,30,Clouds
45409,43,1553670000,7,23,30,Clouds
45410,44,1553670000,12,18,30,Clouds
45411,45,1553670000,30,0,30,Clouds
45412,46,1553670000,20,0,20,Clouds
45413,47,1553670000,40,0,40,Clouds
45414,48,1553670000,38,2,40,Clouds
45415,49,1553670000,35,5,40,Clouds
45416,50,1553670000,3,37,40,Clouds
45417,51,1553670000,38,2,40,Clouds
45418,52,1553670000,26,6,32,Clouds
45419,53,1553670000,40,0,40,Clouds
45420,54,1553670000,33,0,33,Clouds
45421,55,1553670000,35,1,36,Clouds
45422,56,1553670000,40,0,40,Clouds
45423,57,1553670000,20,3,23,Clouds
45424,58,1553670000,40,0,40,Clouds
45425,59,1553670000,18,2,20,Clouds
45426,60,1553670000,5,25,30,Clouds
45427,61,1553670000,0,25,25,Clouds
45428,62,1553670000,37,3,40,Clouds
45429,63,1553670000,34,1,35,Clouds
45430,64,1553670000,40,0,40,Clouds
45431,65,1553670000,40,0,40,Clouds
45432,66,1553670000,32,8,40,Clouds
45433,67,1553670000,36,4,40,Clouds
45434,68,1553670000,38,2,40,Clouds
45435,69,1553670000,35,5,40,Clouds
45436,70,1553670000,21,7,28,Clouds
45437,71,1553670000,38,2,40,Clouds
45438,72,1553670000,5,26,31,Clouds
45439,73,1553670000,11,19,30,Clouds
45440,74,1553670000,11,19,30,Clouds
45441,75,1553670000,22,18,40,Clouds
45442,76,1553670000,17,21,38,Clouds
45443,77,1553670000,27,2,29,Clouds
45444,78,1553670000,3,37,40,Clouds
45445,79,1553670000,7,20,27,Clouds
45446,80,1553670000,19,21,40,Clouds
45447,81,1553670000,40,0,40,Clouds
45448,82,1553670000,2,20,22,Clouds
45449,83,1553670000,4,36,40,Clouds
45450,84,1553670000,6,24,30,Clouds
45451,85,1553670000,5,30,35,Clouds
45452,86,1553670000,9,29,38,Clouds
45453,87,1553670000,10,28,38,Clouds
45454,88,1553670000,1,29,30,Clouds
45455,89,1553670000,40,0,40,Clouds
45456,90,1553670000,37,3,40,Clouds
45457,91,1553670000,28,2,30,Clouds
45458,92,1553670000,5,35,40,Clouds
45459,93,1553670000,7,33,40,Clouds
45460,94,1553670000,4,36,40,Clouds
45461,95,1553670000,1,39,40,Clouds
45462,96,1553670000,10,20,30,Clouds
45463,97,1553670000,3,37,40,Clouds
45464,98,1553670000,40,0,40,Clouds
45465,99,1553670000,30,0,30,Clouds
45466,100,1553670000,0,25,25,Clouds
45467,101,1553670000,11,19,30,Clouds
45468,102,1553670000,15,25,40,Clouds
45469,103,1553670000,30,10,40,Clouds
45470,105,1553670000,34,2,36,Clouds
45471,106,1553670000,16,24,40,Clouds
45472,107,1553670000,8,32,40,Clouds
45473,108,1553670000,14,26,40,Clouds
45474,109,1553670000,18,11,29,Clouds
45475,110,1553670000,15,25,40,Clouds
45476,111,1553670000,7,33,40,Clouds
45477,112,1553670000,3,27,30,Clouds
45478,113,1553670000,39,1,40,Clouds
45479,114,1553670000,40,0,40,Clouds
45480,115,1553670000,0,30,30,Clouds
45481,2,1553673600,17,3,20,Clouds
45482,3,1553673600,19,1,20,Clouds
45483,4,1553673600,20,0,20,Clouds
45484,5,1553673600,23,17,40,Clouds
45485,6,1553673600,20,0,20,Clouds
45486,7,1553673600,15,14,29,Clouds
45487,8,1553673600,23,7,30,Clouds
45488,9,1553673600,13,11,24,Clouds
45489,10,1553673600,13,3,16,Clouds
45490,11,1553673600,30,0,30,Clouds
45491,12,1553673600,12,8,20,Clouds
45492,13,1553673600,27,2,29,Clouds
45493,14,1553673600,17,13,30,Clouds
45494,15,1553673600,12,4,16,Clouds
45495,16,1553673600,20,0,20,Clouds
45496,17,1553673600,19,1,20,Clouds
45497,18,1553673600,23,7,30,Clouds
45498,19,1553673600,27,3,30,Clouds
45499,21,1553673600,26,4,30,Clouds
45500,22,1553673600,17,3,20,Clouds
45501,23,1553673600,27,3,30,Clouds
45502,24,1553673600,12,8,20,Clouds
45503,25,1553673600,24,6,30,Clouds
45504,26,1553673600,15,5,20,Clouds
45505,27,1553673600,13,7,20,Clouds
45506,28,1553673600,18,12,30,Clouds
45507,29,1553673600,27,2,29,Clouds
45508,30,1553673600,7,13,20,Clouds
45509,31,1553673600,15,5,20,Clouds
45510,32,1553673600,25,5,30,Clouds
45511,33,1553673600,6,17,23,Clouds
45512,34,1553673600,30,0,30,Clouds
45513,35,1553673600,25,5,30,Clouds
45514,36,1553673600,36,4,40,Clouds
45515,37,1553673600,27,3,30,Clouds
45516,38,1553673600,34,6,40,Clouds
45517,39,1553673600,15,5,20,Clouds
45518,40,1553673600,14,7,21,Clouds
45519,41,1553673600,20,0,20,Clouds
45520,42,1553673600,12,17,29,Clouds
45521,43,1553673600,21,9,30,Clouds
45522,44,1553673600,22,8,30,Clouds
45523,45,1553673600,29,1,30,Clouds
45524,46,1553673600,20,0,20,Clouds
45525,47,1553673600,40,0,40,Clouds
45526,48,1553673600,40,0,40,Clouds
45527,49,1553673600,37,3,40,Clouds
45528,50,1553673600,2,38,40,Clouds
45529,51,1553673600,31,9,40,Clouds
45530,52,1553673600,27,5,32,Clouds
45531,53,1553673600,38,2,40,Clouds
45532,54,1553673600,31,2,33,Clouds
45533,55,1553673600,31,4,35,Clouds
45534,56,1553673600,39,1,40,Clouds
45535,57,1553673600,23,0,23,Clouds
45536,58,1553673600,31,9,40,Clouds
45537,59,1553673600,10,10,20,Clouds
45538,60,1553673600,22,8,30,Clouds
45539,61,1553673600,6,19,25,Clouds
45540,62,1553673600,40,0,40,Clouds
45541,63,1553673600,34,1,35,Clouds
45542,64,1553673600,35,5,40,Clouds
45543,65,1553673600,27,13,40,Clouds
45544,66,1553673600,25,15,40,Clouds
45545,67,1553673600,38,2,40,Clouds
45546,68,1553673600,28,12,40,Clouds
45547,69,1553673600,26,14,40,Clouds
45548,70,1553673600,12,16,28,Clouds
45549,71,1553673600,39,1,40,Clouds
45550,72,1553673600,9,22,31,Clouds
45551,73,1553673600,17,13,30,Clouds
45552,74,1553673600,15,15,30,Clouds
45553,75,1553673600,22,18,40,Clouds
45554,76,1553673600,25,13,38,Clouds
45555,77,1553673600,26,3,29,Clouds
45556,78,1553673600,5,35,40,Clouds
45557,79,1553673600,7,20,27,Clouds
45558,80,1553673600,19,21,40,Clouds
45559,81,1553673600,39,1,40,Clouds
45560,82,1553673600,2,20,22,Clouds
45561,83,1553673600,6,34,40,Clouds
45562,84,1553673600,7,23,30,Clouds
45563,85,1553673600,8,27,35,Clouds
45564,86,1553673600,12,26,38,Clouds
45565,87,1553673600,10,28,38,Clouds
45566,88,1553673600,8,22,30,Clouds
45567,89,1553673600,39,1,40,Clouds
45568,90,1553673600,31,9,40,Clouds
45569,91,1553673600,27,3,30,Clouds
45570,92,1553673600,8,32,40,Clouds
45571,93,1553673600,1,38,39,Clouds
45572,94,1553673600,5,35,40,Clouds
45573,95,1553673600,9,31,40,Clouds
45574,96,1553673600,11,19,30,Clouds
45575,97,1553673600,13,27,40,Clouds
45576,98,1553673600,40,0,40,Clouds
45577,99,1553673600,26,4,30,Clouds
45578,100,1553673600,8,17,25,Clouds
45579,101,1553673600,21,9,30,Clouds
45580,102,1553673600,18,22,40,Clouds
45581,103,1553673600,29,11,40,Clouds
45582,105,1553673600,33,3,36,Clouds
45583,106,1553673600,18,22,40,Clouds
45584,107,1553673600,13,27,40,Clouds
45585,108,1553673600,21,19,40,Clouds
45586,109,1553673600,26,3,29,Clouds
45587,110,1553673600,18,22,40,Clouds
45588,111,1553673600,13,27,40,Clouds
45589,112,1553673600,15,15,30,Clouds
45590,113,1553673600,35,5,40,Clouds
45591,114,1553673600,38,2,40,Clouds
45592,115,1553673600,3,27,30,Clouds
45593,2,1553677200,20,0,20,Clouds
45594,3,1553677200,18,2,20,Clouds
45595,4,1553677200,17,3,20,Clouds
45596,5,1553677200,40,0,40,Clouds
45597,6,1553677200,20,0,20,Clouds
45598,7,1553677200,24,5,29,Clouds
45599,8,1553677200,28,2,30,Clouds
45600,9,1553677200,9,15,24,Clouds
45601,10,1553677200,13,2,15,Clouds
45602,11,1553677200,25,5,30,Clouds
45603,12,1553677200,20,0,20,Clouds
45604,13,1553677200,24,5,29,Clouds
45605,14,1553677200,22,8,30,Clouds
45606,15,1553677200,16,0,16,Clouds
45607,16,1553677200,16,4,20,Clouds
45608,17,1553677200,13,7,20,Clouds
45609,18,1553677200,29,1,30,Clouds
45610,19,1553677200,8,22,30,Clouds
45611,21,1553677200,24,6,30,Clouds
45612,22,1553677200,15,5,20,Clouds
45613,23,1553677200,25,5,30,Clouds
45614,24,1553677200,17,3,20,Clouds
45615,25,1553677200,20,10,30,Clouds
45616,26,1553677200,14,6,20,Clouds
45617,27,1553677200,2,18,20,Clouds
45618,28,1553677200,30,0,30,Clouds
45619,29,1553677200,28,1,29,Clouds
45620,30,1553677200,6,14,20,Clouds
45621,31,1553677200,17,3,20,Clouds
45622,32,1553677200,19,11,30,Clouds
45623,33,1553677200,0,23,23,Clouds
45624,34,1553677200,30,0,30,Clouds
45625,35,1553677200,24,5,29,Clouds
45626,36,1553677200,28,12,40,Clouds
45627,37,1553677200,27,3,30,Clouds
45628,38,1553677200,34,6,40,Clouds
45629,39,1553677200,19,1,20,Clouds
45630,40,1553677200,8,13,21,Clouds
45631,41,1553677200,20,0,20,Clouds
45632,42,1553677200,21,9,30,Clouds
45633,43,1553677200,25,5,30,Clouds
45634,44,1553677200,29,1,30,Clouds
45635,45,1553677200,29,1,30,Clouds
45636,46,1553677200,19,1,20,Clouds
45637,47,1553677200,33,7,40,Clouds
45638,48,1553677200,31,9,40,Clouds
45639,49,1553677200,24,15,39,Clouds
45640,50,1553677200,20,20,40,Clouds
45641,51,1553677200,38,2,40,Clouds
45642,52,1553677200,25,7,32,Clouds
45643,53,1553677200,31,9,40,Clouds
45644,54,1553677200,29,4,33,Clouds
45645,55,1553677200,23,12,35,Clouds
45646,56,1553677200,18,22,40,Clouds
45647,57,1553677200,15,8,23,Clouds
45648,58,1553677200,19,21,40,Clouds
45649,59,1553677200,8,12,20,Clouds
45650,60,1553677200,26,4,30,Clouds
45651,61,1553677200,7,18,25,Clouds
45652,62,1553677200,30,10,40,Clouds
45653,63,1553677200,23,12,35,Clouds
45654,64,1553677200,25,15,40,Clouds
45655,65,1553677200,35,5,40,Clouds
45656,66,1553677200,22,18,40,Clouds
45657,67,1553677200,34,6,40,Clouds
45658,68,1553677200,17,23,40,Clouds
45659,69,1553677200,24,16,40,Clouds
45660,70,1553677200,14,14,28,Clouds
45661,71,1553677200,37,3,40,Clouds
45662,72,1553677200,20,11,31,Clouds
45663,73,1553677200,29,1,30,Clouds
45664,74,1553677200,27,3,30,Clouds
45665,75,1553677200,35,5,40,Clouds
45666,76,1553677200,34,4,38,Clouds
45667,77,1553677200,28,1,29,Clouds
45668,78,1553677200,13,27,40,Clouds
45669,79,1553677200,8,19,27,Clouds
45670,80,1553677200,20,20,40,Clouds
45671,81,1553677200,34,6,40,Clouds
45672,82,1553677200,8,14,22,Clouds
45673,83,1553677200,17,23,40,Clouds
45674,84,1553677200,23,7,30,Clouds
45675,85,1553677200,30,5,35,Clouds
45676,86,1553677200,35,3,38,Clouds
45677,87,1553677200,21,17,38,Clouds
45678,88,1553677200,14,16,30,Clouds
45679,89,1553677200,35,5,40,Clouds
45680,90,1553677200,7,33,40,Clouds
45681,91,1553677200,30,0,30,Clouds
45682,92,1553677200,25,15,40,Clouds
45683,93,1553677200,20,19,39,Clouds
45684,94,1553677200,10,30,40,Clouds
45685,95,1553677200,27,13,40,Clouds
45686,96,1553677200,14,16,30,Clouds
45687,97,1553677200,35,4,39,Clouds
45688,98,1553677200,37,3,40,Clouds
45689,99,1553677200,25,5,30,Clouds
45690,100,1553677200,24,1,25,Clouds
45691,101,1553677200,30,0,30,Clouds
45692,102,1553677200,27,13,40,Clouds
45693,103,1553677200,26,14,40,Clouds
45694,104,1553677200,30,10,40,Clouds
45695,105,1553677200,33,3,36,Clouds
45696,106,1553677200,19,21,40,Clouds
45697,107,1553677200,26,14,40,Clouds
45698,108,1553677200,26,14,40,Clouds
45699,109,1553677200,27,2,29,Clouds
45700,110,1553677200,26,14,40,Clouds
45701,111,1553677200,27,13,40,Clouds
45702,112,1553677200,28,2,30,Clouds
45703,113,1553677200,33,7,40,Clouds
45704,114,1553677200,35,5,40,Clouds
45705,115,1553677200,11,19,30,Clouds
45706,2,1553680800,20,0,20,Clouds
45707,3,1553680800,16,4,20,Clouds
45708,4,1553680800,14,6,20,Clouds
45709,5,1553680800,40,0,40,Clouds
45710,6,1553680800,20,0,20,Clouds
45711,7,1553680800,29,0,29,Clouds
45712,8,1553680800,19,11,30,Clouds
45713,9,1553680800,14,10,24,Clouds
45714,10,1553680800,10,5,15,Clouds
45715,11,1553680800,6,24,30,Clouds
45716,12,1553680800,20,0,20,Clouds
45717,13,1553680800,10,19,29,Clouds
45718,14,1553680800,26,4,30,Clouds
45719,15,1553680800,11,5,16,Clouds
45720,16,1553680800,19,1,20,Clouds
45721,17,1553680800,17,3,20,Clouds
45722,18,1553680800,29,1,30,Clouds
45723,19,1553680800,0,30,30,Clouds
45724,21,1553680800,3,27,30,Clouds
45725,22,1553680800,17,3,20,Clouds
45726,23,1553680800,20,10,30,Clouds
45727,24,1553680800,8,12,20,Clouds
45728,25,1553680800,5,25,30,Clouds
45729,26,1553680800,8,12,20,Clouds
45730,27,1553680800,2,18,20,Clouds
45731,28,1553680800,30,0,30,Clouds
45732,29,1553680800,27,2,29,Clouds
45733,30,1553680800,9,11,20,Clouds
45734,31,1553680800,19,1,20,Clouds
45735,32,1553680800,24,6,30,Clouds
45736,33,1553680800,0,23,23,Clouds
45737,34,1553680800,25,5,30,Clouds
45738,35,1553680800,28,1,29,Clouds
45739,36,1553680800,6,34,40,Clouds
45740,37,1553680800,18,12,30,Clouds
45741,38,1553680800,40,0,40,Clouds
45742,39,1553680800,20,0,20,Clouds
45743,40,1553680800,6,15,21,Clouds
45744,41,1553680800,11,9,20,Clouds
45745,42,1553680800,30,0,30,Clouds
45746,43,1553680800,30,0,30,Clouds
45747,44,1553680800,30,0,30,Clouds
45748,45,1553680800,30,0,30,Clouds
45749,46,1553680800,18,2,20,Clouds
45750,47,1553680800,9,31,40,Clouds
45751,48,1553680800,13,27,40,Clouds
45752,49,1553680800,3,36,39,Clouds
45753,50,1553680800,40,0,40,Clouds
45754,51,1553680800,34,6,40,Clouds
45755,52,1553680800,7,25,32,Clouds
45756,53,1553680800,24,16,40,Clouds
45757,54,1553680800,27,6,33,Clouds
45758,55,1553680800,19,16,35,Clouds
45759,56,1553680800,0,40,40,Clouds
45760,57,1553680800,5,18,23,Clouds
45761,58,1553680800,1,39,40,Clouds
45762,59,1553680800,20,0,20,Clouds
45763,60,1553680800,30,0,30,Clouds
45764,61,1553680800,25,0,25,Clouds
45765,62,1553680800,5,35,40,Clouds
45766,63,1553680800,6,29,35,Clouds
45767,64,1553680800,0,40,40,Clouds
45768,65,1553680800,25,15,40,Clouds
45769,66,1553680800,9,31,40,Clouds
45770,67,1553680800,33,7,40,Clouds
45771,68,1553680800,5,35,40,Clouds
45772,69,1553680800,9,31,40,Clouds
45773,70,1553680800,25,3,28,Clouds
45774,71,1553680800,39,1,40,Clouds
45775,72,1553680800,31,0,31,Clouds
45776,73,1553680800,29,1,30,Clouds
45777,74,1553680800,28,2,30,Clouds
45778,75,1553680800,40,0,40,Clouds
45779,76,1553680800,38,0,38,Clouds
45780,77,1553680800,27,2,29,Clouds
45781,78,1553680800,40,0,40,Clouds
45782,79,1553680800,26,1,27,Clouds
45783,80,1553680800,40,0,40,Clouds
45784,81,1553680800,40,0,40,Clouds
45785,82,1553680800,22,0,22,Clouds
45786,83,1553680800,40,0,40,Clouds
45787,84,1553680800,30,0,30,Clouds
45788,85,1553680800,35,0,35,Clouds
45789,86,1553680800,37,1,38,Clouds
45790,87,1553680800,38,0,38,Clouds
45791,88,1553680800,28,2,30,Clouds
45792,89,1553680800,35,5,40,Clouds
45793,90,1553680800,2,38,40,Clouds
45794,91,1553680800,26,4,30,Clouds
45795,92,1553680800,40,0,40,Clouds
45796,93,1553680800,40,0,40,Clouds
45797,94,1553680800,40,0,40,Clouds
45798,95,1553680800,40,0,40,Clouds
45799,96,1553680800,30,0,30,Clouds
45800,97,1553680800,38,1,39,Clouds
45801,98,1553680800,35,5,40,Clouds
45802,99,1553680800,8,22,30,Clouds
45803,100,1553680800,25,0,25,Clouds
45804,101,1553680800,30,0,30,Clouds
45805,102,1553680800,40,0,40,Clouds
45806,103,1553680800,32,8,40,Clouds
45807,104,1553680800,29,11,40,Clouds
45808,105,1553680800,36,0,36,Clouds
45809,106,1553680800,31,9,40,Clouds
45810,107,1553680800,38,2,40,Clouds
45811,108,1553680800,39,1,40,Clouds
45812,109,1553680800,28,1,29,Clouds
45813,110,1553680800,34,6,40,Clouds
45814,111,1553680800,40,0,40,Clouds
45815,112,1553680800,30,0,30,Clouds
45816,113,1553680800,28,12,40,Clouds
45817,114,1553680800,16,24,40,Clouds
45818,115,1553680800,30,0,30,Clouds
45819,2,1553684400,20,0,20,Clouds
45820,3,1553684400,13,7,20,Clouds
45821,4,1553684400,16,3,19,Clouds
45822,5,1553684400,25,15,40,Clouds
45823,6,1553684400,18,2,20,Clouds
45824,7,1553684400,29,0,29,Clouds
45825,8,1553684400,18,12,30,Clouds
45826,9,1553684400,12,12,24,Clouds
45827,10,1553684400,10,5,15,Clouds
45828,11,1553684400,2,28,30,Clouds
45829,12,1553684400,16,4,20,Clouds
45830,13,1553684400,5,24,29,Clouds
45831,14,1553684400,8,22,30,Clouds
45832,15,1553684400,14,2,16,Clouds
45833,16,1553684400,14,6,20,Clouds
45834,17,1553684400,20,0,20,Clouds
45835,18,1553684400,27,3,30,Clouds
45836,19,1553684400,17,12,29,Clouds
45837,21,1553684400,0,30,30,Clouds
45838,22,1553684400,17,3,20,Clouds
45839,23,1553684400,26,3,29,Clouds
45840,24,1553684400,5,15,20,Clouds
45841,25,1553684400,1,29,30,Clouds
45842,26,1553684400,0,20,20,Clouds
45843,27,1553684400,0,20,20,Clouds
45844,28,1553684400,30,0,30,Clouds
45845,29,1553684400,27,2,29,Clouds
45846,30,1553684400,9,11,20,Clouds
45847,31,1553684400,13,7,20,Clouds
45848,32,1553684400,17,13,30,Clouds
45849,33,1553684400,0,23,23,Clouds
45850,34,1553684400,21,9,30,Clouds
45851,35,1553684400,30,0,30,Clouds
45852,36,1553684400,1,39,40,Clouds
45853,37,1553684400,14,16,30,Clouds
45854,38,1553684400,37,3,40,Clouds
45855,39,1553684400,20,0,20,Clouds
45856,40,1553684400,2,19,21,Clouds
45857,41,1553684400,14,6,20,Clouds
45858,42,1553684400,28,2,30,Clouds
45859,43,1553684400,30,0,30,Clouds
45860,44,1553684400,30,0,30,Clouds
45861,45,1553684400,30,0,30,Clouds
45862,46,1553684400,18,2,20,Clouds
45863,47,1553684400,3,37,40,Clouds
45864,48,1553684400,4,35,39,Clouds
45865,49,1553684400,0,39,39,Clouds
45866,50,1553684400,40,0,40,Clouds
45867,51,1553684400,30,10,40,Clouds
45868,52,1553684400,8,24,32,Clouds
45869,53,1553684400,16,24,40,Clouds
45870,54,1553684400,21,12,33,Clouds
45871,55,1553684400,22,13,35,Clouds
45872,56,1553684400,4,36,40,Clouds
45873,57,1553684400,0,23,23,Clouds
45874,58,1553684400,0,40,40,Clouds
45875,59,1553684400,20,0,20,Clouds
45876,60,1553684400,30,0,30,Clouds
45877,61,1553684400,25,0,25,Clouds
45878,62,1553684400,0,39,39,Clouds
45879,63,1553684400,1,34,35,Clouds
45880,64,1553684400,0,39,39,Clouds
45881,65,1553684400,7,32,39,Clouds
45882,66,1553684400,0,40,40,Clouds
45883,67,1553684400,29,11,40,Clouds
45884,68,1553684400,13,27,40,Clouds
45885,69,1553684400,1,37,38,Clouds
45886,70,1553684400,19,8,27,Clouds
45887,71,1553684400,33,7,40,Clouds
45888,72,1553684400,31,0,31,Clouds
45889,73,1553684400,30,0,30,Clouds
45890,74,1553684400,30,0,30,Clouds
45891,75,1553684400,40,0,40,Clouds
45892,76,1553684400,38,0,38,Clouds
45893,77,1553684400,28,1,29,Clouds
45894,78,1553684400,40,0,40,Clouds
45895,79,1553684400,26,1,27,Clouds
45896,80,1553684400,38,2,40,Clouds
45897,81,1553684400,38,2,40,Clouds
45898,82,1553684400,22,0,22,Clouds
45899,83,1553684400,40,0,40,Clouds
45900,84,1553684400,30,0,30,Clouds
45901,85,1553684400,35,0,35,Clouds
45902,86,1553684400,37,1,38,Clouds
45903,87,1553684400,36,2,38,Clouds
45904,88,1553684400,29,1,30,Clouds
45905,89,1553684400,28,11,39,Clouds
45906,90,1553684400,0,40,40,Clouds
45907,91,1553684400,23,6,29,Clouds
45908,92,1553684400,39,1,40,Clouds
45909,93,1553684400,40,0,40,Clouds
45910,94,1553684400,40,0,40,Clouds
45911,95,1553684400,40,0,40,Clouds
45912,96,1553684400,30,0,30,Clouds
45913,97,1553684400,40,0,40,Clouds
45914,98,1553684400,26,14,40,Clouds
45915,99,1553684400,2,28,30,Clouds
45916,100,1553684400,21,4,25,Clouds
45917,101,1553684400,30,0,30,Clouds
45918,102,1553684400,40,0,40,Clouds
45919,103,1553684400,31,9,40,Clouds
45920,104,1553684400,31,9,40,Clouds
45921,105,1553684400,34,2,36,Clouds
45922,106,1553684400,37,3,40,Clouds
45923,107,1553684400,40,0,40,Clouds
45924,108,1553684400,40,0,40,Clouds
45925,109,1553684400,29,0,29,Clouds
45926,110,1553684400,40,0,40,Clouds
45927,111,1553684400,40,0,40,Clouds
45928,112,1553684400,30,0,30,Clouds
45929,113,1553684400,7,33,40,Clouds
45930,114,1553684400,1,39,40,Clouds
45931,115,1553684400,26,4,30,Clouds
45932,2,1553688000,20,0,20,Clouds
45933,3,1553688000,14,6,20,Clouds
45934,4,1553688000,17,2,19,Clouds
45935,5,1553688000,34,6,40,Clouds
45936,6,1553688000,20,0,20,Clouds
45937,7,1553688000,29,0,29,Clouds
45938,8,1553688000,13,17,30,Clouds
45939,9,1553688000,4,20,24,Clouds
45940,10,1553688000,10,5,15,Clouds
45941,11,1553688000,4,26,30,Clouds
45942,12,1553688000,19,1,20,Clouds
45943,13,1553688000,3,26,29,Clouds
45944,14,1553688000,13,17,30,Clouds
45945,15,1553688000,16,0,16,Clouds
45946,16,1553688000,16,4,20,Clouds
45947,17,1553688000,19,1,20,Clouds
45948,18,1553688000,30,0,30,Clouds
45949,19,1553688000,20,9,29,Clouds
45950,21,1553688000,1,29,30,Clouds
45951,22,1553688000,17,3,20,Clouds
45952,23,1553688000,26,3,29,Clouds
45953,24,1553688000,9,11,20,Clouds
45954,25,1553688000,1,29,30,Clouds
45955,26,1553688000,7,13,20,Clouds
45956,27,1553688000,0,20,20,Clouds
45957,28,1553688000,30,0,30,Clouds
45958,29,1553688000,22,7,29,Clouds
45959,30,1553688000,7,13,20,Clouds
45960,31,1553688000,20,0,20,Clouds
45961,32,1553688000,3,27,30,Clouds
45962,33,1553688000,1,22,23,Clouds
45963,34,1553688000,19,11,30,Clouds
45964,35,1553688000,28,2,30,Clouds
45965,36,1553688000,0,40,40,Clouds
45966,37,1553688000,13,17,30,Clouds
45967,38,1553688000,37,3,40,Clouds
45968,39,1553688000,18,2,20,Clouds
45969,40,1553688000,6,15,21,Clouds
45970,41,1553688000,18,2,20,Clouds
45971,42,1553688000,29,1,30,Clouds
45972,43,1553688000,22,8,30,Clouds
45973,44,1553688000,30,0,30,Clouds
45974,45,1553688000,30,0,30,Clouds
45975,46,1553688000,15,5,20,Clouds
45976,47,1553688000,0,40,40,Clouds
45977,48,1553688000,2,37,39,Clouds
45978,49,1553688000,0,38,38,Clouds
45979,50,1553688000,39,1,40,Clouds
45980,51,1553688000,28,12,40,Clouds
45981,52,1553688000,9,23,32,Clouds
45982,53,1553688000,15,25,40,Clouds
45983,54,1553688000,21,12,33,Clouds
45984,55,1553688000,20,15,35,Clouds
45985,56,1553688000,4,36,40,Clouds
45986,57,1553688000,1,22,23,Clouds
45987,58,1553688000,16,24,40,Clouds
45988,59,1553688000,20,0,20,Clouds
45989,60,1553688000,27,3,30,Clouds
45990,61,1553688000,18,7,25,Clouds
45991,62,1553688000,1,38,39,Clouds
45992,63,1553688000,3,32,35,Clouds
45993,64,1553688000,3,36,39,Clouds
45994,65,1553688000,2,37,39,Clouds
45995,66,1553688000,5,33,38,Clouds
45996,67,1553688000,29,10,39,Clouds
45997,68,1553688000,3,37,40,Clouds
45998,69,1553688000,1,37,38,Clouds
45999,70,1553688000,19,8,27,Clouds
46000,71,1553688000,37,3,40,Clouds
46001,72,1553688000,31,0,31,Clouds
46002,73,1553688000,28,2,30,Clouds
46003,74,1553688000,30,0,30,Clouds
46004,75,1553688000,40,0,40,Clouds
46005,76,1553688000,19,19,38,Clouds
46006,77,1553688000,29,0,29,Clouds
46007,78,1553688000,40,0,40,Clouds
46008,79,1553688000,26,1,27,Clouds
46009,80,1553688000,40,0,40,Clouds
46010,81,1553688000,40,0,40,Clouds
46011,82,1553688000,22,0,22,Clouds
46012,83,1553688000,40,0,40,Clouds
46013,84,1553688000,29,1,30,Clouds
46014,85,1553688000,35,0,35,Clouds
46015,86,1553688000,37,1,38,Clouds
46016,87,1553688000,38,0,38,Clouds
46017,88,1553688000,29,1,30,Clouds
46018,89,1553688000,23,15,38,Clouds
46019,90,1553688000,1,39,40,Clouds
46020,91,1553688000,27,2,29,Clouds
46021,92,1553688000,40,0,40,Clouds
46022,93,1553688000,40,0,40,Clouds
46023,94,1553688000,40,0,40,Clouds
46024,95,1553688000,40,0,40,Clouds
46025,96,1553688000,30,0,30,Clouds
46026,97,1553688000,39,1,40,Clouds
46027,98,1553688000,26,14,40,Clouds
46028,99,1553688000,1,29,30,Clouds
46029,100,1553688000,24,1,25,Clouds
46030,101,1553688000,30,0,30,Clouds
46031,102,1553688000,40,0,40,Clouds
46032,103,1553688000,32,8,40,Clouds
46033,104,1553688000,31,9,40,Clouds
46034,105,1553688000,35,1,36,Clouds
46035,106,1553688000,40,0,40,Clouds
46036,107,1553688000,40,0,40,Clouds
46037,108,1553688000,40,0,40,Clouds
46038,109,1553688000,29,0,29,Clouds
46039,110,1553688000,40,0,40,Clouds
46040,111,1553688000,40,0,40,Clouds
46041,112,1553688000,28,2,30,Clouds
46042,113,1553688000,5,35,40,Clouds
46043,114,1553688000,0,40,40,Clouds
46044,115,1553688000,10,20,30,Clouds
46045,2,1553691600,19,1,20,Clouds
46046,3,1553691600,13,7,20,Clouds
46047,4,1553691600,15,4,19,Clouds
46048,5,1553691600,34,6,40,Clouds
46049,6,1553691600,20,0,20,Clouds
46050,7,1553691600,28,1,29,Clouds
46051,8,1553691600,9,21,30,Clouds
46052,9,1553691600,2,22,24,Clouds
46053,10,1553691600,11,4,15,Clouds
46054,11,1553691600,5,25,30,Clouds
46055,12,1553691600,20,0,20,Clouds
46056,13,1553691600,0,28,28,Clouds
46057,14,1553691600,9,21,30,Clouds
46058,15,1553691600,16,0,16,Clouds
46059,16,1553691600,15,5,20,Clouds
46060,17,1553691600,19,1,20,Clouds
46061,18,1553691600,29,1,30,Clouds
46062,19,1553691600,18,11,29,Clouds
46063,21,1553691600,1,29,30,Clouds
46064,22,1553691600,14,6,20,Clouds
46065,23,1553691600,26,3,29,Clouds
46066,24,1553691600,17,3,20,Clouds
46067,25,1553691600,2,28,30,Clouds
46068,26,1553691600,5,15,20,Clouds
46069,27,1553691600,5,15,20,Clouds
46070,28,1553691600,28,2,30,Clouds
46071,29,1553691600,21,8,29,Clouds
46072,30,1553691600,11,9,20,Clouds
46073,31,1553691600,18,2,20,Clouds
46074,32,1553691600,5,25,30,Clouds
46075,33,1553691600,3,20,23,Clouds
46076,34,1553691600,23,7,30,Clouds
46077,35,1553691600,29,1,30,Clouds
46078,36,1553691600,0,40,40,Clouds
46079,37,1553691600,13,17,30,Clouds
46080,38,1553691600,38,2,40,Clouds
46081,39,1553691600,16,4,20,Clouds
46082,40,1553691600,13,8,21,Clouds
46083,41,1553691600,19,1,20,Clouds
46084,42,1553691600,29,1,30,Clouds
46085,43,1553691600,23,7,30,Clouds
46086,44,1553691600,30,0,30,Clouds
46087,45,1553691600,29,1,30,Clouds
46088,46,1553691600,15,5,20,Clouds
46089,47,1553691600,1,39,40,Clouds
46090,48,1553691600,7,33,40,Clouds
46091,49,1553691600,9,31,40,Clouds
46092,50,1553691600,40,0,40,Clouds
46093,51,1553691600,27,13,40,Clouds
46094,52,1553691600,5,27,32,Clouds
46095,53,1553691600,12,28,40,Clouds
46096,54,1553691600,23,10,33,Clouds
46097,55,1553691600,22,13,35,Clouds
46098,56,1553691600,5,35,40,Clouds
46099,57,1553691600,0,23,23,Clouds
46100,58,1553691600,20,20,40,Clouds
46101,59,1553691600,18,2,20,Clouds
46102,60,1553691600,28,2,30,Clouds
46103,61,1553691600,19,6,25,Clouds
46104,62,1553691600,3,37,40,Clouds
46105,63,1553691600,2,33,35,Clouds
46106,64,1553691600,3,37,40,Clouds
46107,65,1553691600,2,38,40,Clouds
46108,66,1553691600,10,30,40,Clouds
46109,67,1553691600,35,5,40,Clouds
46110,68,1553691600,8,32,40,Clouds
46111,69,1553691600,4,36,40,Clouds
46112,70,1553691600,19,8,27,Clouds
46113,71,1553691600,36,4,40,Clouds
46114,72,1553691600,31,0,31,Clouds
46115,73,1553691600,28,2,30,Clouds
46116,74,1553691600,29,1,30,Clouds
46117,75,1553691600,40,0,40,Clouds
46118,76,1553691600,22,16,38,Clouds
46119,77,1553691600,29,0,29,Clouds
46120,78,1553691600,39,1,40,Clouds
46121,79,1553691600,27,0,27,Clouds
46122,80,1553691600,38,2,40,Clouds
46123,81,1553691600,40,0,40,Clouds
46124,82,1553691600,22,0,22,Clouds
46125,83,1553691600,40,0,40,Clouds
46126,84,1553691600,30,0,30,Clouds
46127,85,1553691600,35,0,35,Clouds
46128,86,1553691600,38,0,38,Clouds
46129,87,1553691600,38,0,38,Clouds
46130,88,1553691600,28,2,30,Clouds
46131,89,1553691600,18,21,39,Clouds
46132,90,1553691600,9,31,40,Clouds
46133,91,1553691600,30,0,30,Clouds
46134,92,1553691600,40,0,40,Clouds
46135,93,1553691600,40,0,40,Clouds
46136,94,1553691600,40,0,40,Clouds
46137,95,1553691600,38,2,40,Clouds
46138,96,1553691600,29,1,30,Clouds
46139,97,1553691600,39,1,40,Clouds
46140,98,1553691600,15,25,40,Clouds
46141,99,1553691600,2,28,30,Clouds
46142,100,1553691600,24,1,25,Clouds
46143,101,1553691600,30,0,30,Clouds
46144,102,1553691600,40,0,40,Clouds
46145,103,1553691600,34,6,40,Clouds
46146,104,1553691600,33,7,40,Clouds
46147,105,1553691600,36,0,36,Clouds
46148,106,1553691600,40,0,40,Clouds
46149,107,1553691600,39,1,40,Clouds
46150,108,1553691600,40,0,40,Clouds
46151,109,1553691600,27,2,29,Clouds
46152,110,1553691600,40,0,40,Clouds
46153,111,1553691600,38,2,40,Clouds
46154,112,1553691600,30,0,30,Clouds
46155,113,1553691600,6,34,40,Clouds
46156,114,1553691600,1,39,40,Clouds
46157,115,1553691600,11,19,30,Clouds
46158,2,1553695200,20,0,20,Clouds
46159,3,1553695200,20,0,20,Clouds
46160,4,1553695200,16,3,19,Clouds
46161,5,1553695200,35,5,40,Clouds
46162,6,1553695200,20,0,20,Clouds
46163,7,1553695200,29,0,29,Clouds
46164,8,1553695200,19,11,30,Clouds
46165,9,1553695200,2,22,24,Clouds
46166,10,1553695200,10,5,15,Clouds
46167,11,1553695200,15,15,30,Clouds
46168,12,1553695200,19,1,20,Clouds
46169,13,1553695200,12,18,30,Clouds
46170,14,1553695200,23,7,30,Clouds
46171,15,1553695200,16,0,16,Clouds
46172,16,1553695200,18,2,20,Clouds
46173,17,1553695200,20,0,20,Clouds
46174,18,1553695200,26,4,30,Clouds
46175,19,1553695200,12,18,30,Clouds
46176,21,1553695200,18,10,28,Clouds
46177,22,1553695200,5,15,20,Clouds
46178,23,1553695200,30,0,30,Clouds
46179,24,1553695200,20,0,20,Clouds
46180,25,1553695200,1,29,30,Clouds
46181,26,1553695200,1,19,20,Clouds
46182,27,1553695200,2,18,20,Clouds
46183,28,1553695200,16,14,30,Clouds
46184,29,1553695200,26,3,29,Clouds
46185,30,1553695200,16,4,20,Clouds
46186,31,1553695200,18,2,20,Clouds
46187,32,1553695200,3,27,30,Clouds
46188,33,1553695200,5,18,23,Clouds
46189,34,1553695200,20,10,30,Clouds
46190,35,1553695200,28,2,30,Clouds
46191,36,1553695200,5,35,40,Clouds
46192,37,1553695200,12,18,30,Clouds
46193,38,1553695200,39,1,40,Clouds
46194,39,1553695200,17,3,20,Clouds
46195,40,1553695200,19,2,21,Clouds
46196,41,1553695200,18,2,20,Clouds
46197,42,1553695200,30,0,30,Clouds
46198,43,1553695200,22,8,30,Clouds
46199,44,1553695200,28,2,30,Clouds
46200,45,1553695200,30,0,30,Clouds
46201,46,1553695200,14,6,20,Clouds
46202,47,1553695200,7,33,40,Clouds
46203,48,1553695200,6,33,39,Clouds
46204,49,1553695200,12,28,40,Clouds
46205,50,1553695200,38,2,40,Clouds
46206,51,1553695200,27,13,40,Clouds
46207,52,1553695200,1,31,32,Clouds
46208,53,1553695200,6,32,38,Clouds
46209,54,1553695200,21,12,33,Clouds
46210,55,1553695200,32,3,35,Clouds
46211,56,1553695200,14,26,40,Clouds
46212,57,1553695200,4,19,23,Clouds
46213,58,1553695200,33,7,40,Clouds
46214,59,1553695200,20,0,20,Clouds
46215,60,1553695200,29,1,30,Clouds
46216,61,1553695200,25,0,25,Clouds
46217,62,1553695200,9,31,40,Clouds
46218,63,1553695200,0,35,35,Clouds
46219,64,1553695200,9,30,39,Clouds
46220,65,1553695200,10,30,40,Clouds
46221,66,1553695200,27,13,40,Clouds
46222,67,1553695200,15,25,40,Clouds
46223,68,1553695200,11,29,40,Clouds
46224,69,1553695200,0,39,39,Clouds
46225,70,1553695200,26,1,27,Clouds
46226,71,1553695200,34,6,40,Clouds
46227,72,1553695200,31,0,31,Clouds
46228,73,1553695200,30,0,30,Clouds
46229,74,1553695200,28,2,30,Clouds
46230,75,1553695200,40,0,40,Clouds
46231,76,1553695200,23,15,38,Clouds
46232,77,1553695200,27,2,29,Clouds
46233,78,1553695200,40,0,40,Clouds
46234,79,1553695200,27,0,27,Clouds
46235,80,1553695200,25,15,40,Clouds
46236,81,1553695200,40,0,40,Clouds
46237,82,1553695200,22,0,22,Clouds
46238,83,1553695200,40,0,40,Clouds
46239,84,1553695200,29,1,30,Clouds
46240,85,1553695200,34,1,35,Clouds
46241,86,1553695200,37,1,38,Clouds
46242,87,1553695200,38,0,38,Clouds
46243,88,1553695200,25,5,30,Clouds
46244,89,1553695200,14,26,40,Clouds
46245,90,1553695200,15,25,40,Clouds
46246,91,1553695200,25,5,30,Clouds
46247,92,1553695200,31,9,40,Clouds
46248,93,1553695200,40,0,40,Clouds
46249,94,1553695200,40,0,40,Clouds
46250,95,1553695200,40,0,40,Clouds
46251,96,1553695200,30,0,30,Clouds
46252,97,1553695200,38,2,40,Clouds
46253,98,1553695200,17,23,40,Clouds
46254,99,1553695200,3,27,30,Clouds
46255,100,1553695200,22,3,25,Clouds
46256,101,1553695200,29,1,30,Clouds
46257,102,1553695200,40,0,40,Clouds
46258,103,1553695200,35,5,40,Clouds
46259,104,1553695200,33,7,40,Clouds
46260,105,1553695200,36,0,36,Clouds
46261,106,1553695200,40,0,40,Clouds
46262,107,1553695200,40,0,40,Clouds
46263,108,1553695200,40,0,40,Clouds
46264,109,1553695200,28,1,29,Clouds
46265,110,1553695200,40,0,40,Clouds
46266,111,1553695200,40,0,40,Clouds
46267,112,1553695200,29,1,30,Clouds
46268,113,1553695200,6,34,40,Clouds
46269,114,1553695200,4,34,38,Clouds
46270,115,1553695200,2,28,30,Clouds
46271,2,1553698800,20,0,20,Clouds
46272,3,1553698800,14,6,20,Clouds
46273,4,1553698800,17,2,19,Clouds
46274,5,1553698800,32,8,40,Clouds
46275,6,1553698800,20,0,20,Clouds
46276,7,1553698800,27,2,29,Clouds
46277,8,1553698800,25,5,30,Clouds
46278,9,1553698800,11,13,24,Clouds
46279,10,1553698800,8,7,15,Clouds
46280,11,1553698800,19,11,30,Clouds
46281,12,1553698800,19,1,20,Clouds
46282,13,1553698800,0,30,30,Clouds
46283,14,1553698800,19,11,30,Clouds
46284,15,1553698800,11,5,16,Clouds
46285,16,1553698800,13,7,20,Clouds
46286,17,1553698800,18,2,20,Clouds
46287,18,1553698800,26,4,30,Clouds
46288,19,1553698800,5,25,30,Clouds
46289,21,1553698800,22,6,28,Clouds
46290,22,1553698800,16,4,20,Clouds
46291,23,1553698800,30,0,30,Clouds
46292,24,1553698800,14,6,20,Clouds
46293,25,1553698800,4,26,30,Clouds
46294,26,1553698800,0,20,20,Clouds
46295,27,1553698800,4,16,20,Clouds
46296,28,1553698800,29,1,30,Clouds
46297,29,1553698800,26,3,29,Clouds
46298,30,1553698800,7,13,20,Clouds
46299,31,1553698800,10,10,20,Clouds
46300,32,1553698800,13,17,30,Clouds
46301,33,1553698800,1,22,23,Clouds
46302,34,1553698800,28,2,30,Clouds
46303,35,1553698800,30,0,30,Clouds
46304,36,1553698800,18,22,40,Clouds
46305,37,1553698800,13,17,30,Clouds
46306,38,1553698800,36,4,40,Clouds
46307,39,1553698800,18,2,20,Clouds
46308,40,1553698800,20,1,21,Clouds
46309,41,1553698800,17,3,20,Clouds
46310,42,1553698800,29,1,30,Clouds
46311,43,1553698800,26,4,30,Clouds
46312,44,1553698800,30,0,30,Clouds
46313,45,1553698800,29,1,30,Clouds
46314,46,1553698800,17,3,20,Clouds
46315,47,1553698800,4,36,40,Clouds
46316,48,1553698800,8,31,39,Clouds
46317,49,1553698800,7,33,40,Clouds
46318,50,1553698800,35,5,40,Clouds
46319,51,1553698800,21,19,40,Clouds
46320,52,1553698800,5,27,32,Clouds
46321,53,1553698800,15,23,38,Clouds
46322,54,1553698800,25,8,33,Clouds
46323,55,1553698800,30,5,35,Clouds
46324,56,1553698800,11,29,40,Clouds
46325,57,1553698800,1,22,23,Clouds
46326,58,1553698800,27,13,40,Clouds
46327,59,1553698800,16,4,20,Clouds
46328,60,1553698800,30,0,30,Clouds
46329,61,1553698800,24,1,25,Clouds
46330,62,1553698800,5,35,40,Clouds
46331,63,1553698800,0,35,35,Clouds
46332,64,1553698800,3,36,39,Clouds
46333,65,1553698800,10,30,40,Clouds
46334,66,1553698800,22,18,40,Clouds
46335,67,1553698800,22,18,40,Clouds
46336,68,1553698800,0,40,40,Clouds
46337,69,1553698800,1,38,39,Clouds
46338,70,1553698800,22,5,27,Clouds
46339,71,1553698800,36,4,40,Clouds
46340,72,1553698800,30,1,31,Clouds
46341,73,1553698800,30,0,30,Clouds
46342,74,1553698800,29,1,30,Clouds
46343,75,1553698800,39,1,40,Clouds
46344,76,1553698800,24,14,38,Clouds
46345,77,1553698800,24,5,29,Clouds
46346,78,1553698800,40,0,40,Clouds
46347,79,1553698800,25,2,27,Clouds
46348,80,1553698800,30,10,40,Clouds
46349,81,1553698800,40,0,40,Clouds
46350,82,1553698800,22,0,22,Clouds
46351,83,1553698800,40,0,40,Clouds
46352,84,1553698800,30,0,30,Clouds
46353,85,1553698800,34,1,35,Clouds
46354,86,1553698800,38,0,38,Clouds
46355,87,1553698800,35,3,38,Clouds
46356,88,1553698800,21,9,30,Clouds
46357,89,1553698800,6,34,40,Clouds
46358,90,1553698800,7,33,40,Clouds
46359,91,1553698800,24,6,30,Clouds
46360,92,1553698800,36,4,40,Clouds
46361,93,1553698800,40,0,40,Clouds
46362,94,1553698800,40,0,40,Clouds
46363,95,1553698800,38,2,40,Clouds
46364,96,1553698800,29,1,30,Clouds
46365,97,1553698800,32,8,40,Clouds
46366,98,1553698800,19,21,40,Clouds
46367,99,1553698800,3,27,30,Clouds
46368,100,1553698800,25,0,25,Clouds
46369,101,1553698800,29,1,30,Clouds
46370,102,1553698800,40,0,40,Clouds
46371,103,1553698800,36,4,40,Clouds
46372,104,1553698800,35,5,40,Clouds
46373,105,1553698800,36,0,36,Clouds
46374,106,1553698800,40,0,40,Clouds
46375,107,1553698800,40,0,40,Clouds
46376,108,1553698800,38,2,40,Clouds
46377,109,1553698800,28,1,29,Clouds
46378,110,1553698800,40,0,40,Clouds
46379,111,1553698800,40,0,40,Clouds
46380,112,1553698800,30,0,30,Clouds
46381,113,1553698800,3,37,40,Clouds
46382,114,1553698800,8,30,38,Clouds
46383,115,1553698800,14,16,30,Clouds
46384,2,1553702400,20,0,20,Clouds
46385,3,1553702400,15,5,20,Clouds
46386,4,1553702400,16,3,19,Clouds
46387,5,1553702400,34,6,40,Clouds
46388,6,1553702400,15,5,20,Clouds
46389,7,1553702400,28,1,29,Clouds
46390,8,1553702400,21,9,30,Clouds
46391,9,1553702400,6,18,24,Clouds
46392,10,1553702400,11,4,15,Clouds
46393,11,1553702400,20,10,30,Clouds
46394,12,1553702400,20,0,20,Clouds
46395,13,1553702400,1,29,30,Clouds
46396,14,1553702400,13,17,30,Clouds
46397,15,1553702400,13,3,16,Clouds
46398,16,1553702400,11,9,20,Clouds
46399,17,1553702400,19,1,20,Clouds
46400,18,1553702400,30,0,30,Clouds
46401,19,1553702400,0,30,30,Clouds
46402,21,1553702400,19,9,28,Clouds
46403,22,1553702400,20,0,20,Clouds
46404,23,1553702400,23,7,30,Clouds
46405,24,1553702400,14,6,20,Clouds
46406,25,1553702400,5,25,30,Clouds
46407,26,1553702400,0,20,20,Clouds
46408,27,1553702400,5,15,20,Clouds
46409,28,1553702400,29,1,30,Clouds
46410,29,1553702400,22,7,29,Clouds
46411,30,1553702400,10,10,20,Clouds
46412,31,1553702400,17,3,20,Clouds
46413,32,1553702400,16,14,30,Clouds
46414,33,1553702400,0,23,23,Clouds
46415,34,1553702400,26,4,30,Clouds
46416,35,1553702400,25,5,30,Clouds
46417,36,1553702400,20,20,40,Clouds
46418,37,1553702400,15,15,30,Clouds
46419,38,1553702400,35,5,40,Clouds
46420,39,1553702400,16,4,20,Clouds
46421,40,1553702400,15,6,21,Clouds
46422,41,1553702400,13,7,20,Clouds
46423,42,1553702400,27,3,30,Clouds
46424,43,1553702400,27,3,30,Clouds
46425,44,1553702400,28,2,30,Clouds
46426,45,1553702400,28,2,30,Clouds
46427,46,1553702400,19,1,20,Clouds
46428,47,1553702400,4,36,40,Clouds
46429,48,1553702400,6,34,40,Clouds
46430,49,1553702400,11,29,40,Clouds
46431,50,1553702400,40,0,40,Clouds
46432,51,1553702400,13,27,40,Clouds
46433,52,1553702400,6,26,32,Clouds
46434,53,1553702400,16,22,38,Clouds
46435,54,1553702400,28,5,33,Clouds
46436,55,1553702400,33,2,35,Clouds
46437,56,1553702400,7,33,40,Clouds
46438,57,1553702400,0,23,23,Clouds
46439,58,1553702400,3,37,40,Clouds
46440,59,1553702400,17,3,20,Clouds
46441,60,1553702400,27,3,30,Clouds
46442,61,1553702400,25,0,25,Clouds
46443,62,1553702400,0,40,40,Clouds
46444,63,1553702400,5,30,35,Clouds
46445,64,1553702400,18,22,40,Clouds
46446,65,1553702400,1,39,40,Clouds
46447,66,1553702400,14,26,40,Clouds
46448,67,1553702400,14,26,40,Clouds
46449,68,1553702400,7,33,40,Clouds
46450,69,1553702400,10,29,39,Clouds
46451,70,1553702400,20,8,28,Clouds
46452,71,1553702400,33,7,40,Clouds
46453,72,1553702400,29,2,31,Clouds
46454,73,1553702400,25,5,30,Clouds
46455,74,1553702400,25,5,30,Clouds
46456,75,1553702400,38,2,40,Clouds
46457,76,1553702400,31,7,38,Clouds
46458,77,1553702400,22,7,29,Clouds
46459,78,1553702400,40,0,40,Clouds
46460,79,1553702400,26,1,27,Clouds
46461,80,1553702400,35,5,40,Clouds
46462,81,1553702400,40,0,40,Clouds
46463,82,1553702400,22,0,22,Clouds
46464,83,1553702400,40,0,40,Clouds
46465,84,1553702400,29,1,30,Clouds
46466,85,1553702400,35,0,35,Clouds
46467,86,1553702400,33,5,38,Clouds
46468,87,1553702400,37,1,38,Clouds
46469,88,1553702400,20,10,30,Clouds
46470,89,1553702400,2,38,40,Clouds
46471,90,1553702400,4,36,40,Clouds
46472,91,1553702400,22,8,30,Clouds
46473,92,1553702400,38,2,40,Clouds
46474,93,1553702400,40,0,40,Clouds
46475,94,1553702400,40,0,40,Clouds
46476,95,1553702400,37,3,40,Clouds
46477,96,1553702400,29,1,30,Clouds
46478,97,1553702400,27,13,40,Clouds
46479,98,1553702400,21,19,40,Clouds
46480,99,1553702400,4,26,30,Clouds
46481,100,1553702400,21,4,25,Clouds
46482,101,1553702400,29,1,30,Clouds
46483,102,1553702400,34,6,40,Clouds
46484,103,1553702400,36,4,40,Clouds
46485,104,1553702400,39,1,40,Clouds
46486,105,1553702400,36,0,36,Clouds
46487,106,1553702400,33,7,40,Clouds
46488,107,1553702400,32,8,40,Clouds
46489,108,1553702400,38,2,40,Clouds
46490,109,1553702400,25,4,29,Clouds
46491,110,1553702400,38,2,40,Clouds
46492,111,1553702400,40,0,40,Clouds
46493,112,1553702400,30,0,30,Clouds
46494,113,1553702400,0,40,40,Clouds
46495,114,1553702400,10,28,38,Clouds
46496,115,1553702400,14,16,30,Clouds
46497,2,1553706000,16,4,20,Clouds
46498,3,1553706000,20,0,20,Clouds
46499,4,1553706000,20,0,20,Clouds
46500,5,1553706000,36,4,40,Clouds
46501,6,1553706000,13,7,20,Clouds
46502,7,1553706000,9,20,29,Clouds
46503,8,1553706000,20,10,30,Clouds
46504,9,1553706000,16,8,24,Clouds
46505,10,1553706000,10,6,16,Clouds
46506,11,1553706000,14,16,30,Clouds
46507,12,1553706000,20,0,20,Clouds
46508,13,1553706000,5,25,30,Clouds
46509,14,1553706000,9,21,30,Clouds
46510,15,1553706000,13,3,16,Clouds
46511,16,1553706000,14,6,20,Clouds
46512,17,1553706000,20,0,20,Clouds
46513,18,1553706000,24,6,30,Clouds
46514,19,1553706000,6,24,30,Clouds
46515,21,1553706000,14,16,30,Clouds
46516,22,1553706000,18,2,20,Clouds
46517,23,1553706000,15,15,30,Clouds
46518,24,1553706000,19,1,20,Clouds
46519,25,1553706000,9,21,30,Clouds
46520,26,1553706000,6,14,20,Clouds
46521,27,1553706000,8,12,20,Clouds
46522,28,1553706000,30,0,30,Clouds
46523,29,1553706000,21,8,29,Clouds
46524,30,1553706000,12,8,20,Clouds
46525,31,1553706000,20,0,20,Clouds
46526,32,1553706000,4,26,30,Clouds
46527,33,1553706000,14,9,23,Clouds
46528,34,1553706000,28,2,30,Clouds
46529,35,1553706000,24,6,30,Clouds
46530,36,1553706000,16,24,40,Clouds
46531,37,1553706000,15,15,30,Clouds
46532,38,1553706000,26,14,40,Clouds
46533,39,1553706000,19,1,20,Clouds
46534,40,1553706000,19,2,21,Clouds
46535,41,1553706000,10,10,20,Clouds
46536,42,1553706000,25,5,30,Clouds
46537,43,1553706000,26,4,30,Clouds
46538,44,1553706000,25,5,30,Clouds
46539,45,1553706000,25,5,30,Clouds
46540,46,1553706000,19,1,20,Clouds
46541,47,1553706000,8,32,40,Clouds
46542,48,1553706000,4,36,40,Clouds
46543,49,1553706000,5,35,40,Clouds
46544,50,1553706000,39,1,40,Clouds
46545,51,1553706000,33,7,40,Clouds
46546,52,1553706000,8,24,32,Clouds
46547,53,1553706000,17,23,40,Clouds
46548,54,1553706000,27,6,33,Clouds
46549,55,1553706000,35,0,35,Clouds
46550,56,1553706000,11,29,40,Clouds
46551,57,1553706000,4,19,23,Clouds
46552,58,1553706000,14,26,40,Clouds
46553,59,1553706000,19,1,20,Clouds
46554,60,1553706000,24,6,30,Clouds
46555,61,1553706000,25,0,25,Clouds
46556,62,1553706000,7,33,40,Clouds
46557,63,1553706000,2,33,35,Clouds
46558,64,1553706000,18,22,40,Clouds
46559,65,1553706000,1,39,40,Clouds
46560,66,1553706000,20,20,40,Clouds
46561,67,1553706000,15,25,40,Clouds
46562,68,1553706000,10,30,40,Clouds
46563,69,1553706000,20,20,40,Clouds
46564,70,1553706000,19,9,28,Clouds
46565,71,1553706000,36,4,40,Clouds
46566,72,1553706000,28,3,31,Clouds
46567,73,1553706000,30,0,30,Clouds
46568,74,1553706000,24,6,30,Clouds
46569,75,1553706000,37,3,40,Clouds
46570,76,1553706000,33,5,38,Clouds
46571,77,1553706000,22,7,29,Clouds
46572,78,1553706000,40,0,40,Clouds
46573,79,1553706000,27,0,27,Clouds
46574,80,1553706000,40,0,40,Clouds
46575,81,1553706000,40,0,40,Clouds
46576,82,1553706000,21,1,22,Clouds
46577,83,1553706000,40,0,40,Clouds
46578,84,1553706000,30,0,30,Clouds
46579,85,1553706000,33,2,35,Clouds
46580,86,1553706000,30,8,38,Clouds
46581,87,1553706000,38,0,38,Clouds
46582,88,1553706000,22,8,30,Clouds
46583,89,1553706000,4,36,40,Clouds
46584,90,1553706000,14,26,40,Clouds
46585,91,1553706000,22,8,30,Clouds
46586,92,1553706000,37,3,40,Clouds
46587,93,1553706000,39,1,40,Clouds
46588,94,1553706000,39,1,40,Clouds
46589,95,1553706000,36,4,40,Clouds
46590,96,1553706000,29,1,30,Clouds
46591,97,1553706000,28,12,40,Clouds
46592,98,1553706000,20,20,40,Clouds
46593,99,1553706000,4,26,30,Clouds
46594,100,1553706000,8,17,25,Clouds
46595,101,1553706000,28,2,30,Clouds
46596,102,1553706000,36,4,40,Clouds
46597,103,1553706000,38,2,40,Clouds
46598,104,1553706000,39,1,40,Clouds
46599,105,1553706000,35,1,36,Clouds
46600,106,1553706000,36,4,40,Clouds
46601,107,1553706000,33,7,40,Clouds
46602,108,1553706000,36,4,40,Clouds
46603,109,1553706000,27,2,29,Clouds
46604,110,1553706000,35,5,40,Clouds
46605,111,1553706000,40,0,40,Clouds
46606,112,1553706000,30,0,30,Clouds
46607,113,1553706000,3,37,40,Clouds
46608,114,1553706000,16,24,40,Clouds
46609,115,1553706000,18,12,30,Clouds
46610,2,1553709600,20,0,20,Clouds
46611,3,1553709600,19,1,20,Clouds
46612,4,1553709600,17,3,20,Clouds
46613,5,1553709600,31,9,40,Clouds
46614,6,1553709600,17,3,20,Clouds
46615,7,1553709600,13,16,29,Clouds
46616,8,1553709600,5,25,30,Clouds
46617,9,1553709600,22,2,24,Clouds
46618,10,1553709600,15,1,16,Clouds
46619,11,1553709600,30,0,30,Clouds
46620,12,1553709600,20,0,20,Clouds
46621,13,1553709600,11,19,30,Clouds
46622,14,1553709600,22,8,30,Clouds
46623,15,1553709600,16,0,16,Clouds
46624,16,1553709600,10,10,20,Clouds
46625,17,1553709600,20,0,20,Clouds
46626,18,1553709600,30,0,30,Clouds
46627,19,1553709600,22,8,30,Clouds
46628,21,1553709600,5,25,30,Clouds
46629,22,1553709600,15,5,20,Clouds
46630,23,1553709600,2,28,30,Clouds
46631,24,1553709600,17,3,20,Clouds
46632,25,1553709600,21,9,30,Clouds
46633,26,1553709600,4,16,20,Clouds
46634,27,1553709600,7,13,20,Clouds
46635,28,1553709600,30,0,30,Clouds
46636,29,1553709600,25,4,29,Clouds
46637,30,1553709600,19,1,20,Clouds
46638,31,1553709600,16,4,20,Clouds
46639,32,1553709600,8,22,30,Clouds
46640,33,1553709600,21,1,22,Clouds
46641,34,1553709600,15,15,30,Clouds
46642,35,1553709600,30,0,30,Clouds
46643,36,1553709600,26,14,40,Clouds
46644,37,1553709600,20,10,30,Clouds
46645,38,1553709600,25,15,40,Clouds
46646,39,1553709600,15,5,20,Clouds
46647,40,1553709600,21,0,21,Clouds
46648,41,1553709600,14,6,20,Clouds
46649,42,1553709600,26,4,30,Clouds
46650,43,1553709600,14,16,30,Clouds
46651,44,1553709600,24,6,30,Clouds
46652,45,1553709600,23,7,30,Clouds
46653,46,1553709600,19,1,20,Clouds
46654,47,1553709600,18,22,40,Clouds
46655,48,1553709600,0,40,40,Clouds
46656,49,1553709600,1,39,40,Clouds
46657,50,1553709600,34,6,40,Clouds
46658,51,1553709600,35,5,40,Clouds
46659,52,1553709600,31,1,32,Clouds
46660,53,1553709600,24,16,40,Clouds
46661,54,1553709600,32,1,33,Clouds
46662,55,1553709600,33,2,35,Clouds
46663,56,1553709600,35,5,40,Clouds
46664,57,1553709600,16,7,23,Clouds
46665,58,1553709600,16,24,40,Clouds
46666,59,1553709600,19,1,20,Clouds
46667,60,1553709600,17,13,30,Clouds
46668,61,1553709600,25,0,25,Clouds
46669,62,1553709600,24,16,40,Clouds
46670,63,1553709600,2,33,35,Clouds
46671,64,1553709600,16,24,40,Clouds
46672,65,1553709600,12,28,40,Clouds
46673,66,1553709600,40,0,40,Clouds
46674,67,1553709600,9,31,40,Clouds
46675,68,1553709600,30,10,40,Clouds
46676,69,1553709600,25,15,40,Clouds
46677,70,1553709600,10,18,28,Clouds
46678,71,1553709600,40,0,40,Clouds
46679,72,1553709600,29,2,31,Clouds
46680,73,1553709600,23,7,30,Clouds
46681,74,1553709600,6,24,30,Clouds
46682,75,1553709600,34,6,40,Clouds
46683,76,1553709600,33,5,38,Clouds
46684,77,1553709600,28,1,29,Clouds
46685,78,1553709600,37,3,40,Clouds
46686,79,1553709600,27,0,27,Clouds
46687,80,1553709600,38,2,40,Clouds
46688,81,1553709600,40,0,40,Clouds
46689,82,1553709600,21,1,22,Clouds
46690,83,1553709600,32,8,40,Clouds
46691,84,1553709600,27,3,30,Clouds
46692,85,1553709600,27,8,35,Clouds
46693,86,1553709600,20,18,38,Clouds
46694,87,1553709600,37,1,38,Clouds
46695,88,1553709600,26,4,30,Clouds
46696,89,1553709600,13,27,40,Clouds
46697,90,1553709600,34,6,40,Clouds
46698,91,1553709600,29,1,30,Clouds
46699,92,1553709600,14,26,40,Clouds
46700,93,1553709600,0,40,40,Clouds
46701,94,1553709600,38,2,40,Clouds
46702,95,1553709600,29,11,40,Clouds
46703,96,1553709600,29,1,30,Clouds
46704,97,1553709600,33,7,40,Clouds
46705,98,1553709600,22,18,40,Clouds
46706,99,1553709600,1,29,30,Clouds
46707,100,1553709600,0,25,25,Clouds
46708,101,1553709600,28,2,30,Clouds
46709,102,1553709600,30,10,40,Clouds
46710,103,1553709600,40,0,40,Clouds
46711,104,1553709600,39,1,40,Clouds
46712,105,1553709600,36,0,36,Clouds
46713,106,1553709600,31,9,40,Clouds
46714,107,1553709600,35,5,40,Clouds
46715,108,1553709600,35,5,40,Clouds
46716,109,1553709600,26,3,29,Clouds
46717,110,1553709600,35,5,40,Clouds
46718,111,1553709600,40,0,40,Clouds
46719,112,1553709600,30,0,30,Clouds
46720,113,1553709600,5,35,40,Clouds
46721,114,1553709600,38,2,40,Clouds
46722,115,1553709600,14,16,30,Clouds
46723,2,1553713200,17,3,20,Clouds
46724,3,1553713200,19,1,20,Clouds
46725,4,1553713200,18,2,20,Clouds
46726,5,1553713200,8,32,40,Clouds
46727,6,1553713200,16,4,20,Clouds
46728,7,1553713200,18,11,29,Clouds
46729,8,1553713200,10,20,30,Clouds
46730,9,1553713200,16,8,24,Clouds
46731,10,1553713200,7,9,16,Clouds
46732,11,1553713200,30,0,30,Clouds
46733,12,1553713200,17,3,20,Clouds
46734,13,1553713200,28,1,29,Clouds
46735,14,1553713200,9,21,30,Clouds
46736,15,1553713200,15,1,16,Clouds
46737,16,1553713200,5,15,20,Clouds
46738,17,1553713200,20,0,20,Clouds
46739,18,1553713200,30,0,30,Clouds
46740,19,1553713200,26,4,30,Clouds
46741,21,1553713200,1,29,30,Clouds
46742,22,1553713200,0,20,20,Clouds
46743,23,1553713200,0,30,30,Clouds
46744,24,1553713200,13,7,20,Clouds
46745,25,1553713200,26,4,30,Clouds
46746,26,1553713200,19,1,20,Clouds
46747,27,1553713200,18,2,20,Clouds
46748,28,1553713200,26,4,30,Clouds
46749,29,1553713200,28,1,29,Clouds
46750,30,1553713200,20,0,20,Clouds
46751,31,1553713200,17,3,20,Clouds
46752,32,1553713200,1,29,30,Clouds
46753,33,1553713200,10,12,22,Clouds
46754,34,1553713200,7,22,29,Clouds
46755,35,1553713200,26,4,30,Clouds
46756,36,1553713200,38,2,40,Clouds
46757,37,1553713200,26,4,30,Clouds
46758,38,1553713200,13,27,40,Clouds
46759,39,1553713200,20,0,20,Clouds
46760,40,1553713200,21,0,21,Clouds
46761,41,1553713200,20,0,20,Clouds
46762,42,1553713200,25,5,30,Clouds
46763,43,1553713200,9,21,30,Clouds
46764,44,1553713200,19,11,30,Clouds
46765,45,1553713200,23,7,30,Clouds
46766,46,1553713200,20,0,20,Clouds
46767,47,1553713200,40,0,40,Clouds
46768,48,1553713200,1,39,40,Clouds
46769,49,1553713200,27,13,40,Clouds
46770,50,1553713200,33,7,40,Clouds
46771,51,1553713200,39,1,40,Clouds
46772,52,1553713200,32,0,32,Clouds
46773,53,1553713200,40,0,40,Clouds
46774,54,1553713200,33,0,33,Clouds
46775,55,1553713200,35,0,35,Clouds
46776,56,1553713200,40,0,40,Clouds
46777,57,1553713200,23,0,23,Clouds
46778,58,1553713200,39,1,40,Clouds
46779,59,1553713200,18,2,20,Clouds
46780,60,1553713200,5,25,30,Clouds
46781,61,1553713200,22,3,25,Clouds
46782,62,1553713200,39,1,40,Clouds
46783,63,1553713200,16,19,35,Clouds
46784,64,1553713200,13,27,40,Clouds
46785,65,1553713200,40,0,40,Clouds
46786,66,1553713200,39,1,40,Clouds
46787,67,1553713200,21,19,40,Clouds
46788,68,1553713200,40,0,40,Clouds
46789,69,1553713200,40,0,40,Clouds
46790,70,1553713200,27,1,28,Clouds
46791,71,1553713200,38,2,40,Clouds
46792,72,1553713200,29,2,31,Clouds
46793,73,1553713200,25,5,30,Clouds
46794,74,1553713200,11,19,30,Clouds
46795,75,1553713200,22,18,40,Clouds
46796,76,1553713200,25,13,38,Clouds
46797,77,1553713200,28,1,29,Clouds
46798,78,1553713200,36,4,40,Clouds
46799,79,1553713200,27,0,27,Clouds
46800,80,1553713200,20,20,40,Clouds
46801,81,1553713200,40,0,40,Clouds
46802,82,1553713200,21,1,22,Clouds
46803,83,1553713200,23,17,40,Clouds
46804,84,1553713200,25,5,30,Clouds
46805,85,1553713200,29,6,35,Clouds
46806,86,1553713200,1,37,38,Clouds
46807,87,1553713200,29,9,38,Clouds
46808,88,1553713200,23,7,30,Clouds
46809,89,1553713200,27,13,40,Clouds
46810,90,1553713200,39,1,40,Clouds
46811,91,1553713200,27,3,30,Clouds
46812,92,1553713200,0,40,40,Clouds
46813,93,1553713200,0,40,40,Clouds
46814,94,1553713200,0,40,40,Clouds
46815,95,1553713200,20,20,40,Clouds
46816,96,1553713200,24,6,30,Clouds
46817,97,1553713200,31,9,40,Clouds
46818,98,1553713200,26,14,40,Clouds
46819,99,1553713200,12,18,30,Clouds
46820,100,1553713200,2,23,25,Clouds
46821,101,1553713200,26,4,30,Clouds
46822,102,1553713200,32,8,40,Clouds
46823,103,1553713200,40,0,40,Clouds
46824,104,1553713200,40,0,40,Clouds
46825,105,1553713200,36,0,36,Clouds
46826,106,1553713200,28,12,40,Clouds
46827,107,1553713200,32,8,40,Clouds
46828,108,1553713200,25,15,40,Clouds
46829,109,1553713200,26,3,29,Clouds
46830,110,1553713200,30,10,40,Clouds
46831,111,1553713200,37,3,40,Clouds
46832,112,1553713200,25,5,30,Clouds
46833,113,1553713200,21,19,40,Clouds
46834,114,1553713200,38,2,40,Clouds
46835,115,1553713200,13,17,30,Clouds
46836,2,1553716800,16,4,20,Clouds
46837,3,1553716800,20,0,20,Clouds
46838,4,1553716800,20,0,20,Clouds
46839,5,1553716800,29,11,40,Clouds
46840,6,1553716800,18,2,20,Clouds
46841,7,1553716800,20,9,29,Clouds
46842,8,1553716800,27,3,30,Clouds
46843,9,1553716800,17,7,24,Clouds
46844,10,1553716800,9,7,16,Clouds
46845,11,1553716800,30,0,30,Clouds
46846,12,1553716800,17,3,20,Clouds
46847,13,1553716800,29,0,29,Clouds
46848,14,1553716800,6,24,30,Clouds
46849,15,1553716800,12,4,16,Clouds
46850,16,1553716800,1,19,20,Clouds
46851,17,1553716800,18,2,20,Clouds
46852,18,1553716800,25,5,30,Clouds
46853,19,1553716800,28,2,30,Clouds
46854,21,1553716800,3,27,30,Clouds
46855,22,1553716800,1,19,20,Clouds
46856,23,1553716800,0,30,30,Clouds
46857,24,1553716800,16,4,20,Clouds
46858,25,1553716800,21,9,30,Clouds
46859,26,1553716800,18,2,20,Clouds
46860,27,1553716800,12,8,20,Clouds
46861,28,1553716800,28,2,30,Clouds
46862,29,1553716800,29,0,29,Clouds
46863,30,1553716800,17,3,20,Clouds
46864,31,1553716800,19,1,20,Clouds
46865,32,1553716800,1,29,30,Clouds
46866,33,1553716800,3,19,22,Clouds
46867,34,1553716800,15,14,29,Clouds
46868,35,1553716800,20,10,30,Clouds
46869,36,1553716800,39,1,40,Clouds
46870,37,1553716800,29,1,30,Clouds
46871,38,1553716800,14,26,40,Clouds
46872,39,1553716800,14,6,20,Clouds
46873,40,1553716800,20,1,21,Clouds
46874,41,1553716800,20,0,20,Clouds
46875,42,1553716800,19,11,30,Clouds
46876,43,1553716800,5,25,30,Clouds
46877,44,1553716800,8,22,30,Clouds
46878,45,1553716800,24,6,30,Clouds
46879,46,1553716800,17,3,20,Clouds
46880,47,1553716800,40,0,40,Clouds
46881,48,1553716800,16,24,40,Clouds
46882,49,1553716800,38,2,40,Clouds
46883,50,1553716800,26,14,40,Clouds
46884,51,1553716800,37,3,40,Clouds
46885,52,1553716800,30,2,32,Clouds
46886,53,1553716800,37,3,40,Clouds
46887,54,1553716800,33,0,33,Clouds
46888,55,1553716800,35,0,35,Clouds
46889,56,1553716800,37,3,40,Clouds
46890,57,1553716800,22,1,23,Clouds
46891,58,1553716800,32,8,40,Clouds
46892,59,1553716800,20,0,20,Clouds
46893,60,1553716800,0,30,30,Clouds
46894,61,1553716800,22,3,25,Clouds
46895,62,1553716800,40,0,40,Clouds
46896,63,1553716800,28,7,35,Clouds
46897,64,1553716800,13,27,40,Clouds
46898,65,1553716800,40,0,40,Clouds
46899,66,1553716800,39,1,40,Clouds
46900,67,1553716800,19,21,40,Clouds
46901,68,1553716800,39,1,40,Clouds
46902,69,1553716800,33,7,40,Clouds
46903,70,1553716800,20,8,28,Clouds
46904,71,1553716800,36,4,40,Clouds
46905,72,1553716800,30,1,31,Clouds
46906,73,1553716800,28,2,30,Clouds
46907,74,1553716800,14,16,30,Clouds
46908,75,1553716800,13,27,40,Clouds
46909,76,1553716800,29,9,38,Clouds
46910,77,1553716800,22,7,29,Clouds
46911,78,1553716800,26,14,40,Clouds
46912,79,1553716800,26,1,27,Clouds
46913,80,1553716800,17,23,40,Clouds
46914,81,1553716800,38,2,40,Clouds
46915,82,1553716800,16,6,22,Clouds
46916,83,1553716800,18,22,40,Clouds
46917,84,1553716800,10,20,30,Clouds
46918,85,1553716800,26,9,35,Clouds
46919,86,1553716800,0,38,38,Clouds
46920,87,1553716800,15,23,38,Clouds
46921,88,1553716800,13,17,30,Clouds
46922,89,1553716800,39,1,40,Clouds
46923,90,1553716800,40,0,40,Clouds
46924,91,1553716800,29,1,30,Clouds
46925,92,1553716800,0,40,40,Clouds
46926,93,1553716800,0,40,40,Clouds
46927,94,1553716800,0,40,40,Clouds
46928,95,1553716800,7,33,40,Clouds
46929,96,1553716800,21,9,30,Clouds
46930,97,1553716800,21,19,40,Clouds
46931,98,1553716800,29,11,40,Clouds
46932,99,1553716800,30,0,30,Clouds
46933,100,1553716800,0,25,25,Clouds
46934,101,1553716800,24,6,30,Clouds
46935,102,1553716800,34,6,40,Clouds
46936,103,1553716800,39,1,40,Clouds
46937,104,1553716800,40,0,40,Clouds
46938,105,1553716800,35,1,36,Clouds
46939,106,1553716800,26,14,40,Clouds
46940,107,1553716800,30,10,40,Clouds
46941,108,1553716800,24,16,40,Clouds
46942,109,1553716800,28,1,29,Clouds
46943,110,1553716800,27,13,40,Clouds
46944,111,1553716800,35,5,40,Clouds
46945,112,1553716800,19,11,30,Clouds
46946,113,1553716800,36,4,40,Clouds
46947,114,1553716800,39,1,40,Clouds
46948,115,1553716800,9,21,30,Clouds
46949,2,1553720400,18,2,20,Clouds
46950,3,1553720400,17,3,20,Clouds
46951,4,1553720400,19,1,20,Clouds
46952,5,1553720400,27,13,40,Clouds
46953,6,1553720400,19,1,20,Clouds
46954,7,1553720400,20,9,29,Clouds
46955,8,1553720400,27,3,30,Clouds
46956,9,1553720400,24,0,24,Clouds
46957,10,1553720400,5,11,16,Clouds
46958,11,1553720400,30,0,30,Clouds
46959,12,1553720400,14,6,20,Clouds
46960,13,1553720400,24,5,29,Clouds
46961,14,1553720400,1,29,30,Clouds
46962,15,1553720400,11,5,16,Clouds
46963,16,1553720400,5,15,20,Clouds
46964,17,1553720400,18,2,20,Clouds
46965,18,1553720400,19,11,30,Clouds
46966,19,1553720400,25,5,30,Clouds
46967,21,1553720400,12,18,30,Clouds
46968,22,1553720400,19,1,20,Clouds
46969,23,1553720400,1,29,30,Clouds
46970,24,1553720400,15,5,20,Clouds
46971,25,1553720400,21,9,30,Clouds
46972,26,1553720400,18,2,20,Clouds
46973,27,1553720400,19,1,20,Clouds
46974,28,1553720400,30,0,30,Clouds
46975,29,1553720400,19,10,29,Clouds
46976,30,1553720400,15,5,20,Clouds
46977,31,1553720400,20,0,20,Clouds
46978,32,1553720400,16,14,30,Clouds
46979,33,1553720400,7,15,22,Clouds
46980,34,1553720400,0,29,29,Clouds
46981,35,1553720400,15,15,30,Clouds
46982,36,1553720400,40,0,40,Clouds
46983,37,1553720400,30,0,30,Clouds
46984,38,1553720400,6,34,40,Clouds
46985,39,1553720400,16,4,20,Clouds
46986,40,1553720400,21,0,21,Clouds
46987,41,1553720400,20,0,20,Clouds
46988,42,1553720400,15,15,30,Clouds
46989,43,1553720400,0,30,30,Clouds
46990,44,1553720400,4,26,30,Clouds
46991,45,1553720400,26,4,30,Clouds
46992,46,1553720400,16,4,20,Clouds
46993,47,1553720400,40,0,40,Clouds
46994,48,1553720400,19,21,40,Clouds
46995,49,1553720400,36,4,40,Clouds
46996,50,1553720400,25,15,40,Clouds
46997,51,1553720400,40,0,40,Clouds
46998,52,1553720400,32,0,32,Clouds
46999,53,1553720400,39,1,40,Clouds
47000,54,1553720400,33,0,33,Clouds
47001,55,1553720400,35,0,35,Clouds
47002,56,1553720400,27,13,40,Clouds
47003,57,1553720400,22,1,23,Clouds
47004,58,1553720400,39,1,40,Clouds
47005,59,1553720400,18,2,20,Clouds
47006,60,1553720400,0,30,30,Clouds
47007,61,1553720400,20,5,25,Clouds
47008,62,1553720400,40,0,40,Clouds
47009,63,1553720400,31,4,35,Clouds
47010,64,1553720400,21,19,40,Clouds
47011,65,1553720400,39,1,40,Clouds
47012,66,1553720400,37,3,40,Clouds
47013,67,1553720400,18,22,40,Clouds
47014,68,1553720400,39,1,40,Clouds
47015,69,1553720400,39,1,40,Clouds
47016,70,1553720400,27,1,28,Clouds
47017,71,1553720400,38,2,40,Clouds
47018,72,1553720400,27,4,31,Clouds
47019,73,1553720400,27,3,30,Clouds
47020,74,1553720400,12,18,30,Clouds
47021,75,1553720400,10,30,40,Clouds
47022,76,1553720400,29,9,38,Clouds
47023,77,1553720400,28,1,29,Clouds
47024,78,1553720400,25,15,40,Clouds
47025,79,1553720400,18,9,27,Clouds
47026,80,1553720400,15,25,40,Clouds
47027,81,1553720400,38,2,40,Clouds
47028,82,1553720400,13,9,22,Clouds
47029,83,1553720400,8,32,40,Clouds
47030,84,1553720400,3,27,30,Clouds
47031,85,1553720400,19,16,35,Clouds
47032,86,1553720400,0,38,38,Clouds
47033,87,1553720400,4,34,38,Clouds
47034,88,1553720400,7,23,30,Clouds
47035,89,1553720400,35,5,40,Clouds
47036,90,1553720400,39,1,40,Clouds
47037,91,1553720400,22,8,30,Clouds
47038,92,1553720400,0,40,40,Clouds
47039,93,1553720400,1,39,40,Clouds
47040,94,1553720400,0,40,40,Clouds
47041,95,1553720400,4,36,40,Clouds
47042,96,1553720400,22,8,30,Clouds
47043,97,1553720400,16,24,40,Clouds
47044,98,1553720400,29,11,40,Clouds
47045,99,1553720400,30,0,30,Clouds
47046,100,1553720400,1,24,25,Clouds
47047,101,1553720400,20,10,30,Clouds
47048,102,1553720400,29,11,40,Clouds
47049,103,1553720400,39,1,40,Clouds
47050,104,1553720400,40,0,40,Clouds
47051,105,1553720400,35,1,36,Clouds
47052,106,1553720400,24,16,40,Clouds
47053,107,1553720400,25,15,40,Clouds
47054,108,1553720400,22,18,40,Clouds
47055,109,1553720400,22,7,29,Clouds
47056,110,1553720400,25,15,40,Clouds
47057,111,1553720400,31,9,40,Clouds
47058,112,1553720400,15,15,30,Clouds
47059,113,1553720400,39,1,40,Clouds
47060,114,1553720400,40,0,40,Clouds
47061,115,1553720400,0,30,30,Clouds
47062,2,1553724000,16,4,20,Clouds
47063,3,1553724000,20,0,20,Clouds
47064,4,1553724000,20,0,20,Clouds
47065,5,1553724000,29,11,40,Clouds
47066,6,1553724000,18,2,20,Clouds
47067,7,1553724000,23,6,29,Clouds
47068,8,1553724000,30,0,30,Clouds
47069,9,1553724000,23,1,24,Clouds
47070,10,1553724000,16,0,16,Clouds
47071,11,1553724000,29,1,30,Clouds
47072,12,1553724000,13,7,20,Clouds
47073,13,1553724000,25,4,29,Clouds
47074,14,1553724000,11,19,30,Clouds
47075,15,1553724000,16,0,16,Clouds
47076,16,1553724000,10,10,20,Clouds
47077,17,1553724000,16,4,20,Clouds
47078,18,1553724000,8,22,30,Clouds
47079,19,1553724000,30,0,30,Clouds
47080,21,1553724000,24,6,30,Clouds
47081,22,1553724000,17,3,20,Clouds
47082,23,1553724000,9,21,30,Clouds
47083,24,1553724000,12,8,20,Clouds
47084,25,1553724000,27,3,30,Clouds
47085,26,1553724000,20,0,20,Clouds
47086,27,1553724000,20,0,20,Clouds
47087,28,1553724000,15,15,30,Clouds
47088,29,1553724000,15,14,29,Clouds
47089,30,1553724000,19,1,20,Clouds
47090,31,1553724000,20,0,20,Clouds
47091,32,1553724000,9,21,30,Clouds
47092,33,1553724000,9,13,22,Clouds
47093,34,1553724000,0,29,29,Clouds
47094,35,1553724000,13,17,30,Clouds
47095,36,1553724000,39,1,40,Clouds
47096,37,1553724000,30,0,30,Clouds
47097,38,1553724000,7,33,40,Clouds
47098,39,1553724000,19,1,20,Clouds
47099,40,1553724000,19,2,21,Clouds
47100,41,1553724000,19,1,20,Clouds
47101,42,1553724000,10,20,30,Clouds
47102,43,1553724000,1,29,30,Clouds
47103,44,1553724000,0,30,30,Clouds
47104,45,1553724000,25,5,30,Clouds
47105,46,1553724000,18,2,20,Clouds
47106,47,1553724000,40,0,40,Clouds
47107,48,1553724000,26,14,40,Clouds
47108,49,1553724000,35,5,40,Clouds
47109,50,1553724000,17,23,40,Clouds
47110,51,1553724000,38,2,40,Clouds
47111,52,1553724000,30,2,32,Clouds
47112,53,1553724000,40,0,40,Clouds
47113,54,1553724000,33,0,33,Clouds
47114,55,1553724000,35,0,35,Clouds
47115,56,1553724000,34,6,40,Clouds
47116,57,1553724000,19,4,23,Clouds
47117,58,1553724000,40,0,40,Clouds
47118,59,1553724000,17,3,20,Clouds
47119,60,1553724000,0,30,30,Clouds
47120,61,1553724000,14,11,25,Clouds
47121,62,1553724000,40,0,40,Clouds
47122,63,1553724000,34,1,35,Clouds
47123,64,1553724000,23,17,40,Clouds
47124,65,1553724000,40,0,40,Clouds
47125,66,1553724000,38,2,40,Clouds
47126,67,1553724000,14,26,40,Clouds
47127,68,1553724000,40,0,40,Clouds
47128,69,1553724000,39,1,40,Clouds
47129,70,1553724000,20,8,28,Clouds
47130,71,1553724000,40,0,40,Clouds
47131,72,1553724000,26,5,31,Clouds
47132,73,1553724000,27,3,30,Clouds
47133,74,1553724000,10,20,30,Clouds
47134,75,1553724000,8,32,40,Clouds
47135,76,1553724000,27,11,38,Clouds
47136,77,1553724000,27,2,29,Clouds
47137,78,1553724000,24,16,40,Clouds
47138,79,1553724000,18,9,27,Clouds
47139,80,1553724000,14,26,40,Clouds
47140,81,1553724000,38,2,40,Clouds
47141,82,1553724000,10,12,22,Clouds
47142,83,1553724000,6,34,40,Clouds
47143,84,1553724000,0,30,30,Clouds
47144,85,1553724000,12,23,35,Clouds
47145,86,1553724000,0,38,38,Clouds
47146,87,1553724000,1,37,38,Clouds
47147,88,1553724000,7,23,30,Clouds
47148,89,1553724000,38,2,40,Clouds
47149,90,1553724000,40,0,40,Clouds
47150,91,1553724000,18,12,30,Clouds
47151,92,1553724000,0,40,40,Clouds
47152,93,1553724000,0,40,40,Clouds
47153,94,1553724000,0,40,40,Clouds
47154,95,1553724000,0,40,40,Clouds
47155,96,1553724000,18,12,30,Clouds
47156,97,1553724000,18,22,40,Clouds
47157,98,1553724000,37,3,40,Clouds
47158,99,1553724000,30,0,30,Clouds
47159,100,1553724000,1,24,25,Clouds
47160,101,1553724000,16,14,30,Clouds
47161,102,1553724000,29,11,40,Clouds
47162,103,1553724000,40,0,40,Clouds
47163,104,1553724000,40,0,40,Clouds
47164,105,1553724000,35,1,36,Clouds
47165,106,1553724000,7,33,40,Clouds
47166,107,1553724000,21,19,40,Clouds
47167,108,1553724000,19,21,40,Clouds
47168,109,1553724000,16,13,29,Clouds
47169,110,1553724000,27,13,40,Clouds
47170,111,1553724000,25,15,40,Clouds
47171,112,1553724000,8,22,30,Clouds
47172,113,1553724000,39,1,40,Clouds
47173,114,1553724000,34,6,40,Clouds
47174,115,1553724000,11,19,30,Clouds
47175,2,1553727600,11,9,20,Clouds
47176,3,1553727600,20,0,20,Clouds
47177,4,1553727600,19,1,20,Clouds
47178,5,1553727600,23,17,40,Clouds
47179,6,1553727600,20,0,20,Clouds
47180,7,1553727600,24,5,29,Clouds
47181,8,1553727600,30,0,30,Clouds
47182,9,1553727600,24,0,24,Clouds
47183,10,1553727600,16,0,16,Clouds
47184,11,1553727600,30,0,30,Clouds
47185,12,1553727600,14,6,20,Clouds
47186,13,1553727600,28,2,30,Clouds
47187,14,1553727600,19,11,30,Clouds
47188,15,1553727600,15,1,16,Clouds
47189,16,1553727600,18,2,20,Clouds
47190,17,1553727600,16,4,20,Clouds
47191,18,1553727600,11,19,30,Clouds
47192,19,1553727600,30,0,30,Clouds
47193,21,1553727600,30,0,30,Clouds
47194,22,1553727600,20,0,20,Clouds
47195,23,1553727600,12,18,30,Clouds
47196,24,1553727600,11,9,20,Clouds
47197,25,1553727600,30,0,30,Clouds
47198,26,1553727600,20,0,20,Clouds
47199,27,1553727600,19,1,20,Clouds
47200,28,1553727600,10,20,30,Clouds
47201,29,1553727600,18,11,29,Clouds
47202,30,1553727600,20,0,20,Clouds
47203,31,1553727600,19,1,20,Clouds
47204,32,1553727600,21,9,30,Clouds
47205,33,1553727600,20,2,22,Clouds
47206,34,1553727600,3,26,29,Clouds
47207,35,1553727600,16,14,30,Clouds
47208,36,1553727600,40,0,40,Clouds
47209,37,1553727600,30,0,30,Clouds
47210,38,1553727600,8,32,40,Clouds
47211,39,1553727600,16,4,20,Clouds
47212,40,1553727600,21,0,21,Clouds
47213,41,1553727600,20,0,20,Clouds
47214,42,1553727600,17,13,30,Clouds
47215,43,1553727600,0,30,30,Clouds
47216,44,1553727600,1,29,30,Clouds
47217,45,1553727600,23,7,30,Clouds
47218,46,1553727600,20,0,20,Clouds
47219,47,1553727600,40,0,40,Clouds
47220,48,1553727600,30,10,40,Clouds
47221,49,1553727600,40,0,40,Clouds
47222,50,1553727600,4,36,40,Clouds
47223,51,1553727600,40,0,40,Clouds
47224,52,1553727600,32,0,32,Clouds
47225,53,1553727600,39,1,40,Clouds
47226,54,1553727600,33,0,33,Clouds
47227,55,1553727600,35,0,35,Clouds
47228,56,1553727600,34,6,40,Clouds
47229,57,1553727600,20,3,23,Clouds
47230,58,1553727600,39,1,40,Clouds
47231,59,1553727600,19,1,20,Clouds
47232,60,1553727600,1,29,30,Clouds
47233,61,1553727600,16,9,25,Clouds
47234,62,1553727600,39,1,40,Clouds
47235,63,1553727600,34,1,35,Clouds
47236,64,1553727600,28,12,40,Clouds
47237,65,1553727600,40,0,40,Clouds
47238,66,1553727600,37,3,40,Clouds
47239,67,1553727600,12,28,40,Clouds
47240,68,1553727600,38,2,40,Clouds
47241,69,1553727600,40,0,40,Clouds
47242,70,1553727600,15,13,28,Clouds
47243,71,1553727600,40,0,40,Clouds
47244,72,1553727600,23,8,31,Clouds
47245,73,1553727600,25,5,30,Clouds
47246,74,1553727600,9,21,30,Clouds
47247,75,1553727600,4,36,40,Clouds
47248,76,1553727600,27,11,38,Clouds
47249,77,1553727600,27,2,29,Clouds
47250,78,1553727600,25,15,40,Clouds
47251,79,1553727600,18,9,27,Clouds
47252,80,1553727600,15,25,40,Clouds
47253,81,1553727600,39,1,40,Clouds
47254,82,1553727600,7,15,22,Clouds
47255,83,1553727600,3,37,40,Clouds
47256,84,1553727600,0,30,30,Clouds
47257,85,1553727600,7,28,35,Clouds
47258,86,1553727600,0,38,38,Clouds
47259,87,1553727600,0,38,38,Clouds
47260,88,1553727600,1,29,30,Clouds
47261,89,1553727600,40,0,40,Clouds
47262,90,1553727600,40,0,40,Clouds
47263,91,1553727600,16,14,30,Clouds
47264,92,1553727600,0,40,40,Clouds
47265,93,1553727600,9,31,40,Clouds
47266,94,1553727600,1,39,40,Clouds
47267,95,1553727600,0,40,40,Clouds
47268,96,1553727600,16,14,30,Clouds
47269,97,1553727600,16,24,40,Clouds
47270,98,1553727600,40,0,40,Clouds
47271,99,1553727600,30,0,30,Clouds
47272,100,1553727600,1,24,25,Clouds
47273,101,1553727600,17,13,30,Clouds
47274,102,1553727600,28,12,40,Clouds
47275,103,1553727600,32,8,40,Clouds
47276,104,1553727600,30,10,40,Clouds
47277,105,1553727600,36,0,36,Clouds
47278,106,1553727600,4,36,40,Clouds
47279,107,1553727600,17,23,40,Clouds
47280,108,1553727600,17,23,40,Clouds
47281,109,1553727600,12,17,29,Clouds
47282,110,1553727600,22,18,40,Clouds
47283,111,1553727600,18,22,40,Clouds
47284,112,1553727600,4,26,30,Clouds
47285,113,1553727600,39,1,40,Clouds
47286,114,1553727600,38,2,40,Clouds
47287,115,1553727600,8,22,30,Clouds
47288,2,1553731200,8,12,20,Clouds
47289,3,1553731200,18,2,20,Clouds
47290,4,1553731200,20,0,20,Clouds
47291,5,1553731200,23,17,40,Clouds
47292,6,1553731200,19,1,20,Clouds
47293,7,1553731200,22,7,29,Clouds
47294,8,1553731200,29,1,30,Clouds
47295,9,1553731200,12,12,24,Clouds
47296,10,1553731200,16,0,16,Clouds
47297,11,1553731200,30,0,30,Clouds
47298,12,1553731200,11,9,20,Clouds
47299,13,1553731200,30,0,30,Clouds
47300,14,1553731200,27,3,30,Clouds
47301,15,1553731200,15,1,16,Clouds
47302,16,1553731200,20,0,20,Clouds
47303,17,1553731200,18,2,20,Clouds
47304,18,1553731200,18,12,30,Clouds
47305,19,1553731200,30,0,30,Clouds
47306,21,1553731200,30,0,30,Clouds
47307,22,1553731200,19,1,20,Clouds
47308,23,1553731200,16,14,30,Clouds
47309,24,1553731200,13,7,20,Clouds
47310,25,1553731200,30,0,30,Clouds
47311,26,1553731200,20,0,20,Clouds
47312,27,1553731200,20,0,20,Clouds
47313,28,1553731200,10,20,30,Clouds
47314,29,1553731200,18,11,29,Clouds
47315,30,1553731200,20,0,20,Clouds
47316,31,1553731200,17,3,20,Clouds
47317,32,1553731200,30,0,30,Clouds
47318,33,1553731200,21,2,23,Clouds
47319,34,1553731200,1,28,29,Clouds
47320,35,1553731200,17,13,30,Clouds
47321,36,1553731200,40,0,40,Clouds
47322,37,1553731200,29,1,30,Clouds
47323,38,1553731200,9,31,40,Clouds
47324,39,1553731200,19,1,20,Clouds
47325,40,1553731200,20,1,21,Clouds
47326,41,1553731200,20,0,20,Clouds
47327,42,1553731200,16,14,30,Clouds
47328,43,1553731200,4,26,30,Clouds
47329,44,1553731200,3,27,30,Clouds
47330,45,1553731200,24,6,30,Clouds
47331,46,1553731200,20,0,20,Clouds
47332,47,1553731200,40,0,40,Clouds
47333,48,1553731200,32,8,40,Clouds
47334,49,1553731200,38,2,40,Clouds
47335,50,1553731200,0,40,40,Clouds
47336,51,1553731200,40,0,40,Clouds
47337,52,1553731200,30,2,32,Clouds
47338,53,1553731200,40,0,40,Clouds
47339,54,1553731200,33,0,33,Clouds
47340,55,1553731200,35,0,35,Clouds
47341,56,1553731200,30,10,40,Clouds
47342,57,1553731200,20,3,23,Clouds
47343,58,1553731200,40,0,40,Clouds
47344,59,1553731200,19,1,20,Clouds
47345,60,1553731200,11,19,30,Clouds
47346,61,1553731200,16,9,25,Clouds
47347,62,1553731200,39,1,40,Clouds
47348,63,1553731200,35,0,35,Clouds
47349,64,1553731200,32,8,40,Clouds
47350,65,1553731200,38,2,40,Clouds
47351,66,1553731200,38,2,40,Clouds
47352,67,1553731200,14,26,40,Clouds
47353,68,1553731200,40,0,40,Clouds
47354,69,1553731200,37,3,40,Clouds
47355,70,1553731200,12,16,28,Clouds
47356,71,1553731200,38,2,40,Clouds
47357,72,1553731200,18,13,31,Clouds
47358,73,1553731200,23,7,30,Clouds
47359,74,1553731200,7,23,30,Clouds
47360,75,1553731200,7,33,40,Clouds
47361,76,1553731200,24,14,38,Clouds
47362,77,1553731200,26,3,29,Clouds
47363,78,1553731200,24,16,40,Clouds
47364,79,1553731200,18,9,27,Clouds
47365,80,1553731200,14,26,40,Clouds
47366,81,1553731200,39,1,40,Clouds
47367,82,1553731200,6,16,22,Clouds
47368,83,1553731200,7,33,40,Clouds
47369,84,1553731200,10,20,30,Clouds
47370,85,1553731200,2,33,35,Clouds
47371,86,1553731200,0,38,38,Clouds
47372,87,1553731200,0,38,38,Clouds
47373,88,1553731200,3,27,30,Clouds
47374,89,1553731200,40,0,40,Clouds
47375,90,1553731200,40,0,40,Clouds
47376,91,1553731200,14,16,30,Clouds
47377,92,1553731200,2,38,40,Clouds
47378,93,1553731200,2,38,40,Clouds
47379,94,1553731200,9,31,40,Clouds
47380,95,1553731200,0,40,40,Clouds
47381,96,1553731200,16,14,30,Clouds
47382,97,1553731200,12,28,40,Clouds
47383,98,1553731200,40,0,40,Clouds
47384,99,1553731200,30,0,30,Clouds
47385,100,1553731200,8,17,25,Clouds
47386,101,1553731200,14,16,30,Clouds
47387,102,1553731200,28,12,40,Clouds
47388,103,1553731200,32,8,40,Clouds
47389,104,1553731200,31,9,40,Clouds
47390,105,1553731200,26,10,36,Clouds
47391,106,1553731200,4,36,40,Clouds
47392,107,1553731200,9,31,40,Clouds
47393,108,1553731200,16,24,40,Clouds
47394,109,1553731200,11,18,29,Clouds
47395,110,1553731200,21,19,40,Clouds
47396,111,1553731200,12,28,40,Clouds
47397,112,1553731200,0,30,30,Clouds
47398,113,1553731200,40,0,40,Clouds
47399,114,1553731200,40,0,40,Clouds
47400,115,1553731200,0,30,30,Clouds
47401,2,1553734800,7,13,20,Clouds
47402,3,1553734800,16,4,20,Clouds
47403,4,1553734800,19,1,20,Clouds
47404,5,1553734800,22,18,40,Clouds
47405,6,1553734800,20,0,20,Clouds
47406,7,1553734800,22,7,29,Clouds
47407,8,1553734800,30,0,30,Clouds
47408,9,1553734800,24,0,24,Clouds
47409,10,1553734800,16,0,16,Clouds
47410,11,1553734800,30,0,30,Clouds
47411,12,1553734800,10,10,20,Clouds
47412,13,1553734800,30,0,30,Clouds
47413,14,1553734800,30,0,30,Clouds
47414,15,1553734800,11,4,15,Clouds
47415,16,1553734800,19,1,20,Clouds
47416,17,1553734800,18,2,20,Clouds
47417,18,1553734800,23,7,30,Clouds
47418,19,1553734800,28,2,30,Clouds
47419,21,1553734800,30,0,30,Clouds
47420,22,1553734800,20,0,20,Clouds
47421,23,1553734800,20,10,30,Clouds
47422,24,1553734800,14,6,20,Clouds
47423,25,1553734800,30,0,30,Clouds
47424,26,1553734800,20,0,20,Clouds
47425,27,1553734800,20,0,20,Clouds
47426,28,1553734800,8,22,30,Clouds
47427,29,1553734800,22,7,29,Clouds
47428,30,1553734800,20,0,20,Clouds
47429,31,1553734800,17,3,20,Clouds
47430,32,1553734800,30,0,30,Clouds
47431,33,1553734800,22,1,23,Clouds
47432,34,1553734800,2,27,29,Clouds
47433,35,1553734800,16,14,30,Clouds
47434,36,1553734800,40,0,40,Clouds
47435,37,1553734800,30,0,30,Clouds
47436,38,1553734800,8,32,40,Clouds
47437,39,1553734800,18,2,20,Clouds
47438,40,1553734800,18,3,21,Clouds
47439,41,1553734800,20,0,20,Clouds
47440,42,1553734800,10,20,30,Clouds
47441,43,1553734800,4,26,30,Clouds
47442,44,1553734800,2,28,30,Clouds
47443,45,1553734800,26,4,30,Clouds
47444,46,1553734800,20,0,20,Clouds
47445,47,1553734800,40,0,40,Clouds
47446,48,1553734800,36,4,40,Clouds
47447,49,1553734800,38,2,40,Clouds
47448,50,1553734800,0,40,40,Clouds
47449,51,1553734800,40,0,40,Clouds
47450,52,1553734800,32,0,32,Clouds
47451,53,1553734800,40,0,40,Clouds
47452,54,1553734800,33,0,33,Clouds
47453,55,1553734800,35,0,35,Clouds
47454,56,1553734800,28,12,40,Clouds
47455,57,1553734800,22,1,23,Clouds
47456,58,1553734800,37,3,40,Clouds
47457,59,1553734800,20,0,20,Clouds
47458,60,1553734800,11,19,30,Clouds
47459,61,1553734800,16,9,25,Clouds
47460,62,1553734800,40,0,40,Clouds
47461,63,1553734800,35,0,35,Clouds
47462,64,1553734800,37,3,40,Clouds
47463,65,1553734800,40,0,40,Clouds
47464,66,1553734800,33,7,40,Clouds
47465,67,1553734800,17,23,40,Clouds
47466,68,1553734800,37,3,40,Clouds
47467,69,1553734800,39,1,40,Clouds
47468,70,1553734800,10,18,28,Clouds
47469,71,1553734800,37,3,40,Clouds
47470,72,1553734800,19,12,31,Clouds
47471,73,1553734800,21,9,30,Clouds
47472,74,1553734800,7,23,30,Clouds
47473,75,1553734800,6,34,40,Clouds
47474,76,1553734800,25,13,38,Clouds
47475,77,1553734800,25,4,29,Clouds
47476,78,1553734800,23,17,40,Clouds
47477,79,1553734800,18,9,27,Clouds
47478,80,1553734800,12,28,40,Clouds
47479,81,1553734800,39,1,40,Clouds
47480,82,1553734800,3,19,22,Clouds
47481,83,1553734800,7,33,40,Clouds
47482,84,1553734800,7,23,30,Clouds
47483,85,1553734800,1,34,35,Clouds
47484,86,1553734800,3,35,38,Clouds
47485,87,1553734800,0,38,38,Clouds
47486,88,1553734800,3,27,30,Clouds
47487,89,1553734800,40,0,40,Clouds
47488,90,1553734800,38,2,40,Clouds
47489,91,1553734800,13,17,30,Clouds
47490,92,1553734800,6,34,40,Clouds
47491,93,1553734800,2,38,40,Clouds
47492,94,1553734800,9,31,40,Clouds
47493,95,1553734800,0,40,40,Clouds
47494,96,1553734800,15,15,30,Clouds
47495,97,1553734800,11,29,40,Clouds
47496,98,1553734800,39,1,40,Clouds
47497,99,1553734800,30,0,30,Clouds
47498,100,1553734800,8,17,25,Clouds
47499,101,1553734800,15,15,30,Clouds
47500,102,1553734800,26,14,40,Clouds
47501,103,1553734800,33,7,40,Clouds
47502,104,1553734800,31,9,40,Clouds
47503,105,1553734800,25,11,36,Clouds
47504,106,1553734800,4,36,40,Clouds
47505,107,1553734800,6,34,40,Clouds
47506,108,1553734800,16,24,40,Clouds
47507,109,1553734800,9,20,29,Clouds
47508,110,1553734800,23,17,40,Clouds
47509,111,1553734800,9,31,40,Clouds
47510,112,1553734800,5,25,30,Clouds
47511,113,1553734800,40,0,40,Clouds
47512,114,1553734800,40,0,40,Clouds
47513,115,1553734800,0,30,30,Clouds
47514,2,1553738400,7,13,20,Clouds
47515,3,1553738400,16,4,20,Clouds
47516,4,1553738400,19,1,20,Clouds
47517,5,1553738400,21,19,40,Clouds
47518,6,1553738400,20,0,20,Clouds
47519,7,1553738400,24,5,29,Clouds
47520,8,1553738400,30,0,30,Clouds
47521,9,1553738400,24,0,24,Clouds
47522,10,1553738400,16,0,16,Clouds
47523,11,1553738400,30,0,30,Clouds
47524,12,1553738400,9,11,20,Clouds
47525,13,1553738400,30,0,30,Clouds
47526,14,1553738400,30,0,30,Clouds
47527,15,1553738400,11,4,15,Clouds
47528,16,1553738400,19,1,20,Clouds
47529,17,1553738400,18,2,20,Clouds
47530,18,1553738400,24,6,30,Clouds
47531,19,1553738400,30,0,30,Clouds
47532,21,1553738400,30,0,30,Clouds
47533,22,1553738400,19,1,20,Clouds
47534,23,1553738400,23,7,30,Clouds
47535,24,1553738400,17,3,20,Clouds
47536,25,1553738400,30,0,30,Clouds
47537,26,1553738400,20,0,20,Clouds
47538,27,1553738400,20,0,20,Clouds
47539,28,1553738400,8,22,30,Clouds
47540,29,1553738400,24,5,29,Clouds
47541,30,1553738400,20,0,20,Clouds
47542,31,1553738400,18,2,20,Clouds
47543,32,1553738400,30,0,30,Clouds
47544,33,1553738400,22,1,23,Clouds
47545,34,1553738400,0,29,29,Clouds
47546,35,1553738400,17,13,30,Clouds
47547,36,1553738400,40,0,40,Clouds
47548,37,1553738400,30,0,30,Clouds
47549,38,1553738400,10,30,40,Clouds
47550,39,1553738400,18,2,20,Clouds
47551,40,1553738400,18,3,21,Clouds
47552,41,1553738400,20,0,20,Clouds
47553,42,1553738400,8,22,30,Clouds
47554,43,1553738400,3,27,30,Clouds
47555,44,1553738400,2,28,30,Clouds
47556,45,1553738400,26,4,30,Clouds
47557,46,1553738400,20,0,20,Clouds
47558,47,1553738400,40,0,40,Clouds
47559,48,1553738400,37,3,40,Clouds
47560,49,1553738400,39,1,40,Clouds
47561,50,1553738400,0,40,40,Clouds
47562,51,1553738400,40,0,40,Clouds
47563,52,1553738400,32,0,32,Clouds
47564,53,1553738400,40,0,40,Clouds
47565,54,1553738400,33,0,33,Clouds
47566,55,1553738400,35,0,35,Clouds
47567,56,1553738400,27,13,40,Clouds
47568,57,1553738400,22,1,23,Clouds
47569,58,1553738400,37,3,40,Clouds
47570,59,1553738400,19,1,20,Clouds
47571,60,1553738400,6,24,30,Clouds
47572,61,1553738400,15,10,25,Clouds
47573,62,1553738400,40,0,40,Clouds
47574,63,1553738400,35,0,35,Clouds
47575,64,1553738400,37,3,40,Clouds
47576,65,1553738400,40,0,40,Clouds
47577,66,1553738400,31,9,40,Clouds
47578,67,1553738400,18,22,40,Clouds
47579,68,1553738400,37,3,40,Clouds
47580,69,1553738400,38,2,40,Clouds
47581,70,1553738400,11,17,28,Clouds
47582,71,1553738400,38,2,40,Clouds
47583,72,1553738400,19,12,31,Clouds
47584,73,1553738400,21,9,30,Clouds
47585,74,1553738400,7,23,30,Clouds
47586,75,1553738400,6,34,40,Clouds
47587,76,1553738400,25,13,38,Clouds
47588,77,1553738400,26,3,29,Clouds
47589,78,1553738400,21,19,40,Clouds
47590,79,1553738400,18,9,27,Clouds
47591,80,1553738400,12,28,40,Clouds
47592,81,1553738400,39,1,40,Clouds
47593,82,1553738400,3,19,22,Clouds
47594,83,1553738400,6,34,40,Clouds
47595,84,1553738400,3,27,30,Clouds
47596,85,1553738400,2,33,35,Clouds
47597,86,1553738400,4,34,38,Clouds
47598,87,1553738400,0,38,38,Clouds
47599,88,1553738400,3,27,30,Clouds
47600,89,1553738400,39,1,40,Clouds
47601,90,1553738400,38,2,40,Clouds
47602,91,1553738400,14,16,30,Clouds
47603,92,1553738400,6,34,40,Clouds
47604,93,1553738400,2,38,40,Clouds
47605,94,1553738400,9,31,40,Clouds
47606,95,1553738400,0,40,40,Clouds
47607,96,1553738400,15,15,30,Clouds
47608,97,1553738400,10,30,40,Clouds
47609,98,1553738400,40,0,40,Clouds
47610,99,1553738400,30,0,30,Clouds
47611,100,1553738400,7,18,25,Clouds
47612,101,1553738400,15,15,30,Clouds
47613,102,1553738400,26,14,40,Clouds
47614,103,1553738400,33,7,40,Clouds
47615,104,1553738400,31,9,40,Clouds
47616,105,1553738400,24,12,36,Clouds
47617,106,1553738400,4,36,40,Clouds
47618,107,1553738400,6,34,40,Clouds
47619,108,1553738400,16,24,40,Clouds
47620,109,1553738400,5,24,29,Clouds
47621,110,1553738400,23,17,40,Clouds
47622,111,1553738400,9,31,40,Clouds
47623,112,1553738400,3,27,30,Clouds
47624,113,1553738400,40,0,40,Clouds
47625,114,1553738400,40,0,40,Clouds
47626,115,1553738400,0,30,30,Clouds
47627,2,1553742000,7,13,20,Clouds
47628,3,1553742000,16,4,20,Clouds
47629,4,1553742000,19,1,20,Clouds
47630,5,1553742000,21,19,40,Clouds
47631,6,1553742000,20,0,20,Clouds
47632,7,1553742000,24,5,29,Clouds
47633,8,1553742000,30,0,30,Clouds
47634,9,1553742000,24,0,24,Clouds
47635,10,1553742000,16,0,16,Clouds
47636,11,1553742000,30,0,30,Clouds
47637,12,1553742000,8,12,20,Clouds
47638,13,1553742000,30,0,30,Clouds
47639,14,1553742000,30,0,30,Clouds
47640,15,1553742000,11,4,15,Clouds
47641,16,1553742000,19,1,20,Clouds
47642,17,1553742000,18,2,20,Clouds
47643,18,1553742000,24,6,30,Clouds
47644,19,1553742000,30,0,30,Clouds
47645,21,1553742000,30,0,30,Clouds
47646,22,1553742000,19,1,20,Clouds
47647,23,1553742000,23,7,30,Clouds
47648,24,1553742000,17,3,20,Clouds
47649,25,1553742000,30,0,30,Clouds
47650,26,1553742000,20,0,20,Clouds
47651,27,1553742000,20,0,20,Clouds
47652,28,1553742000,7,23,30,Clouds
47653,29,1553742000,24,5,29,Clouds
47654,30,1553742000,20,0,20,Clouds
47655,31,1553742000,18,2,20,Clouds
47656,32,1553742000,30,0,30,Clouds
47657,33,1553742000,22,1,23,Clouds
47658,34,1553742000,0,29,29,Clouds
47659,35,1553742000,17,13,30,Clouds
47660,36,1553742000,40,0,40,Clouds
47661,37,1553742000,30,0,30,Clouds
47662,38,1553742000,10,30,40,Clouds
47663,39,1553742000,18,2,20,Clouds
47664,40,1553742000,18,3,21,Clouds
47665,41,1553742000,20,0,20,Clouds
47666,42,1553742000,8,22,30,Clouds
47667,43,1553742000,3,27,30,Clouds
47668,44,1553742000,1,29,30,Clouds
47669,45,1553742000,26,4,30,Clouds
47670,46,1553742000,20,0,20,Clouds
47671,47,1553742000,40,0,40,Clouds
47672,48,1553742000,37,3,40,Clouds
47673,49,1553742000,39,1,40,Clouds
47674,50,1553742000,0,40,40,Clouds
47675,51,1553742000,40,0,40,Clouds
47676,52,1553742000,32,0,32,Clouds
47677,53,1553742000,40,0,40,Clouds
47678,54,1553742000,33,0,33,Clouds
47679,55,1553742000,35,0,35,Clouds
47680,56,1553742000,27,13,40,Clouds
47681,57,1553742000,22,1,23,Clouds
47682,58,1553742000,37,3,40,Clouds
47683,59,1553742000,19,1,20,Clouds
47684,60,1553742000,6,24,30,Clouds
47685,61,1553742000,15,10,25,Clouds
47686,62,1553742000,40,0,40,Clouds
47687,63,1553742000,35,0,35,Clouds
47688,64,1553742000,37,3,40,Clouds
47689,65,1553742000,40,0,40,Clouds
47690,66,1553742000,31,9,40,Clouds
47691,67,1553742000,18,22,40,Clouds
47692,68,1553742000,37,3,40,Clouds
47693,69,1553742000,38,2,40,Clouds
47694,70,1553742000,11,17,28,Clouds
47695,71,1553742000,38,2,40,Clouds
47696,72,1553742000,19,12,31,Clouds
47697,73,1553742000,21,9,30,Clouds
47698,74,1553742000,7,23,30,Clouds
47699,75,1553742000,6,34,40,Clouds
47700,76,1553742000,25,13,38,Clouds
47701,77,1553742000,26,3,29,Clouds
47702,78,1553742000,21,19,40,Clouds
47703,79,1553742000,18,9,27,Clouds
47704,80,1553742000,12,28,40,Clouds
47705,81,1553742000,39,1,40,Clouds
47706,82,1553742000,3,19,22,Clouds
47707,83,1553742000,6,34,40,Clouds
47708,84,1553742000,3,27,30,Clouds
47709,85,1553742000,2,33,35,Clouds
47710,86,1553742000,4,34,38,Clouds
47711,87,1553742000,0,38,38,Clouds
47712,88,1553742000,3,27,30,Clouds
47713,89,1553742000,39,1,40,Clouds
47714,90,1553742000,38,2,40,Clouds
47715,91,1553742000,14,16,30,Clouds
47716,92,1553742000,6,34,40,Clouds
47717,93,1553742000,2,38,40,Clouds
47718,94,1553742000,9,31,40,Clouds
47719,95,1553742000,0,40,40,Clouds
47720,96,1553742000,15,15,30,Clouds
47721,97,1553742000,10,30,40,Clouds
47722,98,1553742000,40,0,40,Clouds
47723,99,1553742000,30,0,30,Clouds
47724,100,1553742000,7,18,25,Clouds
47725,101,1553742000,15,15,30,Clouds
47726,102,1553742000,26,14,40,Clouds
47727,103,1553742000,33,7,40,Clouds
47728,104,1553742000,31,9,40,Clouds
47729,105,1553742000,24,12,36,Clouds
47730,106,1553742000,4,36,40,Clouds
47731,107,1553742000,6,34,40,Clouds
47732,108,1553742000,16,24,40,Clouds
47733,109,1553742000,5,24,29,Clouds
47734,110,1553742000,23,17,40,Clouds
47735,111,1553742000,9,31,40,Clouds
47736,112,1553742000,3,27,30,Clouds
47737,113,1553742000,40,0,40,Clouds
47738,114,1553742000,40,0,40,Clouds
47739,115,1553742000,0,30,30,Clouds
47740,2,1553745600,7,13,20,Clouds
47741,3,1553745600,16,4,20,Clouds
47742,4,1553745600,19,1,20,Clouds
47743,5,1553745600,21,19,40,Clouds
47744,6,1553745600,20,0,20,Clouds
47745,7,1553745600,24,5,29,Clouds
47746,8,1553745600,30,0,30,Clouds
47747,9,1553745600,24,0,24,Clouds
47748,10,1553745600,16,0,16,Clouds
47749,11,1553745600,30,0,30,Clouds
47750,12,1553745600,8,12,20,Clouds
47751,13,1553745600,30,0,30,Clouds
47752,14,1553745600,30,0,30,Clouds
47753,15,1553745600,11,4,15,Clouds
47754,16,1553745600,19,1,20,Clouds
47755,17,1553745600,18,2,20,Clouds
47756,18,1553745600,24,6,30,Clouds
47757,19,1553745600,30,0,30,Clouds
47758,21,1553745600,30,0,30,Clouds
47759,22,1553745600,19,1,20,Clouds
47760,23,1553745600,23,7,30,Clouds
47761,24,1553745600,17,3,20,Clouds
47762,25,1553745600,30,0,30,Clouds
47763,26,1553745600,20,0,20,Clouds
47764,27,1553745600,20,0,20,Clouds
47765,28,1553745600,7,23,30,Clouds
47766,29,1553745600,24,5,29,Clouds
47767,30,1553745600,20,0,20,Clouds
47768,31,1553745600,18,2,20,Clouds
47769,32,1553745600,30,0,30,Clouds
47770,33,1553745600,22,1,23,Clouds
47771,34,1553745600,0,29,29,Clouds
47772,35,1553745600,17,13,30,Clouds
47773,36,1553745600,40,0,40,Clouds
47774,37,1553745600,30,0,30,Clouds
47775,38,1553745600,10,30,40,Clouds
47776,39,1553745600,18,2,20,Clouds
47777,40,1553745600,18,3,21,Clouds
47778,41,1553745600,20,0,20,Clouds
47779,42,1553745600,8,22,30,Clouds
47780,43,1553745600,3,27,30,Clouds
47781,44,1553745600,1,29,30,Clouds
47782,45,1553745600,26,4,30,Clouds
47783,46,1553745600,20,0,20,Clouds
47784,47,1553745600,40,0,40,Clouds
47785,48,1553745600,37,3,40,Clouds
47786,49,1553745600,39,1,40,Clouds
47787,50,1553745600,0,40,40,Clouds
47788,51,1553745600,40,0,40,Clouds
47789,52,1553745600,32,0,32,Clouds
47790,53,1553745600,40,0,40,Clouds
47791,54,1553745600,33,0,33,Clouds
47792,55,1553745600,35,0,35,Clouds
47793,56,1553745600,27,13,40,Clouds
47794,57,1553745600,22,1,23,Clouds
47795,58,1553745600,37,3,40,Clouds
47796,59,1553745600,19,1,20,Clouds
47797,60,1553745600,6,24,30,Clouds
47798,61,1553745600,15,10,25,Clouds
47799,62,1553745600,40,0,40,Clouds
47800,63,1553745600,35,0,35,Clouds
47801,64,1553745600,37,3,40,Clouds
47802,65,1553745600,40,0,40,Clouds
47803,66,1553745600,31,9,40,Clouds
47804,67,1553745600,18,22,40,Clouds
47805,68,1553745600,37,3,40,Clouds
47806,69,1553745600,38,2,40,Clouds
47807,70,1553745600,11,17,28,Clouds
47808,71,1553745600,38,2,40,Clouds
47809,72,1553745600,19,12,31,Clouds
47810,73,1553745600,21,9,30,Clouds
47811,74,1553745600,7,23,30,Clouds
47812,75,1553745600,6,34,40,Clouds
47813,76,1553745600,25,13,38,Clouds
47814,77,1553745600,26,3,29,Clouds
47815,78,1553745600,21,19,40,Clouds
47816,79,1553745600,18,9,27,Clouds
47817,80,1553745600,12,28,40,Clouds
47818,81,1553745600,39,1,40,Clouds
47819,82,1553745600,3,19,22,Clouds
47820,83,1553745600,6,34,40,Clouds
47821,84,1553745600,3,27,30,Clouds
47822,85,1553745600,2,33,35,Clouds
47823,86,1553745600,4,34,38,Clouds
47824,87,1553745600,0,38,38,Clouds
47825,88,1553745600,3,27,30,Clouds
47826,89,1553745600,39,1,40,Clouds
47827,90,1553745600,38,2,40,Clouds
47828,91,1553745600,14,16,30,Clouds
47829,92,1553745600,6,34,40,Clouds
47830,93,1553745600,2,38,40,Clouds
47831,94,1553745600,9,31,40,Clouds
47832,95,1553745600,0,40,40,Clouds
47833,96,1553745600,15,15,30,Clouds
47834,97,1553745600,10,30,40,Clouds
47835,98,1553745600,40,0,40,Clouds
47836,99,1553745600,30,0,30,Clouds
47837,100,1553745600,7,18,25,Clouds
47838,101,1553745600,15,15,30,Clouds
47839,102,1553745600,26,14,40,Clouds
47840,103,1553745600,33,7,40,Clouds
47841,104,1553745600,31,9,40,Clouds
47842,105,1553745600,24,12,36,Clouds
47843,106,1553745600,4,36,40,Clouds
47844,107,1553745600,6,34,40,Clouds
47845,108,1553745600,16,24,40,Clouds
47846,109,1553745600,5,24,29,Clouds
47847,110,1553745600,23,17,40,Clouds
47848,111,1553745600,9,31,40,Clouds
47849,112,1553745600,3,27,30,Clouds
47850,113,1553745600,40,0,40,Clouds
47851,114,1553745600,40,0,40,Clouds
47852,115,1553745600,0,30,30,Clouds
47853,2,1553749200,7,13,20,Clouds
47854,3,1553749200,16,4,20,Clouds
47855,4,1553749200,19,1,20,Clouds
47856,5,1553749200,21,19,40,Clouds
47857,6,1553749200,20,0,20,Clouds
47858,7,1553749200,24,5,29,Clouds
47859,8,1553749200,30,0,30,Clouds
47860,9,1553749200,24,0,24,Clouds
47861,10,1553749200,16,0,16,Clouds
47862,11,1553749200,30,0,30,Clouds
47863,12,1553749200,8,12,20,Clouds
47864,13,1553749200,30,0,30,Clouds
47865,14,1553749200,30,0,30,Clouds
47866,15,1553749200,11,4,15,Clouds
47867,16,1553749200,19,1,20,Clouds
47868,17,1553749200,18,2,20,Clouds
47869,18,1553749200,24,6,30,Clouds
47870,19,1553749200,30,0,30,Clouds
47871,21,1553749200,30,0,30,Clouds
47872,22,1553749200,19,1,20,Clouds
47873,23,1553749200,23,7,30,Clouds
47874,24,1553749200,17,3,20,Clouds
47875,25,1553749200,30,0,30,Clouds
47876,26,1553749200,20,0,20,Clouds
47877,27,1553749200,20,0,20,Clouds
47878,28,1553749200,7,23,30,Clouds
47879,29,1553749200,24,5,29,Clouds
47880,30,1553749200,20,0,20,Clouds
47881,31,1553749200,18,2,20,Clouds
47882,32,1553749200,30,0,30,Clouds
47883,33,1553749200,22,1,23,Clouds
47884,34,1553749200,0,29,29,Clouds
47885,35,1553749200,17,13,30,Clouds
47886,36,1553749200,40,0,40,Clouds
47887,37,1553749200,30,0,30,Clouds
47888,38,1553749200,10,30,40,Clouds
47889,39,1553749200,18,2,20,Clouds
47890,40,1553749200,18,3,21,Clouds
47891,41,1553749200,20,0,20,Clouds
47892,42,1553749200,8,22,30,Clouds
47893,43,1553749200,3,27,30,Clouds
47894,44,1553749200,1,29,30,Clouds
47895,45,1553749200,26,4,30,Clouds
47896,46,1553749200,20,0,20,Clouds
47897,47,1553749200,40,0,40,Clouds
47898,48,1553749200,37,3,40,Clouds
47899,49,1553749200,39,1,40,Clouds
47900,50,1553749200,0,40,40,Clouds
47901,51,1553749200,40,0,40,Clouds
47902,52,1553749200,32,0,32,Clouds
47903,53,1553749200,40,0,40,Clouds
47904,54,1553749200,33,0,33,Clouds
47905,55,1553749200,35,0,35,Clouds
47906,56,1553749200,27,13,40,Clouds
47907,57,1553749200,22,1,23,Clouds
47908,58,1553749200,37,3,40,Clouds
47909,59,1553749200,19,1,20,Clouds
47910,60,1553749200,6,24,30,Clouds
47911,61,1553749200,15,10,25,Clouds
47912,62,1553749200,40,0,40,Clouds
47913,63,1553749200,35,0,35,Clouds
47914,64,1553749200,37,3,40,Clouds
47915,65,1553749200,40,0,40,Clouds
47916,66,1553749200,31,9,40,Clouds
47917,67,1553749200,18,22,40,Clouds
47918,68,1553749200,37,3,40,Clouds
47919,69,1553749200,38,2,40,Clouds
47920,70,1553749200,11,17,28,Clouds
47921,71,1553749200,38,2,40,Clouds
47922,72,1553749200,19,12,31,Clouds
47923,73,1553749200,21,9,30,Clouds
47924,74,1553749200,7,23,30,Clouds
47925,75,1553749200,6,34,40,Clouds
47926,76,1553749200,25,13,38,Clouds
47927,77,1553749200,26,3,29,Clouds
47928,78,1553749200,21,19,40,Clouds
47929,79,1553749200,18,9,27,Clouds
47930,80,1553749200,12,28,40,Clouds
47931,81,1553749200,39,1,40,Clouds
47932,82,1553749200,3,19,22,Clouds
47933,83,1553749200,6,34,40,Clouds
47934,84,1553749200,3,27,30,Clouds
47935,85,1553749200,2,33,35,Clouds
47936,86,1553749200,4,34,38,Clouds
47937,87,1553749200,0,38,38,Clouds
47938,88,1553749200,3,27,30,Clouds
47939,89,1553749200,39,1,40,Clouds
47940,90,1553749200,38,2,40,Clouds
47941,91,1553749200,14,16,30,Clouds
47942,92,1553749200,6,34,40,Clouds
47943,93,1553749200,2,38,40,Clouds
47944,94,1553749200,9,31,40,Clouds
47945,95,1553749200,0,40,40,Clouds
47946,96,1553749200,15,15,30,Clouds
47947,97,1553749200,10,30,40,Clouds
47948,98,1553749200,40,0,40,Clouds
47949,99,1553749200,30,0,30,Clouds
47950,100,1553749200,7,18,25,Clouds
47951,101,1553749200,15,15,30,Clouds
47952,102,1553749200,26,14,40,Clouds
47953,103,1553749200,33,7,40,Clouds
47954,104,1553749200,31,9,40,Clouds
47955,105,1553749200,24,12,36,Clouds
47956,106,1553749200,4,36,40,Clouds
47957,107,1553749200,6,34,40,Clouds
47958,108,1553749200,16,24,40,Clouds
47959,109,1553749200,5,24,29,Clouds
47960,110,1553749200,23,17,40,Clouds
47961,111,1553749200,9,31,40,Clouds
47962,112,1553749200,3,27,30,Clouds
47963,113,1553749200,40,0,40,Clouds
47964,114,1553749200,40,0,40,Clouds
47965,115,1553749200,0,30,30,Clouds
47966,2,1553752800,7,13,20,Clouds
47967,3,1553752800,16,4,20,Clouds
47968,4,1553752800,19,1,20,Clouds
47969,5,1553752800,21,19,40,Clouds
47970,6,1553752800,20,0,20,Clouds
47971,7,1553752800,24,5,29,Clouds
47972,8,1553752800,30,0,30,Clouds
47973,9,1553752800,24,0,24,Clouds
47974,10,1553752800,16,0,16,Clouds
47975,11,1553752800,30,0,30,Clouds
47976,12,1553752800,7,13,20,Clouds
47977,13,1553752800,30,0,30,Clouds
47978,14,1553752800,30,0,30,Clouds
47979,15,1553752800,11,4,15,Clouds
47980,16,1553752800,19,1,20,Clouds
47981,17,1553752800,18,2,20,Clouds
47982,18,1553752800,24,6,30,Clouds
47983,19,1553752800,30,0,30,Clouds
47984,21,1553752800,30,0,30,Clouds
47985,22,1553752800,19,1,20,Clouds
47986,23,1553752800,23,7,30,Clouds
47987,24,1553752800,17,3,20,Clouds
47988,25,1553752800,30,0,30,Clouds
47989,26,1553752800,20,0,20,Clouds
47990,27,1553752800,20,0,20,Clouds
47991,28,1553752800,7,23,30,Clouds
47992,29,1553752800,24,5,29,Clouds
47993,30,1553752800,20,0,20,Clouds
47994,31,1553752800,18,2,20,Clouds
47995,32,1553752800,30,0,30,Clouds
47996,33,1553752800,22,1,23,Clouds
47997,34,1553752800,0,29,29,Clouds
47998,35,1553752800,17,13,30,Clouds
47999,36,1553752800,40,0,40,Clouds
48000,37,1553752800,30,0,30,Clouds
48001,38,1553752800,10,30,40,Clouds
48002,39,1553752800,18,2,20,Clouds
48003,40,1553752800,18,3,21,Clouds
48004,41,1553752800,20,0,20,Clouds
48005,42,1553752800,8,22,30,Clouds
48006,43,1553752800,3,27,30,Clouds
48007,44,1553752800,1,29,30,Clouds
48008,45,1553752800,26,4,30,Clouds
48009,46,1553752800,20,0,20,Clouds
48010,47,1553752800,40,0,40,Clouds
48011,48,1553752800,37,3,40,Clouds
48012,49,1553752800,39,1,40,Clouds
48013,50,1553752800,0,40,40,Clouds
48014,51,1553752800,40,0,40,Clouds
48015,52,1553752800,32,0,32,Clouds
48016,53,1553752800,40,0,40,Clouds
48017,54,1553752800,33,0,33,Clouds
48018,55,1553752800,35,0,35,Clouds
48019,56,1553752800,27,13,40,Clouds
48020,57,1553752800,22,1,23,Clouds
48021,58,1553752800,37,3,40,Clouds
48022,59,1553752800,19,1,20,Clouds
48023,60,1553752800,6,24,30,Clouds
48024,61,1553752800,15,10,25,Clouds
48025,62,1553752800,40,0,40,Clouds
48026,63,1553752800,35,0,35,Clouds
48027,64,1553752800,37,3,40,Clouds
48028,65,1553752800,40,0,40,Clouds
48029,66,1553752800,31,9,40,Clouds
48030,67,1553752800,18,22,40,Clouds
48031,68,1553752800,37,3,40,Clouds
48032,69,1553752800,38,2,40,Clouds
48033,70,1553752800,11,17,28,Clouds
48034,71,1553752800,38,2,40,Clouds
48035,72,1553752800,19,12,31,Clouds
48036,73,1553752800,21,9,30,Clouds
48037,74,1553752800,7,23,30,Clouds
48038,75,1553752800,6,34,40,Clouds
48039,76,1553752800,25,13,38,Clouds
48040,77,1553752800,26,3,29,Clouds
48041,78,1553752800,21,19,40,Clouds
48042,79,1553752800,18,9,27,Clouds
48043,80,1553752800,13,27,40,Clouds
48044,81,1553752800,39,1,40,Clouds
48045,82,1553752800,3,19,22,Clouds
48046,83,1553752800,6,34,40,Clouds
48047,84,1553752800,3,27,30,Clouds
48048,85,1553752800,2,33,35,Clouds
48049,86,1553752800,4,34,38,Clouds
48050,87,1553752800,0,38,38,Clouds
48051,88,1553752800,3,27,30,Clouds
48052,89,1553752800,39,1,40,Clouds
48053,90,1553752800,38,2,40,Clouds
48054,91,1553752800,14,16,30,Clouds
48055,92,1553752800,6,34,40,Clouds
48056,93,1553752800,2,38,40,Clouds
48057,94,1553752800,9,31,40,Clouds
48058,95,1553752800,0,40,40,Clouds
48059,96,1553752800,15,15,30,Clouds
48060,97,1553752800,10,30,40,Clouds
48061,98,1553752800,40,0,40,Clouds
48062,99,1553752800,30,0,30,Clouds
48063,100,1553752800,7,18,25,Clouds
48064,101,1553752800,15,15,30,Clouds
48065,102,1553752800,26,14,40,Clouds
48066,103,1553752800,33,7,40,Clouds
48067,104,1553752800,31,9,40,Clouds
48068,105,1553752800,24,12,36,Clouds
48069,106,1553752800,4,36,40,Clouds
48070,107,1553752800,6,34,40,Clouds
48071,108,1553752800,16,24,40,Clouds
48072,109,1553752800,5,24,29,Clouds
48073,110,1553752800,23,17,40,Clouds
48074,111,1553752800,9,31,40,Clouds
48075,112,1553752800,3,27,30,Clouds
48076,113,1553752800,40,0,40,Clouds
48077,114,1553752800,40,0,40,Clouds
48078,115,1553752800,0,30,30,Clouds
48079,2,1553756400,7,13,20,Clouds
48080,3,1553756400,18,2,20,Clouds
48081,4,1553756400,20,0,20,Clouds
48082,5,1553756400,23,17,40,Clouds
48083,6,1553756400,19,1,20,Clouds
48084,7,1553756400,25,4,29,Clouds
48085,8,1553756400,28,2,30,Clouds
48086,9,1553756400,18,6,24,Clouds
48087,10,1553756400,14,2,16,Clouds
48088,11,1553756400,29,1,30,Clouds
48089,12,1553756400,10,10,20,Clouds
48090,13,1553756400,30,0,30,Clouds
48091,14,1553756400,20,10,30,Clouds
48092,15,1553756400,13,3,16,Clouds
48093,16,1553756400,19,1,20,Clouds
48094,17,1553756400,18,2,20,Clouds
48095,18,1553756400,26,4,30,Clouds
48096,19,1553756400,28,2,30,Clouds
48097,21,1553756400,28,2,30,Clouds
48098,22,1553756400,18,2,20,Clouds
48099,23,1553756400,24,6,30,Clouds
48100,24,1553756400,14,6,20,Clouds
48101,25,1553756400,29,1,30,Clouds
48102,26,1553756400,19,1,20,Clouds
48103,27,1553756400,19,1,20,Clouds
48104,28,1553756400,11,19,30,Clouds
48105,29,1553756400,22,7,29,Clouds
48106,30,1553756400,20,0,20,Clouds
48107,31,1553756400,19,1,20,Clouds
48108,32,1553756400,24,6,30,Clouds
48109,33,1553756400,14,9,23,Clouds
48110,34,1553756400,5,24,29,Clouds
48111,35,1553756400,22,8,30,Clouds
48112,36,1553756400,36,4,40,Clouds
48113,37,1553756400,30,0,30,Clouds
48114,38,1553756400,12,28,40,Clouds
48115,39,1553756400,18,2,20,Clouds
48116,40,1553756400,17,4,21,Clouds
48117,41,1553756400,20,0,20,Clouds
48118,42,1553756400,10,20,30,Clouds
48119,43,1553756400,9,21,30,Clouds
48120,44,1553756400,6,24,30,Clouds
48121,45,1553756400,28,2,30,Clouds
48122,46,1553756400,19,1,20,Clouds
48123,47,1553756400,40,0,40,Clouds
48124,48,1553756400,35,5,40,Clouds
48125,49,1553756400,33,7,40,Clouds
48126,50,1553756400,3,37,40,Clouds
48127,51,1553756400,36,4,40,Clouds
48128,52,1553756400,25,7,32,Clouds
48129,53,1553756400,40,0,40,Clouds
48130,54,1553756400,33,0,33,Clouds
48131,55,1553756400,34,1,35,Clouds
48132,56,1553756400,31,9,40,Clouds
48133,57,1553756400,21,2,23,Clouds
48134,58,1553756400,37,3,40,Clouds
48135,59,1553756400,19,1,20,Clouds
48136,60,1553756400,10,20,30,Clouds
48137,61,1553756400,17,8,25,Clouds
48138,62,1553756400,38,2,40,Clouds
48139,63,1553756400,34,1,35,Clouds
48140,64,1553756400,38,2,40,Clouds
48141,65,1553756400,40,0,40,Clouds
48142,66,1553756400,29,11,40,Clouds
48143,67,1553756400,36,4,40,Clouds
48144,68,1553756400,34,6,40,Clouds
48145,69,1553756400,36,4,40,Clouds
48146,70,1553756400,16,12,28,Clouds
48147,71,1553756400,37,3,40,Clouds
48148,72,1553756400,19,12,31,Clouds
48149,73,1553756400,22,8,30,Clouds
48150,74,1553756400,9,21,30,Clouds
48151,75,1553756400,6,34,40,Clouds
48152,76,1553756400,27,11,38,Clouds
48153,77,1553756400,26,3,29,Clouds
48154,78,1553756400,22,18,40,Clouds
48155,79,1553756400,10,17,27,Clouds
48156,80,1553756400,16,24,40,Clouds
48157,81,1553756400,39,1,40,Clouds
48158,82,1553756400,4,18,22,Clouds
48159,83,1553756400,8,32,40,Clouds
48160,84,1553756400,9,21,30,Clouds
48161,85,1553756400,2,33,35,Clouds
48162,86,1553756400,1,37,38,Clouds
48163,87,1553756400,1,37,38,Clouds
48164,88,1553756400,0,30,30,Clouds
48165,89,1553756400,40,0,40,Clouds
48166,90,1553756400,36,4,40,Clouds
48167,91,1553756400,26,4,30,Clouds
48168,92,1553756400,1,39,40,Clouds
48169,93,1553756400,0,40,40,Clouds
48170,94,1553756400,0,40,40,Clouds
48171,95,1553756400,2,38,40,Clouds
48172,96,1553756400,15,15,30,Clouds
48173,97,1553756400,15,25,40,Clouds
48174,98,1553756400,39,1,40,Clouds
48175,99,1553756400,26,4,30,Clouds
48176,100,1553756400,0,25,25,Clouds
48177,101,1553756400,18,12,30,Clouds
48178,102,1553756400,26,14,40,Clouds
48179,103,1553756400,24,16,40,Clouds
48180,104,1553756400,22,18,40,Clouds
48181,105,1553756400,25,11,36,Clouds
48182,106,1553756400,4,36,40,Clouds
48183,107,1553756400,11,29,40,Clouds
48184,108,1553756400,17,23,40,Clouds
48185,109,1553756400,12,17,29,Clouds
48186,110,1553756400,24,16,40,Clouds
48187,111,1553756400,10,30,40,Clouds
48188,112,1553756400,7,23,30,Clouds
48189,113,1553756400,39,1,40,Clouds
48190,114,1553756400,40,0,40,Clouds
48191,115,1553756400,0,30,30,Clouds
48192,2,1553760000,19,1,20,Clear
48193,3,1553760000,20,0,20,Clear
48194,4,1553760000,18,2,20,Clear
48195,5,1553760000,22,18,40,Clear
48196,6,1553760000,20,0,20,Clear
48197,7,1553760000,25,4,29,Clear
48198,8,1553760000,22,8,30,Clear
48199,9,1553760000,19,5,24,Clear
48200,10,1553760000,13,3,16,Clear
48201,11,1553760000,26,4,30,Clear
48202,12,1553760000,19,1,20,Clear
48203,13,1553760000,26,4,30,Clear
48204,14,1553760000,20,10,30,Clear
48205,15,1553760000,16,0,16,Clear
48206,16,1553760000,20,0,20,Clear
48207,17,1553760000,20,0,20,Clear
48208,18,1553760000,24,6,30,Clear
48209,19,1553760000,25,5,30,Clear
48210,21,1553760000,28,2,30,Clear
48211,22,1553760000,16,4,20,Clear
48212,23,1553760000,25,5,30,Clear
48213,24,1553760000,13,7,20,Clear
48214,25,1553760000,22,8,30,Clear
48215,26,1553760000,9,11,20,Clear
48216,27,1553760000,14,6,20,Clear
48217,28,1553760000,7,23,30,Clear
48218,29,1553760000,20,9,29,Clear
48219,30,1553760000,19,1,20,Clear
48220,31,1553760000,16,4,20,Clear
48221,32,1553760000,19,11,30,Clear
48222,33,1553760000,0,23,23,Clear
48223,34,1553760000,9,21,30,Clear
48224,35,1553760000,29,1,30,Clear
48225,36,1553760000,38,2,40,Clear
48226,37,1553760000,30,0,30,Clear
48227,38,1553760000,13,27,40,Clear
48228,39,1553760000,17,3,20,Clear
48229,40,1553760000,13,8,21,Clear
48230,41,1553760000,20,0,20,Clear
48231,42,1553760000,18,12,30,Clear
48232,43,1553760000,18,12,30,Clear
48233,44,1553760000,18,12,30,Clear
48234,45,1553760000,28,2,30,Clear
48235,46,1553760000,17,3,20,Clear
48236,47,1553760000,38,2,40,Clear
48237,48,1553760000,33,7,40,Clear
48238,49,1553760000,37,3,40,Clear
48239,50,1553760000,14,26,40,Clear
48240,51,1553760000,33,7,40,Clear
48241,52,1553760000,30,2,32,Clear
48242,53,1553760000,38,2,40,Clear
48243,54,1553760000,31,2,33,Clear
48244,55,1553760000,28,7,35,Clear
48245,56,1553760000,34,6,40,Clear
48246,57,1553760000,23,0,23,Clear
48247,58,1553760000,31,9,40,Clear
48248,59,1553760000,18,2,20,Clear
48249,60,1553760000,30,0,30,Clear
48250,61,1553760000,20,5,25,Clear
48251,62,1553760000,34,6,40,Clear
48252,63,1553760000,31,4,35,Clear
48253,64,1553760000,37,3,40,Clear
48254,65,1553760000,33,7,40,Clear
48255,66,1553760000,30,10,40,Clear
48256,67,1553760000,34,6,40,Clear
48257,68,1553760000,17,23,40,Clear
48258,69,1553760000,31,9,40,Clear
48259,70,1553760000,16,12,28,Clear
48260,71,1553760000,40,0,40,Clear
48261,72,1553760000,25,6,31,Clear
48262,73,1553760000,28,2,30,Clear
48263,74,1553760000,6,24,30,Clear
48264,75,1553760000,5,35,40,Clear
48265,76,1553760000,36,2,38,Clear
48266,77,1553760000,28,1,29,Clear
48267,78,1553760000,24,16,40,Clear
48268,79,1553760000,0,27,27,Clear
48269,80,1553760000,19,21,40,Clear
48270,81,1553760000,39,1,40,Clear
48271,82,1553760000,10,12,22,Clear
48272,83,1553760000,10,30,40,Clear
48273,84,1553760000,10,20,30,Clear
48274,85,1553760000,5,30,35,Clear
48275,86,1553760000,4,34,38,Clear
48276,87,1553760000,2,36,38,Clear
48277,88,1553760000,9,21,30,Clear
48278,89,1553760000,36,4,40,Clear
48279,90,1553760000,26,14,40,Clear
48280,91,1553760000,27,3,30,Clear
48281,92,1553760000,4,36,40,Clear
48282,93,1553760000,0,40,40,Clear
48283,94,1553760000,0,40,40,Clear
48284,95,1553760000,8,32,40,Clear
48285,96,1553760000,17,13,30,Clear
48286,97,1553760000,19,21,40,Clear
48287,98,1553760000,38,2,40,Clear
48288,99,1553760000,26,4,30,Clear
48289,100,1553760000,13,12,25,Clear
48290,101,1553760000,27,3,30,Clear
48291,102,1553760000,31,9,40,Clear
48292,103,1553760000,23,17,40,Clear
48293,104,1553760000,22,18,40,Clear
48294,105,1553760000,25,11,36,Clear
48295,106,1553760000,5,35,40,Clear
48296,107,1553760000,14,26,40,Clear
48297,108,1553760000,21,19,40,Clear
48298,109,1553760000,17,12,29,Clear
48299,110,1553760000,25,15,40,Clear
48300,111,1553760000,19,21,40,Clear
48301,112,1553760000,19,11,30,Clear
48302,113,1553760000,38,2,40,Clear
48303,114,1553760000,38,2,40,Clear
48304,115,1553760000,5,25,30,Clear
48305,2,1553763600,20,0,20,Clear
48306,3,1553763600,18,2,20,Clear
48307,4,1553763600,19,1,20,Clear
48308,5,1553763600,39,1,40,Clear
48309,6,1553763600,20,0,20,Clear
48310,7,1553763600,29,0,29,Clear
48311,8,1553763600,25,5,30,Clear
48312,9,1553763600,15,9,24,Clear
48313,10,1553763600,9,7,16,Clear
48314,11,1553763600,15,15,30,Clear
48315,12,1553763600,19,1,20,Clear
48316,13,1553763600,23,7,30,Clear
48317,14,1553763600,8,22,30,Clear
48318,15,1553763600,15,1,16,Clear
48319,16,1553763600,20,0,20,Clear
48320,17,1553763600,20,0,20,Clear
48321,18,1553763600,28,1,29,Clear
48322,19,1553763600,20,10,30,Clear
48323,21,1553763600,28,2,30,Clear
48324,22,1553763600,14,6,20,Clear
48325,23,1553763600,28,2,30,Clear
48326,24,1553763600,20,0,20,Clear
48327,25,1553763600,10,19,29,Clear
48328,26,1553763600,17,3,20,Clear
48329,27,1553763600,9,11,20,Clear
48330,28,1553763600,14,16,30,Clear
48331,29,1553763600,27,2,29,Clear
48332,30,1553763600,17,3,20,Clear
48333,31,1553763600,13,7,20,Clear
48334,32,1553763600,18,12,30,Clear
48335,33,1553763600,4,19,23,Clear
48336,34,1553763600,30,0,30,Clear
48337,35,1553763600,30,0,30,Clear
48338,36,1553763600,30,10,40,Clear
48339,37,1553763600,28,2,30,Clear
48340,38,1553763600,11,29,40,Clear
48341,39,1553763600,19,1,20,Clear
48342,40,1553763600,2,19,21,Clear
48343,41,1553763600,20,0,20,Clear
48344,42,1553763600,30,0,30,Clear
48345,43,1553763600,30,0,30,Clear
48346,44,1553763600,29,1,30,Clear
48347,45,1553763600,29,1,30,Clear
48348,46,1553763600,17,3,20,Clear
48349,47,1553763600,30,10,40,Clear
48350,48,1553763600,29,11,40,Clear
48351,49,1553763600,28,12,40,Clear
48352,50,1553763600,31,9,40,Clear
48353,51,1553763600,29,11,40,Clear
48354,52,1553763600,24,8,32,Clear
48355,53,1553763600,32,8,40,Clear
48356,54,1553763600,25,8,33,Clear
48357,55,1553763600,21,13,34,Clear
48358,56,1553763600,32,8,40,Clear
48359,57,1553763600,14,9,23,Clear
48360,58,1553763600,30,9,39,Clear
48361,59,1553763600,17,3,20,Clear
48362,60,1553763600,30,0,30,Clear
48363,61,1553763600,25,0,25,Clear
48364,62,1553763600,35,5,40,Clear
48365,63,1553763600,25,9,34,Clear
48366,64,1553763600,33,7,40,Clear
48367,65,1553763600,40,0,40,Clear
48368,66,1553763600,8,31,39,Clear
48369,67,1553763600,26,14,40,Clear
48370,68,1553763600,23,17,40,Clear
48371,69,1553763600,9,31,40,Clear
48372,70,1553763600,13,15,28,Clear
48373,71,1553763600,36,4,40,Clear
48374,72,1553763600,28,3,31,Clear
48375,73,1553763600,30,0,30,Clear
48376,74,1553763600,29,1,30,Clear
48377,75,1553763600,31,9,40,Clear
48378,76,1553763600,38,0,38,Clear
48379,77,1553763600,25,4,29,Clear
48380,78,1553763600,30,9,39,Clear
48381,79,1553763600,2,25,27,Clear
48382,80,1553763600,30,10,40,Clear
48383,81,1553763600,38,2,40,Clear
48384,82,1553763600,15,7,22,Clear
48385,83,1553763600,24,16,40,Clear
48386,84,1553763600,23,7,30,Clear
48387,85,1553763600,20,15,35,Clear
48388,86,1553763600,28,10,38,Clear
48389,87,1553763600,12,26,38,Clear
48390,88,1553763600,21,9,30,Clear
48391,89,1553763600,32,8,40,Clear
48392,90,1553763600,1,38,39,Clear
48393,91,1553763600,27,2,29,Clear
48394,92,1553763600,19,21,40,Clear
48395,93,1553763600,9,31,40,Clear
48396,94,1553763600,11,29,40,Clear
48397,95,1553763600,22,18,40,Clear
48398,96,1553763600,24,6,30,Clear
48399,97,1553763600,40,0,40,Clear
48400,98,1553763600,37,3,40,Clear
48401,99,1553763600,26,4,30,Clear
48402,100,1553763600,25,0,25,Clear
48403,101,1553763600,30,0,30,Clear
48404,102,1553763600,21,19,40,Clear
48405,103,1553763600,21,19,40,Clear
48406,104,1553763600,22,18,40,Clear
48407,105,1553763600,23,13,36,Clear
48408,106,1553763600,9,31,40,Clear
48409,107,1553763600,25,15,40,Clear
48410,108,1553763600,23,17,40,Clear
48411,109,1553763600,16,13,29,Clear
48412,110,1553763600,29,11,40,Clear
48413,111,1553763600,32,8,40,Clear
48414,112,1553763600,28,2,30,Clear
48415,113,1553763600,34,6,40,Clear
48416,114,1553763600,30,10,40,Clear
48417,115,1553763600,11,19,30,Clear
48418,2,1553767200,20,0,20,Clouds
48419,3,1553767200,16,4,20,Clouds
48420,4,1553767200,17,3,20,Clouds
48421,5,1553767200,40,0,40,Clouds
48422,6,1553767200,18,2,20,Clouds
48423,7,1553767200,29,0,29,Clouds
48424,8,1553767200,14,16,30,Clouds
48425,9,1553767200,9,15,24,Clouds
48426,10,1553767200,16,0,16,Clouds
48427,11,1553767200,11,19,30,Clouds
48428,12,1553767200,20,0,20,Clouds
48429,13,1553767200,9,21,30,Clouds
48430,14,1553767200,13,17,30,Clouds
48431,15,1553767200,10,6,16,Clouds
48432,16,1553767200,19,1,20,Clouds
48433,17,1553767200,19,1,20,Clouds
48434,18,1553767200,28,1,29,Clouds
48435,19,1553767200,9,21,30,Clouds
48436,21,1553767200,26,4,30,Clouds
48437,22,1553767200,18,2,20,Clouds
48438,23,1553767200,26,4,30,Clouds
48439,24,1553767200,19,1,20,Clouds
48440,25,1553767200,1,28,29,Clouds
48441,26,1553767200,9,11,20,Clouds
48442,27,1553767200,6,14,20,Clouds
48443,28,1553767200,30,0,30,Clouds
48444,29,1553767200,26,3,29,Clouds
48445,30,1553767200,16,4,20,Clouds
48446,31,1553767200,5,15,20,Clouds
48447,32,1553767200,17,13,30,Clouds
48448,33,1553767200,9,14,23,Clouds
48449,34,1553767200,30,0,30,Clouds
48450,35,1553767200,29,1,30,Clouds
48451,36,1553767200,2,37,39,Clouds
48452,37,1553767200,29,1,30,Clouds
48453,38,1553767200,27,13,40,Clouds
48454,39,1553767200,20,0,20,Clouds
48455,40,1553767200,13,8,21,Clouds
48456,41,1553767200,19,1,20,Clouds
48457,42,1553767200,30,0,30,Clouds
48458,43,1553767200,30,0,30,Clouds
48459,44,1553767200,30,0,30,Clouds
48460,45,1553767200,30,0,30,Clouds
48461,46,1553767200,19,1,20,Clouds
48462,47,1553767200,3,36,39,Clouds
48463,48,1553767200,12,27,39,Clouds
48464,49,1553767200,0,40,40,Clouds
48465,50,1553767200,40,0,40,Clouds
48466,51,1553767200,35,5,40,Clouds
48467,52,1553767200,11,21,32,Clouds
48468,53,1553767200,23,17,40,Clouds
48469,54,1553767200,30,3,33,Clouds
48470,55,1553767200,4,30,34,Clouds
48471,56,1553767200,16,24,40,Clouds
48472,57,1553767200,4,19,23,Clouds
48473,58,1553767200,8,31,39,Clouds
48474,59,1553767200,20,0,20,Clouds
48475,60,1553767200,30,0,30,Clouds
48476,61,1553767200,25,0,25,Clouds
48477,62,1553767200,8,31,39,Clouds
48478,63,1553767200,4,30,34,Clouds
48479,64,1553767200,13,26,39,Clouds
48480,65,1553767200,21,19,40,Clouds
48481,66,1553767200,1,38,39,Clouds
48482,67,1553767200,16,24,40,Clouds
48483,68,1553767200,0,40,40,Clouds
48484,69,1553767200,0,40,40,Clouds
48485,70,1553767200,16,12,28,Clouds
48486,71,1553767200,39,1,40,Clouds
48487,72,1553767200,31,0,31,Clouds
48488,73,1553767200,30,0,30,Clouds
48489,74,1553767200,27,3,30,Clouds
48490,75,1553767200,40,0,40,Clouds
48491,76,1553767200,38,0,38,Clouds
48492,77,1553767200,28,1,29,Clouds
48493,78,1553767200,38,1,39,Clouds
48494,79,1553767200,27,0,27,Clouds
48495,80,1553767200,40,0,40,Clouds
48496,81,1553767200,38,2,40,Clouds
48497,82,1553767200,22,0,22,Clouds
48498,83,1553767200,40,0,40,Clouds
48499,84,1553767200,30,0,30,Clouds
48500,85,1553767200,35,0,35,Clouds
48501,86,1553767200,38,0,38,Clouds
48502,87,1553767200,38,0,38,Clouds
48503,88,1553767200,30,0,30,Clouds
48504,89,1553767200,37,3,40,Clouds
48505,90,1553767200,1,38,39,Clouds
48506,91,1553767200,25,4,29,Clouds
48507,92,1553767200,40,0,40,Clouds
48508,93,1553767200,40,0,40,Clouds
48509,94,1553767200,40,0,40,Clouds
48510,95,1553767200,40,0,40,Clouds
48511,96,1553767200,30,0,30,Clouds
48512,97,1553767200,40,0,40,Clouds
48513,98,1553767200,34,6,40,Clouds
48514,99,1553767200,16,14,30,Clouds
48515,100,1553767200,19,6,25,Clouds
48516,101,1553767200,30,0,30,Clouds
48517,102,1553767200,38,2,40,Clouds
48518,103,1553767200,38,2,40,Clouds
48519,104,1553767200,22,18,40,Clouds
48520,105,1553767200,27,9,36,Clouds
48521,106,1553767200,22,18,40,Clouds
48522,107,1553767200,39,1,40,Clouds
48523,108,1553767200,35,5,40,Clouds
48524,109,1553767200,29,0,29,Clouds
48525,110,1553767200,36,4,40,Clouds
48526,111,1553767200,40,0,40,Clouds
48527,112,1553767200,30,0,30,Clouds
48528,113,1553767200,25,15,40,Clouds
48529,114,1553767200,12,28,40,Clouds
48530,115,1553767200,29,1,30,Clouds
48531,2,1553770800,20,0,20,Clear
48532,3,1553770800,20,0,20,Clear
48533,4,1553770800,16,4,20,Clear
48534,5,1553770800,40,0,40,Clear
48535,6,1553770800,20,0,20,Clear
48536,7,1553770800,29,0,29,Clear
48537,8,1553770800,9,21,30,Clear
48538,9,1553770800,16,8,24,Clear
48539,10,1553770800,15,1,16,Clear
48540,11,1553770800,8,22,30,Clear
48541,12,1553770800,20,0,20,Clear
48542,13,1553770800,7,23,30,Clear
48543,14,1553770800,17,13,30,Clear
48544,15,1553770800,16,0,16,Clear
48545,16,1553770800,19,1,20,Clear
48546,17,1553770800,20,0,20,Clear
48547,18,1553770800,28,1,29,Clear
48548,19,1553770800,0,30,30,Clear
48549,21,1553770800,13,17,30,Clear
48550,22,1553770800,16,4,20,Clear
48551,23,1553770800,30,0,30,Clear
48552,24,1553770800,17,3,20,Clear
48553,25,1553770800,1,28,29,Clear
48554,26,1553770800,7,13,20,Clear
48555,27,1553770800,2,18,20,Clear
48556,28,1553770800,18,12,30,Clear
48557,29,1553770800,27,2,29,Clear
48558,30,1553770800,18,2,20,Clear
48559,31,1553770800,8,12,20,Clear
48560,32,1553770800,16,14,30,Clear
48561,33,1553770800,17,6,23,Clear
48562,34,1553770800,15,15,30,Clear
48563,35,1553770800,30,0,30,Clear
48564,36,1553770800,1,38,39,Clear
48565,37,1553770800,27,3,30,Clear
48566,38,1553770800,35,5,40,Clear
48567,39,1553770800,20,0,20,Clear
48568,40,1553770800,8,13,21,Clear
48569,41,1553770800,6,14,20,Clear
48570,42,1553770800,30,0,30,Clear
48571,43,1553770800,29,1,30,Clear
48572,44,1553770800,30,0,30,Clear
48573,45,1553770800,29,1,30,Clear
48574,46,1553770800,20,0,20,Clear
48575,47,1553770800,2,38,40,Clear
48576,48,1553770800,0,40,40,Clear
48577,49,1553770800,0,40,40,Clear
48578,50,1553770800,39,1,40,Clear
48579,51,1553770800,37,3,40,Clear
48580,52,1553770800,9,23,32,Clear
48581,53,1553770800,11,29,40,Clear
48582,54,1553770800,27,6,33,Clear
48583,55,1553770800,12,22,34,Clear
48584,56,1553770800,14,26,40,Clear
48585,57,1553770800,0,23,23,Clear
48586,58,1553770800,19,21,40,Clear
48587,59,1553770800,20,0,20,Clear
48588,60,1553770800,30,0,30,Clear
48589,61,1553770800,25,0,25,Clear
48590,62,1553770800,1,39,40,Clear
48591,63,1553770800,1,33,34,Clear
48592,64,1553770800,3,37,40,Clear
48593,65,1553770800,0,40,40,Clear
48594,66,1553770800,1,39,40,Clear
48595,67,1553770800,12,28,40,Clear
48596,68,1553770800,1,39,40,Clear
48597,69,1553770800,2,38,40,Clear
48598,70,1553770800,13,15,28,Clear
48599,71,1553770800,38,2,40,Clear
48600,72,1553770800,30,1,31,Clear
48601,73,1553770800,29,1,30,Clear
48602,74,1553770800,29,1,30,Clear
48603,75,1553770800,40,0,40,Clear
48604,76,1553770800,38,0,38,Clear
48605,77,1553770800,23,6,29,Clear
48606,78,1553770800,39,0,39,Clear
48607,79,1553770800,17,10,27,Clear
48608,80,1553770800,36,4,40,Clear
48609,81,1553770800,40,0,40,Clear
48610,82,1553770800,22,0,22,Clear
48611,83,1553770800,40,0,40,Clear
48612,84,1553770800,30,0,30,Clear
48613,85,1553770800,35,0,35,Clear
48614,86,1553770800,37,1,38,Clear
48615,87,1553770800,38,0,38,Clear
48616,88,1553770800,30,0,30,Clear
48617,89,1553770800,24,16,40,Clear
48618,90,1553770800,1,39,40,Clear
48619,91,1553770800,19,11,30,Clear
48620,92,1553770800,40,0,40,Clear
48621,93,1553770800,40,0,40,Clear
48622,94,1553770800,40,0,40,Clear
48623,95,1553770800,39,1,40,Clear
48624,96,1553770800,30,0,30,Clear
48625,97,1553770800,40,0,40,Clear
48626,98,1553770800,22,18,40,Clear
48627,99,1553770800,8,22,30,Clear
48628,100,1553770800,25,0,25,Clear
48629,101,1553770800,30,0,30,Clear
48630,102,1553770800,34,6,40,Clear
48631,103,1553770800,38,2,40,Clear
48632,104,1553770800,23,17,40,Clear
48633,105,1553770800,28,8,36,Clear
48634,106,1553770800,24,16,40,Clear
48635,107,1553770800,40,0,40,Clear
48636,108,1553770800,38,2,40,Clear
48637,109,1553770800,29,0,29,Clear
48638,110,1553770800,38,2,40,Clear
48639,111,1553770800,38,2,40,Clear
48640,112,1553770800,29,1,30,Clear
48641,113,1553770800,6,34,40,Clear
48642,114,1553770800,8,32,40,Clear
48643,115,1553770800,30,0,30,Clear
48644,2,1553774400,20,0,20,Clear
48645,3,1553774400,20,0,20,Clear
48646,4,1553774400,18,2,20,Clear
48647,5,1553774400,35,5,40,Clear
48648,6,1553774400,15,5,20,Clear
48649,7,1553774400,29,0,29,Clear
48650,8,1553774400,3,27,30,Clear
48651,9,1553774400,11,13,24,Clear
48652,10,1553774400,8,8,16,Clear
48653,11,1553774400,11,19,30,Clear
48654,12,1553774400,20,0,20,Clear
48655,13,1553774400,6,23,29,Clear
48656,14,1553774400,6,24,30,Clear
48657,15,1553774400,16,0,16,Clear
48658,16,1553774400,14,5,19,Clear
48659,17,1553774400,17,3,20,Clear
48660,18,1553774400,29,1,30,Clear
48661,19,1553774400,10,20,30,Clear
48662,21,1553774400,6,24,30,Clear
48663,22,1553774400,14,5,19,Clear
48664,23,1553774400,29,1,30,Clear
48665,24,1553774400,16,4,20,Clear
48666,25,1553774400,3,26,29,Clear
48667,26,1553774400,4,16,20,Clear
48668,27,1553774400,0,20,20,Clear
48669,28,1553774400,30,0,30,Clear
48670,29,1553774400,27,2,29,Clear
48671,30,1553774400,20,0,20,Clear
48672,31,1553774400,12,8,20,Clear
48673,32,1553774400,6,24,30,Clear
48674,33,1553774400,15,8,23,Clear
48675,34,1553774400,25,5,30,Clear
48676,35,1553774400,30,0,30,Clear
48677,36,1553774400,21,19,40,Clear
48678,37,1553774400,26,4,30,Clear
48679,38,1553774400,38,2,40,Clear
48680,39,1553774400,19,1,20,Clear
48681,40,1553774400,6,13,19,Clear
48682,41,1553774400,6,14,20,Clear
48683,42,1553774400,29,1,30,Clear
48684,43,1553774400,29,1,30,Clear
48685,44,1553774400,29,1,30,Clear
48686,45,1553774400,30,0,30,Clear
48687,46,1553774400,19,1,20,Clear
48688,47,1553774400,1,39,40,Clear
48689,48,1553774400,1,39,40,Clear
48690,49,1553774400,0,40,40,Clear
48691,50,1553774400,39,1,40,Clear
48692,51,1553774400,34,6,40,Clear
48693,52,1553774400,7,25,32,Clear
48694,53,1553774400,10,30,40,Clear
48695,54,1553774400,26,7,33,Clear
48696,55,1553774400,11,23,34,Clear
48697,56,1553774400,13,27,40,Clear
48698,57,1553774400,1,22,23,Clear
48699,58,1553774400,14,24,38,Clear
48700,59,1553774400,20,0,20,Clear
48701,60,1553774400,30,0,30,Clear
48702,61,1553774400,25,0,25,Clear
48703,62,1553774400,0,40,40,Clear
48704,63,1553774400,1,33,34,Clear
48705,64,1553774400,6,34,40,Clear
48706,65,1553774400,0,40,40,Clear
48707,66,1553774400,0,40,40,Clear
48708,67,1553774400,11,29,40,Clear
48709,68,1553774400,18,22,40,Clear
48710,69,1553774400,1,39,40,Clear
48711,70,1553774400,12,16,28,Clear
48712,71,1553774400,39,1,40,Clear
48713,72,1553774400,29,2,31,Clear
48714,73,1553774400,30,0,30,Clear
48715,74,1553774400,21,9,30,Clear
48716,75,1553774400,39,1,40,Clear
48717,76,1553774400,38,0,38,Clear
48718,77,1553774400,26,3,29,Clear
48719,78,1553774400,40,0,40,Clear
48720,79,1553774400,21,6,27,Clear
48721,80,1553774400,38,2,40,Clear
48722,81,1553774400,30,10,40,Clear
48723,82,1553774400,22,0,22,Clear
48724,83,1553774400,40,0,40,Clear
48725,84,1553774400,30,0,30,Clear
48726,85,1553774400,30,5,35,Clear
48727,86,1553774400,38,0,38,Clear
48728,87,1553774400,38,0,38,Clear
48729,88,1553774400,28,2,30,Clear
48730,89,1553774400,22,17,39,Clear
48731,90,1553774400,1,39,40,Clear
48732,91,1553774400,20,10,30,Clear
48733,92,1553774400,40,0,40,Clear
48734,93,1553774400,40,0,40,Clear
48735,94,1553774400,40,0,40,Clear
48736,95,1553774400,38,2,40,Clear
48737,96,1553774400,30,0,30,Clear
48738,97,1553774400,39,1,40,Clear
48739,98,1553774400,14,26,40,Clear
48740,99,1553774400,6,24,30,Clear
48741,100,1553774400,25,0,25,Clear
48742,101,1553774400,30,0,30,Clear
48743,102,1553774400,36,4,40,Clear
48744,103,1553774400,38,2,40,Clear
48745,104,1553774400,24,16,40,Clear
48746,105,1553774400,28,8,36,Clear
48747,106,1553774400,30,10,40,Clear
48748,107,1553774400,40,0,40,Clear
48749,108,1553774400,40,0,40,Clear
48750,109,1553774400,29,0,29,Clear
48751,110,1553774400,40,0,40,Clear
48752,111,1553774400,40,0,40,Clear
48753,112,1553774400,30,0,30,Clear
48754,113,1553774400,6,34,40,Clear
48755,114,1553774400,8,32,40,Clear
48756,115,1553774400,12,18,30,Clear
48757,2,1553778000,18,2,20,Clouds
48758,3,1553778000,20,0,20,Clouds
48759,4,1553778000,20,0,20,Clouds
48760,5,1553778000,34,6,40,Clouds
48761,6,1553778000,20,0,20,Clouds
48762,7,1553778000,29,0,29,Clouds
48763,8,1553778000,5,25,30,Clouds
48764,9,1553778000,11,13,24,Clouds
48765,10,1553778000,2,13,15,Clouds
48766,11,1553778000,11,19,30,Clouds
48767,12,1553778000,20,0,20,Clouds
48768,13,1553778000,4,26,30,Clouds
48769,14,1553778000,5,24,29,Clouds
48770,15,1553778000,16,0,16,Clouds
48771,16,1553778000,14,5,19,Clouds
48772,17,1553778000,17,3,20,Clouds
48773,18,1553778000,27,3,30,Clouds
48774,19,1553778000,13,17,30,Clouds
48775,21,1553778000,5,25,30,Clouds
48776,22,1553778000,14,6,20,Clouds
48777,23,1553778000,29,1,30,Clouds
48778,24,1553778000,20,0,20,Clouds
48779,25,1553778000,4,26,30,Clouds
48780,26,1553778000,1,19,20,Clouds
48781,27,1553778000,5,15,20,Clouds
48782,28,1553778000,30,0,30,Clouds
48783,29,1553778000,25,4,29,Clouds
48784,30,1553778000,20,0,20,Clouds
48785,31,1553778000,11,9,20,Clouds
48786,32,1553778000,2,28,30,Clouds
48787,33,1553778000,11,12,23,Clouds
48788,34,1553778000,30,0,30,Clouds
48789,35,1553778000,30,0,30,Clouds
48790,36,1553778000,24,16,40,Clouds
48791,37,1553778000,27,3,30,Clouds
48792,38,1553778000,35,5,40,Clouds
48793,39,1553778000,19,1,20,Clouds
48794,40,1553778000,6,13,19,Clouds
48795,41,1553778000,7,13,20,Clouds
48796,42,1553778000,29,1,30,Clouds
48797,43,1553778000,30,0,30,Clouds
48798,44,1553778000,28,2,30,Clouds
48799,45,1553778000,29,1,30,Clouds
48800,46,1553778000,19,1,20,Clouds
48801,47,1553778000,0,40,40,Clouds
48802,48,1553778000,1,39,40,Clouds
48803,49,1553778000,10,30,40,Clouds
48804,50,1553778000,40,0,40,Clouds
48805,51,1553778000,30,10,40,Clouds
48806,52,1553778000,4,28,32,Clouds
48807,53,1553778000,10,30,40,Clouds
48808,54,1553778000,25,8,33,Clouds
48809,55,1553778000,15,21,36,Clouds
48810,56,1553778000,8,32,40,Clouds
48811,57,1553778000,1,22,23,Clouds
48812,58,1553778000,14,26,40,Clouds
48813,59,1553778000,20,0,20,Clouds
48814,60,1553778000,29,1,30,Clouds
48815,61,1553778000,24,1,25,Clouds
48816,62,1553778000,0,40,40,Clouds
48817,63,1553778000,6,29,35,Clouds
48818,64,1553778000,2,38,40,Clouds
48819,65,1553778000,4,36,40,Clouds
48820,66,1553778000,4,36,40,Clouds
48821,67,1553778000,13,27,40,Clouds
48822,68,1553778000,13,27,40,Clouds
48823,69,1553778000,2,38,40,Clouds
48824,70,1553778000,7,21,28,Clouds
48825,71,1553778000,39,1,40,Clouds
48826,72,1553778000,29,2,31,Clouds
48827,73,1553778000,30,0,30,Clouds
48828,74,1553778000,20,10,30,Clouds
48829,75,1553778000,38,2,40,Clouds
48830,76,1553778000,38,0,38,Clouds
48831,77,1553778000,29,0,29,Clouds
48832,78,1553778000,38,2,40,Clouds
48833,79,1553778000,24,3,27,Clouds
48834,80,1553778000,36,4,40,Clouds
48835,81,1553778000,30,10,40,Clouds
48836,82,1553778000,22,0,22,Clouds
48837,83,1553778000,40,0,40,Clouds
48838,84,1553778000,30,0,30,Clouds
48839,85,1553778000,33,2,35,Clouds
48840,86,1553778000,36,2,38,Clouds
48841,87,1553778000,38,0,38,Clouds
48842,88,1553778000,30,0,30,Clouds
48843,89,1553778000,20,20,40,Clouds
48844,90,1553778000,2,38,40,Clouds
48845,91,1553778000,16,14,30,Clouds
48846,92,1553778000,40,0,40,Clouds
48847,93,1553778000,40,0,40,Clouds
48848,94,1553778000,40,0,40,Clouds
48849,95,1553778000,34,6,40,Clouds
48850,96,1553778000,30,0,30,Clouds
48851,97,1553778000,36,4,40,Clouds
48852,98,1553778000,17,23,40,Clouds
48853,99,1553778000,5,25,30,Clouds
48854,100,1553778000,25,0,25,Clouds
48855,101,1553778000,30,0,30,Clouds
48856,102,1553778000,32,8,40,Clouds
48857,103,1553778000,37,3,40,Clouds
48858,104,1553778000,24,16,40,Clouds
48859,105,1553778000,30,6,36,Clouds
48860,106,1553778000,33,7,40,Clouds
48861,107,1553778000,40,0,40,Clouds
48862,108,1553778000,40,0,40,Clouds
48863,109,1553778000,29,0,29,Clouds
48864,110,1553778000,40,0,40,Clouds
48865,111,1553778000,40,0,40,Clouds
48866,112,1553778000,30,0,30,Clouds
48867,113,1553778000,6,34,40,Clouds
48868,114,1553778000,16,24,40,Clouds
48869,115,1553778000,17,13,30,Clouds
48870,2,1553781600,19,1,20,Clouds
48871,3,1553781600,18,2,20,Clouds
48872,4,1553781600,20,0,20,Clouds
48873,5,1553781600,39,1,40,Clouds
48874,6,1553781600,20,0,20,Clouds
48875,7,1553781600,29,0,29,Clouds
48876,8,1553781600,12,18,30,Clouds
48877,9,1553781600,1,23,24,Clouds
48878,10,1553781600,5,11,16,Clouds
48879,11,1553781600,13,17,30,Clouds
48880,12,1553781600,20,0,20,Clouds
48881,13,1553781600,14,16,30,Clouds
48882,14,1553781600,1,28,29,Clouds
48883,15,1553781600,15,1,16,Clouds
48884,16,1553781600,19,1,20,Clouds
48885,17,1553781600,16,4,20,Clouds
48886,18,1553781600,25,5,30,Clouds
48887,19,1553781600,10,20,30,Clouds
48888,21,1553781600,2,28,30,Clouds
48889,22,1553781600,18,2,20,Clouds
48890,23,1553781600,28,2,30,Clouds
48891,24,1553781600,19,1,20,Clouds
48892,25,1553781600,0,30,30,Clouds
48893,26,1553781600,0,20,20,Clouds
48894,27,1553781600,2,18,20,Clouds
48895,28,1553781600,18,12,30,Clouds
48896,29,1553781600,29,0,29,Clouds
48897,30,1553781600,20,0,20,Clouds
48898,31,1553781600,15,5,20,Clouds
48899,32,1553781600,29,1,30,Clouds
48900,33,1553781600,21,2,23,Clouds
48901,34,1553781600,30,0,30,Clouds
48902,35,1553781600,28,2,30,Clouds
48903,36,1553781600,17,23,40,Clouds
48904,37,1553781600,28,2,30,Clouds
48905,38,1553781600,32,8,40,Clouds
48906,39,1553781600,18,2,20,Clouds
48907,40,1553781600,20,1,21,Clouds
48908,41,1553781600,19,1,20,Clouds
48909,42,1553781600,28,2,30,Clouds
48910,43,1553781600,27,3,30,Clouds
48911,44,1553781600,30,0,30,Clouds
48912,45,1553781600,30,0,30,Clouds
48913,46,1553781600,19,1,20,Clouds
48914,47,1553781600,9,31,40,Clouds
48915,48,1553781600,3,37,40,Clouds
48916,49,1553781600,13,27,40,Clouds
48917,50,1553781600,38,2,40,Clouds
48918,51,1553781600,22,18,40,Clouds
48919,52,1553781600,4,28,32,Clouds
48920,53,1553781600,12,28,40,Clouds
48921,54,1553781600,25,8,33,Clouds
48922,55,1553781600,30,6,36,Clouds
48923,56,1553781600,13,27,40,Clouds
48924,57,1553781600,0,23,23,Clouds
48925,58,1553781600,26,14,40,Clouds
48926,59,1553781600,20,0,20,Clouds
48927,60,1553781600,30,0,30,Clouds
48928,61,1553781600,25,0,25,Clouds
48929,62,1553781600,9,31,40,Clouds
48930,63,1553781600,7,28,35,Clouds
48931,64,1553781600,21,19,40,Clouds
48932,65,1553781600,11,29,40,Clouds
48933,66,1553781600,16,24,40,Clouds
48934,67,1553781600,23,17,40,Clouds
48935,68,1553781600,11,29,40,Clouds
48936,69,1553781600,1,39,40,Clouds
48937,70,1553781600,13,15,28,Clouds
48938,71,1553781600,33,7,40,Clouds
48939,72,1553781600,31,0,31,Clouds
48940,73,1553781600,30,0,30,Clouds
48941,74,1553781600,21,9,30,Clouds
48942,75,1553781600,40,0,40,Clouds
48943,76,1553781600,38,0,38,Clouds
48944,77,1553781600,29,0,29,Clouds
48945,78,1553781600,39,1,40,Clouds
48946,79,1553781600,26,1,27,Clouds
48947,80,1553781600,37,3,40,Clouds
48948,81,1553781600,32,8,40,Clouds
48949,82,1553781600,21,1,22,Clouds
48950,83,1553781600,40,0,40,Clouds
48951,84,1553781600,29,1,30,Clouds
48952,85,1553781600,35,0,35,Clouds
48953,86,1553781600,35,3,38,Clouds
48954,87,1553781600,37,1,38,Clouds
48955,88,1553781600,28,2,30,Clouds
48956,89,1553781600,21,19,40,Clouds
48957,90,1553781600,7,33,40,Clouds
48958,91,1553781600,15,15,30,Clouds
48959,92,1553781600,40,0,40,Clouds
48960,93,1553781600,40,0,40,Clouds
48961,94,1553781600,40,0,40,Clouds
48962,95,1553781600,34,6,40,Clouds
48963,96,1553781600,30,0,30,Clouds
48964,97,1553781600,39,1,40,Clouds
48965,98,1553781600,19,21,40,Clouds
48966,99,1553781600,8,22,30,Clouds
48967,100,1553781600,24,1,25,Clouds
48968,101,1553781600,29,1,30,Clouds
48969,102,1553781600,35,5,40,Clouds
48970,103,1553781600,40,0,40,Clouds
48971,104,1553781600,24,16,40,Clouds
48972,105,1553781600,30,6,36,Clouds
48973,106,1553781600,37,3,40,Clouds
48974,107,1553781600,40,0,40,Clouds
48975,108,1553781600,31,9,40,Clouds
48976,109,1553781600,29,0,29,Clouds
48977,110,1553781600,32,8,40,Clouds
48978,111,1553781600,40,0,40,Clouds
48979,112,1553781600,29,1,30,Clouds
48980,113,1553781600,2,38,40,Clouds
48981,114,1553781600,15,25,40,Clouds
48982,115,1553781600,21,9,30,Clouds
48983,2,1553785200,19,1,20,Clear
48984,3,1553785200,10,10,20,Clear
48985,4,1553785200,18,2,20,Clear
48986,5,1553785200,40,0,40,Clear
48987,6,1553785200,12,8,20,Clear
48988,7,1553785200,29,0,29,Clear
48989,8,1553785200,8,22,30,Clear
48990,9,1553785200,16,8,24,Clear
48991,10,1553785200,9,7,16,Clear
48992,11,1553785200,17,13,30,Clear
48993,12,1553785200,19,1,20,Clear
48994,13,1553785200,15,15,30,Clear
48995,14,1553785200,15,15,30,Clear
48996,15,1553785200,10,6,16,Clear
48997,16,1553785200,16,4,20,Clear
48998,17,1553785200,17,3,20,Clear
48999,18,1553785200,29,1,30,Clear
49000,19,1553785200,2,28,30,Clear
49001,21,1553785200,2,28,30,Clear
49002,22,1553785200,15,5,20,Clear
49003,23,1553785200,30,0,30,Clear
49004,24,1553785200,18,2,20,Clear
49005,25,1553785200,1,29,30,Clear
49006,26,1553785200,5,15,20,Clear
49007,27,1553785200,4,16,20,Clear
49008,28,1553785200,27,3,30,Clear
49009,29,1553785200,27,2,29,Clear
49010,30,1553785200,20,0,20,Clear
49011,31,1553785200,12,8,20,Clear
49012,32,1553785200,18,12,30,Clear
49013,33,1553785200,20,3,23,Clear
49014,34,1553785200,29,1,30,Clear
49015,35,1553785200,29,1,30,Clear
49016,36,1553785200,8,32,40,Clear
49017,37,1553785200,27,3,30,Clear
49018,38,1553785200,36,4,40,Clear
49019,39,1553785200,19,1,20,Clear
49020,40,1553785200,21,0,21,Clear
49021,41,1553785200,15,5,20,Clear
49022,42,1553785200,30,0,30,Clear
49023,43,1553785200,30,0,30,Clear
49024,44,1553785200,30,0,30,Clear
49025,45,1553785200,30,0,30,Clear
49026,46,1553785200,16,4,20,Clear
49027,47,1553785200,3,37,40,Clear
49028,48,1553785200,4,36,40,Clear
49029,49,1553785200,8,32,40,Clear
49030,50,1553785200,38,2,40,Clear
49031,51,1553785200,19,21,40,Clear
49032,52,1553785200,7,25,32,Clear
49033,53,1553785200,11,29,40,Clear
49034,54,1553785200,27,6,33,Clear
49035,55,1553785200,31,5,36,Clear
49036,56,1553785200,15,25,40,Clear
49037,57,1553785200,0,23,23,Clear
49038,58,1553785200,29,11,40,Clear
49039,59,1553785200,18,2,20,Clear
49040,60,1553785200,16,14,30,Clear
49041,61,1553785200,24,1,25,Clear
49042,62,1553785200,12,28,40,Clear
49043,63,1553785200,1,34,35,Clear
49044,64,1553785200,14,26,40,Clear
49045,65,1553785200,11,29,40,Clear
49046,66,1553785200,18,22,40,Clear
49047,67,1553785200,22,18,40,Clear
49048,68,1553785200,6,34,40,Clear
49049,69,1553785200,2,38,40,Clear
49050,70,1553785200,9,19,28,Clear
49051,71,1553785200,25,15,40,Clear
49052,72,1553785200,30,1,31,Clear
49053,73,1553785200,28,2,30,Clear
49054,74,1553785200,29,1,30,Clear
49055,75,1553785200,40,0,40,Clear
49056,76,1553785200,38,0,38,Clear
49057,77,1553785200,27,2,29,Clear
49058,78,1553785200,40,0,40,Clear
49059,79,1553785200,26,1,27,Clear
49060,80,1553785200,23,17,40,Clear
49061,81,1553785200,33,7,40,Clear
49062,82,1553785200,22,0,22,Clear
49063,83,1553785200,33,7,40,Clear
49064,84,1553785200,30,0,30,Clear
49065,85,1553785200,29,6,35,Clear
49066,86,1553785200,38,0,38,Clear
49067,87,1553785200,37,1,38,Clear
49068,88,1553785200,29,1,30,Clear
49069,89,1553785200,14,26,40,Clear
49070,90,1553785200,4,36,40,Clear
49071,91,1553785200,21,9,30,Clear
49072,92,1553785200,39,1,40,Clear
49073,93,1553785200,40,0,40,Clear
49074,94,1553785200,38,2,40,Clear
49075,95,1553785200,29,11,40,Clear
49076,96,1553785200,30,0,30,Clear
49077,97,1553785200,38,2,40,Clear
49078,98,1553785200,22,18,40,Clear
49079,99,1553785200,8,22,30,Clear
49080,100,1553785200,22,3,25,Clear
49081,101,1553785200,29,1,30,Clear
49082,102,1553785200,40,0,40,Clear
49083,103,1553785200,37,3,40,Clear
49084,104,1553785200,26,14,40,Clear
49085,105,1553785200,35,1,36,Clear
49086,106,1553785200,40,0,40,Clear
49087,107,1553785200,37,3,40,Clear
49088,108,1553785200,31,9,40,Clear
49089,109,1553785200,29,0,29,Clear
49090,110,1553785200,34,6,40,Clear
49091,111,1553785200,29,11,40,Clear
49092,112,1553785200,29,1,30,Clear
49093,113,1553785200,2,38,40,Clear
49094,114,1553785200,11,29,40,Clear
49095,115,1553785200,21,9,30,Clear
49096,2,1553788800,20,0,20,Clear
49097,3,1553788800,10,10,20,Clear
49098,4,1553788800,16,4,20,Clear
49099,5,1553788800,35,5,40,Clear
49100,6,1553788800,13,7,20,Clear
49101,7,1553788800,29,0,29,Clear
49102,8,1553788800,3,27,30,Clear
49103,9,1553788800,19,5,24,Clear
49104,10,1553788800,0,15,15,Clear
49105,11,1553788800,23,7,30,Clear
49106,12,1553788800,20,0,20,Clear
49107,13,1553788800,17,13,30,Clear
49108,14,1553788800,10,20,30,Clear
49109,15,1553788800,11,5,16,Clear
49110,16,1553788800,14,6,20,Clear
49111,17,1553788800,16,4,20,Clear
49112,18,1553788800,28,2,30,Clear
49113,19,1553788800,6,24,30,Clear
49114,21,1553788800,10,20,30,Clear
49115,22,1553788800,17,3,20,Clear
49116,23,1553788800,24,6,30,Clear
49117,24,1553788800,17,3,20,Clear
49118,25,1553788800,4,26,30,Clear
49119,26,1553788800,1,19,20,Clear
49120,27,1553788800,9,11,20,Clear
49121,28,1553788800,29,1,30,Clear
49122,29,1553788800,24,5,29,Clear
49123,30,1553788800,12,8,20,Clear
49124,31,1553788800,12,8,20,Clear
49125,32,1553788800,25,5,30,Clear
49126,33,1553788800,12,11,23,Clear
49127,34,1553788800,29,1,30,Clear
49128,35,1553788800,27,3,30,Clear
49129,36,1553788800,5,35,40,Clear
49130,37,1553788800,30,0,30,Clear
49131,38,1553788800,23,17,40,Clear
49132,39,1553788800,13,7,20,Clear
49133,40,1553788800,19,2,21,Clear
49134,41,1553788800,11,9,20,Clear
49135,42,1553788800,30,0,30,Clear
49136,43,1553788800,26,4,30,Clear
49137,44,1553788800,29,1,30,Clear
49138,45,1553788800,30,0,30,Clear
49139,46,1553788800,14,6,20,Clear
49140,47,1553788800,1,39,40,Clear
49141,48,1553788800,1,39,40,Clear
49142,49,1553788800,6,34,40,Clear
49143,50,1553788800,39,1,40,Clear
49144,51,1553788800,18,22,40,Clear
49145,52,1553788800,13,19,32,Clear
49146,53,1553788800,12,28,40,Clear
49147,54,1553788800,28,5,33,Clear
49148,55,1553788800,31,5,36,Clear
49149,56,1553788800,1,39,40,Clear
49150,57,1553788800,0,23,23,Clear
49151,58,1553788800,3,37,40,Clear
49152,59,1553788800,19,1,20,Clear
49153,60,1553788800,28,2,30,Clear
49154,61,1553788800,15,10,25,Clear
49155,62,1553788800,4,35,39,Clear
49156,63,1553788800,0,35,35,Clear
49157,64,1553788800,12,28,40,Clear
49158,65,1553788800,13,27,40,Clear
49159,66,1553788800,13,27,40,Clear
49160,67,1553788800,23,17,40,Clear
49161,68,1553788800,2,38,40,Clear
49162,69,1553788800,1,39,40,Clear
49163,70,1553788800,10,18,28,Clear
49164,71,1553788800,32,8,40,Clear
49165,72,1553788800,31,0,31,Clear
49166,73,1553788800,29,1,30,Clear
49167,74,1553788800,29,1,30,Clear
49168,75,1553788800,38,2,40,Clear
49169,76,1553788800,35,3,38,Clear
49170,77,1553788800,29,0,29,Clear
49171,78,1553788800,39,1,40,Clear
49172,79,1553788800,27,0,27,Clear
49173,80,1553788800,25,15,40,Clear
49174,81,1553788800,33,7,40,Clear
49175,82,1553788800,22,0,22,Clear
49176,83,1553788800,36,4,40,Clear
49177,84,1553788800,29,1,30,Clear
49178,85,1553788800,31,4,35,Clear
49179,86,1553788800,33,5,38,Clear
49180,87,1553788800,38,0,38,Clear
49181,88,1553788800,29,1,30,Clear
49182,89,1553788800,11,28,39,Clear
49183,90,1553788800,5,35,40,Clear
49184,91,1553788800,16,14,30,Clear
49185,92,1553788800,39,1,40,Clear
49186,93,1553788800,40,0,40,Clear
49187,94,1553788800,38,2,40,Clear
49188,95,1553788800,27,13,40,Clear
49189,96,1553788800,30,0,30,Clear
49190,97,1553788800,40,0,40,Clear
49191,98,1553788800,24,16,40,Clear
49192,99,1553788800,6,24,30,Clear
49193,100,1553788800,16,9,25,Clear
49194,101,1553788800,30,0,30,Clear
49195,102,1553788800,40,0,40,Clear
49196,103,1553788800,36,4,40,Clear
49197,104,1553788800,27,13,40,Clear
49198,105,1553788800,35,1,36,Clear
49199,106,1553788800,39,1,40,Clear
49200,107,1553788800,38,2,40,Clear
49201,108,1553788800,31,9,40,Clear
49202,109,1553788800,26,3,29,Clear
49203,110,1553788800,37,3,40,Clear
49204,111,1553788800,32,8,40,Clear
49205,112,1553788800,21,9,30,Clear
49206,113,1553788800,3,37,40,Clear
49207,114,1553788800,23,17,40,Clear
49208,115,1553788800,21,9,30,Clear
49209,2,1553792400,20,0,20,Clear
49210,3,1553792400,12,8,20,Clear
49211,4,1553792400,20,0,20,Clear
49212,5,1553792400,27,13,40,Clear
49213,6,1553792400,13,7,20,Clear
49214,7,1553792400,28,1,29,Clear
49215,8,1553792400,4,26,30,Clear
49216,9,1553792400,20,4,24,Clear
49217,10,1553792400,1,14,15,Clear
49218,11,1553792400,12,18,30,Clear
49219,12,1553792400,18,2,20,Clear
49220,13,1553792400,19,11,30,Clear
49221,14,1553792400,20,10,30,Clear
49222,15,1553792400,14,2,16,Clear
49223,16,1553792400,14,6,20,Clear
49224,17,1553792400,20,0,20,Clear
49225,18,1553792400,24,6,30,Clear
49226,19,1553792400,11,19,30,Clear
49227,21,1553792400,15,15,30,Clear
49228,22,1553792400,12,8,20,Clear
49229,23,1553792400,21,8,29,Clear
49230,24,1553792400,15,5,20,Clear
49231,25,1553792400,3,27,30,Clear
49232,26,1553792400,0,20,20,Clear
49233,27,1553792400,10,10,20,Clear
49234,28,1553792400,29,1,30,Clear
49235,29,1553792400,22,7,29,Clear
49236,30,1553792400,16,4,20,Clear
49237,31,1553792400,12,8,20,Clear
49238,32,1553792400,22,8,30,Clear
49239,33,1553792400,5,18,23,Clear
49240,34,1553792400,26,4,30,Clear
49241,35,1553792400,27,3,30,Clear
49242,36,1553792400,9,31,40,Clear
49243,37,1553792400,10,20,30,Clear
49244,38,1553792400,12,28,40,Clear
49245,39,1553792400,15,5,20,Clear
49246,40,1553792400,21,0,21,Clear
49247,41,1553792400,14,6,20,Clear
49248,42,1553792400,26,4,30,Clear
49249,43,1553792400,25,5,30,Clear
49250,44,1553792400,29,1,30,Clear
49251,45,1553792400,27,3,30,Clear
49252,46,1553792400,18,2,20,Clear
49253,47,1553792400,3,37,40,Clear
49254,48,1553792400,0,40,40,Clear
49255,49,1553792400,4,36,40,Clear
49256,50,1553792400,37,3,40,Clear
49257,51,1553792400,34,6,40,Clear
49258,52,1553792400,28,4,32,Clear
49259,53,1553792400,15,25,40,Clear
49260,54,1553792400,30,3,33,Clear
49261,55,1553792400,36,0,36,Clear
49262,56,1553792400,10,30,40,Clear
49263,57,1553792400,1,22,23,Clear
49264,58,1553792400,10,30,40,Clear
49265,59,1553792400,20,0,20,Clear
49266,60,1553792400,24,6,30,Clear
49267,61,1553792400,17,8,25,Clear
49268,62,1553792400,3,36,39,Clear
49269,63,1553792400,7,28,35,Clear
49270,64,1553792400,13,27,40,Clear
49271,65,1553792400,12,28,40,Clear
49272,66,1553792400,17,23,40,Clear
49273,67,1553792400,21,19,40,Clear
49274,68,1553792400,2,38,40,Clear
49275,69,1553792400,11,29,40,Clear
49276,70,1553792400,13,15,28,Clear
49277,71,1553792400,37,3,40,Clear
49278,72,1553792400,13,18,31,Clear
49279,73,1553792400,27,3,30,Clear
49280,74,1553792400,27,3,30,Clear
49281,75,1553792400,37,3,40,Clear
49282,76,1553792400,33,5,38,Clear
49283,77,1553792400,26,3,29,Clear
49284,78,1553792400,40,0,40,Clear
49285,79,1553792400,27,0,27,Clear
49286,80,1553792400,33,7,40,Clear
49287,81,1553792400,35,5,40,Clear
49288,82,1553792400,22,0,22,Clear
49289,83,1553792400,37,3,40,Clear
49290,84,1553792400,29,1,30,Clear
49291,85,1553792400,29,6,35,Clear
49292,86,1553792400,35,3,38,Clear
49293,87,1553792400,37,1,38,Clear
49294,88,1553792400,29,1,30,Clear
49295,89,1553792400,9,31,40,Clear
49296,90,1553792400,10,30,40,Clear
49297,91,1553792400,25,5,30,Clear
49298,92,1553792400,40,0,40,Clear
49299,93,1553792400,39,1,40,Clear
49300,94,1553792400,37,3,40,Clear
49301,95,1553792400,30,10,40,Clear
49302,96,1553792400,28,2,30,Clear
49303,97,1553792400,37,3,40,Clear
49304,98,1553792400,26,14,40,Clear
49305,99,1553792400,4,26,30,Clear
49306,100,1553792400,25,0,25,Clear
49307,101,1553792400,29,1,30,Clear
49308,102,1553792400,40,0,40,Clear
49309,103,1553792400,40,0,40,Clear
49310,104,1553792400,28,12,40,Clear
49311,105,1553792400,35,1,36,Clear
49312,106,1553792400,39,1,40,Clear
49313,107,1553792400,39,1,40,Clear
49314,108,1553792400,31,9,40,Clear
49315,109,1553792400,28,1,29,Clear
49316,110,1553792400,36,4,40,Clear
49317,111,1553792400,37,3,40,Clear
49318,112,1553792400,18,12,30,Clear
49319,113,1553792400,3,37,40,Clear
49320,114,1553792400,32,8,40,Clear
49321,115,1553792400,22,8,30,Clear
49322,2,1553796000,17,3,20,Clear
49323,3,1553796000,19,1,20,Clear
49324,4,1553796000,20,0,20,Clear
49325,5,1553796000,9,31,40,Clear
49326,6,1553796000,20,0,20,Clear
49327,7,1553796000,29,0,29,Clear
49328,8,1553796000,0,30,30,Clear
49329,9,1553796000,19,5,24,Clear
49330,10,1553796000,8,7,15,Clear
49331,11,1553796000,30,0,30,Clear
49332,12,1553796000,20,0,20,Clear
49333,13,1553796000,24,4,28,Clear
49334,14,1553796000,14,16,30,Clear
49335,15,1553796000,15,1,16,Clear
49336,16,1553796000,10,10,20,Clear
49337,17,1553796000,20,0,20,Clear
49338,18,1553796000,28,2,30,Clear
49339,19,1553796000,30,0,30,Clear
49340,21,1553796000,8,22,30,Clear
49341,22,1553796000,16,4,20,Clear
49342,23,1553796000,0,30,30,Clear
49343,24,1553796000,20,0,20,Clear
49344,25,1553796000,15,15,30,Clear
49345,26,1553796000,6,14,20,Clear
49346,27,1553796000,6,14,20,Clear
49347,28,1553796000,30,0,30,Clear
49348,29,1553796000,27,2,29,Clear
49349,30,1553796000,20,0,20,Clear
49350,31,1553796000,18,2,20,Clear
49351,32,1553796000,22,8,30,Clear
49352,33,1553796000,5,18,23,Clear
49353,34,1553796000,10,20,30,Clear
49354,35,1553796000,30,0,30,Clear
49355,36,1553796000,15,25,40,Clear
49356,37,1553796000,16,14,30,Clear
49357,38,1553796000,10,30,40,Clear
49358,39,1553796000,20,0,20,Clear
49359,40,1553796000,19,2,21,Clear
49360,41,1553796000,18,2,20,Clear
49361,42,1553796000,28,2,30,Clear
49362,43,1553796000,21,9,30,Clear
49363,44,1553796000,26,4,30,Clear
49364,45,1553796000,28,2,30,Clear
49365,46,1553796000,20,0,20,Clear
49366,47,1553796000,18,22,40,Clear
49367,48,1553796000,0,40,40,Clear
49368,49,1553796000,12,28,40,Clear
49369,50,1553796000,39,1,40,Clear
49370,51,1553796000,38,1,39,Clear
49371,52,1553796000,32,0,32,Clear
49372,53,1553796000,20,20,40,Clear
49373,54,1553796000,32,1,33,Clear
49374,55,1553796000,36,0,36,Clear
49375,56,1553796000,35,5,40,Clear
49376,57,1553796000,9,14,23,Clear
49377,58,1553796000,40,0,40,Clear
49378,59,1553796000,20,0,20,Clear
49379,60,1553796000,15,15,30,Clear
49380,61,1553796000,25,0,25,Clear
49381,62,1553796000,11,28,39,Clear
49382,63,1553796000,14,21,35,Clear
49383,64,1553796000,7,33,40,Clear
49384,65,1553796000,16,24,40,Clear
49385,66,1553796000,40,0,40,Clear
49386,67,1553796000,22,18,40,Clear
49387,68,1553796000,18,22,40,Clear
49388,69,1553796000,22,18,40,Clear
49389,70,1553796000,9,19,28,Clear
49390,71,1553796000,39,1,40,Clear
49391,72,1553796000,19,12,31,Clear
49392,73,1553796000,30,0,30,Clear
49393,74,1553796000,16,14,30,Clear
49394,75,1553796000,33,7,40,Clear
49395,76,1553796000,27,11,38,Clear
49396,77,1553796000,26,3,29,Clear
49397,78,1553796000,38,2,40,Clear
49398,79,1553796000,27,0,27,Clear
49399,80,1553796000,21,19,40,Clear
49400,81,1553796000,27,13,40,Clear
49401,82,1553796000,21,1,22,Clear
49402,83,1553796000,35,5,40,Clear
49403,84,1553796000,25,5,30,Clear
49404,85,1553796000,30,5,35,Clear
49405,86,1553796000,24,14,38,Clear
49406,87,1553796000,35,3,38,Clear
49407,88,1553796000,27,3,30,Clear
49408,89,1553796000,19,21,40,Clear
49409,90,1553796000,37,3,40,Clear
49410,91,1553796000,28,2,30,Clear
49411,92,1553796000,28,12,40,Clear
49412,93,1553796000,26,14,40,Clear
49413,94,1553796000,37,3,40,Clear
49414,95,1553796000,27,13,40,Clear
49415,96,1553796000,26,3,29,Clear
49416,97,1553796000,39,1,40,Clear
49417,98,1553796000,29,11,40,Clear
49418,99,1553796000,2,28,30,Clear
49419,100,1553796000,0,25,25,Clear
49420,101,1553796000,26,4,30,Clear
49421,102,1553796000,38,2,40,Clear
49422,103,1553796000,40,0,40,Clear
49423,104,1553796000,32,8,40,Clear
49424,105,1553796000,35,1,36,Clear
49425,106,1553796000,39,1,40,Clear
49426,107,1553796000,38,2,40,Clear
49427,108,1553796000,33,7,40,Clear
49428,109,1553796000,24,5,29,Clear
49429,110,1553796000,34,6,40,Clear
49430,111,1553796000,40,0,40,Clear
49431,112,1553796000,21,9,30,Clear
49432,113,1553796000,5,35,40,Clear
49433,114,1553796000,40,0,40,Clear
49434,115,1553796000,15,15,30,Clear
49435,2,1553799600,19,1,20,Clear
49436,3,1553799600,20,0,20,Clear
49437,4,1553799600,16,4,20,Clear
49438,5,1553799600,19,21,40,Clear
49439,6,1553799600,19,1,20,Clear
49440,7,1553799600,25,4,29,Clear
49441,8,1553799600,14,16,30,Clear
49442,9,1553799600,14,10,24,Clear
49443,10,1553799600,10,5,15,Clear
49444,11,1553799600,30,0,30,Clear
49445,12,1553799600,17,3,20,Clear
49446,13,1553799600,23,0,23,Clear
49447,14,1553799600,6,24,30,Clear
49448,15,1553799600,15,1,16,Clear
49449,16,1553799600,0,20,20,Clear
49450,17,1553799600,19,1,20,Clear
49451,18,1553799600,24,6,30,Clear
49452,19,1553799600,29,1,30,Clear
49453,21,1553799600,2,28,30,Clear
49454,22,1553799600,0,20,20,Clear
49455,23,1553799600,3,27,30,Clear
49456,24,1553799600,14,6,20,Clear
49457,25,1553799600,27,3,30,Clear
49458,26,1553799600,2,18,20,Clear
49459,27,1553799600,15,5,20,Clear
49460,28,1553799600,29,1,30,Clear
49461,29,1553799600,29,0,29,Clear
49462,30,1553799600,17,3,20,Clear
49463,31,1553799600,12,8,20,Clear
49464,32,1553799600,9,21,30,Clear
49465,33,1553799600,10,13,23,Clear
49466,34,1553799600,9,21,30,Clear
49467,35,1553799600,28,2,30,Clear
49468,36,1553799600,40,0,40,Clear
49469,37,1553799600,30,0,30,Clear
49470,38,1553799600,20,20,40,Clear
49471,39,1553799600,19,1,20,Clear
49472,40,1553799600,16,5,21,Clear
49473,41,1553799600,19,1,20,Clear
49474,42,1553799600,25,5,30,Clear
49475,43,1553799600,6,24,30,Clear
49476,44,1553799600,25,5,30,Clear
49477,45,1553799600,23,7,30,Clear
49478,46,1553799600,18,2,20,Clear
49479,47,1553799600,39,1,40,Clear
49480,48,1553799600,7,33,40,Clear
49481,49,1553799600,31,9,40,Clear
49482,50,1553799600,32,8,40,Clear
49483,51,1553799600,33,7,40,Clear
49484,52,1553799600,28,4,32,Clear
49485,53,1553799600,40,0,40,Clear
49486,54,1553799600,33,0,33,Clear
49487,55,1553799600,36,0,36,Clear
49488,56,1553799600,40,0,40,Clear
49489,57,1553799600,23,0,23,Clear
49490,58,1553799600,38,2,40,Clear
49491,59,1553799600,20,0,20,Clear
49492,60,1553799600,5,25,30,Clear
49493,61,1553799600,25,0,25,Clear
49494,62,1553799600,38,1,39,Clear
49495,63,1553799600,26,9,35,Clear
49496,64,1553799600,13,27,40,Clear
49497,65,1553799600,38,2,40,Clear
49498,66,1553799600,40,0,40,Clear
49499,67,1553799600,23,17,40,Clear
49500,68,1553799600,40,0,40,Clear
49501,69,1553799600,35,5,40,Clear
49502,70,1553799600,10,18,28,Clear
49503,71,1553799600,40,0,40,Clear
49504,72,1553799600,9,22,31,Clear
49505,73,1553799600,27,3,30,Clear
49506,74,1553799600,7,23,30,Clear
49507,75,1553799600,24,16,40,Clear
49508,76,1553799600,25,13,38,Clear
49509,77,1553799600,29,0,29,Clear
49510,78,1553799600,34,6,40,Clear
49511,79,1553799600,24,3,27,Clear
49512,80,1553799600,24,16,40,Clear
49513,81,1553799600,31,9,40,Clear
49514,82,1553799600,20,2,22,Clear
49515,83,1553799600,23,17,40,Clear
49516,84,1553799600,16,14,30,Clear
49517,85,1553799600,26,9,35,Clear
49518,86,1553799600,21,17,38,Clear
49519,87,1553799600,26,12,38,Clear
49520,88,1553799600,28,2,30,Clear
49521,89,1553799600,39,1,40,Clear
49522,90,1553799600,40,0,40,Clear
49523,91,1553799600,27,3,30,Clear
49524,92,1553799600,1,39,40,Clear
49525,93,1553799600,0,40,40,Clear
49526,94,1553799600,6,34,40,Clear
49527,95,1553799600,22,18,40,Clear
49528,96,1553799600,26,3,29,Clear
49529,97,1553799600,32,8,40,Clear
49530,98,1553799600,27,13,40,Clear
49531,99,1553799600,12,18,30,Clear
49532,100,1553799600,0,25,25,Clear
49533,101,1553799600,24,6,30,Clear
49534,102,1553799600,38,2,40,Clear
49535,103,1553799600,37,3,40,Clear
49536,104,1553799600,39,1,40,Clear
49537,105,1553799600,36,0,36,Clear
49538,106,1553799600,37,3,40,Clear
49539,107,1553799600,38,2,40,Clear
49540,108,1553799600,27,13,40,Clear
49541,109,1553799600,26,3,29,Clear
49542,110,1553799600,35,5,40,Clear
49543,111,1553799600,37,3,40,Clear
49544,112,1553799600,16,14,30,Clear
49545,113,1553799600,26,14,40,Clear
49546,114,1553799600,40,0,40,Clear
49547,115,1553799600,4,26,30,Clear
49548,2,1553803200,16,4,20,Clear
49549,3,1553803200,15,5,20,Clear
49550,4,1553803200,13,7,20,Clear
49551,5,1553803200,5,35,40,Clear
49552,6,1553803200,18,2,20,Clear
49553,7,1553803200,13,16,29,Clear
49554,8,1553803200,20,10,30,Clear
49555,9,1553803200,0,24,24,Clear
49556,10,1553803200,6,9,15,Clear
49557,11,1553803200,30,0,30,Clear
49558,12,1553803200,15,5,20,Clear
49559,13,1553803200,18,12,30,Clear
49560,14,1553803200,1,29,30,Clear
49561,15,1553803200,16,0,16,Clear
49562,16,1553803200,1,19,20,Clear
49563,17,1553803200,12,8,20,Clear
49564,18,1553803200,26,4,30,Clear
49565,19,1553803200,30,0,30,Clear
49566,21,1553803200,5,25,30,Clear
49567,22,1553803200,0,20,20,Clear
49568,23,1553803200,1,29,30,Clear
49569,24,1553803200,12,8,20,Clear
49570,25,1553803200,30,0,30,Clear
49571,26,1553803200,17,2,19,Clear
49572,27,1553803200,16,4,20,Clear
49573,28,1553803200,20,10,30,Clear
49574,29,1553803200,28,1,29,Clear
49575,30,1553803200,20,0,20,Clear
49576,31,1553803200,15,5,20,Clear
49577,32,1553803200,8,22,30,Clear
49578,33,1553803200,10,13,23,Clear
49579,34,1553803200,0,30,30,Clear
49580,35,1553803200,14,16,30,Clear
49581,36,1553803200,39,1,40,Clear
49582,37,1553803200,29,1,30,Clear
49583,38,1553803200,10,30,40,Clear
49584,39,1553803200,19,1,20,Clear
49585,40,1553803200,13,8,21,Clear
49586,41,1553803200,20,0,20,Clear
49587,42,1553803200,16,14,30,Clear
49588,43,1553803200,23,7,30,Clear
49589,44,1553803200,9,21,30,Clear
49590,45,1553803200,20,10,30,Clear
49591,46,1553803200,15,5,20,Clear
49592,47,1553803200,40,0,40,Clear
49593,48,1553803200,34,6,40,Clear
49594,49,1553803200,40,0,40,Clear
49595,50,1553803200,23,17,40,Clear
49596,51,1553803200,34,6,40,Clear
49597,52,1553803200,32,0,32,Clear
49598,53,1553803200,38,2,40,Clear
49599,54,1553803200,33,0,33,Clear
49600,55,1553803200,36,0,36,Clear
49601,56,1553803200,33,7,40,Clear
49602,57,1553803200,23,0,23,Clear
49603,58,1553803200,39,1,40,Clear
49604,59,1553803200,17,3,20,Clear
49605,60,1553803200,0,30,30,Clear
49606,61,1553803200,25,0,25,Clear
49607,62,1553803200,38,1,39,Clear
49608,63,1553803200,31,4,35,Clear
49609,64,1553803200,22,18,40,Clear
49610,65,1553803200,40,0,40,Clear
49611,66,1553803200,38,2,40,Clear
49612,67,1553803200,30,10,40,Clear
49613,68,1553803200,39,1,40,Clear
49614,69,1553803200,39,1,40,Clear
49615,70,1553803200,27,1,28,Clear
49616,71,1553803200,31,9,40,Clear
49617,72,1553803200,14,17,31,Clear
49618,73,1553803200,20,10,30,Clear
49619,74,1553803200,5,25,30,Clear
49620,75,1553803200,13,27,40,Clear
49621,76,1553803200,23,15,38,Clear
49622,77,1553803200,27,2,29,Clear
49623,78,1553803200,37,3,40,Clear
49624,79,1553803200,24,3,27,Clear
49625,80,1553803200,21,19,40,Clear
49626,81,1553803200,31,9,40,Clear
49627,82,1553803200,14,8,22,Clear
49628,83,1553803200,13,27,40,Clear
49629,84,1553803200,11,19,30,Clear
49630,85,1553803200,23,12,35,Clear
49631,86,1553803200,5,33,38,Clear
49632,87,1553803200,16,22,38,Clear
49633,88,1553803200,19,11,30,Clear
49634,89,1553803200,31,9,40,Clear
49635,90,1553803200,39,1,40,Clear
49636,91,1553803200,25,5,30,Clear
49637,92,1553803200,0,40,40,Clear
49638,93,1553803200,0,40,40,Clear
49639,94,1553803200,5,35,40,Clear
49640,95,1553803200,18,22,40,Clear
49641,96,1553803200,24,5,29,Clear
49642,97,1553803200,22,18,40,Clear
49643,98,1553803200,32,8,40,Clear
49644,99,1553803200,25,5,30,Clear
49645,100,1553803200,0,25,25,Clear
49646,101,1553803200,28,2,30,Clear
49647,102,1553803200,39,1,40,Clear
49648,103,1553803200,40,0,40,Clear
49649,104,1553803200,39,1,40,Clear
49650,105,1553803200,32,4,36,Clear
49651,106,1553803200,34,6,40,Clear
49652,107,1553803200,32,8,40,Clear
49653,108,1553803200,27,13,40,Clear
49654,109,1553803200,27,2,29,Clear
49655,110,1553803200,35,5,40,Clear
49656,111,1553803200,36,4,40,Clear
49657,112,1553803200,9,21,30,Clear
49658,113,1553803200,38,2,40,Clear
49659,114,1553803200,40,0,40,Clear
49660,115,1553803200,0,30,30,Clear
49661,2,1553806800,18,2,20,Clear
49662,3,1553806800,18,2,20,Clear
49663,4,1553806800,13,7,20,Clear
49664,5,1553806800,19,21,40,Clear
49665,6,1553806800,13,7,20,Clear
49666,7,1553806800,14,15,29,Clear
49667,8,1553806800,30,0,30,Clear
49668,9,1553806800,22,2,24,Clear
49669,10,1553806800,5,10,15,Clear
49670,11,1553806800,30,0,30,Clear
49671,12,1553806800,12,8,20,Clear
49672,13,1553806800,21,8,29,Clear
49673,14,1553806800,1,29,30,Clear
49674,15,1553806800,16,0,16,Clear
49675,16,1553806800,1,19,20,Clear
49676,17,1553806800,12,8,20,Clear
49677,18,1553806800,23,7,30,Clear
49678,19,1553806800,30,0,30,Clear
49679,21,1553806800,9,21,30,Clear
49680,22,1553806800,10,10,20,Clear
49681,23,1553806800,4,26,30,Clear
49682,24,1553806800,14,6,20,Clear
49683,25,1553806800,28,2,30,Clear
49684,26,1553806800,17,3,20,Clear
49685,27,1553806800,15,5,20,Clear
49686,28,1553806800,15,15,30,Clear
49687,29,1553806800,25,4,29,Clear
49688,30,1553806800,18,2,20,Clear
49689,31,1553806800,17,3,20,Clear
49690,32,1553806800,7,23,30,Clear
49691,33,1553806800,0,23,23,Clear
49692,34,1553806800,0,30,30,Clear
49693,35,1553806800,7,23,30,Clear
49694,36,1553806800,40,0,40,Clear
49695,37,1553806800,29,1,30,Clear
49696,38,1553806800,13,27,40,Clear
49697,39,1553806800,19,1,20,Clear
49698,40,1553806800,21,0,21,Clear
49699,41,1553806800,20,0,20,Clear
49700,42,1553806800,12,18,30,Clear
49701,43,1553806800,9,21,30,Clear
49702,44,1553806800,4,26,30,Clear
49703,45,1553806800,18,12,30,Clear
49704,46,1553806800,8,12,20,Clear
49705,47,1553806800,40,0,40,Clear
49706,48,1553806800,40,0,40,Clear
49707,49,1553806800,36,4,40,Clear
49708,50,1553806800,18,22,40,Clear
49709,51,1553806800,40,0,40,Clear
49710,52,1553806800,32,0,32,Clear
49711,53,1553806800,39,1,40,Clear
49712,54,1553806800,33,0,33,Clear
49713,55,1553806800,36,0,36,Clear
49714,56,1553806800,36,4,40,Clear
49715,57,1553806800,22,1,23,Clear
49716,58,1553806800,39,1,40,Clear
49717,59,1553806800,19,1,20,Clear
49718,60,1553806800,0,30,30,Clear
49719,61,1553806800,24,1,25,Clear
49720,62,1553806800,39,0,39,Clear
49721,63,1553806800,33,2,35,Clear
49722,64,1553806800,26,14,40,Clear
49723,65,1553806800,40,0,40,Clear
49724,66,1553806800,37,3,40,Clear
49725,67,1553806800,33,7,40,Clear
49726,68,1553806800,37,3,40,Clear
49727,69,1553806800,39,1,40,Clear
49728,70,1553806800,25,3,28,Clear
49729,71,1553806800,37,3,40,Clear
49730,72,1553806800,11,20,31,Clear
49731,73,1553806800,19,11,30,Clear
49732,74,1553806800,5,25,30,Clear
49733,75,1553806800,17,23,40,Clear
49734,76,1553806800,22,16,38,Clear
49735,77,1553806800,27,2,29,Clear
49736,78,1553806800,35,5,40,Clear
49737,79,1553806800,25,2,27,Clear
49738,80,1553806800,22,18,40,Clear
49739,81,1553806800,31,9,40,Clear
49740,82,1553806800,12,10,22,Clear
49741,83,1553806800,5,35,40,Clear
49742,84,1553806800,9,21,30,Clear
49743,85,1553806800,23,12,35,Clear
49744,86,1553806800,1,37,38,Clear
49745,87,1553806800,11,27,38,Clear
49746,88,1553806800,14,16,30,Clear
49747,89,1553806800,32,8,40,Clear
49748,90,1553806800,40,0,40,Clear
49749,91,1553806800,20,10,30,Clear
49750,92,1553806800,0,40,40,Clear
49751,93,1553806800,0,40,40,Clear
49752,94,1553806800,0,40,40,Clear
49753,95,1553806800,15,25,40,Clear
49754,96,1553806800,25,4,29,Clear
49755,97,1553806800,16,24,40,Clear
49756,98,1553806800,35,5,40,Clear
49757,99,1553806800,30,0,30,Clear
49758,100,1553806800,0,25,25,Clear
49759,101,1553806800,19,11,30,Clear
49760,102,1553806800,36,4,40,Clear
49761,103,1553806800,31,9,40,Clear
49762,104,1553806800,35,5,40,Clear
49763,105,1553806800,32,4,36,Clear
49764,106,1553806800,34,6,40,Clear
49765,107,1553806800,29,11,40,Clear
49766,108,1553806800,22,18,40,Clear
49767,109,1553806800,20,9,29,Clear
49768,110,1553806800,31,9,40,Clear
49769,111,1553806800,35,5,40,Clear
49770,112,1553806800,2,28,30,Clear
49771,113,1553806800,40,0,40,Clear
49772,114,1553806800,36,4,40,Clear
49773,115,1553806800,1,29,30,Clear
49774,2,1553810400,11,9,20,Clear
49775,3,1553810400,18,2,20,Clear
49776,4,1553810400,12,8,20,Clear
49777,5,1553810400,21,19,40,Clear
49778,6,1553810400,14,6,20,Clear
49779,7,1553810400,14,15,29,Clear
49780,8,1553810400,30,0,30,Clear
49781,9,1553810400,24,0,24,Clear
49782,10,1553810400,7,8,15,Clear
49783,11,1553810400,30,0,30,Clear
49784,12,1553810400,10,10,20,Clear
49785,13,1553810400,21,6,27,Clear
49786,14,1553810400,5,25,30,Clear
49787,15,1553810400,15,1,16,Clear
49788,16,1553810400,10,10,20,Clear
49789,17,1553810400,11,9,20,Clear
49790,18,1553810400,28,2,30,Clear
49791,19,1553810400,30,0,30,Clear
49792,21,1553810400,15,15,30,Clear
49793,22,1553810400,11,9,20,Clear
49794,23,1553810400,5,25,30,Clear
49795,24,1553810400,10,10,20,Clear
49796,25,1553810400,29,1,30,Clear
49797,26,1553810400,19,1,20,Clear
49798,27,1553810400,20,0,20,Clear
49799,28,1553810400,9,21,30,Clear
49800,29,1553810400,25,4,29,Clear
49801,30,1553810400,19,1,20,Clear
49802,31,1553810400,19,1,20,Clear
49803,32,1553810400,12,18,30,Clear
49804,33,1553810400,5,18,23,Clear
49805,34,1553810400,0,30,30,Clear
49806,35,1553810400,6,24,30,Clear
49807,36,1553810400,40,0,40,Clear
49808,37,1553810400,30,0,30,Clear
49809,38,1553810400,16,24,40,Clear
49810,39,1553810400,19,1,20,Clear
49811,40,1553810400,21,0,21,Clear
49812,41,1553810400,20,0,20,Clear
49813,42,1553810400,8,22,30,Clear
49814,43,1553810400,3,27,30,Clear
49815,44,1553810400,0,30,30,Clear
49816,45,1553810400,17,13,30,Clear
49817,46,1553810400,5,15,20,Clear
49818,47,1553810400,40,0,40,Clear
49819,48,1553810400,38,2,40,Clear
49820,49,1553810400,40,0,40,Clear
49821,50,1553810400,9,31,40,Clear
49822,51,1553810400,38,2,40,Clear
49823,52,1553810400,32,0,32,Clear
49824,53,1553810400,40,0,40,Clear
49825,54,1553810400,33,0,33,Clear
49826,55,1553810400,36,0,36,Clear
49827,56,1553810400,34,6,40,Clear
49828,57,1553810400,22,1,23,Clear
49829,58,1553810400,38,2,40,Clear
49830,59,1553810400,19,1,20,Clear
49831,60,1553810400,0,30,30,Clear
49832,61,1553810400,24,1,25,Clear
49833,62,1553810400,39,0,39,Clear
49834,63,1553810400,35,0,35,Clear
49835,64,1553810400,29,11,40,Clear
49836,65,1553810400,40,0,40,Clear
49837,66,1553810400,34,6,40,Clear
49838,67,1553810400,32,8,40,Clear
49839,68,1553810400,38,2,40,Clear
49840,69,1553810400,39,1,40,Clear
49841,70,1553810400,28,0,28,Clear
49842,71,1553810400,40,0,40,Clear
49843,72,1553810400,20,11,31,Clear
49844,73,1553810400,19,11,30,Clear
49845,74,1553810400,2,28,30,Clear
49846,75,1553810400,9,31,40,Clear
49847,76,1553810400,21,17,38,Clear
49848,77,1553810400,29,0,29,Clear
49849,78,1553810400,32,8,40,Clear
49850,79,1553810400,25,2,27,Clear
49851,80,1553810400,20,20,40,Clear
49852,81,1553810400,32,8,40,Clear
49853,82,1553810400,10,12,22,Clear
49854,83,1553810400,3,37,40,Clear
49855,84,1553810400,5,25,30,Clear
49856,85,1553810400,20,15,35,Clear
49857,86,1553810400,0,38,38,Clear
49858,87,1553810400,1,37,38,Clear
49859,88,1553810400,9,21,30,Clear
49860,89,1553810400,33,7,40,Clear
49861,90,1553810400,40,0,40,Clear
49862,91,1553810400,19,11,30,Clear
49863,92,1553810400,0,40,40,Clear
49864,93,1553810400,0,40,40,Clear
49865,94,1553810400,0,40,40,Clear
49866,95,1553810400,4,36,40,Clear
49867,96,1553810400,25,4,29,Clear
49868,97,1553810400,12,28,40,Clear
49869,98,1553810400,40,0,40,Clear
49870,99,1553810400,30,0,30,Clear
49871,100,1553810400,0,25,25,Clear
49872,101,1553810400,14,16,30,Clear
49873,102,1553810400,35,5,40,Clear
49874,103,1553810400,34,6,40,Clear
49875,104,1553810400,32,8,40,Clear
49876,105,1553810400,31,5,36,Clear
49877,106,1553810400,33,7,40,Clear
49878,107,1553810400,29,11,40,Clear
49879,108,1553810400,20,20,40,Clear
49880,109,1553810400,16,13,29,Clear
49881,110,1553810400,27,13,40,Clear
49882,111,1553810400,29,11,40,Clear
49883,112,1553810400,1,29,30,Clear
49884,113,1553810400,40,0,40,Clear
49885,114,1553810400,36,4,40,Clear
49886,115,1553810400,12,18,30,Clear
49887,2,1553814000,7,13,20,Clear
49888,3,1553814000,20,0,20,Clear
49889,4,1553814000,15,5,20,Clear
49890,5,1553814000,26,14,40,Clear
49891,6,1553814000,12,8,20,Clear
49892,7,1553814000,15,14,29,Clear
49893,8,1553814000,28,2,30,Clear
49894,9,1553814000,16,8,24,Clear
49895,10,1553814000,15,1,16,Clear
49896,11,1553814000,30,0,30,Clear
49897,12,1553814000,4,16,20,Clear
49898,13,1553814000,24,3,27,Clear
49899,14,1553814000,12,18,30,Clear
49900,15,1553814000,13,3,16,Clear
49901,16,1553814000,16,4,20,Clear
49902,17,1553814000,11,9,20,Clear
49903,18,1553814000,30,0,30,Clear
49904,19,1553814000,28,2,30,Clear
49905,21,1553814000,30,0,30,Clear
49906,22,1553814000,17,3,20,Clear
49907,23,1553814000,5,25,30,Clear
49908,24,1553814000,15,5,20,Clear
49909,25,1553814000,30,0,30,Clear
49910,26,1553814000,20,0,20,Clear
49911,27,1553814000,20,0,20,Clear
49912,28,1553814000,0,30,30,Clear
49913,29,1553814000,25,4,29,Clear
49914,30,1553814000,20,0,20,Clear
49915,31,1553814000,20,0,20,Clear
49916,32,1553814000,18,12,30,Clear
49917,33,1553814000,13,10,23,Clear
49918,34,1553814000,3,27,30,Clear
49919,35,1553814000,6,24,30,Clear
49920,36,1553814000,39,1,40,Clear
49921,37,1553814000,30,0,30,Clear
49922,38,1553814000,20,20,40,Clear
49923,39,1553814000,18,2,20,Clear
49924,40,1553814000,21,0,21,Clear
49925,41,1553814000,19,1,20,Clear
49926,42,1553814000,9,21,30,Clear
49927,43,1553814000,1,29,30,Clear
49928,44,1553814000,1,29,30,Clear
49929,45,1553814000,17,13,30,Clear
49930,46,1553814000,9,11,20,Clear
49931,47,1553814000,40,0,40,Clear
49932,48,1553814000,38,2,40,Clear
49933,49,1553814000,38,2,40,Clear
49934,50,1553814000,1,39,40,Clear
49935,51,1553814000,40,0,40,Clear
49936,52,1553814000,32,0,32,Clear
49937,53,1553814000,40,0,40,Clear
49938,54,1553814000,33,0,33,Clear
49939,55,1553814000,36,0,36,Clear
49940,56,1553814000,38,2,40,Clear
49941,57,1553814000,22,1,23,Clear
49942,58,1553814000,36,4,40,Clear
49943,59,1553814000,19,1,20,Clear
49944,60,1553814000,1,29,30,Clear
49945,61,1553814000,22,3,25,Clear
49946,62,1553814000,40,0,40,Clear
49947,63,1553814000,34,1,35,Clear
49948,64,1553814000,31,9,40,Clear
49949,65,1553814000,40,0,40,Clear
49950,66,1553814000,38,2,40,Clear
49951,67,1553814000,27,13,40,Clear
49952,68,1553814000,38,2,40,Clear
49953,69,1553814000,40,0,40,Clear
49954,70,1553814000,22,6,28,Clear
49955,71,1553814000,38,2,40,Clear
49956,72,1553814000,22,9,31,Clear
49957,73,1553814000,12,18,30,Clear
49958,74,1553814000,1,29,30,Clear
49959,75,1553814000,9,31,40,Clear
49960,76,1553814000,20,18,38,Clear
49961,77,1553814000,28,1,29,Clear
49962,78,1553814000,28,12,40,Clear
49963,79,1553814000,15,12,27,Clear
49964,80,1553814000,16,24,40,Clear
49965,81,1553814000,33,7,40,Clear
49966,82,1553814000,6,16,22,Clear
49967,83,1553814000,0,40,40,Clear
49968,84,1553814000,4,26,30,Clear
49969,85,1553814000,15,20,35,Clear
49970,86,1553814000,0,38,38,Clear
49971,87,1553814000,7,31,38,Clear
49972,88,1553814000,13,17,30,Clear
49973,89,1553814000,32,8,40,Clear
49974,90,1553814000,39,1,40,Clear
49975,91,1553814000,10,20,30,Clear
49976,92,1553814000,0,40,40,Clear
49977,93,1553814000,0,40,40,Clear
49978,94,1553814000,0,40,40,Clear
49979,95,1553814000,0,40,40,Clear
49980,96,1553814000,25,4,29,Clear
49981,97,1553814000,12,28,40,Clear
49982,98,1553814000,40,0,40,Clear
49983,99,1553814000,30,0,30,Clear
49984,100,1553814000,0,25,25,Clear
49985,101,1553814000,18,12,30,Clear
49986,102,1553814000,35,5,40,Clear
49987,103,1553814000,33,7,40,Clear
49988,104,1553814000,32,8,40,Clear
49989,105,1553814000,29,7,36,Clear
49990,106,1553814000,31,9,40,Clear
49991,107,1553814000,26,14,40,Clear
49992,108,1553814000,16,24,40,Clear
49993,109,1553814000,18,11,29,Clear
49994,110,1553814000,24,16,40,Clear
49995,111,1553814000,20,20,40,Clear
49996,112,1553814000,0,30,30,Clear
49997,113,1553814000,40,0,40,Clear
49998,114,1553814000,40,0,40,Clear
49999,115,1553814000,8,22,30,Clear
50000,2,1553817600,7,13,20,Clear
50001,3,1553817600,17,3,20,Clear
50002,4,1553817600,13,7,20,Clear
50003,5,1553817600,25,15,40,Clear
50004,6,1553817600,11,9,20,Clear
50005,7,1553817600,19,10,29,Clear
50006,8,1553817600,29,1,30,Clear
50007,9,1553817600,18,6,24,Clear
50008,10,1553817600,15,1,16,Clear
50009,11,1553817600,30,0,30,Clear
50010,12,1553817600,1,19,20,Clear
50011,13,1553817600,29,1,30,Clear
50012,14,1553817600,26,4,30,Clear
50013,15,1553817600,11,5,16,Clear
50014,16,1553817600,16,4,20,Clear
50015,17,1553817600,15,5,20,Clear
50016,18,1553817600,28,2,30,Clear
50017,19,1553817600,30,0,30,Clear
50018,21,1553817600,30,0,30,Clear
50019,22,1553817600,19,1,20,Clear
50020,23,1553817600,10,20,30,Clear
50021,24,1553817600,13,7,20,Clear
50022,25,1553817600,30,0,30,Clear
50023,26,1553817600,20,0,20,Clear
50024,27,1553817600,19,1,20,Clear
50025,28,1553817600,6,24,30,Clear
50026,29,1553817600,27,2,29,Clear
50027,30,1553817600,20,0,20,Clear
50028,31,1553817600,16,4,20,Clear
50029,32,1553817600,26,4,30,Clear
50030,33,1553817600,20,3,23,Clear
50031,34,1553817600,13,17,30,Clear
50032,35,1553817600,9,21,30,Clear
50033,36,1553817600,31,9,40,Clear
50034,37,1553817600,30,0,30,Clear
50035,38,1553817600,23,17,40,Clear
50036,39,1553817600,20,0,20,Clear
50037,40,1553817600,21,0,21,Clear
50038,41,1553817600,20,0,20,Clear
50039,42,1553817600,9,21,30,Clear
50040,43,1553817600,8,22,30,Clear
50041,44,1553817600,1,29,30,Clear
50042,45,1553817600,15,15,30,Clear
50043,46,1553817600,11,9,20,Clear
50044,47,1553817600,39,1,40,Clear
50045,48,1553817600,36,4,40,Clear
50046,49,1553817600,32,8,40,Clear
50047,50,1553817600,0,40,40,Clear
50048,51,1553817600,40,0,40,Clear
50049,52,1553817600,31,1,32,Clear
50050,53,1553817600,33,7,40,Clear
50051,54,1553817600,33,0,33,Clear
50052,55,1553817600,36,0,36,Clear
50053,56,1553817600,40,0,40,Clear
50054,57,1553817600,19,4,23,Clear
50055,58,1553817600,37,3,40,Clear
50056,59,1553817600,20,0,20,Clear
50057,60,1553817600,0,30,30,Clear
50058,61,1553817600,17,8,25,Clear
50059,62,1553817600,40,0,40,Clear
50060,63,1553817600,35,0,35,Clear
50061,64,1553817600,34,6,40,Clear
50062,65,1553817600,37,3,40,Clear
50063,66,1553817600,34,6,40,Clear
50064,67,1553817600,25,15,40,Clear
50065,68,1553817600,38,2,40,Clear
50066,69,1553817600,40,0,40,Clear
50067,70,1553817600,23,5,28,Clear
50068,71,1553817600,35,5,40,Clear
50069,72,1553817600,21,10,31,Clear
50070,73,1553817600,8,22,30,Clear
50071,74,1553817600,2,28,30,Clear
50072,75,1553817600,8,32,40,Clear
50073,76,1553817600,19,19,38,Clear
50074,77,1553817600,29,0,29,Clear
50075,78,1553817600,22,18,40,Clear
50076,79,1553817600,14,13,27,Clear
50077,80,1553817600,16,24,40,Clear
50078,81,1553817600,34,6,40,Clear
50079,82,1553817600,5,17,22,Clear
50080,83,1553817600,1,39,40,Clear
50081,84,1553817600,10,20,30,Clear
50082,85,1553817600,12,23,35,Clear
50083,86,1553817600,8,30,38,Clear
50084,87,1553817600,6,32,38,Clear
50085,88,1553817600,7,23,30,Clear
50086,89,1553817600,33,7,40,Clear
50087,90,1553817600,39,1,40,Clear
50088,91,1553817600,13,17,30,Clear
50089,92,1553817600,0,40,40,Clear
50090,93,1553817600,8,32,40,Clear
50091,94,1553817600,0,40,40,Clear
50092,95,1553817600,0,40,40,Clear
50093,96,1553817600,25,4,29,Clear
50094,97,1553817600,10,30,40,Clear
50095,98,1553817600,40,0,40,Clear
50096,99,1553817600,28,2,30,Clear
50097,100,1553817600,7,18,25,Clear
50098,101,1553817600,14,16,30,Clear
50099,102,1553817600,30,10,40,Clear
50100,103,1553817600,33,7,40,Clear
50101,104,1553817600,33,7,40,Clear
50102,105,1553817600,30,6,36,Clear
50103,106,1553817600,13,27,40,Clear
50104,107,1553817600,17,23,40,Clear
50105,108,1553817600,16,24,40,Clear
50106,109,1553817600,15,14,29,Clear
50107,110,1553817600,24,16,40,Clear
50108,111,1553817600,6,34,40,Clear
50109,112,1553817600,1,29,30,Clear
50110,113,1553817600,40,0,40,Clear
50111,114,1553817600,40,0,40,Clear
50112,115,1553817600,5,25,30,Clear
50113,2,1553821200,3,17,20,Clear
50114,3,1553821200,15,5,20,Clear
50115,4,1553821200,12,8,20,Clear
50116,5,1553821200,30,10,40,Clear
50117,6,1553821200,13,7,20,Clear
50118,7,1553821200,20,9,29,Clear
50119,8,1553821200,30,0,30,Clear
50120,9,1553821200,24,0,24,Clear
50121,10,1553821200,16,0,16,Clear
50122,11,1553821200,30,0,30,Clear
50123,12,1553821200,0,20,20,Clear
50124,13,1553821200,30,0,30,Clear
50125,14,1553821200,30,0,30,Clear
50126,15,1553821200,10,6,16,Clear
50127,16,1553821200,17,3,20,Clear
50128,17,1553821200,15,5,20,Clear
50129,18,1553821200,30,0,30,Clear
50130,19,1553821200,30,0,30,Clear
50131,21,1553821200,30,0,30,Clear
50132,22,1553821200,19,1,20,Clear
50133,23,1553821200,22,8,30,Clear
50134,24,1553821200,19,1,20,Clear
50135,25,1553821200,30,0,30,Clear
50136,26,1553821200,20,0,20,Clear
50137,27,1553821200,20,0,20,Clear
50138,28,1553821200,3,27,30,Clear
50139,29,1553821200,29,0,29,Clear
50140,30,1553821200,20,0,20,Clear
50141,31,1553821200,15,5,20,Clear
50142,32,1553821200,26,4,30,Clear
50143,33,1553821200,22,1,23,Clear
50144,34,1553821200,12,18,30,Clear
50145,35,1553821200,12,18,30,Clear
50146,36,1553821200,38,2,40,Clear
50147,37,1553821200,30,0,30,Clear
50148,38,1553821200,27,13,40,Clear
50149,39,1553821200,16,4,20,Clear
50150,40,1553821200,21,0,21,Clear
50151,41,1553821200,18,2,20,Clear
50152,42,1553821200,4,26,30,Clear
50153,43,1553821200,9,21,30,Clear
50154,44,1553821200,3,27,30,Clear
50155,45,1553821200,16,14,30,Clear
50156,46,1553821200,17,3,20,Clear
50157,47,1553821200,39,1,40,Clear
50158,48,1553821200,40,0,40,Clear
50159,49,1553821200,34,6,40,Clear
50160,50,1553821200,0,40,40,Clear
50161,51,1553821200,40,0,40,Clear
50162,52,1553821200,32,0,32,Clear
50163,53,1553821200,37,3,40,Clear
50164,54,1553821200,30,3,33,Clear
50165,55,1553821200,36,0,36,Clear
50166,56,1553821200,39,1,40,Clear
50167,57,1553821200,20,3,23,Clear
50168,58,1553821200,35,5,40,Clear
50169,59,1553821200,20,0,20,Clear
50170,60,1553821200,6,24,30,Clear
50171,61,1553821200,21,4,25,Clear
50172,62,1553821200,40,0,40,Clear
50173,63,1553821200,35,0,35,Clear
50174,64,1553821200,34,6,40,Clear
50175,65,1553821200,40,0,40,Clear
50176,66,1553821200,25,15,40,Clear
50177,67,1553821200,31,9,40,Clear
50178,68,1553821200,38,2,40,Clear
50179,69,1553821200,38,2,40,Clear
50180,70,1553821200,15,13,28,Clear
50181,71,1553821200,35,5,40,Clear
50182,72,1553821200,20,11,31,Clear
50183,73,1553821200,3,27,30,Clear
50184,74,1553821200,2,28,30,Clear
50185,75,1553821200,7,33,40,Clear
50186,76,1553821200,21,17,38,Clear
50187,77,1553821200,28,1,29,Clear
50188,78,1553821200,17,23,40,Clear
50189,79,1553821200,14,13,27,Clear
50190,80,1553821200,17,23,40,Clear
50191,81,1553821200,34,6,40,Clear
50192,82,1553821200,5,17,22,Clear
50193,83,1553821200,0,40,40,Clear
50194,84,1553821200,9,21,30,Clear
50195,85,1553821200,9,26,35,Clear
50196,86,1553821200,4,34,38,Clear
50197,87,1553821200,10,28,38,Clear
50198,88,1553821200,7,23,30,Clear
50199,89,1553821200,37,3,40,Clear
50200,90,1553821200,39,1,40,Clear
50201,91,1553821200,12,18,30,Clear
50202,92,1553821200,0,40,40,Clear
50203,93,1553821200,8,32,40,Clear
50204,94,1553821200,0,40,40,Clear
50205,95,1553821200,7,33,40,Clear
50206,96,1553821200,25,4,29,Clear
50207,97,1553821200,5,35,40,Clear
50208,98,1553821200,39,1,40,Clear
50209,99,1553821200,30,0,30,Clear
50210,100,1553821200,6,19,25,Clear
50211,101,1553821200,11,19,30,Clear
50212,102,1553821200,30,10,40,Clear
50213,103,1553821200,34,6,40,Clear
50214,104,1553821200,33,7,40,Clear
50215,105,1553821200,30,6,36,Clear
50216,106,1553821200,14,26,40,Clear
50217,107,1553821200,4,36,40,Clear
50218,108,1553821200,14,26,40,Clear
50219,109,1553821200,12,17,29,Clear
50220,110,1553821200,23,17,40,Clear
50221,111,1553821200,1,39,40,Clear
50222,112,1553821200,7,23,30,Clear
50223,113,1553821200,40,0,40,Clear
50224,114,1553821200,39,1,40,Clear
50225,115,1553821200,0,30,30,Clear
50226,2,1553824800,4,16,20,Clear
50227,3,1553824800,14,6,20,Clear
50228,4,1553824800,14,6,20,Clear
50229,5,1553824800,29,11,40,Clear
50230,6,1553824800,17,3,20,Clear
50231,7,1553824800,20,9,29,Clear
50232,8,1553824800,30,0,30,Clear
50233,9,1553824800,24,0,24,Clear
50234,10,1553824800,16,0,16,Clear
50235,11,1553824800,30,0,30,Clear
50236,12,1553824800,0,20,20,Clear
50237,13,1553824800,30,0,30,Clear
50238,14,1553824800,29,1,30,Clear
50239,15,1553824800,11,5,16,Clear
50240,16,1553824800,17,3,20,Clear
50241,17,1553824800,15,5,20,Clear
50242,18,1553824800,29,1,30,Clear
50243,19,1553824800,29,1,30,Clear
50244,21,1553824800,29,1,30,Clear
50245,22,1553824800,18,2,20,Clear
50246,23,1553824800,23,7,30,Clear
50247,24,1553824800,19,1,20,Clear
50248,25,1553824800,30,0,30,Clear
50249,26,1553824800,20,0,20,Clear
50250,27,1553824800,20,0,20,Clear
50251,28,1553824800,0,30,30,Clear
50252,29,1553824800,29,0,29,Clear
50253,30,1553824800,19,1,20,Clear
50254,31,1553824800,16,4,20,Clear
50255,32,1553824800,27,3,30,Clear
50256,33,1553824800,23,0,23,Clear
50257,34,1553824800,13,17,30,Clear
50258,35,1553824800,12,18,30,Clear
50259,36,1553824800,40,0,40,Clear
50260,37,1553824800,30,0,30,Clear
50261,38,1553824800,25,15,40,Clear
50262,39,1553824800,17,3,20,Clear
50263,40,1553824800,20,1,21,Clear
50264,41,1553824800,15,5,20,Clear
50265,42,1553824800,3,27,30,Clear
50266,43,1553824800,9,21,30,Clear
50267,44,1553824800,1,29,30,Clear
50268,45,1553824800,16,14,30,Clear
50269,46,1553824800,19,1,20,Clear
50270,47,1553824800,39,1,40,Clear
50271,48,1553824800,40,0,40,Clear
50272,49,1553824800,35,5,40,Clear
50273,50,1553824800,1,39,40,Clear
50274,51,1553824800,40,0,40,Clear
50275,52,1553824800,32,0,32,Clear
50276,53,1553824800,37,3,40,Clear
50277,54,1553824800,31,2,33,Clear
50278,55,1553824800,36,0,36,Clear
50279,56,1553824800,39,1,40,Clear
50280,57,1553824800,18,5,23,Clear
50281,58,1553824800,37,3,40,Clear
50282,59,1553824800,20,0,20,Clear
50283,60,1553824800,0,30,30,Clear
50284,61,1553824800,21,4,25,Clear
50285,62,1553824800,40,0,40,Clear
50286,63,1553824800,35,0,35,Clear
50287,64,1553824800,35,5,40,Clear
50288,65,1553824800,40,0,40,Clear
50289,66,1553824800,23,17,40,Clear
50290,67,1553824800,32,8,40,Clear
50291,68,1553824800,39,1,40,Clear
50292,69,1553824800,39,1,40,Clear
50293,70,1553824800,17,11,28,Clear
50294,71,1553824800,37,3,40,Clear
50295,72,1553824800,19,12,31,Clear
50296,73,1553824800,4,26,30,Clear
50297,74,1553824800,0,30,30,Clear
50298,75,1553824800,5,35,40,Clear
50299,76,1553824800,20,18,38,Clear
50300,77,1553824800,29,0,29,Clear
50301,78,1553824800,16,24,40,Clear
50302,79,1553824800,14,13,27,Clear
50303,80,1553824800,16,24,40,Clear
50304,81,1553824800,34,6,40,Clear
50305,82,1553824800,5,17,22,Clear
50306,83,1553824800,0,40,40,Clear
50307,84,1553824800,6,24,30,Clear
50308,85,1553824800,9,26,35,Clear
50309,86,1553824800,5,33,38,Clear
50310,87,1553824800,10,28,38,Clear
50311,88,1553824800,4,26,30,Clear
50312,89,1553824800,37,3,40,Clear
50313,90,1553824800,39,1,40,Clear
50314,91,1553824800,11,19,30,Clear
50315,92,1553824800,0,40,40,Clear
50316,93,1553824800,8,32,40,Clear
50317,94,1553824800,0,40,40,Clear
50318,95,1553824800,6,34,40,Clear
50319,96,1553824800,25,4,29,Clear
50320,97,1553824800,3,37,40,Clear
50321,98,1553824800,40,0,40,Clear
50322,99,1553824800,30,0,30,Clear
50323,100,1553824800,6,19,25,Clear
50324,101,1553824800,10,20,30,Clear
50325,102,1553824800,28,12,40,Clear
50326,103,1553824800,34,6,40,Clear
50327,104,1553824800,33,7,40,Clear
50328,105,1553824800,28,8,36,Clear
50329,106,1553824800,14,26,40,Clear
50330,107,1553824800,4,36,40,Clear
50331,108,1553824800,14,26,40,Clear
50332,109,1553824800,12,17,29,Clear
50333,110,1553824800,21,19,40,Clear
50334,111,1553824800,0,40,40,Clear
50335,112,1553824800,4,26,30,Clear
50336,113,1553824800,40,0,40,Clear
50337,114,1553824800,39,1,40,Clear
50338,115,1553824800,0,30,30,Clear
50339,2,1553828400,4,16,20,Clear
50340,3,1553828400,14,6,20,Clear
50341,4,1553828400,14,6,20,Clear
50342,5,1553828400,29,11,40,Clear
50343,6,1553828400,17,3,20,Clear
50344,7,1553828400,20,9,29,Clear
50345,8,1553828400,30,0,30,Clear
50346,9,1553828400,24,0,24,Clear
50347,10,1553828400,16,0,16,Clear
50348,11,1553828400,30,0,30,Clear
50349,12,1553828400,0,20,20,Clear
50350,13,1553828400,30,0,30,Clear
50351,14,1553828400,29,1,30,Clear
50352,15,1553828400,11,5,16,Clear
50353,16,1553828400,17,3,20,Clear
50354,17,1553828400,15,5,20,Clear
50355,18,1553828400,29,1,30,Clear
50356,19,1553828400,29,1,30,Clear
50357,21,1553828400,29,1,30,Clear
50358,22,1553828400,18,2,20,Clear
50359,23,1553828400,23,7,30,Clear
50360,24,1553828400,19,1,20,Clear
50361,25,1553828400,30,0,30,Clear
50362,26,1553828400,20,0,20,Clear
50363,27,1553828400,20,0,20,Clear
50364,28,1553828400,0,30,30,Clear
50365,29,1553828400,29,0,29,Clear
50366,30,1553828400,19,1,20,Clear
50367,31,1553828400,16,4,20,Clear
50368,32,1553828400,27,3,30,Clear
50369,33,1553828400,23,0,23,Clear
50370,34,1553828400,13,17,30,Clear
50371,35,1553828400,12,18,30,Clear
50372,36,1553828400,40,0,40,Clear
50373,37,1553828400,30,0,30,Clear
50374,38,1553828400,25,15,40,Clear
50375,39,1553828400,17,3,20,Clear
50376,40,1553828400,20,1,21,Clear
50377,41,1553828400,15,5,20,Clear
50378,42,1553828400,3,27,30,Clear
50379,43,1553828400,9,21,30,Clear
50380,44,1553828400,0,30,30,Clear
50381,45,1553828400,16,14,30,Clear
50382,46,1553828400,19,1,20,Clear
50383,47,1553828400,39,1,40,Clear
50384,48,1553828400,40,0,40,Clear
50385,49,1553828400,35,5,40,Clear
50386,50,1553828400,1,39,40,Clear
50387,51,1553828400,40,0,40,Clear
50388,52,1553828400,32,0,32,Clear
50389,53,1553828400,37,3,40,Clear
50390,54,1553828400,31,2,33,Clear
50391,55,1553828400,36,0,36,Clear
50392,56,1553828400,39,1,40,Clear
50393,57,1553828400,18,5,23,Clear
50394,58,1553828400,37,3,40,Clear
50395,59,1553828400,20,0,20,Clear
50396,60,1553828400,0,30,30,Clear
50397,61,1553828400,21,4,25,Clear
50398,62,1553828400,40,0,40,Clear
50399,63,1553828400,35,0,35,Clear
50400,64,1553828400,35,5,40,Clear
50401,65,1553828400,40,0,40,Clear
50402,66,1553828400,23,17,40,Clear
50403,67,1553828400,32,8,40,Clear
50404,68,1553828400,39,1,40,Clear
50405,69,1553828400,39,1,40,Clear
50406,70,1553828400,17,11,28,Clear
50407,71,1553828400,37,3,40,Clear
50408,72,1553828400,19,12,31,Clear
50409,73,1553828400,4,26,30,Clear
50410,74,1553828400,0,30,30,Clear
50411,75,1553828400,5,35,40,Clear
50412,76,1553828400,20,18,38,Clear
50413,77,1553828400,29,0,29,Clear
50414,78,1553828400,16,24,40,Clear
50415,79,1553828400,14,13,27,Clear
50416,80,1553828400,16,24,40,Clear
50417,81,1553828400,34,6,40,Clear
50418,82,1553828400,5,17,22,Clear
50419,83,1553828400,0,40,40,Clear
50420,84,1553828400,6,24,30,Clear
50421,85,1553828400,9,26,35,Clear
50422,86,1553828400,5,33,38,Clear
50423,87,1553828400,10,28,38,Clear
50424,88,1553828400,4,26,30,Clear
50425,89,1553828400,37,3,40,Clear
50426,90,1553828400,39,1,40,Clear
50427,91,1553828400,11,19,30,Clear
50428,92,1553828400,0,40,40,Clear
50429,93,1553828400,8,32,40,Clear
50430,94,1553828400,0,40,40,Clear
50431,95,1553828400,6,34,40,Clear
50432,96,1553828400,25,4,29,Clear
50433,97,1553828400,3,37,40,Clear
50434,98,1553828400,40,0,40,Clear
50435,99,1553828400,30,0,30,Clear
50436,100,1553828400,6,19,25,Clear
50437,101,1553828400,10,20,30,Clear
50438,102,1553828400,27,13,40,Clear
50439,103,1553828400,34,6,40,Clear
50440,104,1553828400,33,7,40,Clear
50441,105,1553828400,28,8,36,Clear
50442,106,1553828400,14,26,40,Clear
50443,107,1553828400,3,37,40,Clear
50444,108,1553828400,14,26,40,Clear
50445,109,1553828400,12,17,29,Clear
50446,110,1553828400,21,19,40,Clear
50447,111,1553828400,0,40,40,Clear
50448,112,1553828400,4,26,30,Clear
50449,113,1553828400,40,0,40,Clear
50450,114,1553828400,39,1,40,Clear
50451,115,1553828400,0,30,30,Clear
50452,2,1553832000,4,16,20,Clear
50453,3,1553832000,14,6,20,Clear
50454,4,1553832000,14,6,20,Clear
50455,5,1553832000,29,11,40,Clear
50456,6,1553832000,17,3,20,Clear
50457,7,1553832000,20,9,29,Clear
50458,8,1553832000,30,0,30,Clear
50459,9,1553832000,24,0,24,Clear
50460,10,1553832000,16,0,16,Clear
50461,11,1553832000,30,0,30,Clear
50462,12,1553832000,0,20,20,Clear
50463,13,1553832000,30,0,30,Clear
50464,14,1553832000,29,1,30,Clear
50465,15,1553832000,11,5,16,Clear
50466,16,1553832000,17,3,20,Clear
50467,17,1553832000,15,5,20,Clear
50468,18,1553832000,29,1,30,Clear
50469,19,1553832000,29,1,30,Clear
50470,21,1553832000,29,1,30,Clear
50471,22,1553832000,18,2,20,Clear
50472,23,1553832000,23,7,30,Clear
50473,24,1553832000,19,1,20,Clear
50474,25,1553832000,30,0,30,Clear
50475,26,1553832000,20,0,20,Clear
50476,27,1553832000,20,0,20,Clear
50477,28,1553832000,0,30,30,Clear
50478,29,1553832000,29,0,29,Clear
50479,30,1553832000,19,1,20,Clear
50480,31,1553832000,16,4,20,Clear
50481,32,1553832000,27,3,30,Clear
50482,33,1553832000,23,0,23,Clear
50483,34,1553832000,13,17,30,Clear
50484,35,1553832000,12,18,30,Clear
50485,36,1553832000,40,0,40,Clear
50486,37,1553832000,30,0,30,Clear
50487,38,1553832000,25,15,40,Clear
50488,39,1553832000,16,4,20,Clear
50489,40,1553832000,20,1,21,Clear
50490,41,1553832000,15,5,20,Clear
50491,42,1553832000,3,27,30,Clear
50492,43,1553832000,9,21,30,Clear
50493,44,1553832000,0,30,30,Clear
50494,45,1553832000,16,14,30,Clear
50495,46,1553832000,19,1,20,Clear
50496,47,1553832000,39,1,40,Clear
50497,48,1553832000,40,0,40,Clear
50498,49,1553832000,35,5,40,Clear
50499,50,1553832000,1,39,40,Clear
50500,51,1553832000,40,0,40,Clear
50501,52,1553832000,32,0,32,Clear
50502,53,1553832000,37,3,40,Clear
50503,54,1553832000,31,2,33,Clear
50504,55,1553832000,36,0,36,Clear
50505,56,1553832000,39,1,40,Clear
50506,57,1553832000,18,5,23,Clear
50507,58,1553832000,37,3,40,Clear
50508,59,1553832000,20,0,20,Clear
50509,60,1553832000,0,30,30,Clear
50510,61,1553832000,21,4,25,Clear
50511,62,1553832000,40,0,40,Clear
50512,63,1553832000,35,0,35,Clear
50513,64,1553832000,35,5,40,Clear
50514,65,1553832000,40,0,40,Clear
50515,66,1553832000,23,17,40,Clear
50516,67,1553832000,32,8,40,Clear
50517,68,1553832000,39,1,40,Clear
50518,69,1553832000,39,1,40,Clear
50519,70,1553832000,17,11,28,Clear
50520,71,1553832000,37,3,40,Clear
50521,72,1553832000,19,12,31,Clear
50522,73,1553832000,4,26,30,Clear
50523,74,1553832000,0,30,30,Clear
50524,75,1553832000,5,35,40,Clear
50525,76,1553832000,20,18,38,Clear
50526,77,1553832000,29,0,29,Clear
50527,78,1553832000,15,25,40,Clear
50528,79,1553832000,14,13,27,Clear
50529,80,1553832000,16,24,40,Clear
50530,81,1553832000,34,6,40,Clear
50531,82,1553832000,5,17,22,Clear
50532,83,1553832000,0,40,40,Clear
50533,84,1553832000,6,24,30,Clear
50534,85,1553832000,9,26,35,Clear
50535,86,1553832000,5,33,38,Clear
50536,87,1553832000,10,28,38,Clear
50537,88,1553832000,4,26,30,Clear
50538,89,1553832000,37,3,40,Clear
50539,90,1553832000,39,1,40,Clear
50540,91,1553832000,11,19,30,Clear
50541,92,1553832000,0,40,40,Clear
50542,93,1553832000,8,32,40,Clear
50543,94,1553832000,0,40,40,Clear
50544,95,1553832000,6,34,40,Clear
50545,96,1553832000,25,4,29,Clear
50546,97,1553832000,3,37,40,Clear
50547,98,1553832000,40,0,40,Clear
50548,99,1553832000,30,0,30,Clear
50549,100,1553832000,6,19,25,Clear
50550,101,1553832000,10,20,30,Clear
50551,102,1553832000,27,13,40,Clear
50552,103,1553832000,34,6,40,Clear
50553,104,1553832000,33,7,40,Clear
50554,105,1553832000,28,8,36,Clear
50555,106,1553832000,14,26,40,Clear
50556,107,1553832000,3,37,40,Clear
50557,108,1553832000,14,26,40,Clear
50558,109,1553832000,12,17,29,Clear
50559,110,1553832000,21,19,40,Clear
50560,111,1553832000,0,40,40,Clear
50561,112,1553832000,4,26,30,Clear
50562,113,1553832000,40,0,40,Clear
50563,114,1553832000,39,1,40,Clear
50564,115,1553832000,0,30,30,Clear
50565,2,1553835600,4,16,20,Clear
50566,3,1553835600,14,6,20,Clear
50567,4,1553835600,14,6,20,Clear
50568,5,1553835600,29,11,40,Clear
50569,6,1553835600,17,3,20,Clear
50570,7,1553835600,20,9,29,Clear
50571,8,1553835600,30,0,30,Clear
50572,9,1553835600,24,0,24,Clear
50573,10,1553835600,16,0,16,Clear
50574,11,1553835600,30,0,30,Clear
50575,12,1553835600,0,20,20,Clear
50576,13,1553835600,30,0,30,Clear
50577,14,1553835600,29,1,30,Clear
50578,15,1553835600,11,5,16,Clear
50579,16,1553835600,17,3,20,Clear
50580,17,1553835600,15,5,20,Clear
50581,18,1553835600,29,1,30,Clear
50582,19,1553835600,29,1,30,Clear
50583,21,1553835600,29,1,30,Clear
50584,22,1553835600,18,2,20,Clear
50585,23,1553835600,23,7,30,Clear
50586,24,1553835600,19,1,20,Clear
50587,25,1553835600,30,0,30,Clear
50588,26,1553835600,20,0,20,Clear
50589,27,1553835600,20,0,20,Clear
50590,28,1553835600,0,30,30,Clear
50591,29,1553835600,29,0,29,Clear
50592,30,1553835600,19,1,20,Clear
50593,31,1553835600,16,4,20,Clear
50594,32,1553835600,27,3,30,Clear
50595,33,1553835600,23,0,23,Clear
50596,34,1553835600,13,17,30,Clear
50597,35,1553835600,12,18,30,Clear
50598,36,1553835600,40,0,40,Clear
50599,37,1553835600,30,0,30,Clear
50600,38,1553835600,25,15,40,Clear
50601,39,1553835600,16,4,20,Clear
50602,40,1553835600,20,1,21,Clear
50603,41,1553835600,15,5,20,Clear
50604,42,1553835600,3,27,30,Clear
50605,43,1553835600,9,21,30,Clear
50606,44,1553835600,0,30,30,Clear
50607,45,1553835600,16,14,30,Clear
50608,46,1553835600,19,1,20,Clear
50609,47,1553835600,39,1,40,Clear
50610,48,1553835600,40,0,40,Clear
50611,49,1553835600,35,5,40,Clear
50612,50,1553835600,1,39,40,Clear
50613,51,1553835600,40,0,40,Clear
50614,52,1553835600,32,0,32,Clear
50615,53,1553835600,37,3,40,Clear
50616,54,1553835600,31,2,33,Clear
50617,55,1553835600,36,0,36,Clear
50618,56,1553835600,39,1,40,Clear
50619,57,1553835600,18,5,23,Clear
50620,58,1553835600,37,3,40,Clear
50621,59,1553835600,20,0,20,Clear
50622,60,1553835600,0,30,30,Clear
50623,61,1553835600,21,4,25,Clear
50624,62,1553835600,40,0,40,Clear
50625,63,1553835600,35,0,35,Clear
50626,64,1553835600,35,5,40,Clear
50627,65,1553835600,40,0,40,Clear
50628,66,1553835600,23,17,40,Clear
50629,67,1553835600,32,8,40,Clear
50630,68,1553835600,39,1,40,Clear
50631,69,1553835600,39,1,40,Clear
50632,70,1553835600,17,11,28,Clear
50633,71,1553835600,37,3,40,Clear
50634,72,1553835600,19,12,31,Clear
50635,73,1553835600,4,26,30,Clear
50636,74,1553835600,0,30,30,Clear
50637,75,1553835600,5,35,40,Clear
50638,76,1553835600,20,18,38,Clear
50639,77,1553835600,29,0,29,Clear
50640,78,1553835600,15,25,40,Clear
50641,79,1553835600,14,13,27,Clear
50642,80,1553835600,16,24,40,Clear
50643,81,1553835600,34,6,40,Clear
50644,82,1553835600,5,17,22,Clear
50645,83,1553835600,0,40,40,Clear
50646,84,1553835600,6,24,30,Clear
50647,85,1553835600,9,26,35,Clear
50648,86,1553835600,5,33,38,Clear
50649,87,1553835600,10,28,38,Clear
50650,88,1553835600,4,26,30,Clear
50651,89,1553835600,37,3,40,Clear
50652,90,1553835600,39,1,40,Clear
50653,91,1553835600,11,19,30,Clear
50654,92,1553835600,0,40,40,Clear
50655,93,1553835600,8,32,40,Clear
50656,94,1553835600,0,40,40,Clear
50657,95,1553835600,6,34,40,Clear
50658,96,1553835600,25,4,29,Clear
50659,97,1553835600,3,37,40,Clear
50660,98,1553835600,40,0,40,Clear
50661,99,1553835600,30,0,30,Clear
50662,100,1553835600,6,19,25,Clear
50663,101,1553835600,10,20,30,Clear
50664,102,1553835600,27,13,40,Clear
50665,103,1553835600,34,6,40,Clear
50666,104,1553835600,33,7,40,Clear
50667,105,1553835600,28,8,36,Clear
50668,106,1553835600,14,26,40,Clear
50669,107,1553835600,3,37,40,Clear
50670,108,1553835600,14,26,40,Clear
50671,109,1553835600,12,17,29,Clear
50672,110,1553835600,21,19,40,Clear
50673,111,1553835600,0,40,40,Clear
50674,112,1553835600,4,26,30,Clear
50675,113,1553835600,40,0,40,Clear
50676,114,1553835600,39,1,40,Clear
50677,115,1553835600,0,30,30,Clear
50678,2,1553839200,4,16,20,Clouds
50679,3,1553839200,14,6,20,Clouds
50680,4,1553839200,14,6,20,Clouds
50681,5,1553839200,29,11,40,Clouds
50682,6,1553839200,17,3,20,Clouds
50683,7,1553839200,20,9,29,Clouds
50684,8,1553839200,30,0,30,Clouds
50685,9,1553839200,24,0,24,Clouds
50686,10,1553839200,16,0,16,Clouds
50687,11,1553839200,30,0,30,Clouds
50688,12,1553839200,0,20,20,Clouds
50689,13,1553839200,30,0,30,Clouds
50690,14,1553839200,29,1,30,Clouds
50691,15,1553839200,11,5,16,Clouds
50692,16,1553839200,17,3,20,Clouds
50693,17,1553839200,15,5,20,Clouds
50694,18,1553839200,29,1,30,Clouds
50695,19,1553839200,29,1,30,Clouds
50696,21,1553839200,29,1,30,Clouds
50697,22,1553839200,18,2,20,Clouds
50698,23,1553839200,23,7,30,Clouds
50699,24,1553839200,19,1,20,Clouds
50700,25,1553839200,30,0,30,Clouds
50701,26,1553839200,20,0,20,Clouds
50702,27,1553839200,20,0,20,Clouds
50703,28,1553839200,0,30,30,Clouds
50704,29,1553839200,29,0,29,Clouds
50705,30,1553839200,19,1,20,Clouds
50706,31,1553839200,16,4,20,Clouds
50707,32,1553839200,27,3,30,Clouds
50708,33,1553839200,23,0,23,Clouds
50709,34,1553839200,13,17,30,Clouds
50710,35,1553839200,12,18,30,Clouds
50711,36,1553839200,40,0,40,Clouds
50712,37,1553839200,30,0,30,Clouds
50713,38,1553839200,25,15,40,Clouds
50714,39,1553839200,16,4,20,Clouds
50715,40,1553839200,20,1,21,Clouds
50716,41,1553839200,15,5,20,Clouds
50717,42,1553839200,3,27,30,Clouds
50718,43,1553839200,9,21,30,Clouds
50719,44,1553839200,0,30,30,Clouds
50720,45,1553839200,16,14,30,Clouds
50721,46,1553839200,19,1,20,Clouds
50722,47,1553839200,39,1,40,Clouds
50723,48,1553839200,40,0,40,Clouds
50724,49,1553839200,35,5,40,Clouds
50725,50,1553839200,1,39,40,Clouds
50726,51,1553839200,40,0,40,Clouds
50727,52,1553839200,32,0,32,Clouds
50728,53,1553839200,37,3,40,Clouds
50729,54,1553839200,31,2,33,Clouds
50730,55,1553839200,36,0,36,Clouds
50731,56,1553839200,39,1,40,Clouds
50732,57,1553839200,18,5,23,Clouds
50733,58,1553839200,37,3,40,Clouds
50734,59,1553839200,20,0,20,Clouds
50735,60,1553839200,0,30,30,Clouds
50736,61,1553839200,21,4,25,Clouds
50737,62,1553839200,40,0,40,Clouds
50738,63,1553839200,35,0,35,Clouds
50739,64,1553839200,35,5,40,Clouds
50740,65,1553839200,40,0,40,Clouds
50741,66,1553839200,23,17,40,Clouds
50742,67,1553839200,32,8,40,Clouds
50743,68,1553839200,39,1,40,Clouds
50744,69,1553839200,39,1,40,Clouds
50745,70,1553839200,17,11,28,Clouds
50746,71,1553839200,37,3,40,Clouds
50747,72,1553839200,19,12,31,Clouds
50748,73,1553839200,4,26,30,Clouds
50749,74,1553839200,0,30,30,Clouds
50750,75,1553839200,5,35,40,Clouds
50751,76,1553839200,20,18,38,Clouds
50752,77,1553839200,29,0,29,Clouds
50753,78,1553839200,15,25,40,Clouds
50754,79,1553839200,14,13,27,Clouds
50755,80,1553839200,16,24,40,Clouds
50756,81,1553839200,34,6,40,Clouds
50757,82,1553839200,5,17,22,Clouds
50758,83,1553839200,0,40,40,Clouds
50759,84,1553839200,6,24,30,Clouds
50760,85,1553839200,9,26,35,Clouds
50761,86,1553839200,5,33,38,Clouds
50762,87,1553839200,10,28,38,Clouds
50763,88,1553839200,4,26,30,Clouds
50764,89,1553839200,36,3,39,Clouds
50765,90,1553839200,39,1,40,Clouds
50766,91,1553839200,11,19,30,Clouds
50767,92,1553839200,0,40,40,Clouds
50768,93,1553839200,8,32,40,Clouds
50769,94,1553839200,0,40,40,Clouds
50770,95,1553839200,6,34,40,Clouds
50771,96,1553839200,25,4,29,Clouds
50772,97,1553839200,3,37,40,Clouds
50773,98,1553839200,40,0,40,Clouds
50774,99,1553839200,30,0,30,Clouds
50775,100,1553839200,6,19,25,Clouds
50776,101,1553839200,10,20,30,Clouds
50777,102,1553839200,27,13,40,Clouds
50778,103,1553839200,34,6,40,Clouds
50779,104,1553839200,33,7,40,Clouds
50780,105,1553839200,28,8,36,Clouds
50781,106,1553839200,14,26,40,Clouds
50782,107,1553839200,3,37,40,Clouds
50783,108,1553839200,14,26,40,Clouds
50784,109,1553839200,12,17,29,Clouds
50785,110,1553839200,21,19,40,Clouds
50786,111,1553839200,0,40,40,Clouds
50787,112,1553839200,4,26,30,Clouds
50788,113,1553839200,40,0,40,Clouds
50789,114,1553839200,39,1,40,Clouds
50790,115,1553839200,0,30,30,Clouds
50791,2,1553842800,4,16,20,Clouds
50792,3,1553842800,18,2,20,Clouds
50793,4,1553842800,15,5,20,Clouds
50794,5,1553842800,14,26,40,Clouds
50795,6,1553842800,17,3,20,Clouds
50796,7,1553842800,22,7,29,Clouds
50797,8,1553842800,23,7,30,Clouds
50798,9,1553842800,20,4,24,Clouds
50799,10,1553842800,16,0,16,Clouds
50800,11,1553842800,28,2,30,Clouds
50801,12,1553842800,3,17,20,Clouds
50802,13,1553842800,30,0,30,Clouds
50803,14,1553842800,22,8,30,Clouds
50804,15,1553842800,11,5,16,Clouds
50805,16,1553842800,17,3,20,Clouds
50806,17,1553842800,16,4,20,Clouds
50807,18,1553842800,30,0,30,Clouds
50808,19,1553842800,25,5,30,Clouds
50809,21,1553842800,27,3,30,Clouds
50810,22,1553842800,15,5,20,Clouds
50811,23,1553842800,20,10,30,Clouds
50812,24,1553842800,14,6,20,Clouds
50813,25,1553842800,29,1,30,Clouds
50814,26,1553842800,19,1,20,Clouds
50815,27,1553842800,19,1,20,Clouds
50816,28,1553842800,2,28,30,Clouds
50817,29,1553842800,28,1,29,Clouds
50818,30,1553842800,18,2,20,Clouds
50819,31,1553842800,19,1,20,Clouds
50820,32,1553842800,22,8,30,Clouds
50821,33,1553842800,14,9,23,Clouds
50822,34,1553842800,7,23,30,Clouds
50823,35,1553842800,14,16,30,Clouds
50824,36,1553842800,37,3,40,Clouds
50825,37,1553842800,30,0,30,Clouds
50826,38,1553842800,25,15,40,Clouds
50827,39,1553842800,17,3,20,Clouds
50828,40,1553842800,20,1,21,Clouds
50829,41,1553842800,15,5,20,Clouds
50830,42,1553842800,5,25,30,Clouds
50831,43,1553842800,15,15,30,Clouds
50832,44,1553842800,4,26,30,Clouds
50833,45,1553842800,17,13,30,Clouds
50834,46,1553842800,19,1,20,Clouds
50835,47,1553842800,39,1,40,Clouds
50836,48,1553842800,37,3,40,Clouds
50837,49,1553842800,34,6,40,Clouds
50838,50,1553842800,1,39,40,Clouds
50839,51,1553842800,39,1,40,Clouds
50840,52,1553842800,25,7,32,Clouds
50841,53,1553842800,37,3,40,Clouds
50842,54,1553842800,32,1,33,Clouds
50843,55,1553842800,36,0,36,Clouds
50844,56,1553842800,40,0,40,Clouds
50845,57,1553842800,17,6,23,Clouds
50846,58,1553842800,37,3,40,Clouds
50847,59,1553842800,20,0,20,Clouds
50848,60,1553842800,6,24,30,Clouds
50849,61,1553842800,23,2,25,Clouds
50850,62,1553842800,37,3,40,Clouds
50851,63,1553842800,33,2,35,Clouds
50852,64,1553842800,35,5,40,Clouds
50853,65,1553842800,40,0,40,Clouds
50854,66,1553842800,37,3,40,Clouds
50855,67,1553842800,32,8,40,Clouds
50856,68,1553842800,33,7,40,Clouds
50857,69,1553842800,33,7,40,Clouds
50858,70,1553842800,16,12,28,Clouds
50859,71,1553842800,40,0,40,Clouds
50860,72,1553842800,21,10,31,Clouds
50861,73,1553842800,5,25,30,Clouds
50862,74,1553842800,2,28,30,Clouds
50863,75,1553842800,5,35,40,Clouds
50864,76,1553842800,22,16,38,Clouds
50865,77,1553842800,28,1,29,Clouds
50866,78,1553842800,16,24,40,Clouds
50867,79,1553842800,13,14,27,Clouds
50868,80,1553842800,19,21,40,Clouds
50869,81,1553842800,34,6,40,Clouds
50870,82,1553842800,5,17,22,Clouds
50871,83,1553842800,2,38,40,Clouds
50872,84,1553842800,10,20,30,Clouds
50873,85,1553842800,9,26,35,Clouds
50874,86,1553842800,7,31,38,Clouds
50875,87,1553842800,11,27,38,Clouds
50876,88,1553842800,3,27,30,Clouds
50877,89,1553842800,37,2,39,Clouds
50878,90,1553842800,38,2,40,Clouds
50879,91,1553842800,28,2,30,Clouds
50880,92,1553842800,1,39,40,Clouds
50881,93,1553842800,8,32,40,Clouds
50882,94,1553842800,0,40,40,Clouds
50883,95,1553842800,8,32,40,Clouds
50884,96,1553842800,7,23,30,Clouds
50885,97,1553842800,6,34,40,Clouds
50886,98,1553842800,40,0,40,Clouds
50887,99,1553842800,29,1,30,Clouds
50888,100,1553842800,3,22,25,Clouds
50889,101,1553842800,17,13,30,Clouds
50890,102,1553842800,27,13,40,Clouds
50891,103,1553842800,34,6,40,Clouds
50892,104,1553842800,33,7,40,Clouds
50893,105,1553842800,29,7,36,Clouds
50894,106,1553842800,14,26,40,Clouds
50895,107,1553842800,9,31,40,Clouds
50896,108,1553842800,16,24,40,Clouds
50897,109,1553842800,19,10,29,Clouds
50898,110,1553842800,23,17,40,Clouds
50899,111,1553842800,3,37,40,Clouds
50900,112,1553842800,7,23,30,Clouds
50901,113,1553842800,40,0,40,Clouds
50902,114,1553842800,39,1,40,Clouds
50903,115,1553842800,1,29,30,Clouds
50904,2,1553846400,17,3,20,Clouds
50905,3,1553846400,19,1,20,Clouds
50906,4,1553846400,17,3,20,Clouds
50907,5,1553846400,14,26,40,Clouds
50908,6,1553846400,20,0,20,Clouds
50909,7,1553846400,25,4,29,Clouds
50910,8,1553846400,19,11,30,Clouds
50911,9,1553846400,11,13,24,Clouds
50912,10,1553846400,15,1,16,Clouds
50913,11,1553846400,25,5,30,Clouds
50914,12,1553846400,7,13,20,Clouds
50915,13,1553846400,27,3,30,Clouds
50916,14,1553846400,18,12,30,Clouds
50917,15,1553846400,16,0,16,Clouds
50918,16,1553846400,15,5,20,Clouds
50919,17,1553846400,14,6,20,Clouds
50920,18,1553846400,25,5,30,Clouds
50921,19,1553846400,23,7,30,Clouds
50922,21,1553846400,24,6,30,Clouds
50923,22,1553846400,12,8,20,Clouds
50924,23,1553846400,19,11,30,Clouds
50925,24,1553846400,8,12,20,Clouds
50926,25,1553846400,23,7,30,Clouds
50927,26,1553846400,13,7,20,Clouds
50928,27,1553846400,17,3,20,Clouds
50929,28,1553846400,19,11,30,Clouds
50930,29,1553846400,26,3,29,Clouds
50931,30,1553846400,15,5,20,Clouds
50932,31,1553846400,18,2,20,Clouds
50933,32,1553846400,22,8,30,Clouds
50934,33,1553846400,6,17,23,Clouds
50935,34,1553846400,20,10,30,Clouds
50936,35,1553846400,28,2,30,Clouds
50937,36,1553846400,36,4,40,Clouds
50938,37,1553846400,29,1,30,Clouds
50939,38,1553846400,22,18,40,Clouds
50940,39,1553846400,13,7,20,Clouds
50941,40,1553846400,8,13,21,Clouds
50942,41,1553846400,17,3,20,Clouds
50943,42,1553846400,9,21,30,Clouds
50944,43,1553846400,24,6,30,Clouds
50945,44,1553846400,15,15,30,Clouds
50946,45,1553846400,21,9,30,Clouds
50947,46,1553846400,18,2,20,Clouds
50948,47,1553846400,37,3,40,Clouds
50949,48,1553846400,37,3,40,Clouds
50950,49,1553846400,40,0,40,Clouds
50951,50,1553846400,8,32,40,Clouds
50952,51,1553846400,37,3,40,Clouds
50953,52,1553846400,20,12,32,Clouds
50954,53,1553846400,34,6,40,Clouds
50955,54,1553846400,30,3,33,Clouds
50956,55,1553846400,32,4,36,Clouds
50957,56,1553846400,39,1,40,Clouds
50958,57,1553846400,19,4,23,Clouds
50959,58,1553846400,32,8,40,Clouds
50960,59,1553846400,3,17,20,Clouds
50961,60,1553846400,19,11,30,Clouds
50962,61,1553846400,25,0,25,Clouds
50963,62,1553846400,30,10,40,Clouds
50964,63,1553846400,33,2,35,Clouds
50965,64,1553846400,35,5,40,Clouds
50966,65,1553846400,34,6,40,Clouds
50967,66,1553846400,24,16,40,Clouds
50968,67,1553846400,33,7,40,Clouds
50969,68,1553846400,40,0,40,Clouds
50970,69,1553846400,30,10,40,Clouds
50971,70,1553846400,3,25,28,Clouds
50972,71,1553846400,40,0,40,Clouds
50973,72,1553846400,24,7,31,Clouds
50974,73,1553846400,9,21,30,Clouds
50975,74,1553846400,4,26,30,Clouds
50976,75,1553846400,4,36,40,Clouds
50977,76,1553846400,29,9,38,Clouds
50978,77,1553846400,29,0,29,Clouds
50979,78,1553846400,18,22,40,Clouds
50980,79,1553846400,13,14,27,Clouds
50981,80,1553846400,22,18,40,Clouds
50982,81,1553846400,34,6,40,Clouds
50983,82,1553846400,8,14,22,Clouds
50984,83,1553846400,6,34,40,Clouds
50985,84,1553846400,11,19,30,Clouds
50986,85,1553846400,15,20,35,Clouds
50987,86,1553846400,8,30,38,Clouds
50988,87,1553846400,10,28,38,Clouds
50989,88,1553846400,11,19,30,Clouds
50990,89,1553846400,36,4,40,Clouds
50991,90,1553846400,19,21,40,Clouds
50992,91,1553846400,28,2,30,Clouds
50993,92,1553846400,3,37,40,Clouds
50994,93,1553846400,16,24,40,Clouds
50995,94,1553846400,1,39,40,Clouds
50996,95,1553846400,16,24,40,Clouds
50997,96,1553846400,8,22,30,Clouds
50998,97,1553846400,10,30,40,Clouds
50999,98,1553846400,40,0,40,Clouds
51000,99,1553846400,26,4,30,Clouds
51001,100,1553846400,10,15,25,Clouds
51002,101,1553846400,25,5,30,Clouds
51003,102,1553846400,30,10,40,Clouds
51004,103,1553846400,33,7,40,Clouds
51005,104,1553846400,33,7,40,Clouds
51006,105,1553846400,29,7,36,Clouds
51007,106,1553846400,17,23,40,Clouds
51008,107,1553846400,12,28,40,Clouds
51009,108,1553846400,21,19,40,Clouds
51010,109,1553846400,24,5,29,Clouds
51011,110,1553846400,25,15,40,Clouds
51012,111,1553846400,14,26,40,Clouds
51013,112,1553846400,14,16,30,Clouds
51014,113,1553846400,37,3,40,Clouds
51015,114,1553846400,32,8,40,Clouds
51016,115,1553846400,11,19,30,Clouds
51017,2,1553850000,20,0,20,Clouds
51018,3,1553850000,18,2,20,Clouds
51019,4,1553850000,15,5,20,Clouds
51020,5,1553850000,38,2,40,Clouds
51021,6,1553850000,20,0,20,Clouds
51022,7,1553850000,29,0,29,Clouds
51023,8,1553850000,29,1,30,Clouds
51024,9,1553850000,1,23,24,Clouds
51025,10,1553850000,8,8,16,Clouds
51026,11,1553850000,20,10,30,Clouds
51027,12,1553850000,14,6,20,Clouds
51028,13,1553850000,20,10,30,Clouds
51029,14,1553850000,5,25,30,Clouds
51030,15,1553850000,16,0,16,Clouds
51031,16,1553850000,14,6,20,Clouds
51032,17,1553850000,12,7,19,Clouds
51033,18,1553850000,30,0,30,Clouds
51034,19,1553850000,6,24,30,Clouds
51035,21,1553850000,25,5,30,Clouds
51036,22,1553850000,15,5,20,Clouds
51037,23,1553850000,22,8,30,Clouds
51038,24,1553850000,13,6,19,Clouds
51039,25,1553850000,24,5,29,Clouds
51040,26,1553850000,4,16,20,Clouds
51041,27,1553850000,12,8,20,Clouds
51042,28,1553850000,24,6,30,Clouds
51043,29,1553850000,28,1,29,Clouds
51044,30,1553850000,15,5,20,Clouds
51045,31,1553850000,19,1,20,Clouds
51046,32,1553850000,19,11,30,Clouds
51047,33,1553850000,5,18,23,Clouds
51048,34,1553850000,30,0,30,Clouds
51049,35,1553850000,24,6,30,Clouds
51050,36,1553850000,27,13,40,Clouds
51051,37,1553850000,28,2,30,Clouds
51052,38,1553850000,24,16,40,Clouds
51053,39,1553850000,18,2,20,Clouds
51054,40,1553850000,13,8,21,Clouds
51055,41,1553850000,20,0,20,Clouds
51056,42,1553850000,28,2,30,Clouds
51057,43,1553850000,30,0,30,Clouds
51058,44,1553850000,30,0,30,Clouds
51059,45,1553850000,22,8,30,Clouds
51060,46,1553850000,16,4,20,Clouds
51061,47,1553850000,34,6,40,Clouds
51062,48,1553850000,29,11,40,Clouds
51063,49,1553850000,38,2,40,Clouds
51064,50,1553850000,30,10,40,Clouds
51065,51,1553850000,28,12,40,Clouds
51066,52,1553850000,5,27,32,Clouds
51067,53,1553850000,25,15,40,Clouds
51068,54,1553850000,26,7,33,Clouds
51069,55,1553850000,27,9,36,Clouds
51070,56,1553850000,24,16,40,Clouds
51071,57,1553850000,13,10,23,Clouds
51072,58,1553850000,21,19,40,Clouds
51073,59,1553850000,4,16,20,Clouds
51074,60,1553850000,30,0,30,Clouds
51075,61,1553850000,24,1,25,Clouds
51076,62,1553850000,21,19,40,Clouds
51077,63,1553850000,29,6,35,Clouds
51078,64,1553850000,33,7,40,Clouds
51079,65,1553850000,23,17,40,Clouds
51080,66,1553850000,11,28,39,Clouds
51081,67,1553850000,23,17,40,Clouds
51082,68,1553850000,21,19,40,Clouds
51083,69,1553850000,29,11,40,Clouds
51084,70,1553850000,0,27,27,Clouds
51085,71,1553850000,35,5,40,Clouds
51086,72,1553850000,29,2,31,Clouds
51087,73,1553850000,18,12,30,Clouds
51088,74,1553850000,17,13,30,Clouds
51089,75,1553850000,11,29,40,Clouds
51090,76,1553850000,35,3,38,Clouds
51091,77,1553850000,28,1,29,Clouds
51092,78,1553850000,27,13,40,Clouds
51093,79,1553850000,13,14,27,Clouds
51094,80,1553850000,27,13,40,Clouds
51095,81,1553850000,31,9,40,Clouds
51096,82,1553850000,12,10,22,Clouds
51097,83,1553850000,21,19,40,Clouds
51098,84,1553850000,24,6,30,Clouds
51099,85,1553850000,35,0,35,Clouds
51100,86,1553850000,28,10,38,Clouds
51101,87,1553850000,16,22,38,Clouds
51102,88,1553850000,15,15,30,Clouds
51103,89,1553850000,33,7,40,Clouds
51104,90,1553850000,1,39,40,Clouds
51105,91,1553850000,28,2,30,Clouds
51106,92,1553850000,21,19,40,Clouds
51107,93,1553850000,36,4,40,Clouds
51108,94,1553850000,10,30,40,Clouds
51109,95,1553850000,31,9,40,Clouds
51110,96,1553850000,15,15,30,Clouds
51111,97,1553850000,33,7,40,Clouds
51112,98,1553850000,37,3,40,Clouds
51113,99,1553850000,21,9,30,Clouds
51114,100,1553850000,19,6,25,Clouds
51115,101,1553850000,29,1,30,Clouds
51116,102,1553850000,36,4,40,Clouds
51117,103,1553850000,32,8,40,Clouds
51118,104,1553850000,33,7,40,Clouds
51119,105,1553850000,27,9,36,Clouds
51120,106,1553850000,17,23,40,Clouds
51121,107,1553850000,28,12,40,Clouds
51122,108,1553850000,21,19,40,Clouds
51123,109,1553850000,18,11,29,Clouds
51124,110,1553850000,29,11,40,Clouds
51125,111,1553850000,31,9,40,Clouds
51126,112,1553850000,29,1,30,Clouds
51127,113,1553850000,35,5,40,Clouds
51128,114,1553850000,25,15,40,Clouds
51129,115,1553850000,15,15,30,Clouds
51130,2,1553853600,20,0,20,Clouds
51131,3,1553853600,17,3,20,Clouds
51132,4,1553853600,15,5,20,Clouds
51133,5,1553853600,40,0,40,Clouds
51134,6,1553853600,18,2,20,Clouds
51135,7,1553853600,29,0,29,Clouds
51136,8,1553853600,18,12,30,Clouds
51137,9,1553853600,1,23,24,Clouds
51138,10,1553853600,1,15,16,Clouds
51139,11,1553853600,0,30,30,Clouds
51140,12,1553853600,20,0,20,Clouds
51141,13,1553853600,0,30,30,Clouds
51142,14,1553853600,9,21,30,Clouds
51143,15,1553853600,15,1,16,Clouds
51144,16,1553853600,17,3,20,Clouds
51145,17,1553853600,17,2,19,Clouds
51146,18,1553853600,30,0,30,Clouds
51147,19,1553853600,3,27,30,Clouds
51148,21,1553853600,2,28,30,Clouds
51149,22,1553853600,11,9,20,Clouds
51150,23,1553853600,15,15,30,Clouds
51151,24,1553853600,18,1,19,Clouds
51152,25,1553853600,9,20,29,Clouds
51153,26,1553853600,7,13,20,Clouds
51154,27,1553853600,4,16,20,Clouds
51155,28,1553853600,28,2,30,Clouds
51156,29,1553853600,25,4,29,Clouds
51157,30,1553853600,20,0,20,Clouds
51158,31,1553853600,13,7,20,Clouds
51159,32,1553853600,24,6,30,Clouds
51160,33,1553853600,4,19,23,Clouds
51161,34,1553853600,30,0,30,Clouds
51162,35,1553853600,29,1,30,Clouds
51163,36,1553853600,6,34,40,Clouds
51164,37,1553853600,18,12,30,Clouds
51165,38,1553853600,28,12,40,Clouds
51166,39,1553853600,20,0,20,Clouds
51167,40,1553853600,18,3,21,Clouds
51168,41,1553853600,19,1,20,Clouds
51169,42,1553853600,30,0,30,Clouds
51170,43,1553853600,30,0,30,Clouds
51171,44,1553853600,30,0,30,Clouds
51172,45,1553853600,30,0,30,Clouds
51173,46,1553853600,18,2,20,Clouds
51174,47,1553853600,7,33,40,Clouds
51175,48,1553853600,12,28,40,Clouds
51176,49,1553853600,18,22,40,Clouds
51177,50,1553853600,40,0,40,Clouds
51178,51,1553853600,24,16,40,Clouds
51179,52,1553853600,0,32,32,Clouds
51180,53,1553853600,11,29,40,Clouds
51181,54,1553853600,25,8,33,Clouds
51182,55,1553853600,23,13,36,Clouds
51183,56,1553853600,5,35,40,Clouds
51184,57,1553853600,0,23,23,Clouds
51185,58,1553853600,1,39,40,Clouds
51186,59,1553853600,20,0,20,Clouds
51187,60,1553853600,29,1,30,Clouds
51188,61,1553853600,25,0,25,Clouds
51189,62,1553853600,0,40,40,Clouds
51190,63,1553853600,10,25,35,Clouds
51191,64,1553853600,7,33,40,Clouds
51192,65,1553853600,7,33,40,Clouds
51193,66,1553853600,5,34,39,Clouds
51194,67,1553853600,26,14,40,Clouds
51195,68,1553853600,3,37,40,Clouds
51196,69,1553853600,15,25,40,Clouds
51197,70,1553853600,6,21,27,Clouds
51198,71,1553853600,40,0,40,Clouds
51199,72,1553853600,31,0,31,Clouds
51200,73,1553853600,29,1,30,Clouds
51201,74,1553853600,28,2,30,Clouds
51202,75,1553853600,40,0,40,Clouds
51203,76,1553853600,38,0,38,Clouds
51204,77,1553853600,29,0,29,Clouds
51205,78,1553853600,40,0,40,Clouds
51206,79,1553853600,26,1,27,Clouds
51207,80,1553853600,39,1,40,Clouds
51208,81,1553853600,39,1,40,Clouds
51209,82,1553853600,22,0,22,Clouds
51210,83,1553853600,40,0,40,Clouds
51211,84,1553853600,30,0,30,Clouds
51212,85,1553853600,35,0,35,Clouds
51213,86,1553853600,38,0,38,Clouds
51214,87,1553853600,38,0,38,Clouds
51215,88,1553853600,30,0,30,Clouds
51216,89,1553853600,36,4,40,Clouds
51217,90,1553853600,3,37,40,Clouds
51218,91,1553853600,30,0,30,Clouds
51219,92,1553853600,39,1,40,Clouds
51220,93,1553853600,40,0,40,Clouds
51221,94,1553853600,39,1,40,Clouds
51222,95,1553853600,39,1,40,Clouds
51223,96,1553853600,30,0,30,Clouds
51224,97,1553853600,40,0,40,Clouds
51225,98,1553853600,37,3,40,Clouds
51226,99,1553853600,9,21,30,Clouds
51227,100,1553853600,16,9,25,Clouds
51228,101,1553853600,29,1,30,Clouds
51229,102,1553853600,40,0,40,Clouds
51230,103,1553853600,31,9,40,Clouds
51231,104,1553853600,34,5,39,Clouds
51232,105,1553853600,31,5,36,Clouds
51233,106,1553853600,30,10,40,Clouds
51234,107,1553853600,40,0,40,Clouds
51235,108,1553853600,33,7,40,Clouds
51236,109,1553853600,29,0,29,Clouds
51237,110,1553853600,40,0,40,Clouds
51238,111,1553853600,26,14,40,Clouds
51239,112,1553853600,30,0,30,Clouds
51240,113,1553853600,28,12,40,Clouds
51241,114,1553853600,24,16,40,Clouds
51242,115,1553853600,30,0,30,Clouds
51243,2,1553857200,19,1,20,Clouds
51244,3,1553857200,19,1,20,Clouds
51245,4,1553857200,20,0,20,Clouds
51246,5,1553857200,27,13,40,Clouds
51247,6,1553857200,19,1,20,Clouds
51248,7,1553857200,29,0,29,Clouds
51249,8,1553857200,4,26,30,Clouds
51250,9,1553857200,0,24,24,Clouds
51251,10,1553857200,9,7,16,Clouds
51252,11,1553857200,0,30,30,Clouds
51253,12,1553857200,20,0,20,Clouds
51254,13,1553857200,0,30,30,Clouds
51255,14,1553857200,10,20,30,Clouds
51256,15,1553857200,16,0,16,Clouds
51257,16,1553857200,17,3,20,Clouds
51258,17,1553857200,12,7,19,Clouds
51259,18,1553857200,28,2,30,Clouds
51260,19,1553857200,1,29,30,Clouds
51261,21,1553857200,0,30,30,Clouds
51262,22,1553857200,12,8,20,Clouds
51263,23,1553857200,14,16,30,Clouds
51264,24,1553857200,18,1,19,Clouds
51265,25,1553857200,1,28,29,Clouds
51266,26,1553857200,0,20,20,Clouds
51267,27,1553857200,0,20,20,Clouds
51268,28,1553857200,19,11,30,Clouds
51269,29,1553857200,29,0,29,Clouds
51270,30,1553857200,19,1,20,Clouds
51271,31,1553857200,17,3,20,Clouds
51272,32,1553857200,13,17,30,Clouds
51273,33,1553857200,15,8,23,Clouds
51274,34,1553857200,28,2,30,Clouds
51275,35,1553857200,30,0,30,Clouds
51276,36,1553857200,0,40,40,Clouds
51277,37,1553857200,13,17,30,Clouds
51278,38,1553857200,38,2,40,Clouds
51279,39,1553857200,19,1,20,Clouds
51280,40,1553857200,21,0,21,Clouds
51281,41,1553857200,18,2,20,Clouds
51282,42,1553857200,28,2,30,Clouds
51283,43,1553857200,30,0,30,Clouds
51284,44,1553857200,30,0,30,Clouds
51285,45,1553857200,28,2,30,Clouds
51286,46,1553857200,20,0,20,Clouds
51287,47,1553857200,1,39,40,Clouds
51288,48,1553857200,3,37,40,Clouds
51289,49,1553857200,0,40,40,Clouds
51290,50,1553857200,40,0,40,Clouds
51291,51,1553857200,14,26,40,Clouds
51292,52,1553857200,0,32,32,Clouds
51293,53,1553857200,1,39,40,Clouds
51294,54,1553857200,21,12,33,Clouds
51295,55,1553857200,15,21,36,Clouds
51296,56,1553857200,12,28,40,Clouds
51297,57,1553857200,0,23,23,Clouds
51298,58,1553857200,17,23,40,Clouds
51299,59,1553857200,20,0,20,Clouds
51300,60,1553857200,29,1,30,Clouds
51301,61,1553857200,25,0,25,Clouds
51302,62,1553857200,15,25,40,Clouds
51303,63,1553857200,0,35,35,Clouds
51304,64,1553857200,0,40,40,Clouds
51305,65,1553857200,16,24,40,Clouds
51306,66,1553857200,1,38,39,Clouds
51307,67,1553857200,30,10,40,Clouds
51308,68,1553857200,1,39,40,Clouds
51309,69,1553857200,15,25,40,Clouds
51310,70,1553857200,5,22,27,Clouds
51311,71,1553857200,38,2,40,Clouds
51312,72,1553857200,31,0,31,Clouds
51313,73,1553857200,30,0,30,Clouds
51314,74,1553857200,28,2,30,Clouds
51315,75,1553857200,39,1,40,Clouds
51316,76,1553857200,38,0,38,Clouds
51317,77,1553857200,26,3,29,Clouds
51318,78,1553857200,40,0,40,Clouds
51319,79,1553857200,10,17,27,Clouds
51320,80,1553857200,38,2,40,Clouds
51321,81,1553857200,39,1,40,Clouds
51322,82,1553857200,22,0,22,Clouds
51323,83,1553857200,40,0,40,Clouds
51324,84,1553857200,29,1,30,Clouds
51325,85,1553857200,35,0,35,Clouds
51326,86,1553857200,38,0,38,Clouds
51327,87,1553857200,38,0,38,Clouds
51328,88,1553857200,29,1,30,Clouds
51329,89,1553857200,23,17,40,Clouds
51330,90,1553857200,12,28,40,Clouds
51331,91,1553857200,28,2,30,Clouds
51332,92,1553857200,40,0,40,Clouds
51333,93,1553857200,40,0,40,Clouds
51334,94,1553857200,40,0,40,Clouds
51335,95,1553857200,40,0,40,Clouds
51336,96,1553857200,30,0,30,Clouds
51337,97,1553857200,38,2,40,Clouds
51338,98,1553857200,32,8,40,Clouds
51339,99,1553857200,0,30,30,Clouds
51340,100,1553857200,25,0,25,Clouds
51341,101,1553857200,29,1,30,Clouds
51342,102,1553857200,40,0,40,Clouds
51343,103,1553857200,26,14,40,Clouds
51344,104,1553857200,34,6,40,Clouds
51345,105,1553857200,31,5,36,Clouds
51346,106,1553857200,36,4,40,Clouds
51347,107,1553857200,40,0,40,Clouds
51348,108,1553857200,37,3,40,Clouds
51349,109,1553857200,28,1,29,Clouds
51350,110,1553857200,40,0,40,Clouds
51351,111,1553857200,40,0,40,Clouds
51352,112,1553857200,30,0,30,Clouds
51353,113,1553857200,14,26,40,Clouds
51354,114,1553857200,14,26,40,Clouds
51355,115,1553857200,15,15,30,Clouds
51356,2,1553860800,20,0,20,Clouds
51357,3,1553860800,17,3,20,Clouds
51358,4,1553860800,16,4,20,Clouds
51359,5,1553860800,24,16,40,Clouds
51360,6,1553860800,20,0,20,Clouds
51361,7,1553860800,21,8,29,Clouds
51362,8,1553860800,7,23,30,Clouds
51363,9,1553860800,1,23,24,Clouds
51364,10,1553860800,1,15,16,Clouds
51365,11,1553860800,10,20,30,Clouds
51366,12,1553860800,20,0,20,Clouds
51367,13,1553860800,2,28,30,Clouds
51368,14,1553860800,8,22,30,Clouds
51369,15,1553860800,16,0,16,Clouds
51370,16,1553860800,15,4,19,Clouds
51371,17,1553860800,12,8,20,Clouds
51372,18,1553860800,28,2,30,Clouds
51373,19,1553860800,15,15,30,Clouds
51374,21,1553860800,0,30,30,Clouds
51375,22,1553860800,10,10,20,Clouds
51376,23,1553860800,15,15,30,Clouds
51377,24,1553860800,18,2,20,Clouds
51378,25,1553860800,9,21,30,Clouds
51379,26,1553860800,1,19,20,Clouds
51380,27,1553860800,0,20,20,Clouds
51381,28,1553860800,25,5,30,Clouds
51382,29,1553860800,28,1,29,Clouds
51383,30,1553860800,19,1,20,Clouds
51384,31,1553860800,14,6,20,Clouds
51385,32,1553860800,3,27,30,Clouds
51386,33,1553860800,11,12,23,Clouds
51387,34,1553860800,22,8,30,Clouds
51388,35,1553860800,30,0,30,Clouds
51389,36,1553860800,2,38,40,Clouds
51390,37,1553860800,11,19,30,Clouds
51391,38,1553860800,37,3,40,Clouds
51392,39,1553860800,18,2,20,Clouds
51393,40,1553860800,17,4,21,Clouds
51394,41,1553860800,17,3,20,Clouds
51395,42,1553860800,30,0,30,Clouds
51396,43,1553860800,30,0,30,Clouds
51397,44,1553860800,30,0,30,Clouds
51398,45,1553860800,29,1,30,Clouds
51399,46,1553860800,19,1,20,Clouds
51400,47,1553860800,7,33,40,Clouds
51401,48,1553860800,1,39,40,Clouds
51402,49,1553860800,1,39,40,Clouds
51403,50,1553860800,40,0,40,Clouds
51404,51,1553860800,8,32,40,Clouds
51405,52,1553860800,1,31,32,Clouds
51406,53,1553860800,1,39,40,Clouds
51407,54,1553860800,18,15,33,Clouds
51408,55,1553860800,15,21,36,Clouds
51409,56,1553860800,14,26,40,Clouds
51410,57,1553860800,0,23,23,Clouds
51411,58,1553860800,17,23,40,Clouds
51412,59,1553860800,20,0,20,Clouds
51413,60,1553860800,30,0,30,Clouds
51414,61,1553860800,25,0,25,Clouds
51415,62,1553860800,12,28,40,Clouds
51416,63,1553860800,8,27,35,Clouds
51417,64,1553860800,1,39,40,Clouds
51418,65,1553860800,15,25,40,Clouds
51419,66,1553860800,2,38,40,Clouds
51420,67,1553860800,30,10,40,Clouds
51421,68,1553860800,2,38,40,Clouds
51422,69,1553860800,9,31,40,Clouds
51423,70,1553860800,4,23,27,Clouds
51424,71,1553860800,40,0,40,Clouds
51425,72,1553860800,31,0,31,Clouds
51426,73,1553860800,29,1,30,Clouds
51427,74,1553860800,29,1,30,Clouds
51428,75,1553860800,40,0,40,Clouds
51429,76,1553860800,38,0,38,Clouds
51430,77,1553860800,29,0,29,Clouds
51431,78,1553860800,40,0,40,Clouds
51432,79,1553860800,16,11,27,Clouds
51433,80,1553860800,38,2,40,Clouds
51434,81,1553860800,40,0,40,Clouds
51435,82,1553860800,22,0,22,Clouds
51436,83,1553860800,40,0,40,Clouds
51437,84,1553860800,29,1,30,Clouds
51438,85,1553860800,35,0,35,Clouds
51439,86,1553860800,35,3,38,Clouds
51440,87,1553860800,38,0,38,Clouds
51441,88,1553860800,30,0,30,Clouds
51442,89,1553860800,11,29,40,Clouds
51443,90,1553860800,11,29,40,Clouds
51444,91,1553860800,30,0,30,Clouds
51445,92,1553860800,40,0,40,Clouds
51446,93,1553860800,40,0,40,Clouds
51447,94,1553860800,40,0,40,Clouds
51448,95,1553860800,39,1,40,Clouds
51449,96,1553860800,30,0,30,Clouds
51450,97,1553860800,40,0,40,Clouds
51451,98,1553860800,21,19,40,Clouds
51452,99,1553860800,0,30,30,Clouds
51453,100,1553860800,25,0,25,Clouds
51454,101,1553860800,29,1,30,Clouds
51455,102,1553860800,40,0,40,Clouds
51456,103,1553860800,28,12,40,Clouds
51457,104,1553860800,34,6,40,Clouds
51458,105,1553860800,34,2,36,Clouds
51459,106,1553860800,40,0,40,Clouds
51460,107,1553860800,39,1,40,Clouds
51461,108,1553860800,40,0,40,Clouds
51462,109,1553860800,29,0,29,Clouds
51463,110,1553860800,39,1,40,Clouds
51464,111,1553860800,39,1,40,Clouds
51465,112,1553860800,30,0,30,Clouds
51466,113,1553860800,10,30,40,Clouds
51467,114,1553860800,14,26,40,Clouds
51468,115,1553860800,21,9,30,Clouds
51469,2,1553864400,20,0,20,Clouds
51470,3,1553864400,19,1,20,Clouds
51471,4,1553864400,19,1,20,Clouds
51472,5,1553864400,31,9,40,Clouds
51473,6,1553864400,17,3,20,Clouds
51474,7,1553864400,23,6,29,Clouds
51475,8,1553864400,1,29,30,Clouds
51476,9,1553864400,0,24,24,Clouds
51477,10,1553864400,2,14,16,Clouds
51478,11,1553864400,13,17,30,Clouds
51479,12,1553864400,20,0,20,Clouds
51480,13,1553864400,1,29,30,Clouds
51481,14,1553864400,1,29,30,Clouds
51482,15,1553864400,16,0,16,Clouds
51483,16,1553864400,16,4,20,Clouds
51484,17,1553864400,16,4,20,Clouds
51485,18,1553864400,30,0,30,Clouds
51486,19,1553864400,18,12,30,Clouds
51487,21,1553864400,0,30,30,Clouds
51488,22,1553864400,10,10,20,Clouds
51489,23,1553864400,15,15,30,Clouds
51490,24,1553864400,19,1,20,Clouds
51491,25,1553864400,10,20,30,Clouds
51492,26,1553864400,0,20,20,Clouds
51493,27,1553864400,3,17,20,Clouds
51494,28,1553864400,29,1,30,Clouds
51495,29,1553864400,24,5,29,Clouds
51496,30,1553864400,20,0,20,Clouds
51497,31,1553864400,15,5,20,Clouds
51498,32,1553864400,1,29,30,Clouds
51499,33,1553864400,19,4,23,Clouds
51500,34,1553864400,30,0,30,Clouds
51501,35,1553864400,30,0,30,Clouds
51502,36,1553864400,2,38,40,Clouds
51503,37,1553864400,10,20,30,Clouds
51504,38,1553864400,39,1,40,Clouds
51505,39,1553864400,20,0,20,Clouds
51506,40,1553864400,20,1,21,Clouds
51507,41,1553864400,17,3,20,Clouds
51508,42,1553864400,30,0,30,Clouds
51509,43,1553864400,28,2,30,Clouds
51510,44,1553864400,28,2,30,Clouds
51511,45,1553864400,30,0,30,Clouds
51512,46,1553864400,18,2,20,Clouds
51513,47,1553864400,7,33,40,Clouds
51514,48,1553864400,0,40,40,Clouds
51515,49,1553864400,0,40,40,Clouds
51516,50,1553864400,38,2,40,Clouds
51517,51,1553864400,8,32,40,Clouds
51518,52,1553864400,2,30,32,Clouds
51519,53,1553864400,2,38,40,Clouds
51520,54,1553864400,18,15,33,Clouds
51521,55,1553864400,13,23,36,Clouds
51522,56,1553864400,11,29,40,Clouds
51523,57,1553864400,0,23,23,Clouds
51524,58,1553864400,13,27,40,Clouds
51525,59,1553864400,20,0,20,Clouds
51526,60,1553864400,30,0,30,Clouds
51527,61,1553864400,25,0,25,Clouds
51528,62,1553864400,14,26,40,Clouds
51529,63,1553864400,7,28,35,Clouds
51530,64,1553864400,0,40,40,Clouds
51531,65,1553864400,11,29,40,Clouds
51532,66,1553864400,5,35,40,Clouds
51533,67,1553864400,29,11,40,Clouds
51534,68,1553864400,8,32,40,Clouds
51535,69,1553864400,9,31,40,Clouds
51536,70,1553864400,4,24,28,Clouds
51537,71,1553864400,36,3,39,Clouds
51538,72,1553864400,31,0,31,Clouds
51539,73,1553864400,28,2,30,Clouds
51540,74,1553864400,30,0,30,Clouds
51541,75,1553864400,40,0,40,Clouds
51542,76,1553864400,38,0,38,Clouds
51543,77,1553864400,28,1,29,Clouds
51544,78,1553864400,38,2,40,Clouds
51545,79,1553864400,20,7,27,Clouds
51546,80,1553864400,40,0,40,Clouds
51547,81,1553864400,40,0,40,Clouds
51548,82,1553864400,22,0,22,Clouds
51549,83,1553864400,40,0,40,Clouds
51550,84,1553864400,30,0,30,Clouds
51551,85,1553864400,35,0,35,Clouds
51552,86,1553864400,37,1,38,Clouds
51553,87,1553864400,38,0,38,Clouds
51554,88,1553864400,30,0,30,Clouds
51555,89,1553864400,10,30,40,Clouds
51556,90,1553864400,11,29,40,Clouds
51557,91,1553864400,28,2,30,Clouds
51558,92,1553864400,40,0,40,Clouds
51559,93,1553864400,40,0,40,Clouds
51560,94,1553864400,40,0,40,Clouds
51561,95,1553864400,40,0,40,Clouds
51562,96,1553864400,30,0,30,Clouds
51563,97,1553864400,40,0,40,Clouds
51564,98,1553864400,12,28,40,Clouds
51565,99,1553864400,2,28,30,Clouds
51566,100,1553864400,25,0,25,Clouds
51567,101,1553864400,30,0,30,Clouds
51568,102,1553864400,40,0,40,Clouds
51569,103,1553864400,31,9,40,Clouds
51570,104,1553864400,34,6,40,Clouds
51571,105,1553864400,36,0,36,Clouds
51572,106,1553864400,40,0,40,Clouds
51573,107,1553864400,40,0,40,Clouds
51574,108,1553864400,40,0,40,Clouds
51575,109,1553864400,29,0,29,Clouds
51576,110,1553864400,40,0,40,Clouds
51577,111,1553864400,39,1,40,Clouds
51578,112,1553864400,27,3,30,Clouds
51579,113,1553864400,4,36,40,Clouds
51580,114,1553864400,18,22,40,Clouds
51581,115,1553864400,21,9,30,Clouds
51582,2,1553868000,20,0,20,Clouds
51583,3,1553868000,16,4,20,Clouds
51584,4,1553868000,17,3,20,Clouds
51585,5,1553868000,37,3,40,Clouds
51586,6,1553868000,14,6,20,Clouds
51587,7,1553868000,29,0,29,Clouds
51588,8,1553868000,3,27,30,Clouds
51589,9,1553868000,0,24,24,Clouds
51590,10,1553868000,1,15,16,Clouds
51591,11,1553868000,21,9,30,Clouds
51592,12,1553868000,19,1,20,Clouds
51593,13,1553868000,7,23,30,Clouds
51594,14,1553868000,0,30,30,Clouds
51595,15,1553868000,16,0,16,Clouds
51596,16,1553868000,19,1,20,Clouds
51597,17,1553868000,19,1,20,Clouds
51598,18,1553868000,25,5,30,Clouds
51599,19,1553868000,19,11,30,Clouds
51600,21,1553868000,3,27,30,Clouds
51601,22,1553868000,10,10,20,Clouds
51602,23,1553868000,11,19,30,Clouds
51603,24,1553868000,18,2,20,Clouds
51604,25,1553868000,9,21,30,Clouds
51605,26,1553868000,2,18,20,Clouds
51606,27,1553868000,5,15,20,Clouds
51607,28,1553868000,29,1,30,Clouds
51608,29,1553868000,27,2,29,Clouds
51609,30,1553868000,20,0,20,Clouds
51610,31,1553868000,15,5,20,Clouds
51611,32,1553868000,0,30,30,Clouds
51612,33,1553868000,14,9,23,Clouds
51613,34,1553868000,30,0,30,Clouds
51614,35,1553868000,30,0,30,Clouds
51615,36,1553868000,7,33,40,Clouds
51616,37,1553868000,6,24,30,Clouds
51617,38,1553868000,26,14,40,Clouds
51618,39,1553868000,20,0,20,Clouds
51619,40,1553868000,14,7,21,Clouds
51620,41,1553868000,20,0,20,Clouds
51621,42,1553868000,30,0,30,Clouds
51622,43,1553868000,30,0,30,Clouds
51623,44,1553868000,30,0,30,Clouds
51624,45,1553868000,30,0,30,Clouds
51625,46,1553868000,15,5,20,Clouds
51626,47,1553868000,12,28,40,Clouds
51627,48,1553868000,2,38,40,Clouds
51628,49,1553868000,6,34,40,Clouds
51629,50,1553868000,38,2,40,Clouds
51630,51,1553868000,3,37,40,Clouds
51631,52,1553868000,20,12,32,Clouds
51632,53,1553868000,2,38,40,Clouds
51633,54,1553868000,19,14,33,Clouds
51634,55,1553868000,23,13,36,Clouds
51635,56,1553868000,25,15,40,Clouds
51636,57,1553868000,5,18,23,Clouds
51637,58,1553868000,26,14,40,Clouds
51638,59,1553868000,20,0,20,Clouds
51639,60,1553868000,26,4,30,Clouds
51640,61,1553868000,25,0,25,Clouds
51641,62,1553868000,16,24,40,Clouds
51642,63,1553868000,9,26,35,Clouds
51643,64,1553868000,6,34,40,Clouds
51644,65,1553868000,18,22,40,Clouds
51645,66,1553868000,9,31,40,Clouds
51646,67,1553868000,27,13,40,Clouds
51647,68,1553868000,5,35,40,Clouds
51648,69,1553868000,7,33,40,Clouds
51649,70,1553868000,7,21,28,Clouds
51650,71,1553868000,35,4,39,Clouds
51651,72,1553868000,31,0,31,Clouds
51652,73,1553868000,30,0,30,Clouds
51653,74,1553868000,30,0,30,Clouds
51654,75,1553868000,40,0,40,Clouds
51655,76,1553868000,37,1,38,Clouds
51656,77,1553868000,19,10,29,Clouds
51657,78,1553868000,39,1,40,Clouds
51658,79,1553868000,26,1,27,Clouds
51659,80,1553868000,40,0,40,Clouds
51660,81,1553868000,40,0,40,Clouds
51661,82,1553868000,22,0,22,Clouds
51662,83,1553868000,30,10,40,Clouds
51663,84,1553868000,30,0,30,Clouds
51664,85,1553868000,35,0,35,Clouds
51665,86,1553868000,36,2,38,Clouds
51666,87,1553868000,38,0,38,Clouds
51667,88,1553868000,30,0,30,Clouds
51668,89,1553868000,9,31,40,Clouds
51669,90,1553868000,23,17,40,Clouds
51670,91,1553868000,28,2,30,Clouds
51671,92,1553868000,38,2,40,Clouds
51672,93,1553868000,40,0,40,Clouds
51673,94,1553868000,40,0,40,Clouds
51674,95,1553868000,39,1,40,Clouds
51675,96,1553868000,30,0,30,Clouds
51676,97,1553868000,34,6,40,Clouds
51677,98,1553868000,5,35,40,Clouds
51678,99,1553868000,2,28,30,Clouds
51679,100,1553868000,19,6,25,Clouds
51680,101,1553868000,29,1,30,Clouds
51681,102,1553868000,40,0,40,Clouds
51682,103,1553868000,34,6,40,Clouds
51683,104,1553868000,38,2,40,Clouds
51684,105,1553868000,36,0,36,Clouds
51685,106,1553868000,40,0,40,Clouds
51686,107,1553868000,40,0,40,Clouds
51687,108,1553868000,40,0,40,Clouds
51688,109,1553868000,28,1,29,Clouds
51689,110,1553868000,39,1,40,Clouds
51690,111,1553868000,40,0,40,Clouds
51691,112,1553868000,28,2,30,Clouds
51692,113,1553868000,7,33,40,Clouds
51693,114,1553868000,25,15,40,Clouds
51694,115,1553868000,26,4,30,Clouds
51695,2,1553871600,20,0,20,Clouds
51696,3,1553871600,12,8,20,Clouds
51697,4,1553871600,19,1,20,Clouds
51698,5,1553871600,36,4,40,Clouds
51699,6,1553871600,17,3,20,Clouds
51700,7,1553871600,29,0,29,Clouds
51701,8,1553871600,6,24,30,Clouds
51702,9,1553871600,7,17,24,Clouds
51703,10,1553871600,6,10,16,Clouds
51704,11,1553871600,22,8,30,Clouds
51705,12,1553871600,18,2,20,Clouds
51706,13,1553871600,9,21,30,Clouds
51707,14,1553871600,0,30,30,Clouds
51708,15,1553871600,14,2,16,Clouds
51709,16,1553871600,20,0,20,Clouds
51710,17,1553871600,14,6,20,Clouds
51711,18,1553871600,28,2,30,Clouds
51712,19,1553871600,1,29,30,Clouds
51713,21,1553871600,6,24,30,Clouds
51714,22,1553871600,8,12,20,Clouds
51715,23,1553871600,8,22,30,Clouds
51716,24,1553871600,16,4,20,Clouds
51717,25,1553871600,17,13,30,Clouds
51718,26,1553871600,8,12,20,Clouds
51719,27,1553871600,9,11,20,Clouds
51720,28,1553871600,21,9,30,Clouds
51721,29,1553871600,28,1,29,Clouds
51722,30,1553871600,18,2,20,Clouds
51723,31,1553871600,16,4,20,Clouds
51724,32,1553871600,1,29,30,Clouds
51725,33,1553871600,3,20,23,Clouds
51726,34,1553871600,27,3,30,Clouds
51727,35,1553871600,29,1,30,Clouds
51728,36,1553871600,3,37,40,Clouds
51729,37,1553871600,1,29,30,Clouds
51730,38,1553871600,28,12,40,Clouds
51731,39,1553871600,17,3,20,Clouds
51732,40,1553871600,19,2,21,Clouds
51733,41,1553871600,17,3,20,Clouds
51734,42,1553871600,30,0,30,Clouds
51735,43,1553871600,28,2,30,Clouds
51736,44,1553871600,30,0,30,Clouds
51737,45,1553871600,28,2,30,Clouds
51738,46,1553871600,15,5,20,Clouds
51739,47,1553871600,9,31,40,Clouds
51740,48,1553871600,8,32,40,Clouds
51741,49,1553871600,0,40,40,Clouds
51742,50,1553871600,38,2,40,Clouds
51743,51,1553871600,1,39,40,Clouds
51744,52,1553871600,20,12,32,Clouds
51745,53,1553871600,4,36,40,Clouds
51746,54,1553871600,19,14,33,Clouds
51747,55,1553871600,19,17,36,Clouds
51748,56,1553871600,17,23,40,Clouds
51749,57,1553871600,2,21,23,Clouds
51750,58,1553871600,23,17,40,Clouds
51751,59,1553871600,17,3,20,Clouds
51752,60,1553871600,30,0,30,Clouds
51753,61,1553871600,25,0,25,Clouds
51754,62,1553871600,14,26,40,Clouds
51755,63,1553871600,6,29,35,Clouds
51756,64,1553871600,0,40,40,Clouds
51757,65,1553871600,12,28,40,Clouds
51758,66,1553871600,6,34,40,Clouds
51759,67,1553871600,28,12,40,Clouds
51760,68,1553871600,1,39,40,Clouds
51761,69,1553871600,7,33,40,Clouds
51762,70,1553871600,12,16,28,Clouds
51763,71,1553871600,33,6,39,Clouds
51764,72,1553871600,29,2,31,Clouds
51765,73,1553871600,28,2,30,Clouds
51766,74,1553871600,27,3,30,Clouds
51767,75,1553871600,40,0,40,Clouds
51768,76,1553871600,35,3,38,Clouds
51769,77,1553871600,16,13,29,Clouds
51770,78,1553871600,39,1,40,Clouds
51771,79,1553871600,25,2,27,Clouds
51772,80,1553871600,39,1,40,Clouds
51773,81,1553871600,40,0,40,Clouds
51774,82,1553871600,22,0,22,Clouds
51775,83,1553871600,34,6,40,Clouds
51776,84,1553871600,30,0,30,Clouds
51777,85,1553871600,35,0,35,Clouds
51778,86,1553871600,33,5,38,Clouds
51779,87,1553871600,37,1,38,Clouds
51780,88,1553871600,27,3,30,Clouds
51781,89,1553871600,7,33,40,Clouds
51782,90,1553871600,22,18,40,Clouds
51783,91,1553871600,22,8,30,Clouds
51784,92,1553871600,39,1,40,Clouds
51785,93,1553871600,40,0,40,Clouds
51786,94,1553871600,37,3,40,Clouds
51787,95,1553871600,40,0,40,Clouds
51788,96,1553871600,30,0,30,Clouds
51789,97,1553871600,31,9,40,Clouds
51790,98,1553871600,5,35,40,Clouds
51791,99,1553871600,7,23,30,Clouds
51792,100,1553871600,20,5,25,Clouds
51793,101,1553871600,29,1,30,Clouds
51794,102,1553871600,30,10,40,Clouds
51795,103,1553871600,37,3,40,Clouds
51796,104,1553871600,39,1,40,Clouds
51797,105,1553871600,36,0,36,Clouds
51798,106,1553871600,40,0,40,Clouds
51799,107,1553871600,39,1,40,Clouds
51800,108,1553871600,39,1,40,Clouds
51801,109,1553871600,25,4,29,Clouds
51802,110,1553871600,38,2,40,Clouds
51803,111,1553871600,40,0,40,Clouds
51804,112,1553871600,27,3,30,Clouds
51805,113,1553871600,10,30,40,Clouds
51806,114,1553871600,29,11,40,Clouds
51807,115,1553871600,27,3,30,Clouds
51808,2,1553875200,18,2,20,Clouds
51809,3,1553875200,18,2,20,Clouds
51810,4,1553875200,17,3,20,Clouds
51811,5,1553875200,26,14,40,Clouds
51812,6,1553875200,16,4,20,Clouds
51813,7,1553875200,29,0,29,Clouds
51814,8,1553875200,2,28,30,Clouds
51815,9,1553875200,9,15,24,Clouds
51816,10,1553875200,8,8,16,Clouds
51817,11,1553875200,22,8,30,Clouds
51818,12,1553875200,20,0,20,Clouds
51819,13,1553875200,8,22,30,Clouds
51820,14,1553875200,3,27,30,Clouds
51821,15,1553875200,16,0,16,Clouds
51822,16,1553875200,20,0,20,Clouds
51823,17,1553875200,10,10,20,Clouds
51824,18,1553875200,27,3,30,Clouds
51825,19,1553875200,4,26,30,Clouds
51826,21,1553875200,5,25,30,Clouds
51827,22,1553875200,6,14,20,Clouds
51828,23,1553875200,2,28,30,Clouds
51829,24,1553875200,13,7,20,Clouds
51830,25,1553875200,19,11,30,Clouds
51831,26,1553875200,9,11,20,Clouds
51832,27,1553875200,15,5,20,Clouds
51833,28,1553875200,16,14,30,Clouds
51834,29,1553875200,25,4,29,Clouds
51835,30,1553875200,19,1,20,Clouds
51836,31,1553875200,20,0,20,Clouds
51837,32,1553875200,16,14,30,Clouds
51838,33,1553875200,3,20,23,Clouds
51839,34,1553875200,27,3,30,Clouds
51840,35,1553875200,22,8,30,Clouds
51841,36,1553875200,4,36,40,Clouds
51842,37,1553875200,3,27,30,Clouds
51843,38,1553875200,28,12,40,Clouds
51844,39,1553875200,16,4,20,Clouds
51845,40,1553875200,19,2,21,Clouds
51846,41,1553875200,14,6,20,Clouds
51847,42,1553875200,27,3,30,Clouds
51848,43,1553875200,27,3,30,Clouds
51849,44,1553875200,30,0,30,Clouds
51850,45,1553875200,28,2,30,Clouds
51851,46,1553875200,19,1,20,Clouds
51852,47,1553875200,12,28,40,Clouds
51853,48,1553875200,9,31,40,Clouds
51854,49,1553875200,2,38,40,Clouds
51855,50,1553875200,33,7,40,Clouds
51856,51,1553875200,10,30,40,Clouds
51857,52,1553875200,20,12,32,Clouds
51858,53,1553875200,1,39,40,Clouds
51859,54,1553875200,24,9,33,Clouds
51860,55,1553875200,23,13,36,Clouds
51861,56,1553875200,9,31,40,Clouds
51862,57,1553875200,1,22,23,Clouds
51863,58,1553875200,22,18,40,Clouds
51864,59,1553875200,17,3,20,Clouds
51865,60,1553875200,28,2,30,Clouds
51866,61,1553875200,25,0,25,Clouds
51867,62,1553875200,18,22,40,Clouds
51868,63,1553875200,5,30,35,Clouds
51869,64,1553875200,2,38,40,Clouds
51870,65,1553875200,7,33,40,Clouds
51871,66,1553875200,9,31,40,Clouds
51872,67,1553875200,23,17,40,Clouds
51873,68,1553875200,4,36,40,Clouds
51874,69,1553875200,9,31,40,Clouds
51875,70,1553875200,10,18,28,Clouds
51876,71,1553875200,35,4,39,Clouds
51877,72,1553875200,31,0,31,Clouds
51878,73,1553875200,27,3,30,Clouds
51879,74,1553875200,30,0,30,Clouds
51880,75,1553875200,40,0,40,Clouds
51881,76,1553875200,38,0,38,Clouds
51882,77,1553875200,20,9,29,Clouds
51883,78,1553875200,40,0,40,Clouds
51884,79,1553875200,27,0,27,Clouds
51885,80,1553875200,40,0,40,Clouds
51886,81,1553875200,40,0,40,Clouds
51887,82,1553875200,22,0,22,Clouds
51888,83,1553875200,38,2,40,Clouds
51889,84,1553875200,28,2,30,Clouds
51890,85,1553875200,35,0,35,Clouds
51891,86,1553875200,37,1,38,Clouds
51892,87,1553875200,36,2,38,Clouds
51893,88,1553875200,24,6,30,Clouds
51894,89,1553875200,7,33,40,Clouds
51895,90,1553875200,24,16,40,Clouds
51896,91,1553875200,17,13,30,Clouds
51897,92,1553875200,37,3,40,Clouds
51898,93,1553875200,40,0,40,Clouds
51899,94,1553875200,36,4,40,Clouds
51900,95,1553875200,38,2,40,Clouds
51901,96,1553875200,30,0,30,Clouds
51902,97,1553875200,36,4,40,Clouds
51903,98,1553875200,13,27,40,Clouds
51904,99,1553875200,4,26,30,Clouds
51905,100,1553875200,8,17,25,Clouds
51906,101,1553875200,27,3,30,Clouds
51907,102,1553875200,31,9,40,Clouds
51908,103,1553875200,39,1,40,Clouds
51909,104,1553875200,39,1,40,Clouds
51910,105,1553875200,36,0,36,Clouds
51911,106,1553875200,39,1,40,Clouds
51912,107,1553875200,38,2,40,Clouds
51913,108,1553875200,40,0,40,Clouds
51914,109,1553875200,25,4,29,Clouds
51915,110,1553875200,36,4,40,Clouds
51916,111,1553875200,31,9,40,Clouds
51917,112,1553875200,22,8,30,Clouds
51918,113,1553875200,11,29,40,Clouds
51919,114,1553875200,12,28,40,Clouds
51920,115,1553875200,29,1,30,Clouds
51921,2,1553878800,20,0,20,Clouds
51922,3,1553878800,16,4,20,Clouds
51923,4,1553878800,18,2,20,Clouds
51924,5,1553878800,36,4,40,Clouds
51925,6,1553878800,20,0,20,Clouds
51926,7,1553878800,27,2,29,Clouds
51927,8,1553878800,5,25,30,Clouds
51928,9,1553878800,4,20,24,Clouds
51929,10,1553878800,2,14,16,Clouds
51930,11,1553878800,30,0,30,Clouds
51931,12,1553878800,20,0,20,Clouds
51932,13,1553878800,10,20,30,Clouds
51933,14,1553878800,0,30,30,Clouds
51934,15,1553878800,15,1,16,Clouds
51935,16,1553878800,13,7,20,Clouds
51936,17,1553878800,15,5,20,Clouds
51937,18,1553878800,25,5,30,Clouds
51938,19,1553878800,17,13,30,Clouds
51939,21,1553878800,3,27,30,Clouds
51940,22,1553878800,8,12,20,Clouds
51941,23,1553878800,0,30,30,Clouds
51942,24,1553878800,8,12,20,Clouds
51943,25,1553878800,18,12,30,Clouds
51944,26,1553878800,9,11,20,Clouds
51945,27,1553878800,20,0,20,Clouds
51946,28,1553878800,16,14,30,Clouds
51947,29,1553878800,27,2,29,Clouds
51948,30,1553878800,20,0,20,Clouds
51949,31,1553878800,16,4,20,Clouds
51950,32,1553878800,17,13,30,Clouds
51951,33,1553878800,7,16,23,Clouds
51952,34,1553878800,17,13,30,Clouds
51953,35,1553878800,25,5,30,Clouds
51954,36,1553878800,6,34,40,Clouds
51955,37,1553878800,4,26,30,Clouds
51956,38,1553878800,20,20,40,Clouds
51957,39,1553878800,15,5,20,Clouds
51958,40,1553878800,15,6,21,Clouds
51959,41,1553878800,15,5,20,Clouds
51960,42,1553878800,28,2,30,Clouds
51961,43,1553878800,24,6,30,Clouds
51962,44,1553878800,26,4,30,Clouds
51963,45,1553878800,29,1,30,Clouds
51964,46,1553878800,14,6,20,Clouds
51965,47,1553878800,18,22,40,Clouds
51966,48,1553878800,4,36,40,Clouds
51967,49,1553878800,5,35,40,Clouds
51968,50,1553878800,38,2,40,Clouds
51969,51,1553878800,18,22,40,Clouds
51970,52,1553878800,22,10,32,Clouds
51971,53,1553878800,4,36,40,Clouds
51972,54,1553878800,28,5,33,Clouds
51973,55,1553878800,27,9,36,Clouds
51974,56,1553878800,15,25,40,Clouds
51975,57,1553878800,5,18,23,Clouds
51976,58,1553878800,38,2,40,Clouds
51977,59,1553878800,19,1,20,Clouds
51978,60,1553878800,22,8,30,Clouds
51979,61,1553878800,24,1,25,Clouds
51980,62,1553878800,24,16,40,Clouds
51981,63,1553878800,2,33,35,Clouds
51982,64,1553878800,7,33,40,Clouds
51983,65,1553878800,4,36,40,Clouds
51984,66,1553878800,15,25,40,Clouds
51985,67,1553878800,22,18,40,Clouds
51986,68,1553878800,5,35,40,Clouds
51987,69,1553878800,18,22,40,Clouds
51988,70,1553878800,8,20,28,Clouds
51989,71,1553878800,38,1,39,Clouds
51990,72,1553878800,21,10,31,Clouds
51991,73,1553878800,29,1,30,Clouds
51992,74,1553878800,26,4,30,Clouds
51993,75,1553878800,38,2,40,Clouds
51994,76,1553878800,35,3,38,Clouds
51995,77,1553878800,21,8,29,Clouds
51996,78,1553878800,38,2,40,Clouds
51997,79,1553878800,27,0,27,Clouds
51998,80,1553878800,30,10,40,Clouds
51999,81,1553878800,39,1,40,Clouds
52000,82,1553878800,22,0,22,Clouds
52001,83,1553878800,40,0,40,Clouds
52002,84,1553878800,28,2,30,Clouds
52003,85,1553878800,35,0,35,Clouds
52004,86,1553878800,30,8,38,Clouds
52005,87,1553878800,36,2,38,Clouds
52006,88,1553878800,24,6,30,Clouds
52007,89,1553878800,6,34,40,Clouds
52008,90,1553878800,32,8,40,Clouds
52009,91,1553878800,17,13,30,Clouds
52010,92,1553878800,38,2,40,Clouds
52011,93,1553878800,40,0,40,Clouds
52012,94,1553878800,36,4,40,Clouds
52013,95,1553878800,36,4,40,Clouds
52014,96,1553878800,30,0,30,Clouds
52015,97,1553878800,34,6,40,Clouds
52016,98,1553878800,11,29,40,Clouds
52017,99,1553878800,4,26,30,Clouds
52018,100,1553878800,7,18,25,Clouds
52019,101,1553878800,28,2,30,Clouds
52020,102,1553878800,35,5,40,Clouds
52021,103,1553878800,39,1,40,Clouds
52022,104,1553878800,39,1,40,Clouds
52023,105,1553878800,35,1,36,Clouds
52024,106,1553878800,40,0,40,Clouds
52025,107,1553878800,40,0,40,Clouds
52026,108,1553878800,38,2,40,Clouds
52027,109,1553878800,24,5,29,Clouds
52028,110,1553878800,40,0,40,Clouds
52029,111,1553878800,34,6,40,Clouds
52030,112,1553878800,24,6,30,Clouds
52031,113,1553878800,14,26,40,Clouds
52032,114,1553878800,21,19,40,Clouds
52033,115,1553878800,28,2,30,Clouds
52034,2,1553882400,16,4,20,Clouds
52035,3,1553882400,18,2,20,Clouds
52036,4,1553882400,20,0,20,Clouds
52037,5,1553882400,22,18,40,Clouds
52038,6,1553882400,17,3,20,Clouds
52039,7,1553882400,27,2,29,Clouds
52040,8,1553882400,0,29,29,Clouds
52041,9,1553882400,4,20,24,Clouds
52042,10,1553882400,10,6,16,Clouds
52043,11,1553882400,30,0,30,Clouds
52044,12,1553882400,16,4,20,Clouds
52045,13,1553882400,13,17,30,Clouds
52046,14,1553882400,0,30,30,Clouds
52047,15,1553882400,16,0,16,Clouds
52048,16,1553882400,5,15,20,Clouds
52049,17,1553882400,16,4,20,Clouds
52050,18,1553882400,24,6,30,Clouds
52051,19,1553882400,30,0,30,Clouds
52052,21,1553882400,1,29,30,Clouds
52053,22,1553882400,1,19,20,Clouds
52054,23,1553882400,0,30,30,Clouds
52055,24,1553882400,6,14,20,Clouds
52056,25,1553882400,28,2,30,Clouds
52057,26,1553882400,15,5,20,Clouds
52058,27,1553882400,17,3,20,Clouds
52059,28,1553882400,18,12,30,Clouds
52060,29,1553882400,27,2,29,Clouds
52061,30,1553882400,20,0,20,Clouds
52062,31,1553882400,20,0,20,Clouds
52063,32,1553882400,0,30,30,Clouds
52064,33,1553882400,2,21,23,Clouds
52065,34,1553882400,16,14,30,Clouds
52066,35,1553882400,24,6,30,Clouds
52067,36,1553882400,24,16,40,Clouds
52068,37,1553882400,13,17,30,Clouds
52069,38,1553882400,10,30,40,Clouds
52070,39,1553882400,20,0,20,Clouds
52071,40,1553882400,20,1,21,Clouds
52072,41,1553882400,20,0,20,Clouds
52073,42,1553882400,27,3,30,Clouds
52074,43,1553882400,26,4,30,Clouds
52075,44,1553882400,25,5,30,Clouds
52076,45,1553882400,23,7,30,Clouds
52077,46,1553882400,11,9,20,Clouds
52078,47,1553882400,30,10,40,Clouds
52079,48,1553882400,0,40,40,Clouds
52080,49,1553882400,5,35,40,Clouds
52081,50,1553882400,32,8,40,Clouds
52082,51,1553882400,21,19,40,Clouds
52083,52,1553882400,21,11,32,Clouds
52084,53,1553882400,16,24,40,Clouds
52085,54,1553882400,33,0,33,Clouds
52086,55,1553882400,36,0,36,Clouds
52087,56,1553882400,32,8,40,Clouds
52088,57,1553882400,16,7,23,Clouds
52089,58,1553882400,40,0,40,Clouds
52090,59,1553882400,20,0,20,Clouds
52091,60,1553882400,20,10,30,Clouds
52092,61,1553882400,25,0,25,Clouds
52093,62,1553882400,40,0,40,Clouds
52094,63,1553882400,7,28,35,Clouds
52095,64,1553882400,2,38,40,Clouds
52096,65,1553882400,15,25,40,Clouds
52097,66,1553882400,39,1,40,Clouds
52098,67,1553882400,20,20,40,Clouds
52099,68,1553882400,17,23,40,Clouds
52100,69,1553882400,22,18,40,Clouds
52101,70,1553882400,15,13,28,Clouds
52102,71,1553882400,37,2,39,Clouds
52103,72,1553882400,27,4,31,Clouds
52104,73,1553882400,29,1,30,Clouds
52105,74,1553882400,7,23,30,Clouds
52106,75,1553882400,32,8,40,Clouds
52107,76,1553882400,35,3,38,Clouds
52108,77,1553882400,25,4,29,Clouds
52109,78,1553882400,37,3,40,Clouds
52110,79,1553882400,26,1,27,Clouds
52111,80,1553882400,31,9,40,Clouds
52112,81,1553882400,40,0,40,Clouds
52113,82,1553882400,21,1,22,Clouds
52114,83,1553882400,26,14,40,Clouds
52115,84,1553882400,25,5,30,Clouds
52116,85,1553882400,29,6,35,Clouds
52117,86,1553882400,29,9,38,Clouds
52118,87,1553882400,38,0,38,Clouds
52119,88,1553882400,26,4,30,Clouds
52120,89,1553882400,15,25,40,Clouds
52121,90,1553882400,40,0,40,Clouds
52122,91,1553882400,20,10,30,Clouds
52123,92,1553882400,26,14,40,Clouds
52124,93,1553882400,7,33,40,Clouds
52125,94,1553882400,35,5,40,Clouds
52126,95,1553882400,31,9,40,Clouds
52127,96,1553882400,28,2,30,Clouds
52128,97,1553882400,36,4,40,Clouds
52129,98,1553882400,20,20,40,Clouds
52130,99,1553882400,5,25,30,Clouds
52131,100,1553882400,0,25,25,Clouds
52132,101,1553882400,30,0,30,Clouds
52133,102,1553882400,38,2,40,Clouds
52134,103,1553882400,38,2,40,Clouds
52135,104,1553882400,39,1,40,Clouds
52136,105,1553882400,36,0,36,Clouds
52137,106,1553882400,40,0,40,Clouds
52138,107,1553882400,39,1,40,Clouds
52139,108,1553882400,35,5,40,Clouds
52140,109,1553882400,21,8,29,Clouds
52141,110,1553882400,40,0,40,Clouds
52142,111,1553882400,40,0,40,Clouds
52143,112,1553882400,19,11,30,Clouds
52144,113,1553882400,18,22,40,Clouds
52145,114,1553882400,40,0,40,Clouds
52146,115,1553882400,23,7,30,Clouds
52147,2,1553886000,16,4,20,Clouds
52148,3,1553886000,20,0,20,Clouds
52149,4,1553886000,17,3,20,Clouds
52150,5,1553886000,18,22,40,Clouds
52151,6,1553886000,19,1,20,Clouds
52152,7,1553886000,27,2,29,Clouds
52153,8,1553886000,28,1,29,Clouds
52154,9,1553886000,8,16,24,Clouds
52155,10,1553886000,9,7,16,Clouds
52156,11,1553886000,30,0,30,Clouds
52157,12,1553886000,15,5,20,Clouds
52158,13,1553886000,24,6,30,Clouds
52159,14,1553886000,0,30,30,Clouds
52160,15,1553886000,15,1,16,Clouds
52161,16,1553886000,2,18,20,Clouds
52162,17,1553886000,19,1,20,Clouds
52163,18,1553886000,15,15,30,Clouds
52164,19,1553886000,29,1,30,Clouds
52165,21,1553886000,2,28,30,Clouds
52166,22,1553886000,0,20,20,Clouds
52167,23,1553886000,0,30,30,Clouds
52168,24,1553886000,16,4,20,Clouds
52169,25,1553886000,29,1,30,Clouds
52170,26,1553886000,4,16,20,Clouds
52171,27,1553886000,10,10,20,Clouds
52172,28,1553886000,26,4,30,Clouds
52173,29,1553886000,24,5,29,Clouds
52174,30,1553886000,20,0,20,Clouds
52175,31,1553886000,16,4,20,Clouds
52176,32,1553886000,0,30,30,Clouds
52177,33,1553886000,1,22,23,Clouds
52178,34,1553886000,0,30,30,Clouds
52179,35,1553886000,28,2,30,Clouds
52180,36,1553886000,31,9,40,Clouds
52181,37,1553886000,30,0,30,Clouds
52182,38,1553886000,8,32,40,Clouds
52183,39,1553886000,20,0,20,Clouds
52184,40,1553886000,18,3,21,Clouds
52185,41,1553886000,16,4,20,Clouds
52186,42,1553886000,20,10,30,Clouds
52187,43,1553886000,19,11,30,Clouds
52188,44,1553886000,20,10,30,Clouds
52189,45,1553886000,21,9,30,Clouds
52190,46,1553886000,9,11,20,Clouds
52191,47,1553886000,40,0,40,Clouds
52192,48,1553886000,6,34,40,Clouds
52193,49,1553886000,9,31,40,Clouds
52194,50,1553886000,23,17,40,Clouds
52195,51,1553886000,17,23,40,Clouds
52196,52,1553886000,19,13,32,Clouds
52197,53,1553886000,24,16,40,Clouds
52198,54,1553886000,32,1,33,Clouds
52199,55,1553886000,35,1,36,Clouds
52200,56,1553886000,31,9,40,Clouds
52201,57,1553886000,22,1,23,Clouds
52202,58,1553886000,34,6,40,Clouds
52203,59,1553886000,19,1,20,Clouds
52204,60,1553886000,9,21,30,Clouds
52205,61,1553886000,25,0,25,Clouds
52206,62,1553886000,40,0,40,Clouds
52207,63,1553886000,16,19,35,Clouds
52208,64,1553886000,5,35,40,Clouds
52209,65,1553886000,39,1,40,Clouds
52210,66,1553886000,38,2,40,Clouds
52211,67,1553886000,8,32,40,Clouds
52212,68,1553886000,40,0,40,Clouds
52213,69,1553886000,40,0,40,Clouds
52214,70,1553886000,27,1,28,Clouds
52215,71,1553886000,35,4,39,Clouds
52216,72,1553886000,30,1,31,Clouds
52217,73,1553886000,29,1,30,Clouds
52218,74,1553886000,9,21,30,Clouds
52219,75,1553886000,26,14,40,Clouds
52220,76,1553886000,32,6,38,Clouds
52221,77,1553886000,27,2,29,Clouds
52222,78,1553886000,30,10,40,Clouds
52223,79,1553886000,27,0,27,Clouds
52224,80,1553886000,28,12,40,Clouds
52225,81,1553886000,33,7,40,Clouds
52226,82,1553886000,18,4,22,Clouds
52227,83,1553886000,19,21,40,Clouds
52228,84,1553886000,20,10,30,Clouds
52229,85,1553886000,29,6,35,Clouds
52230,86,1553886000,2,36,38,Clouds
52231,87,1553886000,33,5,38,Clouds
52232,88,1553886000,26,4,30,Clouds
52233,89,1553886000,33,7,40,Clouds
52234,90,1553886000,40,0,40,Clouds
52235,91,1553886000,15,15,30,Clouds
52236,92,1553886000,0,40,40,Clouds
52237,93,1553886000,11,29,40,Clouds
52238,94,1553886000,17,23,40,Clouds
52239,95,1553886000,27,13,40,Clouds
52240,96,1553886000,22,8,30,Clouds
52241,97,1553886000,33,7,40,Clouds
52242,98,1553886000,25,15,40,Clouds
52243,99,1553886000,20,10,30,Clouds
52244,100,1553886000,0,25,25,Clouds
52245,101,1553886000,26,4,30,Clouds
52246,102,1553886000,38,2,40,Clouds
52247,103,1553886000,40,0,40,Clouds
52248,104,1553886000,40,0,40,Clouds
52249,105,1553886000,36,0,36,Clouds
52250,106,1553886000,35,5,40,Clouds
52251,107,1553886000,38,2,40,Clouds
52252,108,1553886000,34,6,40,Clouds
52253,109,1553886000,23,6,29,Clouds
52254,110,1553886000,39,1,40,Clouds
52255,111,1553886000,38,2,40,Clouds
52256,112,1553886000,14,16,30,Clouds
52257,113,1553886000,38,2,40,Clouds
52258,114,1553886000,40,0,40,Clouds
52259,115,1553886000,14,16,30,Clouds
52260,2,1553889600,15,5,20,Clouds
52261,3,1553889600,19,1,20,Clouds
52262,4,1553889600,16,4,20,Clouds
52263,5,1553889600,10,30,40,Clouds
52264,6,1553889600,16,4,20,Clouds
52265,7,1553889600,10,19,29,Clouds
52266,8,1553889600,30,0,30,Clouds
52267,9,1553889600,3,21,24,Clouds
52268,10,1553889600,2,14,16,Clouds
52269,11,1553889600,30,0,30,Clouds
52270,12,1553889600,11,9,20,Clouds
52271,13,1553889600,28,2,30,Clouds
52272,14,1553889600,1,29,30,Clouds
52273,15,1553889600,14,2,16,Clouds
52274,16,1553889600,10,10,20,Clouds
52275,17,1553889600,14,6,20,Clouds
52276,18,1553889600,15,15,30,Clouds
52277,19,1553889600,30,0,30,Clouds
52278,21,1553889600,5,25,30,Clouds
52279,22,1553889600,1,19,20,Clouds
52280,23,1553889600,2,28,30,Clouds
52281,24,1553889600,11,9,20,Clouds
52282,25,1553889600,30,0,30,Clouds
52283,26,1553889600,4,16,20,Clouds
52284,27,1553889600,17,3,20,Clouds
52285,28,1553889600,27,3,30,Clouds
52286,29,1553889600,25,4,29,Clouds
52287,30,1553889600,15,5,20,Clouds
52288,31,1553889600,14,6,20,Clouds
52289,32,1553889600,9,21,30,Clouds
52290,33,1553889600,6,17,23,Clouds
52291,34,1553889600,0,30,30,Clouds
52292,35,1553889600,22,8,30,Clouds
52293,36,1553889600,32,8,40,Clouds
52294,37,1553889600,30,0,30,Clouds
52295,38,1553889600,6,34,40,Clouds
52296,39,1553889600,18,2,20,Clouds
52297,40,1553889600,17,4,21,Clouds
52298,41,1553889600,20,0,20,Clouds
52299,42,1553889600,17,13,30,Clouds
52300,43,1553889600,3,27,30,Clouds
52301,44,1553889600,19,11,30,Clouds
52302,45,1553889600,19,11,30,Clouds
52303,46,1553889600,7,13,20,Clouds
52304,47,1553889600,40,0,40,Clouds
52305,48,1553889600,10,30,40,Clouds
52306,49,1553889600,18,22,40,Clouds
52307,50,1553889600,29,11,40,Clouds
52308,51,1553889600,16,24,40,Clouds
52309,52,1553889600,28,4,32,Clouds
52310,53,1553889600,35,5,40,Clouds
52311,54,1553889600,33,0,33,Clouds
52312,55,1553889600,36,0,36,Clouds
52313,56,1553889600,40,0,40,Clouds
52314,57,1553889600,23,0,23,Clouds
52315,58,1553889600,40,0,40,Clouds
52316,59,1553889600,16,4,20,Clouds
52317,60,1553889600,5,25,30,Clouds
52318,61,1553889600,25,0,25,Clouds
52319,62,1553889600,40,0,40,Clouds
52320,63,1553889600,15,20,35,Clouds
52321,64,1553889600,3,37,40,Clouds
52322,65,1553889600,40,0,40,Clouds
52323,66,1553889600,37,3,40,Clouds
52324,67,1553889600,10,30,40,Clouds
52325,68,1553889600,40,0,40,Clouds
52326,69,1553889600,40,0,40,Clouds
52327,70,1553889600,21,7,28,Clouds
52328,71,1553889600,36,3,39,Clouds
52329,72,1553889600,6,25,31,Clouds
52330,73,1553889600,27,3,30,Clouds
52331,74,1553889600,4,26,30,Clouds
52332,75,1553889600,25,15,40,Clouds
52333,76,1553889600,36,2,38,Clouds
52334,77,1553889600,28,1,29,Clouds
52335,78,1553889600,19,21,40,Clouds
52336,79,1553889600,26,1,27,Clouds
52337,80,1553889600,28,12,40,Clouds
52338,81,1553889600,32,8,40,Clouds
52339,82,1553889600,20,2,22,Clouds
52340,83,1553889600,18,22,40,Clouds
52341,84,1553889600,17,13,30,Clouds
52342,85,1553889600,22,13,35,Clouds
52343,86,1553889600,7,31,38,Clouds
52344,87,1553889600,25,13,38,Clouds
52345,88,1553889600,20,10,30,Clouds
52346,89,1553889600,38,2,40,Clouds
52347,90,1553889600,39,1,40,Clouds
52348,91,1553889600,7,23,30,Clouds
52349,92,1553889600,3,37,40,Clouds
52350,93,1553889600,0,40,40,Clouds
52351,94,1553889600,13,27,40,Clouds
52352,95,1553889600,30,10,40,Clouds
52353,96,1553889600,18,12,30,Clouds
52354,97,1553889600,31,9,40,Clouds
52355,98,1553889600,25,15,40,Clouds
52356,99,1553889600,29,1,30,Clouds
52357,100,1553889600,0,25,25,Clouds
52358,101,1553889600,19,11,30,Clouds
52359,102,1553889600,31,9,40,Clouds
52360,103,1553889600,38,2,40,Clouds
52361,104,1553889600,40,0,40,Clouds
52362,105,1553889600,34,2,36,Clouds
52363,106,1553889600,35,5,40,Clouds
52364,107,1553889600,40,0,40,Clouds
52365,108,1553889600,26,14,40,Clouds
52366,109,1553889600,23,6,29,Clouds
52367,110,1553889600,28,12,40,Clouds
52368,111,1553889600,38,2,40,Clouds
52369,112,1553889600,15,15,30,Clouds
52370,113,1553889600,40,0,40,Clouds
52371,114,1553889600,40,0,40,Clouds
52372,115,1553889600,15,15,30,Clouds
52373,2,1553896800,9,11,20,Clouds
52374,3,1553896800,18,2,20,Clouds
52375,4,1553896800,19,1,20,Clouds
52376,5,1553896800,8,32,40,Clouds
52377,6,1553896800,14,6,20,Clouds
52378,7,1553896800,12,17,29,Clouds
52379,8,1553896800,27,3,30,Clouds
52380,9,1553896800,8,16,24,Clouds
52381,10,1553896800,1,15,16,Clouds
52382,11,1553896800,30,0,30,Clouds
52383,12,1553896800,10,10,20,Clouds
52384,13,1553896800,30,0,30,Clouds
52385,14,1553896800,0,30,30,Clouds
52386,15,1553896800,16,0,16,Clouds
52387,16,1553896800,13,7,20,Clouds
52388,17,1553896800,20,0,20,Clouds
52389,18,1553896800,9,21,30,Clouds
52390,19,1553896800,25,5,30,Clouds
52391,21,1553896800,13,17,30,Clouds
52392,22,1553896800,4,16,20,Clouds
52393,23,1553896800,16,14,30,Clouds
52394,24,1553896800,11,9,20,Clouds
52395,25,1553896800,28,2,30,Clouds
52396,26,1553896800,13,7,20,Clouds
52397,27,1553896800,20,0,20,Clouds
52398,28,1553896800,28,2,30,Clouds
52399,29,1553896800,15,14,29,Clouds
52400,30,1553896800,18,2,20,Clouds
52401,31,1553896800,15,5,20,Clouds
52402,32,1553896800,21,9,30,Clouds
52403,33,1553896800,8,15,23,Clouds
52404,34,1553896800,5,25,30,Clouds
52405,35,1553896800,15,15,30,Clouds
52406,36,1553896800,32,8,40,Clouds
52407,37,1553896800,29,1,30,Clouds
52408,38,1553896800,8,32,40,Clouds
52409,39,1553896800,18,2,20,Clouds
52410,40,1553896800,20,1,21,Clouds
52411,41,1553896800,20,0,20,Clouds
52412,42,1553896800,16,14,30,Clouds
52413,43,1553896800,3,27,30,Clouds
52414,44,1553896800,6,24,30,Clouds
52415,45,1553896800,17,13,30,Clouds
52416,46,1553896800,5,15,20,Clouds
52417,47,1553896800,40,0,40,Clouds
52418,48,1553896800,25,15,40,Clouds
52419,49,1553896800,38,2,40,Clouds
52420,50,1553896800,25,15,40,Clouds
52421,51,1553896800,18,22,40,Clouds
52422,52,1553896800,22,10,32,Clouds
52423,53,1553896800,38,2,40,Clouds
52424,54,1553896800,33,0,33,Clouds
52425,55,1553896800,36,0,36,Clouds
52426,56,1553896800,36,4,40,Clouds
52427,57,1553896800,17,6,23,Clouds
52428,58,1553896800,37,3,40,Clouds
52429,59,1553896800,19,1,20,Clouds
52430,60,1553896800,1,29,30,Clouds
52431,61,1553896800,23,2,25,Clouds
52432,62,1553896800,38,2,40,Clouds
52433,63,1553896800,13,22,35,Clouds
52434,64,1553896800,5,35,40,Clouds
52435,65,1553896800,40,0,40,Clouds
52436,66,1553896800,36,4,40,Clouds
52437,67,1553896800,11,29,40,Clouds
52438,68,1553896800,38,2,40,Clouds
52439,69,1553896800,32,8,40,Clouds
52440,70,1553896800,24,4,28,Clouds
52441,71,1553896800,35,4,39,Clouds
52442,72,1553896800,3,28,31,Clouds
52443,73,1553896800,25,5,30,Clouds
52444,74,1553896800,0,30,30,Clouds
52445,75,1553896800,19,21,40,Clouds
52446,76,1553896800,36,2,38,Clouds
52447,77,1553896800,26,3,29,Clouds
52448,78,1553896800,14,26,40,Clouds
52449,79,1553896800,27,0,27,Clouds
52450,80,1553896800,27,13,40,Clouds
52451,81,1553896800,34,6,40,Clouds
52452,82,1553896800,13,9,22,Clouds
52453,83,1553896800,6,34,40,Clouds
52454,84,1553896800,11,19,30,Clouds
52455,85,1553896800,21,14,35,Clouds
52456,86,1553896800,0,38,38,Clouds
52457,87,1553896800,15,23,38,Clouds
52458,88,1553896800,13,17,30,Clouds
52459,89,1553896800,40,0,40,Clouds
52460,90,1553896800,40,0,40,Clouds
52461,91,1553896800,8,22,30,Clouds
52462,92,1553896800,0,40,40,Clouds
52463,93,1553896800,0,40,40,Clouds
52464,94,1553896800,8,32,40,Clouds
52465,95,1553896800,30,10,40,Clouds
52466,96,1553896800,22,8,30,Clouds
52467,97,1553896800,29,11,40,Clouds
52468,98,1553896800,31,9,40,Clouds
52469,99,1553896800,30,0,30,Clouds
52470,100,1553896800,0,25,25,Clouds
52471,101,1553896800,17,13,30,Clouds
52472,102,1553896800,28,12,40,Clouds
52473,103,1553896800,39,1,40,Clouds
52474,104,1553896800,40,0,40,Clouds
52475,105,1553896800,35,1,36,Clouds
52476,106,1553896800,32,8,40,Clouds
52477,107,1553896800,39,1,40,Clouds
52478,108,1553896800,28,12,40,Clouds
52479,109,1553896800,23,6,29,Clouds
52480,110,1553896800,27,13,40,Clouds
52481,111,1553896800,34,6,40,Clouds
52482,112,1553896800,7,23,30,Clouds
52483,113,1553896800,40,0,40,Clouds
52484,114,1553896800,40,0,40,Clouds
52485,115,1553896800,9,21,30,Clouds
52486,2,1553900400,9,11,20,Clouds
52487,3,1553900400,15,5,20,Clouds
52488,4,1553900400,19,1,20,Clouds
52489,5,1553900400,14,26,40,Clouds
52490,6,1553900400,3,17,20,Clouds
52491,7,1553900400,9,20,29,Clouds
52492,8,1553900400,26,4,30,Clouds
52493,9,1553900400,0,24,24,Clouds
52494,10,1553900400,0,16,16,Clouds
52495,11,1553900400,30,0,30,Clouds
52496,12,1553900400,11,9,20,Clouds
52497,13,1553900400,21,9,30,Clouds
52498,14,1553900400,1,29,30,Clouds
52499,15,1553900400,16,0,16,Clouds
52500,16,1553900400,14,6,20,Clouds
52501,17,1553900400,18,2,20,Clouds
52502,18,1553900400,5,25,30,Clouds
52503,19,1553900400,26,4,30,Clouds
52504,21,1553900400,16,14,30,Clouds
52505,22,1553900400,10,10,20,Clouds
52506,23,1553900400,19,11,30,Clouds
52507,24,1553900400,12,8,20,Clouds
52508,25,1553900400,30,0,30,Clouds
52509,26,1553900400,14,6,20,Clouds
52510,27,1553900400,20,0,20,Clouds
52511,28,1553900400,30,0,30,Clouds
52512,29,1553900400,6,23,29,Clouds
52513,30,1553900400,17,3,20,Clouds
52514,31,1553900400,14,6,20,Clouds
52515,32,1553900400,28,2,30,Clouds
52516,33,1553900400,17,6,23,Clouds
52517,34,1553900400,5,25,30,Clouds
52518,35,1553900400,16,14,30,Clouds
52519,36,1553900400,29,11,40,Clouds
52520,37,1553900400,30,0,30,Clouds
52521,38,1553900400,17,23,40,Clouds
52522,39,1553900400,20,0,20,Clouds
52523,40,1553900400,20,1,21,Clouds
52524,41,1553900400,20,0,20,Clouds
52525,42,1553900400,11,19,30,Clouds
52526,43,1553900400,2,28,30,Clouds
52527,44,1553900400,2,28,30,Clouds
52528,45,1553900400,17,13,30,Clouds
52529,46,1553900400,6,14,20,Clouds
52530,47,1553900400,40,0,40,Clouds
52531,48,1553900400,28,12,40,Clouds
52532,49,1553900400,38,2,40,Clouds
52533,50,1553900400,23,17,40,Clouds
52534,51,1553900400,19,21,40,Clouds
52535,52,1553900400,22,10,32,Clouds
52536,53,1553900400,40,0,40,Clouds
52537,54,1553900400,33,0,33,Clouds
52538,55,1553900400,36,0,36,Clouds
52539,56,1553900400,37,3,40,Clouds
52540,57,1553900400,17,6,23,Clouds
52541,58,1553900400,39,1,40,Clouds
52542,59,1553900400,16,4,20,Clouds
52543,60,1553900400,3,27,30,Clouds
52544,61,1553900400,21,4,25,Clouds
52545,62,1553900400,40,0,40,Clouds
52546,63,1553900400,13,22,35,Clouds
52547,64,1553900400,23,17,40,Clouds
52548,65,1553900400,40,0,40,Clouds
52549,66,1553900400,40,0,40,Clouds
52550,67,1553900400,8,32,40,Clouds
52551,68,1553900400,40,0,40,Clouds
52552,69,1553900400,38,2,40,Clouds
52553,70,1553900400,24,4,28,Clouds
52554,71,1553900400,38,2,40,Clouds
52555,72,1553900400,4,27,31,Clouds
52556,73,1553900400,19,11,30,Clouds
52557,74,1553900400,0,30,30,Clouds
52558,75,1553900400,22,18,40,Clouds
52559,76,1553900400,35,3,38,Clouds
52560,77,1553900400,24,5,29,Clouds
52561,78,1553900400,16,24,40,Clouds
52562,79,1553900400,27,0,27,Clouds
52563,80,1553900400,27,13,40,Clouds
52564,81,1553900400,34,6,40,Clouds
52565,82,1553900400,13,9,22,Clouds
52566,83,1553900400,4,36,40,Clouds
52567,84,1553900400,8,22,30,Clouds
52568,85,1553900400,20,15,35,Clouds
52569,86,1553900400,5,33,38,Clouds
52570,87,1553900400,16,22,38,Clouds
52571,88,1553900400,12,18,30,Clouds
52572,89,1553900400,31,9,40,Clouds
52573,90,1553900400,39,1,40,Clouds
52574,91,1553900400,12,18,30,Clouds
52575,92,1553900400,3,37,40,Clouds
52576,93,1553900400,0,40,40,Clouds
52577,94,1553900400,8,32,40,Clouds
52578,95,1553900400,27,13,40,Clouds
52579,96,1553900400,19,11,30,Clouds
52580,97,1553900400,26,14,40,Clouds
52581,98,1553900400,34,6,40,Clouds
52582,99,1553900400,30,0,30,Clouds
52583,100,1553900400,5,20,25,Clouds
52584,101,1553900400,17,13,30,Clouds
52585,102,1553900400,29,11,40,Clouds
52586,103,1553900400,40,0,40,Clouds
52587,104,1553900400,40,0,40,Clouds
52588,105,1553900400,35,1,36,Clouds
52589,106,1553900400,33,7,40,Clouds
52590,107,1553900400,18,22,40,Clouds
52591,108,1553900400,26,14,40,Clouds
52592,109,1553900400,20,9,29,Clouds
52593,110,1553900400,26,14,40,Clouds
52594,111,1553900400,30,10,40,Clouds
52595,112,1553900400,7,23,30,Clouds
52596,113,1553900400,40,0,40,Clouds
52597,114,1553900400,40,0,40,Clouds
52598,115,1553900400,19,11,30,Clouds
52599,2,1553904000,11,9,20,Clouds
52600,3,1553904000,16,4,20,Clouds
52601,4,1553904000,17,3,20,Clouds
52602,5,1553904000,12,28,40,Clouds
52603,6,1553904000,3,17,20,Clouds
52604,7,1553904000,11,18,29,Clouds
52605,8,1553904000,29,1,30,Clouds
52606,9,1553904000,3,21,24,Clouds
52607,10,1553904000,0,16,16,Clouds
52608,11,1553904000,30,0,30,Clouds
52609,12,1553904000,11,9,20,Clouds
52610,13,1553904000,22,8,30,Clouds
52611,14,1553904000,8,22,30,Clouds
52612,15,1553904000,15,1,16,Clouds
52613,16,1553904000,16,4,20,Clouds
52614,17,1553904000,18,2,20,Clouds
52615,18,1553904000,7,23,30,Clouds
52616,19,1553904000,23,7,30,Clouds
52617,21,1553904000,18,12,30,Clouds
52618,22,1553904000,9,11,20,Clouds
52619,23,1553904000,20,10,30,Clouds
52620,24,1553904000,15,5,20,Clouds
52621,25,1553904000,30,0,30,Clouds
52622,26,1553904000,16,4,20,Clouds
52623,27,1553904000,20,0,20,Clouds
52624,28,1553904000,28,2,30,Clouds
52625,29,1553904000,5,24,29,Clouds
52626,30,1553904000,19,1,20,Clouds
52627,31,1553904000,18,2,20,Clouds
52628,32,1553904000,27,3,30,Clouds
52629,33,1553904000,21,2,23,Clouds
52630,34,1553904000,3,27,30,Clouds
52631,35,1553904000,17,13,30,Clouds
52632,36,1553904000,33,7,40,Clouds
52633,37,1553904000,29,1,30,Clouds
52634,38,1553904000,13,27,40,Clouds
52635,39,1553904000,20,0,20,Clouds
52636,40,1553904000,19,2,21,Clouds
52637,41,1553904000,20,0,20,Clouds
52638,42,1553904000,10,20,30,Clouds
52639,43,1553904000,1,29,30,Clouds
52640,44,1553904000,4,26,30,Clouds
52641,45,1553904000,17,13,30,Clouds
52642,46,1553904000,8,12,20,Clouds
52643,47,1553904000,39,1,40,Clouds
52644,48,1553904000,26,14,40,Clouds
52645,49,1553904000,35,5,40,Clouds
52646,50,1553904000,19,21,40,Clouds
52647,51,1553904000,19,21,40,Clouds
52648,52,1553904000,27,5,32,Clouds
52649,53,1553904000,40,0,40,Clouds
52650,54,1553904000,32,1,33,Clouds
52651,55,1553904000,36,0,36,Clouds
52652,56,1553904000,34,6,40,Clouds
52653,57,1553904000,19,4,23,Clouds
52654,58,1553904000,37,3,40,Clouds
52655,59,1553904000,17,3,20,Clouds
52656,60,1553904000,1,28,29,Clouds
52657,61,1553904000,23,2,25,Clouds
52658,62,1553904000,40,0,40,Clouds
52659,63,1553904000,13,22,35,Clouds
52660,64,1553904000,26,14,40,Clouds
52661,65,1553904000,40,0,40,Clouds
52662,66,1553904000,32,8,40,Clouds
52663,67,1553904000,11,29,40,Clouds
52664,68,1553904000,38,2,40,Clouds
52665,69,1553904000,36,4,40,Clouds
52666,70,1553904000,26,2,28,Clouds
52667,71,1553904000,33,7,40,Clouds
52668,72,1553904000,3,28,31,Clouds
52669,73,1553904000,17,13,30,Clouds
52670,74,1553904000,1,29,30,Clouds
52671,75,1553904000,21,19,40,Clouds
52672,76,1553904000,35,3,38,Clouds
52673,77,1553904000,26,3,29,Clouds
52674,78,1553904000,14,26,40,Clouds
52675,79,1553904000,14,13,27,Clouds
52676,80,1553904000,28,12,40,Clouds
52677,81,1553904000,35,5,40,Clouds
52678,82,1553904000,10,12,22,Clouds
52679,83,1553904000,1,39,40,Clouds
52680,84,1553904000,7,23,30,Clouds
52681,85,1553904000,17,18,35,Clouds
52682,86,1553904000,7,31,38,Clouds
52683,87,1553904000,15,23,38,Clouds
52684,88,1553904000,11,19,30,Clouds
52685,89,1553904000,32,8,40,Clouds
52686,90,1553904000,39,1,40,Clouds
52687,91,1553904000,13,17,30,Clouds
52688,92,1553904000,2,38,40,Clouds
52689,93,1553904000,0,40,40,Clouds
52690,94,1553904000,8,32,40,Clouds
52691,95,1553904000,25,15,40,Clouds
52692,96,1553904000,18,12,30,Clouds
52693,97,1553904000,26,14,40,Clouds
52694,98,1553904000,35,5,40,Clouds
52695,99,1553904000,30,0,30,Clouds
52696,100,1553904000,5,20,25,Clouds
52697,101,1553904000,15,15,30,Clouds
52698,102,1553904000,28,12,40,Clouds
52699,103,1553904000,37,3,40,Clouds
52700,104,1553904000,40,0,40,Clouds
52701,105,1553904000,35,1,36,Clouds
52702,106,1553904000,32,8,40,Clouds
52703,107,1553904000,18,22,40,Clouds
52704,108,1553904000,29,11,40,Clouds
52705,109,1553904000,18,11,29,Clouds
52706,110,1553904000,25,15,40,Clouds
52707,111,1553904000,14,26,40,Clouds
52708,112,1553904000,1,29,30,Clouds
52709,113,1553904000,39,1,40,Clouds
52710,114,1553904000,40,0,40,Clouds
52711,115,1553904000,17,13,30,Clouds
52712,2,1553907600,10,10,20,Clouds
52713,3,1553907600,16,4,20,Clouds
52714,4,1553907600,18,2,20,Clouds
52715,5,1553907600,23,17,40,Clouds
52716,6,1553907600,5,15,20,Clouds
52717,7,1553907600,14,15,29,Clouds
52718,8,1553907600,30,0,30,Clouds
52719,9,1553907600,12,12,24,Clouds
52720,10,1553907600,5,11,16,Clouds
52721,11,1553907600,30,0,30,Clouds
52722,12,1553907600,13,7,20,Clouds
52723,13,1553907600,23,7,30,Clouds
52724,14,1553907600,14,16,30,Clouds
52725,15,1553907600,15,1,16,Clouds
52726,16,1553907600,18,2,20,Clouds
52727,17,1553907600,18,2,20,Clouds
52728,18,1553907600,11,19,30,Clouds
52729,19,1553907600,24,6,30,Clouds
52730,21,1553907600,22,8,30,Clouds
52731,22,1553907600,10,10,20,Clouds
52732,23,1553907600,22,8,30,Clouds
52733,24,1553907600,15,5,20,Clouds
52734,25,1553907600,30,0,30,Clouds
52735,26,1553907600,18,2,20,Clouds
52736,27,1553907600,20,0,20,Clouds
52737,28,1553907600,27,3,30,Clouds
52738,29,1553907600,7,22,29,Clouds
52739,30,1553907600,20,0,20,Clouds
52740,31,1553907600,16,4,20,Clouds
52741,32,1553907600,30,0,30,Clouds
52742,33,1553907600,17,6,23,Clouds
52743,34,1553907600,1,29,30,Clouds
52744,35,1553907600,13,17,30,Clouds
52745,36,1553907600,35,5,40,Clouds
52746,37,1553907600,30,0,30,Clouds
52747,38,1553907600,22,18,40,Clouds
52748,39,1553907600,20,0,20,Clouds
52749,40,1553907600,18,3,21,Clouds
52750,41,1553907600,20,0,20,Clouds
52751,42,1553907600,12,18,30,Clouds
52752,43,1553907600,1,29,30,Clouds
52753,44,1553907600,0,30,30,Clouds
52754,45,1553907600,17,13,30,Clouds
52755,46,1553907600,8,12,20,Clouds
52756,47,1553907600,40,0,40,Clouds
52757,48,1553907600,30,10,40,Clouds
52758,49,1553907600,29,11,40,Clouds
52759,50,1553907600,18,22,40,Clouds
52760,51,1553907600,20,20,40,Clouds
52761,52,1553907600,27,5,32,Clouds
52762,53,1553907600,40,0,40,Clouds
52763,54,1553907600,31,2,33,Clouds
52764,55,1553907600,36,0,36,Clouds
52765,56,1553907600,29,11,40,Clouds
52766,57,1553907600,18,5,23,Clouds
52767,58,1553907600,37,3,40,Clouds
52768,59,1553907600,16,4,20,Clouds
52769,60,1553907600,0,29,29,Clouds
52770,61,1553907600,23,2,25,Clouds
52771,62,1553907600,40,0,40,Clouds
52772,63,1553907600,15,20,35,Clouds
52773,64,1553907600,24,16,40,Clouds
52774,65,1553907600,40,0,40,Clouds
52775,66,1553907600,28,12,40,Clouds
52776,67,1553907600,17,23,40,Clouds
52777,68,1553907600,37,3,40,Clouds
52778,69,1553907600,39,1,40,Clouds
52779,70,1553907600,24,4,28,Clouds
52780,71,1553907600,40,0,40,Clouds
52781,72,1553907600,0,31,31,Clouds
52782,73,1553907600,15,15,30,Clouds
52783,74,1553907600,0,30,30,Clouds
52784,75,1553907600,20,20,40,Clouds
52785,76,1553907600,36,2,38,Clouds
52786,77,1553907600,27,2,29,Clouds
52787,78,1553907600,11,29,40,Clouds
52788,79,1553907600,14,13,27,Clouds
52789,80,1553907600,26,14,40,Clouds
52790,81,1553907600,36,4,40,Clouds
52791,82,1553907600,11,11,22,Clouds
52792,83,1553907600,0,40,40,Clouds
52793,84,1553907600,5,25,30,Clouds
52794,85,1553907600,16,19,35,Clouds
52795,86,1553907600,9,29,38,Clouds
52796,87,1553907600,8,30,38,Clouds
52797,88,1553907600,10,20,30,Clouds
52798,89,1553907600,33,7,40,Clouds
52799,90,1553907600,39,1,40,Clouds
52800,91,1553907600,13,17,30,Clouds
52801,92,1553907600,1,39,40,Clouds
52802,93,1553907600,0,40,40,Clouds
52803,94,1553907600,8,32,40,Clouds
52804,95,1553907600,22,18,40,Clouds
52805,96,1553907600,19,11,30,Clouds
52806,97,1553907600,20,20,40,Clouds
52807,98,1553907600,39,1,40,Clouds
52808,99,1553907600,30,0,30,Clouds
52809,100,1553907600,6,19,25,Clouds
52810,101,1553907600,14,16,30,Clouds
52811,102,1553907600,25,15,40,Clouds
52812,103,1553907600,37,3,40,Clouds
52813,104,1553907600,39,1,40,Clouds
52814,105,1553907600,36,0,36,Clouds
52815,106,1553907600,34,6,40,Clouds
52816,107,1553907600,19,21,40,Clouds
52817,108,1553907600,28,12,40,Clouds
52818,109,1553907600,14,15,29,Clouds
52819,110,1553907600,23,17,40,Clouds
52820,111,1553907600,6,34,40,Clouds
52821,112,1553907600,0,30,30,Clouds
52822,113,1553907600,39,1,40,Clouds
52823,114,1553907600,40,0,40,Clouds
52824,115,1553907600,10,20,30,Clouds
52825,2,1553911200,10,10,20,Clouds
52826,3,1553911200,16,4,20,Clouds
52827,4,1553911200,18,2,20,Clouds
52828,5,1553911200,21,19,40,Clouds
52829,6,1553911200,5,15,20,Clouds
52830,7,1553911200,14,15,29,Clouds
52831,8,1553911200,30,0,30,Clouds
52832,9,1553911200,14,10,24,Clouds
52833,10,1553911200,7,9,16,Clouds
52834,11,1553911200,30,0,30,Clouds
52835,12,1553911200,10,10,20,Clouds
52836,13,1553911200,23,7,30,Clouds
52837,14,1553911200,17,13,30,Clouds
52838,15,1553911200,14,2,16,Clouds
52839,16,1553911200,19,1,20,Clouds
52840,17,1553911200,20,0,20,Clouds
52841,18,1553911200,17,13,30,Clouds
52842,19,1553911200,27,3,30,Clouds
52843,21,1553911200,25,5,30,Clouds
52844,22,1553911200,10,10,20,Clouds
52845,23,1553911200,23,7,30,Clouds
52846,24,1553911200,16,4,20,Clouds
52847,25,1553911200,30,0,30,Clouds
52848,26,1553911200,20,0,20,Clouds
52849,27,1553911200,20,0,20,Clouds
52850,28,1553911200,25,5,30,Clouds
52851,29,1553911200,9,20,29,Clouds
52852,30,1553911200,19,1,20,Clouds
52853,31,1553911200,16,4,20,Clouds
52854,32,1553911200,30,0,30,Clouds
52855,33,1553911200,15,8,23,Clouds
52856,34,1553911200,3,27,30,Clouds
52857,35,1553911200,13,17,30,Clouds
52858,36,1553911200,38,2,40,Clouds
52859,37,1553911200,30,0,30,Clouds
52860,38,1553911200,22,18,40,Clouds
52861,39,1553911200,19,1,20,Clouds
52862,40,1553911200,18,3,21,Clouds
52863,41,1553911200,20,0,20,Clouds
52864,42,1553911200,10,20,30,Clouds
52865,43,1553911200,0,30,30,Clouds
52866,44,1553911200,0,30,30,Clouds
52867,45,1553911200,16,14,30,Clouds
52868,46,1553911200,10,10,20,Clouds
52869,47,1553911200,40,0,40,Clouds
52870,48,1553911200,30,10,40,Clouds
52871,49,1553911200,29,11,40,Clouds
52872,50,1553911200,15,25,40,Clouds
52873,51,1553911200,21,19,40,Clouds
52874,52,1553911200,30,2,32,Clouds
52875,53,1553911200,40,0,40,Clouds
52876,54,1553911200,31,2,33,Clouds
52877,55,1553911200,36,0,36,Clouds
52878,56,1553911200,27,13,40,Clouds
52879,57,1553911200,17,6,23,Clouds
52880,58,1553911200,40,0,40,Clouds
52881,59,1553911200,16,4,20,Clouds
52882,60,1553911200,0,29,29,Clouds
52883,61,1553911200,23,2,25,Clouds
52884,62,1553911200,40,0,40,Clouds
52885,63,1553911200,15,20,35,Clouds
52886,64,1553911200,26,14,40,Clouds
52887,65,1553911200,40,0,40,Clouds
52888,66,1553911200,25,15,40,Clouds
52889,67,1553911200,16,24,40,Clouds
52890,68,1553911200,38,2,40,Clouds
52891,69,1553911200,38,2,40,Clouds
52892,70,1553911200,25,3,28,Clouds
52893,71,1553911200,40,0,40,Clouds
52894,72,1553911200,1,30,31,Clouds
52895,73,1553911200,12,18,30,Clouds
52896,74,1553911200,0,30,30,Clouds
52897,75,1553911200,17,23,40,Clouds
52898,76,1553911200,35,3,38,Clouds
52899,77,1553911200,27,2,29,Clouds
52900,78,1553911200,9,31,40,Clouds
52901,79,1553911200,14,13,27,Clouds
52902,80,1553911200,26,14,40,Clouds
52903,81,1553911200,36,4,40,Clouds
52904,82,1553911200,10,12,22,Clouds
52905,83,1553911200,0,40,40,Clouds
52906,84,1553911200,3,27,30,Clouds
52907,85,1553911200,11,24,35,Clouds
52908,86,1553911200,9,29,38,Clouds
52909,87,1553911200,6,32,38,Clouds
52910,88,1553911200,9,21,30,Clouds
52911,89,1553911200,33,7,40,Clouds
52912,90,1553911200,39,1,40,Clouds
52913,91,1553911200,14,16,30,Clouds
52914,92,1553911200,1,39,40,Clouds
52915,93,1553911200,0,40,40,Clouds
52916,94,1553911200,8,32,40,Clouds
52917,95,1553911200,23,17,40,Clouds
52918,96,1553911200,17,13,30,Clouds
52919,97,1553911200,18,22,40,Clouds
52920,98,1553911200,39,1,40,Clouds
52921,99,1553911200,29,1,30,Clouds
52922,100,1553911200,5,20,25,Clouds
52923,101,1553911200,13,17,30,Clouds
52924,102,1553911200,25,15,40,Clouds
52925,103,1553911200,37,3,40,Clouds
52926,104,1553911200,39,1,40,Clouds
52927,105,1553911200,35,1,36,Clouds
52928,106,1553911200,34,6,40,Clouds
52929,107,1553911200,18,22,40,Clouds
52930,108,1553911200,28,12,40,Clouds
52931,109,1553911200,12,17,29,Clouds
52932,110,1553911200,20,20,40,Clouds
52933,111,1553911200,2,38,40,Clouds
52934,112,1553911200,0,30,30,Clouds
52935,113,1553911200,39,1,40,Clouds
52936,114,1553911200,40,0,40,Clouds
52937,115,1553911200,6,24,30,Clouds
52938,2,1553914800,10,10,20,Clouds
52939,3,1553914800,16,4,20,Clouds
52940,4,1553914800,18,2,20,Clouds
52941,5,1553914800,21,19,40,Clouds
52942,6,1553914800,4,16,20,Clouds
52943,7,1553914800,13,16,29,Clouds
52944,8,1553914800,30,0,30,Clouds
52945,9,1553914800,14,10,24,Clouds
52946,10,1553914800,7,9,16,Clouds
52947,11,1553914800,30,0,30,Clouds
52948,12,1553914800,10,10,20,Clouds
52949,13,1553914800,23,7,30,Clouds
52950,14,1553914800,17,13,30,Clouds
52951,15,1553914800,14,2,16,Clouds
52952,16,1553914800,19,1,20,Clouds
52953,17,1553914800,20,0,20,Clouds
52954,18,1553914800,17,13,30,Clouds
52955,19,1553914800,27,3,30,Clouds
52956,21,1553914800,25,5,30,Clouds
52957,22,1553914800,10,10,20,Clouds
52958,23,1553914800,23,7,30,Clouds
52959,24,1553914800,16,4,20,Clouds
52960,25,1553914800,30,0,30,Clouds
52961,26,1553914800,20,0,20,Clouds
52962,27,1553914800,20,0,20,Clouds
52963,28,1553914800,25,5,30,Clouds
52964,29,1553914800,9,20,29,Clouds
52965,30,1553914800,19,1,20,Clouds
52966,31,1553914800,16,4,20,Clouds
52967,32,1553914800,30,0,30,Clouds
52968,33,1553914800,15,8,23,Clouds
52969,34,1553914800,3,27,30,Clouds
52970,35,1553914800,13,17,30,Clouds
52971,36,1553914800,38,2,40,Clouds
52972,37,1553914800,30,0,30,Clouds
52973,38,1553914800,22,18,40,Clouds
52974,39,1553914800,19,1,20,Clouds
52975,40,1553914800,18,3,21,Clouds
52976,41,1553914800,20,0,20,Clouds
52977,42,1553914800,10,20,30,Clouds
52978,43,1553914800,0,30,30,Clouds
52979,44,1553914800,0,30,30,Clouds
52980,45,1553914800,16,14,30,Clouds
52981,46,1553914800,10,10,20,Clouds
52982,47,1553914800,40,0,40,Clouds
52983,48,1553914800,30,10,40,Clouds
52984,49,1553914800,29,11,40,Clouds
52985,50,1553914800,14,26,40,Clouds
52986,51,1553914800,21,19,40,Clouds
52987,52,1553914800,30,2,32,Clouds
52988,53,1553914800,40,0,40,Clouds
52989,54,1553914800,30,3,33,Clouds
52990,55,1553914800,36,0,36,Clouds
52991,56,1553914800,27,13,40,Clouds
52992,57,1553914800,17,6,23,Clouds
52993,58,1553914800,40,0,40,Clouds
52994,59,1553914800,16,4,20,Clouds
52995,60,1553914800,0,29,29,Clouds
52996,61,1553914800,23,2,25,Clouds
52997,62,1553914800,40,0,40,Clouds
52998,63,1553914800,15,20,35,Clouds
52999,64,1553914800,26,14,40,Clouds
53000,65,1553914800,40,0,40,Clouds
53001,66,1553914800,24,16,40,Clouds
53002,67,1553914800,16,24,40,Clouds
53003,68,1553914800,38,2,40,Clouds
53004,69,1553914800,38,2,40,Clouds
53005,70,1553914800,25,3,28,Clouds
53006,71,1553914800,39,1,40,Clouds
53007,72,1553914800,1,30,31,Clouds
53008,73,1553914800,12,18,30,Clouds
53009,74,1553914800,0,30,30,Clouds
53010,75,1553914800,17,23,40,Clouds
53011,76,1553914800,35,3,38,Clouds
53012,77,1553914800,27,2,29,Clouds
53013,78,1553914800,9,31,40,Clouds
53014,79,1553914800,14,13,27,Clouds
53015,80,1553914800,26,14,40,Clouds
53016,81,1553914800,36,4,40,Clouds
53017,82,1553914800,10,12,22,Clouds
53018,83,1553914800,0,40,40,Clouds
53019,84,1553914800,3,27,30,Clouds
53020,85,1553914800,11,24,35,Clouds
53021,86,1553914800,9,29,38,Clouds
53022,87,1553914800,6,32,38,Clouds
53023,88,1553914800,9,21,30,Clouds
53024,89,1553914800,33,7,40,Clouds
53025,90,1553914800,39,1,40,Clouds
53026,91,1553914800,14,16,30,Clouds
53027,92,1553914800,1,39,40,Clouds
53028,93,1553914800,0,40,40,Clouds
53029,94,1553914800,8,32,40,Clouds
53030,95,1553914800,23,17,40,Clouds
53031,96,1553914800,17,13,30,Clouds
53032,97,1553914800,17,23,40,Clouds
53033,98,1553914800,39,1,40,Clouds
53034,99,1553914800,29,1,30,Clouds
53035,100,1553914800,5,20,25,Clouds
53036,101,1553914800,13,17,30,Clouds
53037,102,1553914800,25,15,40,Clouds
53038,103,1553914800,37,3,40,Clouds
53039,104,1553914800,39,1,40,Clouds
53040,105,1553914800,35,1,36,Clouds
53041,106,1553914800,34,6,40,Clouds
53042,107,1553914800,18,22,40,Clouds
53043,108,1553914800,28,12,40,Clouds
53044,109,1553914800,12,17,29,Clouds
53045,110,1553914800,20,20,40,Clouds
53046,111,1553914800,1,39,40,Clouds
53047,112,1553914800,0,30,30,Clouds
53048,113,1553914800,39,1,40,Clouds
53049,114,1553914800,40,0,40,Clouds
53050,115,1553914800,5,25,30,Clouds
53051,2,1553918400,10,10,20,Clouds
53052,3,1553918400,16,4,20,Clouds
53053,4,1553918400,18,2,20,Clouds
53054,5,1553918400,21,19,40,Clouds
53055,6,1553918400,4,16,20,Clouds
53056,7,1553918400,13,16,29,Clouds
53057,8,1553918400,30,0,30,Clouds
53058,9,1553918400,14,10,24,Clouds
53059,10,1553918400,7,9,16,Clouds
53060,11,1553918400,30,0,30,Clouds
53061,12,1553918400,10,10,20,Clouds
53062,13,1553918400,23,7,30,Clouds
53063,14,1553918400,17,13,30,Clouds
53064,15,1553918400,14,2,16,Clouds
53065,16,1553918400,19,1,20,Clouds
53066,17,1553918400,20,0,20,Clouds
53067,18,1553918400,17,13,30,Clouds
53068,19,1553918400,27,3,30,Clouds
53069,21,1553918400,25,5,30,Clouds
53070,22,1553918400,10,10,20,Clouds
53071,23,1553918400,23,7,30,Clouds
53072,24,1553918400,16,4,20,Clouds
53073,25,1553918400,30,0,30,Clouds
53074,26,1553918400,20,0,20,Clouds
53075,27,1553918400,20,0,20,Clouds
53076,28,1553918400,25,5,30,Clouds
53077,29,1553918400,9,20,29,Clouds
53078,30,1553918400,19,1,20,Clouds
53079,31,1553918400,16,4,20,Clouds
53080,32,1553918400,30,0,30,Clouds
53081,33,1553918400,15,8,23,Clouds
53082,34,1553918400,3,27,30,Clouds
53083,35,1553918400,13,17,30,Clouds
53084,36,1553918400,38,2,40,Clouds
53085,37,1553918400,30,0,30,Clouds
53086,38,1553918400,22,18,40,Clouds
53087,39,1553918400,19,1,20,Clouds
53088,40,1553918400,18,3,21,Clouds
53089,41,1553918400,20,0,20,Clouds
53090,42,1553918400,10,20,30,Clouds
53091,43,1553918400,0,30,30,Clouds
53092,44,1553918400,0,30,30,Clouds
53093,45,1553918400,15,15,30,Clouds
53094,46,1553918400,10,10,20,Clouds
53095,47,1553918400,40,0,40,Clouds
53096,48,1553918400,30,10,40,Clouds
53097,49,1553918400,29,11,40,Clouds
53098,50,1553918400,14,26,40,Clouds
53099,51,1553918400,21,19,40,Clouds
53100,52,1553918400,30,2,32,Clouds
53101,53,1553918400,40,0,40,Clouds
53102,54,1553918400,30,3,33,Clouds
53103,55,1553918400,36,0,36,Clouds
53104,56,1553918400,27,13,40,Clouds
53105,57,1553918400,17,6,23,Clouds
53106,58,1553918400,40,0,40,Clouds
53107,59,1553918400,16,4,20,Clouds
53108,60,1553918400,0,29,29,Clouds
53109,61,1553918400,23,2,25,Clouds
53110,62,1553918400,40,0,40,Clouds
53111,63,1553918400,15,20,35,Clouds
53112,64,1553918400,25,15,40,Clouds
53113,65,1553918400,40,0,40,Clouds
53114,66,1553918400,24,16,40,Clouds
53115,67,1553918400,16,24,40,Clouds
53116,68,1553918400,38,2,40,Clouds
53117,69,1553918400,38,2,40,Clouds
53118,70,1553918400,25,3,28,Clouds
53119,71,1553918400,39,1,40,Clouds
53120,72,1553918400,1,30,31,Clouds
53121,73,1553918400,12,18,30,Clouds
53122,74,1553918400,0,30,30,Clouds
53123,75,1553918400,17,23,40,Clouds
53124,76,1553918400,35,3,38,Clouds
53125,77,1553918400,27,2,29,Clouds
53126,78,1553918400,9,31,40,Clouds
53127,79,1553918400,14,13,27,Clouds
53128,80,1553918400,26,14,40,Clouds
53129,81,1553918400,36,4,40,Clouds
53130,82,1553918400,10,12,22,Clouds
53131,83,1553918400,0,40,40,Clouds
53132,84,1553918400,3,27,30,Clouds
53133,85,1553918400,11,24,35,Clouds
53134,86,1553918400,9,29,38,Clouds
53135,87,1553918400,6,32,38,Clouds
53136,88,1553918400,9,21,30,Clouds
53137,89,1553918400,33,7,40,Clouds
53138,90,1553918400,39,1,40,Clouds
53139,91,1553918400,14,16,30,Clouds
53140,92,1553918400,1,39,40,Clouds
53141,93,1553918400,0,40,40,Clouds
53142,94,1553918400,8,32,40,Clouds
53143,95,1553918400,23,17,40,Clouds
53144,96,1553918400,17,13,30,Clouds
53145,97,1553918400,16,24,40,Clouds
53146,98,1553918400,39,1,40,Clouds
53147,99,1553918400,29,1,30,Clouds
53148,100,1553918400,5,20,25,Clouds
53149,101,1553918400,13,17,30,Clouds
53150,102,1553918400,25,15,40,Clouds
53151,103,1553918400,37,3,40,Clouds
53152,104,1553918400,39,1,40,Clouds
53153,105,1553918400,35,1,36,Clouds
53154,106,1553918400,34,6,40,Clouds
53155,107,1553918400,18,22,40,Clouds
53156,108,1553918400,28,12,40,Clouds
53157,109,1553918400,12,17,29,Clouds
53158,110,1553918400,20,20,40,Clouds
53159,111,1553918400,0,40,40,Clouds
53160,112,1553918400,0,30,30,Clouds
53161,113,1553918400,39,1,40,Clouds
53162,114,1553918400,40,0,40,Clouds
53163,115,1553918400,5,25,30,Clouds
53164,2,1553922000,10,10,20,Clouds
53165,3,1553922000,16,4,20,Clouds
53166,4,1553922000,18,2,20,Clouds
53167,5,1553922000,21,19,40,Clouds
53168,6,1553922000,4,16,20,Clouds
53169,7,1553922000,13,16,29,Clouds
53170,8,1553922000,30,0,30,Clouds
53171,9,1553922000,14,10,24,Clouds
53172,10,1553922000,7,9,16,Clouds
53173,11,1553922000,30,0,30,Clouds
53174,12,1553922000,10,10,20,Clouds
53175,13,1553922000,23,7,30,Clouds
53176,14,1553922000,17,13,30,Clouds
53177,15,1553922000,14,2,16,Clouds
53178,16,1553922000,19,1,20,Clouds
53179,17,1553922000,20,0,20,Clouds
53180,18,1553922000,17,13,30,Clouds
53181,19,1553922000,27,3,30,Clouds
53182,21,1553922000,25,5,30,Clouds
53183,22,1553922000,10,10,20,Clouds
53184,23,1553922000,23,7,30,Clouds
53185,24,1553922000,16,4,20,Clouds
53186,25,1553922000,30,0,30,Clouds
53187,26,1553922000,20,0,20,Clouds
53188,27,1553922000,20,0,20,Clouds
53189,28,1553922000,25,5,30,Clouds
53190,29,1553922000,9,20,29,Clouds
53191,30,1553922000,19,1,20,Clouds
53192,31,1553922000,16,4,20,Clouds
53193,32,1553922000,30,0,30,Clouds
53194,33,1553922000,15,8,23,Clouds
53195,34,1553922000,3,27,30,Clouds
53196,35,1553922000,13,17,30,Clouds
53197,36,1553922000,38,2,40,Clouds
53198,37,1553922000,30,0,30,Clouds
53199,38,1553922000,22,18,40,Clouds
53200,39,1553922000,19,1,20,Clouds
53201,40,1553922000,18,3,21,Clouds
53202,41,1553922000,20,0,20,Clouds
53203,42,1553922000,10,20,30,Clouds
53204,43,1553922000,0,30,30,Clouds
53205,44,1553922000,0,30,30,Clouds
53206,45,1553922000,15,15,30,Clouds
53207,46,1553922000,10,10,20,Clouds
53208,47,1553922000,40,0,40,Clouds
53209,48,1553922000,30,10,40,Clouds
53210,49,1553922000,29,11,40,Clouds
53211,50,1553922000,14,26,40,Clouds
53212,51,1553922000,21,19,40,Clouds
53213,52,1553922000,30,2,32,Clouds
53214,53,1553922000,40,0,40,Clouds
53215,54,1553922000,30,3,33,Clouds
53216,55,1553922000,36,0,36,Clouds
53217,56,1553922000,27,13,40,Clouds
53218,57,1553922000,17,6,23,Clouds
53219,58,1553922000,40,0,40,Clouds
53220,60,1553922000,0,29,29,Clouds
53221,61,1553922000,23,2,25,Clouds
53222,62,1553922000,40,0,40,Clouds
53223,63,1553922000,15,20,35,Clouds
53224,64,1553922000,25,15,40,Clouds
53225,65,1553922000,40,0,40,Clouds
53226,66,1553922000,24,16,40,Clouds
53227,67,1553922000,16,24,40,Clouds
53228,68,1553922000,38,2,40,Clouds
53229,69,1553922000,38,2,40,Clouds
53230,70,1553922000,25,3,28,Clouds
53231,71,1553922000,39,1,40,Clouds
53232,72,1553922000,1,30,31,Clouds
53233,73,1553922000,12,18,30,Clouds
53234,74,1553922000,0,30,30,Clouds
53235,75,1553922000,17,23,40,Clouds
53236,76,1553922000,35,3,38,Clouds
53237,77,1553922000,27,2,29,Clouds
53238,78,1553922000,9,31,40,Clouds
53239,79,1553922000,14,13,27,Clouds
53240,80,1553922000,26,14,40,Clouds
53241,81,1553922000,36,4,40,Clouds
53242,82,1553922000,10,12,22,Clouds
53243,83,1553922000,0,40,40,Clouds
53244,84,1553922000,3,27,30,Clouds
53245,85,1553922000,11,24,35,Clouds
53246,86,1553922000,9,29,38,Clouds
53247,87,1553922000,6,32,38,Clouds
53248,88,1553922000,9,21,30,Clouds
53249,89,1553922000,33,7,40,Clouds
53250,90,1553922000,39,1,40,Clouds
53251,91,1553922000,14,16,30,Clouds
53252,92,1553922000,1,39,40,Clouds
53253,93,1553922000,0,40,40,Clouds
53254,94,1553922000,8,32,40,Clouds
53255,95,1553922000,23,17,40,Clouds
53256,96,1553922000,17,13,30,Clouds
53257,97,1553922000,16,24,40,Clouds
53258,98,1553922000,39,1,40,Clouds
53259,99,1553922000,29,1,30,Clouds
53260,100,1553922000,5,20,25,Clouds
53261,101,1553922000,13,17,30,Clouds
53262,102,1553922000,25,15,40,Clouds
53263,103,1553922000,37,3,40,Clouds
53264,104,1553922000,39,1,40,Clouds
53265,105,1553922000,35,1,36,Clouds
53266,106,1553922000,34,6,40,Clouds
53267,107,1553922000,18,22,40,Clouds
53268,108,1553922000,28,12,40,Clouds
53269,109,1553922000,12,17,29,Clouds
53270,110,1553922000,20,20,40,Clouds
53271,111,1553922000,0,40,40,Clouds
53272,112,1553922000,0,30,30,Clouds
53273,113,1553922000,39,1,40,Clouds
53274,114,1553922000,40,0,40,Clouds
53275,115,1553922000,5,25,30,Clouds
53276,2,1553925600,10,10,20,Clouds
53277,3,1553925600,16,4,20,Clouds
53278,4,1553925600,18,2,20,Clouds
53279,5,1553925600,21,19,40,Clouds
53280,6,1553925600,4,16,20,Clouds
53281,7,1553925600,13,16,29,Clouds
53282,8,1553925600,30,0,30,Clouds
53283,9,1553925600,14,10,24,Clouds
53284,10,1553925600,7,9,16,Clouds
53285,11,1553925600,30,0,30,Clouds
53286,12,1553925600,10,10,20,Clouds
53287,13,1553925600,23,7,30,Clouds
53288,14,1553925600,17,13,30,Clouds
53289,15,1553925600,14,2,16,Clouds
53290,16,1553925600,19,1,20,Clouds
53291,17,1553925600,20,0,20,Clouds
53292,18,1553925600,17,13,30,Clouds
53293,19,1553925600,27,3,30,Clouds
53294,21,1553925600,25,5,30,Clouds
53295,22,1553925600,10,10,20,Clouds
53296,23,1553925600,23,7,30,Clouds
53297,24,1553925600,16,4,20,Clouds
53298,25,1553925600,30,0,30,Clouds
53299,26,1553925600,20,0,20,Clouds
53300,27,1553925600,20,0,20,Clouds
53301,28,1553925600,25,5,30,Clouds
53302,29,1553925600,9,20,29,Clouds
53303,30,1553925600,19,1,20,Clouds
53304,31,1553925600,16,4,20,Clouds
53305,32,1553925600,30,0,30,Clouds
53306,33,1553925600,15,8,23,Clouds
53307,34,1553925600,3,27,30,Clouds
53308,35,1553925600,13,17,30,Clouds
53309,36,1553925600,38,2,40,Clouds
53310,37,1553925600,30,0,30,Clouds
53311,38,1553925600,22,18,40,Clouds
53312,39,1553925600,19,1,20,Clouds
53313,40,1553925600,18,3,21,Clouds
53314,41,1553925600,20,0,20,Clouds
53315,42,1553925600,10,20,30,Clouds
53316,43,1553925600,0,30,30,Clouds
53317,44,1553925600,0,30,30,Clouds
53318,45,1553925600,15,15,30,Clouds
53319,46,1553925600,10,10,20,Clouds
53320,47,1553925600,40,0,40,Clouds
53321,48,1553925600,30,10,40,Clouds
53322,49,1553925600,29,11,40,Clouds
53323,50,1553925600,14,26,40,Clouds
53324,51,1553925600,21,19,40,Clouds
53325,52,1553925600,30,2,32,Clouds
53326,53,1553925600,40,0,40,Clouds
53327,54,1553925600,30,3,33,Clouds
53328,55,1553925600,36,0,36,Clouds
53329,56,1553925600,27,13,40,Clouds
53330,57,1553925600,17,6,23,Clouds
53331,58,1553925600,40,0,40,Clouds
53332,59,1553925600,16,4,20,Clouds
53333,60,1553925600,0,29,29,Clouds
53334,61,1553925600,23,2,25,Clouds
53335,62,1553925600,40,0,40,Clouds
53336,63,1553925600,15,20,35,Clouds
53337,64,1553925600,25,15,40,Clouds
53338,65,1553925600,40,0,40,Clouds
53339,66,1553925600,24,16,40,Clouds
53340,67,1553925600,16,24,40,Clouds
53341,68,1553925600,38,2,40,Clouds
53342,69,1553925600,38,2,40,Clouds
53343,70,1553925600,25,3,28,Clouds
53344,71,1553925600,40,0,40,Clouds
53345,72,1553925600,1,30,31,Clouds
53346,73,1553925600,12,18,30,Clouds
53347,74,1553925600,0,30,30,Clouds
53348,75,1553925600,18,22,40,Clouds
53349,76,1553925600,35,3,38,Clouds
53350,77,1553925600,27,2,29,Clouds
53351,78,1553925600,9,31,40,Clouds
53352,79,1553925600,14,13,27,Clouds
53353,80,1553925600,26,14,40,Clouds
53354,81,1553925600,36,4,40,Clouds
53355,82,1553925600,10,12,22,Clouds
53356,83,1553925600,0,40,40,Clouds
53357,84,1553925600,3,27,30,Clouds
53358,85,1553925600,11,24,35,Clouds
53359,86,1553925600,9,29,38,Clouds
53360,87,1553925600,6,32,38,Clouds
53361,88,1553925600,9,21,30,Clouds
53362,89,1553925600,33,7,40,Clouds
53363,90,1553925600,39,1,40,Clouds
53364,91,1553925600,14,16,30,Clouds
53365,92,1553925600,1,39,40,Clouds
53366,93,1553925600,0,40,40,Clouds
53367,94,1553925600,8,32,40,Clouds
53368,95,1553925600,23,17,40,Clouds
53369,96,1553925600,17,13,30,Clouds
53370,97,1553925600,16,24,40,Clouds
53371,98,1553925600,39,1,40,Clouds
53372,99,1553925600,29,1,30,Clouds
53373,100,1553925600,5,20,25,Clouds
53374,101,1553925600,13,17,30,Clouds
53375,102,1553925600,25,15,40,Clouds
53376,103,1553925600,37,3,40,Clouds
53377,104,1553925600,39,1,40,Clouds
53378,105,1553925600,35,1,36,Clouds
53379,106,1553925600,34,6,40,Clouds
53380,107,1553925600,18,22,40,Clouds
53381,108,1553925600,28,12,40,Clouds
53382,109,1553925600,12,17,29,Clouds
53383,110,1553925600,20,20,40,Clouds
53384,111,1553925600,0,40,40,Clouds
53385,112,1553925600,1,29,30,Clouds
53386,113,1553925600,39,1,40,Clouds
53387,114,1553925600,40,0,40,Clouds
53388,115,1553925600,5,25,30,Clouds
53389,2,1553929200,11,9,20,Clouds
53390,3,1553929200,17,3,20,Clouds
53391,4,1553929200,17,3,20,Clouds
53392,5,1553929200,20,20,40,Clouds
53393,6,1553929200,6,14,20,Clouds
53394,7,1553929200,13,16,29,Clouds
53395,8,1553929200,30,0,30,Clouds
53396,9,1553929200,13,11,24,Clouds
53397,10,1553929200,7,9,16,Clouds
53398,11,1553929200,30,0,30,Clouds
53399,12,1553929200,12,8,20,Clouds
53400,13,1553929200,23,7,30,Clouds
53401,14,1553929200,11,19,30,Clouds
53402,15,1553929200,14,2,16,Clouds
53403,16,1553929200,19,1,20,Clouds
53404,17,1553929200,19,1,20,Clouds
53405,18,1553929200,18,12,30,Clouds
53406,19,1553929200,26,4,30,Clouds
53407,21,1553929200,25,5,30,Clouds
53408,22,1553929200,9,11,20,Clouds
53409,23,1553929200,22,8,30,Clouds
53410,24,1553929200,12,8,20,Clouds
53411,25,1553929200,29,1,30,Clouds
53412,26,1553929200,18,2,20,Clouds
53413,27,1553929200,20,0,20,Clouds
53414,28,1553929200,24,6,30,Clouds
53415,29,1553929200,9,20,29,Clouds
53416,30,1553929200,19,1,20,Clouds
53417,31,1553929200,16,4,20,Clouds
53418,32,1553929200,30,0,30,Clouds
53419,33,1553929200,11,12,23,Clouds
53420,34,1553929200,6,24,30,Clouds
53421,35,1553929200,12,18,30,Clouds
53422,36,1553929200,39,1,40,Clouds
53423,37,1553929200,30,0,30,Clouds
53424,38,1553929200,21,19,40,Clouds
53425,39,1553929200,18,2,20,Clouds
53426,40,1553929200,18,3,21,Clouds
53427,41,1553929200,20,0,20,Clouds
53428,42,1553929200,10,20,30,Clouds
53429,43,1553929200,1,29,30,Clouds
53430,44,1553929200,2,28,30,Clouds
53431,45,1553929200,16,14,30,Clouds
53432,46,1553929200,10,10,20,Clouds
53433,47,1553929200,40,0,40,Clouds
53434,48,1553929200,29,11,40,Clouds
53435,49,1553929200,30,10,40,Clouds
53436,50,1553929200,16,24,40,Clouds
53437,51,1553929200,21,19,40,Clouds
53438,52,1553929200,30,2,32,Clouds
53439,53,1553929200,40,0,40,Clouds
53440,54,1553929200,33,0,33,Clouds
53441,55,1553929200,36,0,36,Clouds
53442,56,1553929200,28,12,40,Clouds
53443,57,1553929200,17,6,23,Clouds
53444,58,1553929200,40,0,40,Clouds
53445,59,1553929200,16,4,20,Clouds
53446,60,1553929200,2,27,29,Clouds
53447,61,1553929200,23,2,25,Clouds
53448,62,1553929200,40,0,40,Clouds
53449,63,1553929200,14,21,35,Clouds
53450,64,1553929200,25,15,40,Clouds
53451,65,1553929200,40,0,40,Clouds
53452,66,1553929200,24,16,40,Clouds
53453,67,1553929200,16,24,40,Clouds
53454,68,1553929200,39,1,40,Clouds
53455,69,1553929200,38,2,40,Clouds
53456,70,1553929200,24,4,28,Clouds
53457,71,1553929200,38,2,40,Clouds
53458,72,1553929200,0,31,31,Clouds
53459,73,1553929200,12,18,30,Clouds
53460,74,1553929200,1,29,30,Clouds
53461,75,1553929200,19,21,40,Clouds
53462,76,1553929200,38,0,38,Clouds
53463,77,1553929200,24,5,29,Clouds
53464,78,1553929200,11,29,40,Clouds
53465,79,1553929200,14,13,27,Clouds
53466,80,1553929200,27,13,40,Clouds
53467,81,1553929200,36,4,40,Clouds
53468,82,1553929200,11,11,22,Clouds
53469,83,1553929200,0,40,40,Clouds
53470,84,1553929200,3,27,30,Clouds
53471,85,1553929200,11,24,35,Clouds
53472,86,1553929200,9,29,38,Clouds
53473,87,1553929200,6,32,38,Clouds
53474,88,1553929200,8,22,30,Clouds
53475,89,1553929200,33,7,40,Clouds
53476,90,1553929200,39,1,40,Clouds
53477,91,1553929200,14,16,30,Clouds
53478,92,1553929200,2,38,40,Clouds
53479,93,1553929200,0,40,40,Clouds
53480,94,1553929200,8,32,40,Clouds
53481,95,1553929200,23,17,40,Clouds
53482,96,1553929200,17,13,30,Clouds
53483,97,1553929200,18,22,40,Clouds
53484,98,1553929200,39,1,40,Clouds
53485,99,1553929200,29,1,30,Clouds
53486,100,1553929200,5,20,25,Clouds
53487,101,1553929200,13,17,30,Clouds
53488,102,1553929200,25,15,40,Clouds
53489,103,1553929200,37,3,40,Clouds
53490,104,1553929200,39,1,40,Clouds
53491,105,1553929200,35,1,36,Clouds
53492,106,1553929200,33,7,40,Clouds
53493,107,1553929200,18,22,40,Clouds
53494,108,1553929200,30,10,40,Clouds
53495,109,1553929200,13,16,29,Clouds
53496,110,1553929200,20,20,40,Clouds
53497,111,1553929200,1,39,40,Clouds
53498,112,1553929200,2,28,30,Clouds
53499,113,1553929200,39,1,40,Clouds
53500,114,1553929200,40,0,40,Clouds
53501,115,1553929200,6,24,30,Clouds
53502,2,1553932800,17,3,20,Clouds
53503,3,1553932800,19,1,20,Clouds
53504,4,1553932800,18,2,20,Clouds
53505,5,1553932800,22,18,40,Clouds
53506,6,1553932800,5,15,20,Clouds
53507,7,1553932800,13,16,29,Clouds
53508,8,1553932800,30,0,30,Clouds
53509,9,1553932800,2,22,24,Clouds
53510,10,1553932800,7,9,16,Clouds
53511,11,1553932800,30,0,30,Clouds
53512,12,1553932800,15,5,20,Clouds
53513,13,1553932800,24,6,30,Clouds
53514,14,1553932800,23,7,30,Clouds
53515,15,1553932800,14,2,16,Clouds
53516,16,1553932800,19,1,20,Clouds
53517,17,1553932800,19,1,20,Clouds
53518,18,1553932800,20,10,30,Clouds
53519,19,1553932800,21,9,30,Clouds
53520,21,1553932800,23,7,30,Clouds
53521,22,1553932800,8,12,20,Clouds
53522,23,1553932800,24,6,30,Clouds
53523,24,1553932800,9,11,20,Clouds
53524,25,1553932800,28,2,30,Clouds
53525,26,1553932800,16,4,20,Clouds
53526,27,1553932800,20,0,20,Clouds
53527,28,1553932800,27,3,30,Clouds
53528,29,1553932800,5,24,29,Clouds
53529,30,1553932800,17,3,20,Clouds
53530,31,1553932800,14,6,20,Clouds
53531,32,1553932800,30,0,30,Clouds
53532,33,1553932800,11,12,23,Clouds
53533,34,1553932800,13,17,30,Clouds
53534,35,1553932800,19,11,30,Clouds
53535,36,1553932800,36,4,40,Clouds
53536,37,1553932800,30,0,30,Clouds
53537,38,1553932800,21,19,40,Clouds
53538,39,1553932800,17,3,20,Clouds
53539,40,1553932800,17,4,21,Clouds
53540,41,1553932800,20,0,20,Clouds
53541,42,1553932800,14,16,30,Clouds
53542,43,1553932800,1,29,30,Clouds
53543,44,1553932800,5,25,30,Clouds
53544,45,1553932800,15,15,30,Clouds
53545,46,1553932800,9,11,20,Clouds
53546,47,1553932800,40,0,40,Clouds
53547,48,1553932800,26,14,40,Clouds
53548,49,1553932800,30,10,40,Clouds
53549,50,1553932800,19,21,40,Clouds
53550,51,1553932800,36,4,40,Clouds
53551,52,1553932800,26,6,32,Clouds
53552,53,1553932800,38,2,40,Clouds
53553,54,1553932800,31,2,33,Clouds
53554,55,1553932800,36,0,36,Clouds
53555,56,1553932800,29,11,40,Clouds
53556,57,1553932800,15,8,23,Clouds
53557,58,1553932800,39,1,40,Clouds
53558,59,1553932800,14,6,20,Clouds
53559,60,1553932800,3,26,29,Clouds
53560,61,1553932800,23,2,25,Clouds
53561,62,1553932800,40,0,40,Clouds
53562,63,1553932800,14,21,35,Clouds
53563,64,1553932800,25,15,40,Clouds
53564,65,1553932800,39,1,40,Clouds
53565,66,1553932800,22,18,40,Clouds
53566,67,1553932800,18,22,40,Clouds
53567,68,1553932800,32,8,40,Clouds
53568,69,1553932800,36,4,40,Clouds
53569,70,1553932800,23,5,28,Clouds
53570,71,1553932800,40,0,40,Clouds
53571,72,1553932800,1,30,31,Clouds
53572,73,1553932800,15,15,30,Clouds
53573,74,1553932800,0,30,30,Clouds
53574,75,1553932800,17,23,40,Clouds
53575,76,1553932800,20,18,38,Clouds
53576,77,1553932800,25,4,29,Clouds
53577,78,1553932800,13,27,40,Clouds
53578,79,1553932800,13,14,27,Clouds
53579,80,1553932800,28,12,40,Clouds
53580,81,1553932800,36,4,40,Clouds
53581,82,1553932800,15,7,22,Clouds
53582,83,1553932800,2,38,40,Clouds
53583,84,1553932800,8,22,30,Clouds
53584,85,1553932800,12,23,35,Clouds
53585,86,1553932800,10,28,38,Clouds
53586,87,1553932800,6,32,38,Clouds
53587,88,1553932800,11,19,30,Clouds
53588,89,1553932800,33,7,40,Clouds
53589,90,1553932800,35,5,40,Clouds
53590,91,1553932800,13,17,30,Clouds
53591,92,1553932800,4,36,40,Clouds
53592,93,1553932800,0,40,40,Clouds
53593,94,1553932800,8,32,40,Clouds
53594,95,1553932800,23,17,40,Clouds
53595,96,1553932800,17,13,30,Clouds
53596,97,1553932800,19,21,40,Clouds
53597,98,1553932800,40,0,40,Clouds
53598,99,1553932800,30,0,30,Clouds
53599,100,1553932800,2,23,25,Clouds
53600,101,1553932800,14,16,30,Clouds
53601,102,1553932800,25,15,40,Clouds
53602,103,1553932800,37,3,40,Clouds
53603,104,1553932800,39,1,40,Clouds
53604,105,1553932800,35,1,36,Clouds
53605,106,1553932800,33,7,40,Clouds
53606,107,1553932800,18,22,40,Clouds
53607,108,1553932800,34,6,40,Clouds
53608,109,1553932800,17,12,29,Clouds
53609,110,1553932800,20,20,40,Clouds
53610,111,1553932800,5,35,40,Clouds
53611,112,1553932800,3,27,30,Clouds
53612,113,1553932800,39,1,40,Clouds
53613,114,1553932800,40,0,40,Clouds
53614,115,1553932800,6,24,30,Clouds
53615,2,1553936400,20,0,20,Clouds
53616,3,1553936400,19,1,20,Clouds
53617,4,1553936400,17,3,20,Clouds
53618,5,1553936400,23,17,40,Clouds
53619,6,1553936400,6,14,20,Clouds
53620,7,1553936400,13,16,29,Clouds
53621,8,1553936400,29,1,30,Clouds
53622,9,1553936400,15,9,24,Clouds
53623,10,1553936400,3,13,16,Clouds
53624,11,1553936400,30,0,30,Clouds
53625,12,1553936400,20,0,20,Clouds
53626,13,1553936400,24,6,30,Clouds
53627,14,1553936400,18,12,30,Clouds
53628,15,1553936400,15,1,16,Clouds
53629,16,1553936400,19,1,20,Clouds
53630,17,1553936400,20,0,20,Clouds
53631,18,1553936400,20,10,30,Clouds
53632,19,1553936400,20,10,30,Clouds
53633,21,1553936400,22,8,30,Clouds
53634,22,1553936400,5,15,20,Clouds
53635,23,1553936400,19,11,30,Clouds
53636,24,1553936400,8,12,20,Clouds
53637,25,1553936400,29,1,30,Clouds
53638,26,1553936400,15,5,20,Clouds
53639,27,1553936400,8,12,20,Clouds
53640,28,1553936400,12,18,30,Clouds
53641,29,1553936400,5,24,29,Clouds
53642,30,1553936400,16,4,20,Clouds
53643,31,1553936400,12,8,20,Clouds
53644,32,1553936400,27,3,30,Clouds
53645,33,1553936400,7,16,23,Clouds
53646,34,1553936400,22,8,30,Clouds
53647,35,1553936400,14,16,30,Clouds
53648,36,1553936400,37,3,40,Clouds
53649,37,1553936400,30,0,30,Clouds
53650,38,1553936400,22,18,40,Clouds
53651,39,1553936400,15,5,20,Clouds
53652,40,1553936400,15,6,21,Clouds
53653,41,1553936400,20,0,20,Clouds
53654,42,1553936400,17,13,30,Clouds
53655,43,1553936400,4,26,30,Clouds
53656,44,1553936400,8,22,30,Clouds
53657,45,1553936400,17,13,30,Clouds
53658,46,1553936400,7,13,20,Clouds
53659,47,1553936400,40,0,40,Clouds
53660,48,1553936400,24,16,40,Clouds
53661,49,1553936400,32,8,40,Clouds
53662,50,1553936400,23,17,40,Clouds
53663,51,1553936400,33,7,40,Clouds
53664,52,1553936400,22,10,32,Clouds
53665,53,1553936400,36,4,40,Clouds
53666,54,1553936400,30,3,33,Clouds
53667,55,1553936400,35,1,36,Clouds
53668,56,1553936400,26,14,40,Clouds
53669,57,1553936400,16,7,23,Clouds
53670,58,1553936400,37,3,40,Clouds
53671,59,1553936400,16,4,20,Clouds
53672,60,1553936400,8,21,29,Clouds
53673,61,1553936400,7,18,25,Clouds
53674,62,1553936400,39,1,40,Clouds
53675,63,1553936400,13,22,35,Clouds
53676,64,1553936400,20,20,40,Clouds
53677,65,1553936400,39,1,40,Clouds
53678,66,1553936400,23,17,40,Clouds
53679,67,1553936400,14,26,40,Clouds
53680,68,1553936400,27,13,40,Clouds
53681,69,1553936400,31,9,40,Clouds
53682,70,1553936400,23,5,28,Clouds
53683,71,1553936400,38,2,40,Clouds
53684,72,1553936400,6,25,31,Clouds
53685,73,1553936400,16,14,30,Clouds
53686,74,1553936400,1,29,30,Clouds
53687,75,1553936400,15,25,40,Clouds
53688,76,1553936400,23,15,38,Clouds
53689,77,1553936400,24,5,29,Clouds
53690,78,1553936400,11,29,40,Clouds
53691,79,1553936400,17,10,27,Clouds
53692,80,1553936400,28,12,40,Clouds
53693,81,1553936400,36,4,40,Clouds
53694,82,1553936400,17,5,22,Clouds
53695,83,1553936400,3,37,40,Clouds
53696,84,1553936400,9,21,30,Clouds
53697,85,1553936400,15,20,35,Clouds
53698,86,1553936400,11,27,38,Clouds
53699,87,1553936400,7,31,38,Clouds
53700,88,1553936400,14,16,30,Clouds
53701,89,1553936400,33,7,40,Clouds
53702,90,1553936400,36,4,40,Clouds
53703,91,1553936400,15,15,30,Clouds
53704,92,1553936400,5,35,40,Clouds
53705,93,1553936400,1,39,40,Clouds
53706,94,1553936400,7,33,40,Clouds
53707,95,1553936400,23,17,40,Clouds
53708,96,1553936400,17,13,30,Clouds
53709,97,1553936400,20,20,40,Clouds
53710,98,1553936400,39,1,40,Clouds
53711,99,1553936400,28,2,30,Clouds
53712,100,1553936400,4,21,25,Clouds
53713,101,1553936400,15,15,30,Clouds
53714,102,1553936400,26,14,40,Clouds
53715,103,1553936400,36,4,40,Clouds
53716,104,1553936400,39,1,40,Clouds
53717,105,1553936400,34,2,36,Clouds
53718,106,1553936400,34,6,40,Clouds
53719,107,1553936400,20,20,40,Clouds
53720,108,1553936400,37,3,40,Clouds
53721,109,1553936400,16,13,29,Clouds
53722,110,1553936400,22,18,40,Clouds
53723,111,1553936400,9,31,40,Clouds
53724,112,1553936400,10,20,30,Clouds
53725,113,1553936400,39,1,40,Clouds
53726,114,1553936400,40,0,40,Clouds
53727,115,1553936400,10,20,30,Clouds
53728,2,1553940000,19,1,20,Clouds
53729,3,1553940000,17,3,20,Clouds
53730,4,1553940000,17,3,20,Clouds
53731,5,1553940000,22,18,40,Clouds
53732,6,1553940000,4,16,20,Clouds
53733,7,1553940000,13,16,29,Clouds
53734,8,1553940000,28,2,30,Clouds
53735,9,1553940000,8,16,24,Clouds
53736,10,1553940000,2,14,16,Clouds
53737,11,1553940000,30,0,30,Clouds
53738,12,1553940000,19,1,20,Clouds
53739,13,1553940000,23,7,30,Clouds
53740,14,1553940000,13,17,30,Clouds
53741,15,1553940000,15,1,16,Clouds
53742,16,1553940000,19,1,20,Clouds
53743,17,1553940000,20,0,20,Clouds
53744,18,1553940000,15,15,30,Clouds
53745,19,1553940000,19,11,30,Clouds
53746,21,1553940000,18,12,30,Clouds
53747,22,1553940000,3,17,20,Clouds
53748,23,1553940000,19,11,30,Clouds
53749,24,1553940000,10,10,20,Clouds
53750,25,1553940000,28,2,30,Clouds
53751,26,1553940000,13,7,20,Clouds
53752,27,1553940000,4,16,20,Clouds
53753,28,1553940000,14,16,30,Clouds
53754,29,1553940000,24,5,29,Clouds
53755,30,1553940000,17,3,20,Clouds
53756,31,1553940000,11,9,20,Clouds
53757,32,1553940000,25,5,30,Clouds
53758,33,1553940000,16,6,22,Clouds
53759,34,1553940000,12,18,30,Clouds
53760,35,1553940000,14,16,30,Clouds
53761,36,1553940000,37,3,40,Clouds
53762,37,1553940000,29,1,30,Clouds
53763,38,1553940000,21,19,40,Clouds
53764,39,1553940000,16,4,20,Clouds
53765,40,1553940000,12,9,21,Clouds
53766,41,1553940000,20,0,20,Clouds
53767,42,1553940000,23,7,30,Clouds
53768,43,1553940000,10,20,30,Clouds
53769,44,1553940000,11,19,30,Clouds
53770,45,1553940000,20,10,30,Clouds
53771,46,1553940000,4,16,20,Clouds
53772,47,1553940000,39,1,40,Clouds
53773,48,1553940000,20,20,40,Clouds
53774,49,1553940000,26,14,40,Clouds
53775,50,1553940000,25,15,40,Clouds
53776,51,1553940000,35,5,40,Clouds
53777,52,1553940000,17,15,32,Clouds
53778,53,1553940000,36,4,40,Clouds
53779,54,1553940000,31,2,33,Clouds
53780,55,1553940000,35,1,36,Clouds
53781,56,1553940000,30,10,40,Clouds
53782,57,1553940000,16,7,23,Clouds
53783,58,1553940000,37,3,40,Clouds
53784,59,1553940000,15,5,20,Clouds
53785,60,1553940000,12,17,29,Clouds
53786,61,1553940000,12,13,25,Clouds
53787,62,1553940000,40,0,40,Clouds
53788,63,1553940000,11,24,35,Clouds
53789,64,1553940000,14,26,40,Clouds
53790,65,1553940000,37,3,40,Clouds
53791,66,1553940000,22,18,40,Clouds
53792,67,1553940000,19,21,40,Clouds
53793,68,1553940000,27,13,40,Clouds
53794,69,1553940000,28,12,40,Clouds
53795,70,1553940000,25,3,28,Clouds
53796,71,1553940000,38,2,40,Clouds
53797,72,1553940000,5,26,31,Clouds
53798,73,1553940000,18,12,30,Clouds
53799,74,1553940000,1,29,30,Clouds
53800,75,1553940000,16,24,40,Clouds
53801,76,1553940000,24,14,38,Clouds
53802,77,1553940000,25,4,29,Clouds
53803,78,1553940000,13,27,40,Clouds
53804,79,1553940000,19,8,27,Clouds
53805,80,1553940000,29,11,40,Clouds
53806,81,1553940000,36,4,40,Clouds
53807,82,1553940000,19,3,22,Clouds
53808,83,1553940000,8,32,40,Clouds
53809,84,1553940000,13,17,30,Clouds
53810,85,1553940000,21,14,35,Clouds
53811,86,1553940000,11,27,38,Clouds
53812,87,1553940000,7,31,38,Clouds
53813,88,1553940000,16,14,30,Clouds
53814,89,1553940000,34,6,40,Clouds
53815,90,1553940000,32,8,40,Clouds
53816,91,1553940000,14,16,30,Clouds
53817,92,1553940000,2,38,40,Clouds
53818,93,1553940000,2,38,40,Clouds
53819,94,1553940000,7,33,40,Clouds
53820,95,1553940000,25,15,40,Clouds
53821,96,1553940000,18,12,30,Clouds
53822,97,1553940000,24,16,40,Clouds
53823,98,1553940000,38,2,40,Clouds
53824,99,1553940000,26,4,30,Clouds
53825,100,1553940000,1,24,25,Clouds
53826,101,1553940000,19,11,30,Clouds
53827,102,1553940000,28,12,40,Clouds
53828,103,1553940000,36,4,40,Clouds
53829,104,1553940000,39,1,40,Clouds
53830,105,1553940000,34,2,36,Clouds
53831,106,1553940000,34,6,40,Clouds
53832,107,1553940000,23,17,40,Clouds
53833,108,1553940000,40,0,40,Clouds
53834,109,1553940000,18,11,29,Clouds
53835,110,1553940000,24,16,40,Clouds
53836,111,1553940000,11,29,40,Clouds
53837,112,1553940000,18,12,30,Clouds
53838,113,1553940000,39,1,40,Clouds
53839,114,1553940000,38,2,40,Clouds
53840,115,1553940000,14,16,30,Clouds
53841,2,1553943600,20,0,20,Clouds
53842,3,1553943600,17,3,20,Clouds
53843,4,1553943600,16,4,20,Clouds
53844,5,1553943600,31,9,40,Clouds
53845,6,1553943600,2,18,20,Clouds
53846,7,1553943600,16,13,29,Clouds
53847,8,1553943600,22,8,30,Clouds
53848,9,1553943600,0,24,24,Clouds
53849,10,1553943600,0,16,16,Clouds
53850,11,1553943600,30,0,30,Clouds
53851,12,1553943600,18,2,20,Clouds
53852,13,1553943600,23,7,30,Clouds
53853,14,1553943600,18,12,30,Clouds
53854,15,1553943600,16,0,16,Clouds
53855,16,1553943600,15,5,20,Clouds
53856,17,1553943600,15,5,20,Clouds
53857,18,1553943600,18,12,30,Clouds
53858,19,1553943600,21,9,30,Clouds
53859,21,1553943600,14,16,30,Clouds
53860,22,1553943600,1,19,20,Clouds
53861,23,1553943600,18,12,30,Clouds
53862,24,1553943600,11,9,20,Clouds
53863,25,1553943600,25,5,30,Clouds
53864,26,1553943600,13,7,20,Clouds
53865,27,1553943600,0,20,20,Clouds
53866,28,1553943600,19,11,30,Clouds
53867,29,1553943600,19,10,29,Clouds
53868,30,1553943600,16,4,20,Clouds
53869,31,1553943600,7,13,20,Clouds
53870,32,1553943600,20,10,30,Clouds
53871,33,1553943600,9,14,23,Clouds
53872,34,1553943600,18,12,30,Clouds
53873,35,1553943600,18,12,30,Clouds
53874,36,1553943600,35,5,40,Clouds
53875,37,1553943600,27,3,30,Clouds
53876,38,1553943600,21,19,40,Clouds
53877,39,1553943600,17,3,20,Clouds
53878,40,1553943600,9,12,21,Clouds
53879,41,1553943600,20,0,20,Clouds
53880,42,1553943600,18,12,30,Clouds
53881,43,1553943600,15,15,30,Clouds
53882,44,1553943600,11,19,30,Clouds
53883,45,1553943600,22,8,30,Clouds
53884,46,1553943600,7,13,20,Clouds
53885,47,1553943600,36,4,40,Clouds
53886,48,1553943600,12,28,40,Clouds
53887,49,1553943600,28,12,40,Clouds
53888,50,1553943600,30,10,40,Clouds
53889,51,1553943600,25,15,40,Clouds
53890,52,1553943600,15,17,32,Clouds
53891,53,1553943600,36,4,40,Clouds
53892,54,1553943600,27,6,33,Clouds
53893,55,1553943600,35,1,36,Clouds
53894,56,1553943600,33,7,40,Clouds
53895,57,1553943600,13,10,23,Clouds
53896,58,1553943600,39,1,40,Clouds
53897,59,1553943600,16,4,20,Clouds
53898,60,1553943600,19,10,29,Clouds
53899,61,1553943600,14,11,25,Clouds
53900,62,1553943600,38,2,40,Clouds
53901,63,1553943600,13,22,35,Clouds
53902,64,1553943600,11,29,40,Clouds
53903,65,1553943600,39,1,40,Clouds
53904,66,1553943600,28,12,40,Clouds
53905,67,1553943600,19,21,40,Clouds
53906,68,1553943600,26,14,40,Clouds
53907,69,1553943600,19,21,40,Clouds
53908,70,1553943600,27,1,28,Clouds
53909,71,1553943600,40,0,40,Clouds
53910,72,1553943600,11,20,31,Clouds
53911,73,1553943600,18,12,30,Clouds
53912,74,1553943600,2,28,30,Clouds
53913,75,1553943600,15,25,40,Clouds
53914,76,1553943600,21,17,38,Clouds
53915,77,1553943600,21,8,29,Clouds
53916,78,1553943600,17,23,40,Clouds
53917,79,1553943600,21,6,27,Clouds
53918,80,1553943600,30,10,40,Clouds
53919,81,1553943600,36,4,40,Clouds
53920,82,1553943600,21,1,22,Clouds
53921,83,1553943600,9,31,40,Clouds
53922,84,1553943600,18,12,30,Clouds
53923,85,1553943600,25,10,35,Clouds
53924,86,1553943600,12,26,38,Clouds
53925,87,1553943600,11,27,38,Clouds
53926,88,1553943600,18,12,30,Clouds
53927,89,1553943600,36,4,40,Clouds
53928,90,1553943600,34,6,40,Clouds
53929,91,1553943600,18,12,30,Clouds
53930,92,1553943600,6,34,40,Clouds
53931,93,1553943600,3,37,40,Clouds
53932,94,1553943600,7,33,40,Clouds
53933,95,1553943600,31,9,40,Clouds
53934,96,1553943600,19,11,30,Clouds
53935,97,1553943600,27,13,40,Clouds
53936,98,1553943600,38,2,40,Clouds
53937,99,1553943600,25,5,30,Clouds
53938,100,1553943600,1,24,25,Clouds
53939,101,1553943600,21,9,30,Clouds
53940,102,1553943600,34,6,40,Clouds
53941,103,1553943600,36,4,40,Clouds
53942,104,1553943600,39,1,40,Clouds
53943,105,1553943600,34,2,36,Clouds
53944,106,1553943600,34,6,40,Clouds
53945,107,1553943600,27,13,40,Clouds
53946,108,1553943600,22,18,40,Clouds
53947,109,1553943600,18,11,29,Clouds
53948,110,1553943600,28,12,40,Clouds
53949,111,1553943600,18,22,40,Clouds
53950,112,1553943600,21,9,30,Clouds
53951,113,1553943600,40,0,40,Clouds
53952,114,1553943600,35,5,40,Clouds
53953,115,1553943600,17,13,30,Clouds
53954,2,1553947200,20,0,20,Clouds
53955,3,1553947200,18,2,20,Clouds
53956,4,1553947200,17,3,20,Clouds
53957,5,1553947200,16,24,40,Clouds
53958,6,1553947200,0,20,20,Clouds
53959,7,1553947200,19,10,29,Clouds
53960,8,1553947200,19,11,30,Clouds
53961,9,1553947200,6,18,24,Clouds
53962,10,1553947200,0,16,16,Clouds
53963,11,1553947200,28,2,30,Clouds
53964,12,1553947200,18,2,20,Clouds
53965,13,1553947200,23,7,30,Clouds
53966,14,1553947200,4,26,30,Clouds
53967,15,1553947200,16,0,16,Clouds
53968,16,1553947200,13,7,20,Clouds
53969,17,1553947200,15,5,20,Clouds
53970,18,1553947200,19,11,30,Clouds
53971,19,1553947200,21,9,30,Clouds
53972,21,1553947200,4,26,30,Clouds
53973,22,1553947200,2,18,20,Clouds
53974,23,1553947200,13,17,30,Clouds
53975,24,1553947200,8,12,20,Clouds
53976,25,1553947200,26,4,30,Clouds
53977,26,1553947200,12,8,20,Clouds
53978,27,1553947200,0,20,20,Clouds
53979,28,1553947200,25,5,30,Clouds
53980,29,1553947200,20,9,29,Clouds
53981,30,1553947200,12,8,20,Clouds
53982,31,1553947200,1,19,20,Clouds
53983,32,1553947200,12,18,30,Clouds
53984,33,1553947200,10,13,23,Clouds
53985,34,1553947200,21,9,30,Clouds
53986,35,1553947200,18,12,30,Clouds
53987,36,1553947200,35,5,40,Clouds
53988,37,1553947200,28,2,30,Clouds
53989,38,1553947200,26,14,40,Clouds
53990,39,1553947200,13,7,20,Clouds
53991,40,1553947200,1,20,21,Clouds
53992,41,1553947200,20,0,20,Clouds
53993,42,1553947200,20,10,30,Clouds
53994,43,1553947200,22,8,30,Clouds
53995,44,1553947200,19,11,30,Clouds
53996,45,1553947200,22,8,30,Clouds
53997,46,1553947200,7,13,20,Clouds
53998,47,1553947200,37,3,40,Clouds
53999,48,1553947200,12,28,40,Clouds
54000,49,1553947200,24,16,40,Clouds
54001,50,1553947200,33,7,40,Clouds
54002,51,1553947200,25,15,40,Clouds
54003,52,1553947200,9,23,32,Clouds
54004,53,1553947200,36,4,40,Clouds
54005,54,1553947200,25,8,33,Clouds
54006,55,1553947200,35,1,36,Clouds
54007,56,1553947200,39,1,40,Clouds
54008,57,1553947200,12,11,23,Clouds
54009,58,1553947200,38,2,40,Clouds
54010,59,1553947200,16,4,20,Clouds
54011,60,1553947200,23,6,29,Clouds
54012,61,1553947200,11,14,25,Clouds
54013,62,1553947200,39,1,40,Clouds
54014,63,1553947200,10,25,35,Clouds
54015,64,1553947200,10,30,40,Clouds
54016,65,1553947200,33,7,40,Clouds
54017,66,1553947200,35,5,40,Clouds
54018,67,1553947200,24,16,40,Clouds
54019,68,1553947200,30,10,40,Clouds
54020,69,1553947200,24,16,40,Clouds
54021,70,1553947200,27,1,28,Clouds
54022,71,1553947200,35,5,40,Clouds
54023,72,1553947200,8,23,31,Clouds
54024,73,1553947200,20,10,30,Clouds
54025,74,1553947200,3,27,30,Clouds
54026,75,1553947200,11,29,40,Clouds
54027,76,1553947200,21,17,38,Clouds
54028,77,1553947200,18,11,29,Clouds
54029,78,1553947200,15,25,40,Clouds
54030,79,1553947200,25,2,27,Clouds
54031,80,1553947200,31,9,40,Clouds
54032,81,1553947200,36,4,40,Clouds
54033,82,1553947200,22,0,22,Clouds
54034,83,1553947200,12,28,40,Clouds
54035,84,1553947200,24,6,30,Clouds
54036,85,1553947200,29,6,35,Clouds
54037,86,1553947200,19,19,38,Clouds
54038,87,1553947200,15,23,38,Clouds
54039,88,1553947200,18,12,30,Clouds
54040,89,1553947200,36,4,40,Clouds
54041,90,1553947200,35,5,40,Clouds
54042,91,1553947200,21,9,30,Clouds
54043,92,1553947200,4,36,40,Clouds
54044,93,1553947200,3,37,40,Clouds
54045,94,1553947200,7,33,40,Clouds
54046,95,1553947200,30,10,40,Clouds
54047,96,1553947200,21,9,30,Clouds
54048,97,1553947200,26,14,40,Clouds
54049,98,1553947200,36,4,40,Clouds
54050,99,1553947200,27,3,30,Clouds
54051,100,1553947200,0,25,25,Clouds
54052,101,1553947200,21,9,30,Clouds
54053,102,1553947200,36,4,40,Clouds
54054,103,1553947200,36,4,40,Clouds
54055,104,1553947200,39,1,40,Clouds
54056,105,1553947200,35,1,36,Clouds
54057,106,1553947200,35,5,40,Clouds
54058,107,1553947200,32,8,40,Clouds
54059,108,1553947200,23,17,40,Clouds
54060,109,1553947200,21,8,29,Clouds
54061,110,1553947200,31,9,40,Clouds
54062,111,1553947200,26,14,40,Clouds
54063,112,1553947200,19,11,30,Clouds
54064,113,1553947200,39,1,40,Clouds
54065,114,1553947200,32,8,40,Clouds
54066,115,1553947200,16,14,30,Clouds
54067,2,1553950800,20,0,20,Clouds
54068,3,1553950800,16,4,20,Clouds
54069,4,1553950800,18,2,20,Clouds
54070,5,1553950800,11,29,40,Clouds
54071,6,1553950800,3,17,20,Clouds
54072,7,1553950800,23,6,29,Clouds
54073,8,1553950800,13,17,30,Clouds
54074,9,1553950800,0,24,24,Clouds
54075,10,1553950800,1,15,16,Clouds
54076,11,1553950800,27,3,30,Clouds
54077,12,1553950800,20,0,20,Clouds
54078,13,1553950800,23,7,30,Clouds
54079,14,1553950800,1,29,30,Clouds
54080,15,1553950800,16,0,16,Clouds
54081,16,1553950800,12,8,20,Clouds
54082,17,1553950800,15,5,20,Clouds
54083,18,1553950800,23,7,30,Clouds
54084,19,1553950800,14,16,30,Clouds
54085,21,1553950800,0,30,30,Clouds
54086,22,1553950800,3,17,20,Clouds
54087,23,1553950800,1,29,30,Clouds
54088,24,1553950800,9,11,20,Clouds
54089,25,1553950800,27,3,30,Clouds
54090,26,1553950800,3,17,20,Clouds
54091,27,1553950800,0,20,20,Clouds
54092,28,1553950800,25,5,30,Clouds
54093,29,1553950800,13,16,29,Clouds
54094,30,1553950800,15,5,20,Clouds
54095,31,1553950800,0,20,20,Clouds
54096,32,1553950800,4,26,30,Clouds
54097,33,1553950800,3,20,23,Clouds
54098,34,1553950800,23,7,30,Clouds
54099,35,1553950800,19,11,30,Clouds
54100,36,1553950800,31,9,40,Clouds
54101,37,1553950800,26,4,30,Clouds
54102,38,1553950800,34,6,40,Clouds
54103,39,1553950800,20,0,20,Clouds
54104,40,1553950800,1,20,21,Clouds
54105,41,1553950800,20,0,20,Clouds
54106,42,1553950800,21,9,30,Clouds
54107,43,1553950800,30,0,30,Clouds
54108,44,1553950800,21,9,30,Clouds
54109,45,1553950800,24,6,30,Clouds
54110,46,1553950800,0,20,20,Clouds
54111,47,1553950800,37,3,40,Clouds
54112,48,1553950800,11,29,40,Clouds
54113,49,1553950800,23,17,40,Clouds
54114,50,1553950800,40,0,40,Clouds
54115,51,1553950800,16,24,40,Clouds
54116,52,1553950800,8,24,32,Clouds
54117,53,1553950800,37,3,40,Clouds
54118,54,1553950800,23,10,33,Clouds
54119,55,1553950800,35,1,36,Clouds
54120,56,1553950800,38,2,40,Clouds
54121,57,1553950800,13,10,23,Clouds
54122,58,1553950800,35,5,40,Clouds
54123,59,1553950800,15,5,20,Clouds
54124,60,1553950800,28,2,30,Clouds
54125,61,1553950800,13,12,25,Clouds
54126,62,1553950800,40,0,40,Clouds
54127,63,1553950800,9,26,35,Clouds
54128,64,1553950800,13,27,40,Clouds
54129,65,1553950800,39,1,40,Clouds
54130,66,1553950800,38,2,40,Clouds
54131,67,1553950800,25,15,40,Clouds
54132,68,1553950800,40,0,40,Clouds
54133,69,1553950800,29,11,40,Clouds
54134,70,1553950800,28,0,28,Clouds
54135,71,1553950800,36,4,40,Clouds
54136,72,1553950800,12,19,31,Clouds
54137,73,1553950800,23,7,30,Clouds
54138,74,1553950800,4,26,30,Clouds
54139,75,1553950800,17,23,40,Clouds
54140,76,1553950800,22,16,38,Clouds
54141,77,1553950800,5,24,29,Clouds
54142,78,1553950800,23,17,40,Clouds
54143,79,1553950800,26,1,27,Clouds
54144,80,1553950800,33,7,40,Clouds
54145,81,1553950800,37,3,40,Clouds
54146,82,1553950800,22,0,22,Clouds
54147,83,1553950800,21,19,40,Clouds
54148,84,1553950800,26,4,30,Clouds
54149,85,1553950800,35,0,35,Clouds
54150,86,1553950800,18,20,38,Clouds
54151,87,1553950800,16,22,38,Clouds
54152,88,1553950800,22,8,30,Clouds
54153,89,1553950800,35,5,40,Clouds
54154,90,1553950800,33,7,40,Clouds
54155,91,1553950800,17,13,30,Clouds
54156,92,1553950800,7,33,40,Clouds
54157,93,1553950800,3,37,40,Clouds
54158,94,1553950800,6,34,40,Clouds
54159,95,1553950800,34,6,40,Clouds
54160,96,1553950800,21,9,30,Clouds
54161,97,1553950800,30,10,40,Clouds
54162,98,1553950800,31,9,40,Clouds
54163,99,1553950800,28,2,30,Clouds
54164,100,1553950800,2,23,25,Clouds
54165,101,1553950800,22,8,30,Clouds
54166,102,1553950800,39,1,40,Clouds
54167,103,1553950800,37,3,40,Clouds
54168,104,1553950800,37,3,40,Clouds
54169,105,1553950800,36,0,36,Clouds
54170,106,1553950800,37,3,40,Clouds
54171,107,1553950800,31,9,40,Clouds
54172,108,1553950800,27,13,40,Clouds
54173,109,1553950800,23,6,29,Clouds
54174,110,1553950800,29,11,40,Clouds
54175,111,1553950800,33,7,40,Clouds
54176,112,1553950800,22,8,30,Clouds
54177,113,1553950800,39,1,40,Clouds
54178,114,1553950800,33,7,40,Clouds
54179,115,1553950800,18,12,30,Clouds
54180,2,1553954400,20,0,20,Drizzle
54181,3,1553954400,15,5,20,Drizzle
54182,4,1553954400,18,2,20,Drizzle
54183,5,1553954400,25,15,40,Drizzle
54184,6,1553954400,1,19,20,Drizzle
54185,7,1553954400,18,11,29,Drizzle
54186,8,1553954400,8,22,30,Drizzle
54187,9,1553954400,1,23,24,Drizzle
54188,10,1553954400,0,16,16,Drizzle
54189,11,1553954400,29,1,30,Drizzle
54190,12,1553954400,18,2,20,Drizzle
54191,13,1553954400,21,9,30,Drizzle
54192,14,1553954400,1,29,30,Drizzle
54193,15,1553954400,16,0,16,Drizzle
54194,16,1553954400,6,14,20,Drizzle
54195,17,1553954400,14,6,20,Drizzle
54196,18,1553954400,27,3,30,Drizzle
54197,19,1553954400,5,25,30,Drizzle
54198,21,1553954400,0,30,30,Drizzle
54199,22,1553954400,1,19,20,Drizzle
54200,23,1553954400,1,29,30,Drizzle
54201,24,1553954400,0,20,20,Drizzle
54202,25,1553954400,30,0,30,Drizzle
54203,26,1553954400,2,18,20,Drizzle
54204,27,1553954400,0,20,20,Drizzle
54205,28,1553954400,24,6,30,Drizzle
54206,29,1553954400,0,29,29,Drizzle
54207,30,1553954400,18,2,20,Drizzle
54208,31,1553954400,11,9,20,Drizzle
54209,32,1553954400,0,30,30,Drizzle
54210,33,1553954400,0,23,23,Drizzle
54211,34,1553954400,28,2,30,Drizzle
54212,35,1553954400,24,6,30,Drizzle
54213,36,1553954400,33,7,40,Drizzle
54214,37,1553954400,25,5,30,Drizzle
54215,38,1553954400,32,8,40,Drizzle
54216,39,1553954400,17,3,20,Drizzle
54217,40,1553954400,0,21,21,Drizzle
54218,41,1553954400,19,1,20,Drizzle
54219,42,1553954400,23,7,30,Drizzle
54220,43,1553954400,28,2,30,Drizzle
54221,44,1553954400,27,3,30,Drizzle
54222,45,1553954400,16,14,30,Drizzle
54223,46,1553954400,0,20,20,Drizzle
54224,47,1553954400,36,4,40,Drizzle
54225,48,1553954400,12,28,40,Drizzle
54226,49,1553954400,25,15,40,Drizzle
54227,50,1553954400,40,0,40,Drizzle
54228,51,1553954400,10,30,40,Drizzle
54229,52,1553954400,4,28,32,Drizzle
54230,53,1553954400,36,4,40,Drizzle
54231,54,1553954400,23,10,33,Drizzle
54232,55,1553954400,36,0,36,Drizzle
54233,56,1553954400,32,8,40,Drizzle
54234,57,1553954400,12,11,23,Drizzle
54235,58,1553954400,33,7,40,Drizzle
54236,59,1553954400,19,1,20,Drizzle
54237,60,1553954400,27,3,30,Drizzle
54238,61,1553954400,16,9,25,Drizzle
54239,62,1553954400,38,2,40,Drizzle
54240,63,1553954400,4,31,35,Drizzle
54241,64,1553954400,14,26,40,Drizzle
54242,65,1553954400,40,0,40,Drizzle
54243,66,1553954400,39,1,40,Drizzle
54244,67,1553954400,32,8,40,Drizzle
54245,68,1553954400,38,2,40,Drizzle
54246,69,1553954400,32,8,40,Drizzle
54247,70,1553954400,27,1,28,Drizzle
54248,71,1553954400,35,5,40,Drizzle
54249,72,1553954400,13,18,31,Drizzle
54250,73,1553954400,28,2,30,Drizzle
54251,74,1553954400,0,30,30,Drizzle
54252,75,1553954400,14,26,40,Drizzle
54253,76,1553954400,26,12,38,Drizzle
54254,77,1553954400,1,28,29,Drizzle
54255,78,1553954400,22,18,40,Drizzle
54256,79,1553954400,15,12,27,Drizzle
54257,80,1553954400,35,5,40,Drizzle
54258,81,1553954400,37,3,40,Drizzle
54259,82,1553954400,22,0,22,Drizzle
54260,83,1553954400,24,16,40,Drizzle
54261,84,1553954400,27,3,30,Drizzle
54262,85,1553954400,35,0,35,Drizzle
54263,86,1553954400,20,18,38,Drizzle
54264,87,1553954400,18,20,38,Drizzle
54265,88,1553954400,30,0,30,Drizzle
54266,89,1553954400,37,3,40,Drizzle
54267,90,1553954400,36,4,40,Drizzle
54268,91,1553954400,23,7,30,Drizzle
54269,92,1553954400,7,33,40,Drizzle
54270,93,1553954400,3,37,40,Drizzle
54271,94,1553954400,6,34,40,Drizzle
54272,95,1553954400,35,5,40,Drizzle
54273,96,1553954400,20,10,30,Drizzle
54274,97,1553954400,37,3,40,Drizzle
54275,98,1553954400,23,17,40,Drizzle
54276,99,1553954400,30,0,30,Drizzle
54277,100,1553954400,0,25,25,Drizzle
54278,101,1553954400,26,4,30,Drizzle
54279,102,1553954400,40,0,40,Drizzle
54280,103,1553954400,36,4,40,Drizzle
54281,104,1553954400,38,2,40,Drizzle
54282,105,1553954400,36,0,36,Drizzle
54283,106,1553954400,39,1,40,Drizzle
54284,107,1553954400,35,5,40,Drizzle
54285,108,1553954400,29,11,40,Drizzle
54286,109,1553954400,26,3,29,Drizzle
54287,110,1553954400,31,9,40,Drizzle
54288,111,1553954400,34,6,40,Drizzle
54289,112,1553954400,20,10,30,Drizzle
54290,113,1553954400,40,0,40,Drizzle
54291,114,1553954400,38,2,40,Drizzle
54292,115,1553954400,15,15,30,Drizzle
54293,2,1553958000,20,0,20,Drizzle
54294,3,1553958000,17,3,20,Drizzle
54295,4,1553958000,13,7,20,Drizzle
54296,5,1553958000,21,19,40,Drizzle
54297,6,1553958000,1,19,20,Drizzle
54298,7,1553958000,14,15,29,Drizzle
54299,8,1553958000,9,21,30,Drizzle
54300,9,1553958000,4,20,24,Drizzle
54301,10,1553958000,0,16,16,Drizzle
54302,11,1553958000,29,1,30,Drizzle
54303,12,1553958000,17,3,20,Drizzle
54304,13,1553958000,19,11,30,Drizzle
54305,14,1553958000,0,30,30,Drizzle
54306,15,1553958000,16,0,16,Drizzle
54307,16,1553958000,7,13,20,Drizzle
54308,17,1553958000,14,6,20,Drizzle
54309,18,1553958000,15,15,30,Drizzle
54310,19,1553958000,4,26,30,Drizzle
54311,21,1553958000,0,30,30,Drizzle
54312,22,1553958000,0,20,20,Drizzle
54313,23,1553958000,26,4,30,Drizzle
54314,24,1553958000,6,14,20,Drizzle
54315,25,1553958000,28,2,30,Drizzle
54316,26,1553958000,4,16,20,Drizzle
54317,27,1553958000,1,19,20,Drizzle
54318,28,1553958000,8,22,30,Drizzle
54319,29,1553958000,0,29,29,Drizzle
54320,30,1553958000,20,0,20,Drizzle
54321,31,1553958000,9,11,20,Drizzle
54322,32,1553958000,3,27,30,Drizzle
54323,33,1553958000,18,5,23,Drizzle
54324,34,1553958000,30,0,30,Drizzle
54325,35,1553958000,23,7,30,Drizzle
54326,36,1553958000,32,8,40,Drizzle
54327,37,1553958000,24,6,30,Drizzle
54328,38,1553958000,29,11,40,Drizzle
54329,39,1553958000,12,8,20,Drizzle
54330,40,1553958000,0,21,21,Drizzle
54331,41,1553958000,19,1,20,Drizzle
54332,42,1553958000,19,11,30,Drizzle
54333,43,1553958000,30,0,30,Drizzle
54334,44,1553958000,27,3,30,Drizzle
54335,45,1553958000,19,11,30,Drizzle
54336,46,1553958000,0,20,20,Drizzle
54337,47,1553958000,37,3,40,Drizzle
54338,48,1553958000,9,31,40,Drizzle
54339,49,1553958000,27,13,40,Drizzle
54340,50,1553958000,36,4,40,Drizzle
54341,51,1553958000,1,39,40,Drizzle
54342,52,1553958000,3,29,32,Drizzle
54343,53,1553958000,38,2,40,Drizzle
54344,54,1553958000,24,9,33,Drizzle
54345,55,1553958000,36,0,36,Drizzle
54346,56,1553958000,22,18,40,Drizzle
54347,57,1553958000,12,11,23,Drizzle
54348,58,1553958000,32,8,40,Drizzle
54349,59,1553958000,18,2,20,Drizzle
54350,60,1553958000,8,22,30,Drizzle
54351,61,1553958000,17,8,25,Drizzle
54352,62,1553958000,37,3,40,Drizzle
54353,63,1553958000,4,31,35,Drizzle
54354,64,1553958000,10,30,40,Drizzle
54355,65,1553958000,38,2,40,Drizzle
54356,66,1553958000,38,2,40,Drizzle
54357,67,1553958000,35,5,40,Drizzle
54358,68,1553958000,37,3,40,Drizzle
54359,69,1553958000,35,5,40,Drizzle
54360,70,1553958000,28,0,28,Drizzle
54361,71,1553958000,36,4,40,Drizzle
54362,72,1553958000,4,27,31,Drizzle
54363,73,1553958000,30,0,30,Drizzle
54364,74,1553958000,0,30,30,Drizzle
54365,75,1553958000,23,17,40,Drizzle
54366,76,1553958000,29,9,38,Drizzle
54367,77,1553958000,7,22,29,Drizzle
54368,78,1553958000,21,19,40,Drizzle
54369,79,1553958000,15,12,27,Drizzle
54370,80,1553958000,37,3,40,Drizzle
54371,81,1553958000,40,0,40,Drizzle
54372,82,1553958000,22,0,22,Drizzle
54373,83,1553958000,30,10,40,Drizzle
54374,84,1553958000,30,0,30,Drizzle
54375,85,1553958000,31,4,35,Drizzle
54376,86,1553958000,26,12,38,Drizzle
54377,87,1553958000,16,22,38,Drizzle
54378,88,1553958000,30,0,30,Drizzle
54379,89,1553958000,37,3,40,Drizzle
54380,90,1553958000,39,1,40,Drizzle
54381,91,1553958000,26,4,30,Drizzle
54382,92,1553958000,8,32,40,Drizzle
54383,93,1553958000,4,36,40,Drizzle
54384,94,1553958000,6,34,40,Drizzle
54385,95,1553958000,40,0,40,Drizzle
54386,96,1553958000,24,6,30,Drizzle
54387,97,1553958000,39,1,40,Drizzle
54388,98,1553958000,19,21,40,Drizzle
54389,99,1553958000,30,0,30,Drizzle
54390,100,1553958000,3,22,25,Drizzle
54391,101,1553958000,30,0,30,Drizzle
54392,102,1553958000,39,1,40,Drizzle
54393,103,1553958000,36,4,40,Drizzle
54394,104,1553958000,39,1,40,Drizzle
54395,105,1553958000,36,0,36,Drizzle
54396,106,1553958000,37,3,40,Drizzle
54397,107,1553958000,35,5,40,Drizzle
54398,108,1553958000,28,12,40,Drizzle
54399,109,1553958000,25,4,29,Drizzle
54400,110,1553958000,36,4,40,Drizzle
54401,111,1553958000,35,5,40,Drizzle
54402,112,1553958000,22,8,30,Drizzle
54403,113,1553958000,39,1,40,Drizzle
54404,114,1553958000,35,5,40,Drizzle
54405,115,1553958000,21,9,30,Drizzle
54406,2,1553961600,18,2,20,Rain
54407,3,1553961600,16,4,20,Rain
54408,4,1553961600,15,5,20,Rain
54409,5,1553961600,31,9,40,Rain
54410,6,1553961600,0,20,20,Rain
54411,7,1553961600,13,16,29,Rain
54412,8,1553961600,14,16,30,Rain
54413,9,1553961600,0,24,24,Rain
54414,10,1553961600,0,16,16,Rain
54415,11,1553961600,30,0,30,Rain
54416,12,1553961600,15,5,20,Rain
54417,13,1553961600,17,13,30,Rain
54418,14,1553961600,0,30,30,Rain
54419,15,1553961600,16,0,16,Rain
54420,16,1553961600,8,12,20,Rain
54421,17,1553961600,11,9,20,Rain
54422,18,1553961600,18,12,30,Rain
54423,19,1553961600,2,28,30,Rain
54424,21,1553961600,0,30,30,Rain
54425,22,1553961600,9,11,20,Rain
54426,23,1553961600,24,6,30,Rain
54427,24,1553961600,0,20,20,Rain
54428,25,1553961600,27,3,30,Rain
54429,26,1553961600,1,19,20,Rain
54430,27,1553961600,3,17,20,Rain
54431,28,1553961600,15,15,30,Rain
54432,29,1553961600,0,29,29,Rain
54433,30,1553961600,20,0,20,Rain
54434,31,1553961600,12,8,20,Rain
54435,32,1553961600,10,20,30,Rain
54436,33,1553961600,11,12,23,Rain
54437,34,1553961600,27,3,30,Rain
54438,35,1553961600,28,2,30,Rain
54439,36,1553961600,29,11,40,Rain
54440,37,1553961600,21,9,30,Rain
54441,38,1553961600,25,15,40,Rain
54442,39,1553961600,16,4,20,Rain
54443,40,1553961600,2,19,21,Rain
54444,41,1553961600,19,1,20,Rain
54445,42,1553961600,19,11,30,Rain
54446,43,1553961600,12,18,30,Rain
54447,44,1553961600,12,18,30,Rain
54448,45,1553961600,17,13,30,Rain
54449,46,1553961600,0,20,20,Rain
54450,47,1553961600,35,5,40,Rain
54451,48,1553961600,10,30,40,Rain
54452,49,1553961600,31,9,40,Rain
54453,50,1553961600,36,4,40,Rain
54454,51,1553961600,2,38,40,Rain
54455,52,1553961600,0,32,32,Rain
54456,53,1553961600,36,4,40,Rain
54457,54,1553961600,23,10,33,Rain
54458,55,1553961600,36,0,36,Rain
54459,56,1553961600,25,15,40,Rain
54460,57,1553961600,13,10,23,Rain
54461,58,1553961600,28,12,40,Rain
54462,59,1553961600,17,3,20,Rain
54463,60,1553961600,12,18,30,Rain
54464,61,1553961600,18,7,25,Rain
54465,62,1553961600,36,4,40,Rain
54466,63,1553961600,7,28,35,Rain
54467,64,1553961600,12,28,40,Rain
54468,65,1553961600,40,0,40,Rain
54469,66,1553961600,40,0,40,Rain
54470,67,1553961600,33,7,40,Rain
54471,68,1553961600,39,1,40,Rain
54472,69,1553961600,32,8,40,Rain
54473,70,1553961600,25,3,28,Rain
54474,71,1553961600,37,3,40,Rain
54475,72,1553961600,8,23,31,Rain
54476,73,1553961600,30,0,30,Rain
54477,74,1553961600,5,25,30,Rain
54478,75,1553961600,23,17,40,Rain
54479,76,1553961600,31,7,38,Rain
54480,77,1553961600,7,22,29,Rain
54481,78,1553961600,23,17,40,Rain
54482,79,1553961600,17,10,27,Rain
54483,80,1553961600,38,2,40,Rain
54484,81,1553961600,40,0,40,Rain
54485,82,1553961600,22,0,22,Rain
54486,83,1553961600,27,13,40,Rain
54487,84,1553961600,30,0,30,Rain
54488,85,1553961600,28,7,35,Rain
54489,86,1553961600,16,22,38,Rain
54490,87,1553961600,17,21,38,Rain
54491,88,1553961600,30,0,30,Rain
54492,89,1553961600,39,1,40,Rain
54493,90,1553961600,39,1,40,Rain
54494,91,1553961600,17,13,30,Rain
54495,92,1553961600,10,30,40,Rain
54496,93,1553961600,4,36,40,Rain
54497,94,1553961600,6,34,40,Rain
54498,95,1553961600,37,3,40,Rain
54499,96,1553961600,26,4,30,Rain
54500,97,1553961600,40,0,40,Rain
54501,98,1553961600,17,23,40,Rain
54502,99,1553961600,28,2,30,Rain
54503,100,1553961600,0,25,25,Rain
54504,101,1553961600,27,3,30,Rain
54505,102,1553961600,40,0,40,Rain
54506,103,1553961600,37,3,40,Rain
54507,104,1553961600,39,1,40,Rain
54508,105,1553961600,36,0,36,Rain
54509,106,1553961600,40,0,40,Rain
54510,107,1553961600,40,0,40,Rain
54511,108,1553961600,23,17,40,Rain
54512,109,1553961600,27,2,29,Rain
54513,110,1553961600,39,1,40,Rain
54514,111,1553961600,37,3,40,Rain
54515,112,1553961600,22,8,30,Rain
54516,113,1553961600,38,2,40,Rain
54517,114,1553961600,32,8,40,Rain
54518,115,1553961600,24,6,30,Rain
54519,2,1553968800,20,0,20,Drizzle
54520,3,1553968800,20,0,20,Drizzle
54521,4,1553968800,19,1,20,Drizzle
54522,5,1553968800,37,3,40,Drizzle
54523,6,1553968800,0,20,20,Drizzle
54524,7,1553968800,12,17,29,Drizzle
54525,8,1553968800,13,17,30,Drizzle
54526,9,1553968800,2,22,24,Drizzle
54527,10,1553968800,4,12,16,Drizzle
54528,11,1553968800,30,0,30,Drizzle
54529,12,1553968800,20,0,20,Drizzle
54530,13,1553968800,17,13,30,Drizzle
54531,14,1553968800,0,30,30,Drizzle
54532,15,1553968800,16,0,16,Drizzle
54533,16,1553968800,9,11,20,Drizzle
54534,17,1553968800,12,8,20,Drizzle
54535,18,1553968800,29,1,30,Drizzle
54536,19,1553968800,2,28,30,Drizzle
54537,21,1553968800,8,22,30,Drizzle
54538,22,1553968800,4,16,20,Drizzle
54539,23,1553968800,18,12,30,Drizzle
54540,24,1553968800,7,13,20,Drizzle
54541,25,1553968800,26,4,30,Drizzle
54542,26,1553968800,8,12,20,Drizzle
54543,27,1553968800,0,20,20,Drizzle
54544,28,1553968800,14,16,30,Drizzle
54545,29,1553968800,4,25,29,Drizzle
54546,30,1553968800,20,0,20,Drizzle
54547,31,1553968800,18,2,20,Drizzle
54548,32,1553968800,3,27,30,Drizzle
54549,33,1553968800,1,22,23,Drizzle
54550,34,1553968800,18,12,30,Drizzle
54551,35,1553968800,25,5,30,Drizzle
54552,36,1553968800,28,12,40,Drizzle
54553,37,1553968800,21,9,30,Drizzle
54554,38,1553968800,19,21,40,Drizzle
54555,39,1553968800,17,1,18,Drizzle
54556,40,1553968800,8,13,21,Drizzle
54557,41,1553968800,20,0,20,Drizzle
54558,42,1553968800,19,11,30,Drizzle
54559,43,1553968800,23,7,30,Drizzle
54560,44,1553968800,10,20,30,Drizzle
54561,45,1553968800,18,12,30,Drizzle
54562,46,1553968800,5,15,20,Drizzle
54563,47,1553968800,26,14,40,Drizzle
54564,48,1553968800,14,26,40,Drizzle
54565,49,1553968800,40,0,40,Drizzle
54566,50,1553968800,34,6,40,Drizzle
54567,51,1553968800,2,38,40,Drizzle
54568,52,1553968800,3,29,32,Drizzle
54569,53,1553968800,40,0,40,Drizzle
54570,54,1553968800,25,8,33,Drizzle
54571,55,1553968800,36,0,36,Drizzle
54572,56,1553968800,10,30,40,Drizzle
54573,57,1553968800,9,14,23,Drizzle
54574,58,1553968800,0,40,40,Drizzle
54575,59,1553968800,17,3,20,Drizzle
54576,60,1553968800,22,8,30,Drizzle
54577,61,1553968800,15,10,25,Drizzle
54578,62,1553968800,38,2,40,Drizzle
54579,63,1553968800,5,30,35,Drizzle
54580,64,1553968800,12,28,40,Drizzle
54581,65,1553968800,40,0,40,Drizzle
54582,66,1553968800,38,2,40,Drizzle
54583,67,1553968800,33,7,40,Drizzle
54584,68,1553968800,40,0,40,Drizzle
54585,69,1553968800,25,15,40,Drizzle
54586,70,1553968800,13,15,28,Drizzle
54587,71,1553968800,36,4,40,Drizzle
54588,72,1553968800,12,19,31,Drizzle
54589,73,1553968800,27,3,30,Drizzle
54590,74,1553968800,2,28,30,Drizzle
54591,75,1553968800,38,2,40,Drizzle
54592,76,1553968800,33,5,38,Drizzle
54593,77,1553968800,4,25,29,Drizzle
54594,78,1553968800,23,17,40,Drizzle
54595,79,1553968800,18,9,27,Drizzle
54596,80,1553968800,40,0,40,Drizzle
54597,81,1553968800,40,0,40,Drizzle
54598,82,1553968800,21,1,22,Drizzle
54599,83,1553968800,33,7,40,Drizzle
54600,84,1553968800,30,0,30,Drizzle
54601,85,1553968800,35,0,35,Drizzle
54602,86,1553968800,29,9,38,Drizzle
54603,87,1553968800,16,22,38,Drizzle
54604,88,1553968800,24,6,30,Drizzle
54605,89,1553968800,38,2,40,Drizzle
54606,90,1553968800,40,0,40,Drizzle
54607,91,1553968800,9,21,30,Drizzle
54608,92,1553968800,4,36,40,Drizzle
54609,93,1553968800,5,35,40,Drizzle
54610,94,1553968800,6,34,40,Drizzle
54611,95,1553968800,38,2,40,Drizzle
54612,96,1553968800,28,2,30,Drizzle
54613,97,1553968800,40,0,40,Drizzle
54614,98,1553968800,11,29,40,Drizzle
54615,99,1553968800,25,5,30,Drizzle
54616,100,1553968800,1,24,25,Drizzle
54617,101,1553968800,30,0,30,Drizzle
54618,102,1553968800,39,1,40,Drizzle
54619,103,1553968800,38,2,40,Drizzle
54620,104,1553968800,39,1,40,Drizzle
54621,105,1553968800,35,1,36,Drizzle
54622,106,1553968800,40,0,40,Drizzle
54623,107,1553968800,37,3,40,Drizzle
54624,108,1553968800,26,14,40,Drizzle
54625,109,1553968800,25,4,29,Drizzle
54626,110,1553968800,38,2,40,Drizzle
54627,111,1553968800,38,2,40,Drizzle
54628,112,1553968800,14,16,30,Drizzle
54629,113,1553968800,38,2,40,Drizzle
54630,114,1553968800,11,29,40,Drizzle
54631,115,1553968800,23,7,30,Drizzle
54632,2,1553972400,20,0,20,Clouds
54633,3,1553972400,19,1,20,Clouds
54634,4,1553972400,16,4,20,Clouds
54635,5,1553972400,40,0,40,Clouds
54636,6,1553972400,0,20,20,Clouds
54637,7,1553972400,15,14,29,Clouds
54638,8,1553972400,13,17,30,Clouds
54639,9,1553972400,2,22,24,Clouds
54640,10,1553972400,1,15,16,Clouds
54641,11,1553972400,30,0,30,Clouds
54642,12,1553972400,18,2,20,Clouds
54643,13,1553972400,18,12,30,Clouds
54644,14,1553972400,2,28,30,Clouds
54645,15,1553972400,14,2,16,Clouds
54646,16,1553972400,12,8,20,Clouds
54647,17,1553972400,12,8,20,Clouds
54648,18,1553972400,28,2,30,Clouds
54649,19,1553972400,1,29,30,Clouds
54650,21,1553972400,9,21,30,Clouds
54651,22,1553972400,11,9,20,Clouds
54652,23,1553972400,19,11,30,Clouds
54653,24,1553972400,0,19,19,Clouds
54654,25,1553972400,26,4,30,Clouds
54655,26,1553972400,7,13,20,Clouds
54656,27,1553972400,0,20,20,Clouds
54657,28,1553972400,16,14,30,Clouds
54658,29,1553972400,0,29,29,Clouds
54659,30,1553972400,20,0,20,Clouds
54660,31,1553972400,17,3,20,Clouds
54661,32,1553972400,5,25,30,Clouds
54662,33,1553972400,2,21,23,Clouds
54663,34,1553972400,16,14,30,Clouds
54664,35,1553972400,26,4,30,Clouds
54665,36,1553972400,26,14,40,Clouds
54666,37,1553972400,22,8,30,Clouds
54667,38,1553972400,24,16,40,Clouds
54668,39,1553972400,11,7,18,Clouds
54669,40,1553972400,7,14,21,Clouds
54670,41,1553972400,20,0,20,Clouds
54671,42,1553972400,21,9,30,Clouds
54672,43,1553972400,23,7,30,Clouds
54673,44,1553972400,12,18,30,Clouds
54674,45,1553972400,16,14,30,Clouds
54675,46,1553972400,4,16,20,Clouds
54676,47,1553972400,22,18,40,Clouds
54677,48,1553972400,14,26,40,Clouds
54678,49,1553972400,37,3,40,Clouds
54679,50,1553972400,32,8,40,Clouds
54680,51,1553972400,0,40,40,Clouds
54681,52,1553972400,7,25,32,Clouds
54682,53,1553972400,40,0,40,Clouds
54683,54,1553972400,27,6,33,Clouds
54684,55,1553972400,35,1,36,Clouds
54685,56,1553972400,2,38,40,Clouds
54686,57,1553972400,9,14,23,Clouds
54687,58,1553972400,1,38,39,Clouds
54688,59,1553972400,17,3,20,Clouds
54689,60,1553972400,27,3,30,Clouds
54690,61,1553972400,17,8,25,Clouds
54691,62,1553972400,37,3,40,Clouds
54692,63,1553972400,9,26,35,Clouds
54693,64,1553972400,8,32,40,Clouds
54694,65,1553972400,40,0,40,Clouds
54695,66,1553972400,39,1,40,Clouds
54696,67,1553972400,29,11,40,Clouds
54697,68,1553972400,34,6,40,Clouds
54698,69,1553972400,30,10,40,Clouds
54699,70,1553972400,2,26,28,Clouds
54700,71,1553972400,31,9,40,Clouds
54701,72,1553972400,13,18,31,Clouds
54702,73,1553972400,29,1,30,Clouds
54703,74,1553972400,0,30,30,Clouds
54704,75,1553972400,40,0,40,Clouds
54705,76,1553972400,32,6,38,Clouds
54706,77,1553972400,0,29,29,Clouds
54707,78,1553972400,24,16,40,Clouds
54708,79,1553972400,18,9,27,Clouds
54709,80,1553972400,39,1,40,Clouds
54710,81,1553972400,40,0,40,Clouds
54711,82,1553972400,19,3,22,Clouds
54712,83,1553972400,30,10,40,Clouds
54713,84,1553972400,30,0,30,Clouds
54714,85,1553972400,34,1,35,Clouds
54715,86,1553972400,30,8,38,Clouds
54716,87,1553972400,18,20,38,Clouds
54717,88,1553972400,21,9,30,Clouds
54718,89,1553972400,37,3,40,Clouds
54719,90,1553972400,40,0,40,Clouds
54720,91,1553972400,1,29,30,Clouds
54721,92,1553972400,8,32,40,Clouds
54722,93,1553972400,5,35,40,Clouds
54723,94,1553972400,6,34,40,Clouds
54724,95,1553972400,37,3,40,Clouds
54725,96,1553972400,26,4,30,Clouds
54726,97,1553972400,39,1,40,Clouds
54727,98,1553972400,12,28,40,Clouds
54728,99,1553972400,25,5,30,Clouds
54729,100,1553972400,2,23,25,Clouds
54730,101,1553972400,29,1,30,Clouds
54731,102,1553972400,40,0,40,Clouds
54732,103,1553972400,38,2,40,Clouds
54733,104,1553972400,39,1,40,Clouds
54734,105,1553972400,36,0,36,Clouds
54735,106,1553972400,40,0,40,Clouds
54736,107,1553972400,38,2,40,Clouds
54737,108,1553972400,29,11,40,Clouds
54738,109,1553972400,28,1,29,Clouds
54739,110,1553972400,39,1,40,Clouds
54740,111,1553972400,40,0,40,Clouds
54741,112,1553972400,15,15,30,Clouds
54742,113,1553972400,39,1,40,Clouds
54743,114,1553972400,11,29,40,Clouds
54744,115,1553972400,26,4,30,Clouds
54745,2,1553976000,19,1,20,Clouds
54746,3,1553976000,17,3,20,Clouds
54747,4,1553976000,16,4,20,Clouds
54748,5,1553976000,33,7,40,Clouds
54749,6,1553976000,0,20,20,Clouds
54750,7,1553976000,13,16,29,Clouds
54751,8,1553976000,10,20,30,Clouds
54752,9,1553976000,0,24,24,Clouds
54753,10,1553976000,0,16,16,Clouds
54754,11,1553976000,28,2,30,Clouds
54755,12,1553976000,14,6,20,Clouds
54756,13,1553976000,20,10,30,Clouds
54757,14,1553976000,0,30,30,Clouds
54758,15,1553976000,16,0,16,Clouds
54759,16,1553976000,13,7,20,Clouds
54760,17,1553976000,12,8,20,Clouds
54761,18,1553976000,23,7,30,Clouds
54762,19,1553976000,5,25,30,Clouds
54763,21,1553976000,8,22,30,Clouds
54764,22,1553976000,10,10,20,Clouds
54765,23,1553976000,15,15,30,Clouds
54766,24,1553976000,7,13,20,Clouds
54767,25,1553976000,25,5,30,Clouds
54768,26,1553976000,6,14,20,Clouds
54769,27,1553976000,5,15,20,Clouds
54770,28,1553976000,17,13,30,Clouds
54771,29,1553976000,1,28,29,Clouds
54772,30,1553976000,20,0,20,Clouds
54773,31,1553976000,15,5,20,Clouds
54774,32,1553976000,14,16,30,Clouds
54775,33,1553976000,1,22,23,Clouds
54776,34,1553976000,20,10,30,Clouds
54777,35,1553976000,25,5,30,Clouds
54778,36,1553976000,25,15,40,Clouds
54779,37,1553976000,20,10,30,Clouds
54780,38,1553976000,26,14,40,Clouds
54781,39,1553976000,11,7,18,Clouds
54782,40,1553976000,10,11,21,Clouds
54783,41,1553976000,20,0,20,Clouds
54784,42,1553976000,18,12,30,Clouds
54785,43,1553976000,24,6,30,Clouds
54786,44,1553976000,13,17,30,Clouds
54787,45,1553976000,20,10,30,Clouds
54788,46,1553976000,3,17,20,Clouds
54789,47,1553976000,22,18,40,Clouds
54790,48,1553976000,18,22,40,Clouds
54791,49,1553976000,40,0,40,Clouds
54792,50,1553976000,30,10,40,Clouds
54793,51,1553976000,21,19,40,Clouds
54794,52,1553976000,8,24,32,Clouds
54795,53,1553976000,39,1,40,Clouds
54796,54,1553976000,26,7,33,Clouds
54797,55,1553976000,34,2,36,Clouds
54798,56,1553976000,5,35,40,Clouds
54799,57,1553976000,9,14,23,Clouds
54800,58,1553976000,6,34,40,Clouds
54801,59,1553976000,17,3,20,Clouds
54802,60,1553976000,30,0,30,Clouds
54803,61,1553976000,18,7,25,Clouds
54804,62,1553976000,35,5,40,Clouds
54805,63,1553976000,8,27,35,Clouds
54806,64,1553976000,7,33,40,Clouds
54807,65,1553976000,40,0,40,Clouds
54808,66,1553976000,35,5,40,Clouds
54809,67,1553976000,34,6,40,Clouds
54810,68,1553976000,30,10,40,Clouds
54811,69,1553976000,29,11,40,Clouds
54812,70,1553976000,0,28,28,Clouds
54813,71,1553976000,29,11,40,Clouds
54814,72,1553976000,8,23,31,Clouds
54815,73,1553976000,30,0,30,Clouds
54816,74,1553976000,1,29,30,Clouds
54817,75,1553976000,40,0,40,Clouds
54818,76,1553976000,37,1,38,Clouds
54819,77,1553976000,3,26,29,Clouds
54820,78,1553976000,26,14,40,Clouds
54821,79,1553976000,18,9,27,Clouds
54822,80,1553976000,38,2,40,Clouds
54823,81,1553976000,40,0,40,Clouds
54824,82,1553976000,20,2,22,Clouds
54825,83,1553976000,35,5,40,Clouds
54826,84,1553976000,27,3,30,Clouds
54827,85,1553976000,35,0,35,Clouds
54828,86,1553976000,25,13,38,Clouds
54829,87,1553976000,21,17,38,Clouds
54830,88,1553976000,17,13,30,Clouds
54831,89,1553976000,38,2,40,Clouds
54832,90,1553976000,40,0,40,Clouds
54833,91,1553976000,4,26,30,Clouds
54834,92,1553976000,7,33,40,Clouds
54835,93,1553976000,5,35,40,Clouds
54836,94,1553976000,6,34,40,Clouds
54837,95,1553976000,39,1,40,Clouds
54838,96,1553976000,27,3,30,Clouds
54839,97,1553976000,36,4,40,Clouds
54840,98,1553976000,14,26,40,Clouds
54841,99,1553976000,25,5,30,Clouds
54842,100,1553976000,2,23,25,Clouds
54843,101,1553976000,26,4,30,Clouds
54844,102,1553976000,39,1,40,Clouds
54845,103,1553976000,38,2,40,Clouds
54846,104,1553976000,39,1,40,Clouds
54847,105,1553976000,36,0,36,Clouds
54848,106,1553976000,38,2,40,Clouds
54849,107,1553976000,40,0,40,Clouds
54850,108,1553976000,27,13,40,Clouds
54851,109,1553976000,28,1,29,Clouds
54852,110,1553976000,37,3,40,Clouds
54853,111,1553976000,38,2,40,Clouds
54854,112,1553976000,15,15,30,Clouds
54855,113,1553976000,39,1,40,Clouds
54856,114,1553976000,13,27,40,Clouds
54857,115,1553976000,19,11,30,Clouds
54858,2,1553979600,16,4,20,Clouds
54859,3,1553979600,20,0,20,Clouds
54860,4,1553979600,16,4,20,Clouds
54861,5,1553979600,31,9,40,Clouds
54862,6,1553979600,0,20,20,Clouds
54863,7,1553979600,14,15,29,Clouds
54864,8,1553979600,11,19,30,Clouds
54865,9,1553979600,1,23,24,Clouds
54866,10,1553979600,0,16,16,Clouds
54867,11,1553979600,26,4,30,Clouds
54868,12,1553979600,9,11,20,Clouds
54869,13,1553979600,20,10,30,Clouds
54870,14,1553979600,0,30,30,Clouds
54871,15,1553979600,16,0,16,Clouds
54872,16,1553979600,10,10,20,Clouds
54873,17,1553979600,8,12,20,Clouds
54874,18,1553979600,19,11,30,Clouds
54875,19,1553979600,7,23,30,Clouds
54876,21,1553979600,10,20,30,Clouds
54877,22,1553979600,6,14,20,Clouds
54878,23,1553979600,13,17,30,Clouds
54879,24,1553979600,7,13,20,Clouds
54880,25,1553979600,24,6,30,Clouds
54881,26,1553979600,6,14,20,Clouds
54882,27,1553979600,5,15,20,Clouds
54883,28,1553979600,16,14,30,Clouds
54884,29,1553979600,3,26,29,Clouds
54885,30,1553979600,19,1,20,Clouds
54886,31,1553979600,20,0,20,Clouds
54887,32,1553979600,10,20,30,Clouds
54888,33,1553979600,11,12,23,Clouds
54889,34,1553979600,12,18,30,Clouds
54890,35,1553979600,24,6,30,Clouds
54891,36,1553979600,25,15,40,Clouds
54892,37,1553979600,19,11,30,Clouds
54893,38,1553979600,27,13,40,Clouds
54894,39,1553979600,9,9,18,Clouds
54895,40,1553979600,14,7,21,Clouds
54896,41,1553979600,18,2,20,Clouds
54897,42,1553979600,23,7,30,Clouds
54898,43,1553979600,28,2,30,Clouds
54899,44,1553979600,7,23,30,Clouds
54900,45,1553979600,22,8,30,Clouds
54901,46,1553979600,4,16,20,Clouds
54902,47,1553979600,22,18,40,Clouds
54903,48,1553979600,19,21,40,Clouds
54904,49,1553979600,39,1,40,Clouds
54905,50,1553979600,31,9,40,Clouds
54906,51,1553979600,21,19,40,Clouds
54907,52,1553979600,13,19,32,Clouds
54908,53,1553979600,38,2,40,Clouds
54909,54,1553979600,24,9,33,Clouds
54910,55,1553979600,32,4,36,Clouds
54911,56,1553979600,2,38,40,Clouds
54912,57,1553979600,9,14,23,Clouds
54913,58,1553979600,11,29,40,Clouds
54914,59,1553979600,19,1,20,Clouds
54915,60,1553979600,25,5,30,Clouds
54916,61,1553979600,18,7,25,Clouds
54917,62,1553979600,35,5,40,Clouds
54918,63,1553979600,7,28,35,Clouds
54919,64,1553979600,9,31,40,Clouds
54920,65,1553979600,40,0,40,Clouds
54921,66,1553979600,33,7,40,Clouds
54922,67,1553979600,32,8,40,Clouds
54923,68,1553979600,37,3,40,Clouds
54924,69,1553979600,25,15,40,Clouds
54925,70,1553979600,5,23,28,Clouds
54926,71,1553979600,29,11,40,Clouds
54927,72,1553979600,2,29,31,Clouds
54928,73,1553979600,28,2,30,Clouds
54929,74,1553979600,3,27,30,Clouds
54930,75,1553979600,39,1,40,Clouds
54931,76,1553979600,38,0,38,Clouds
54932,77,1553979600,3,26,29,Clouds
54933,78,1553979600,30,10,40,Clouds
54934,79,1553979600,18,9,27,Clouds
54935,80,1553979600,40,0,40,Clouds
54936,81,1553979600,40,0,40,Clouds
54937,82,1553979600,21,1,22,Clouds
54938,83,1553979600,38,2,40,Clouds
54939,84,1553979600,30,0,30,Clouds
54940,85,1553979600,34,1,35,Clouds
54941,86,1553979600,26,12,38,Clouds
54942,87,1553979600,25,13,38,Clouds
54943,88,1553979600,17,13,30,Clouds
54944,89,1553979600,36,4,40,Clouds
54945,90,1553979600,40,0,40,Clouds
54946,91,1553979600,6,24,30,Clouds
54947,92,1553979600,6,34,40,Clouds
54948,93,1553979600,6,34,40,Clouds
54949,94,1553979600,6,34,40,Clouds
54950,95,1553979600,39,1,40,Clouds
54951,96,1553979600,27,3,30,Clouds
54952,97,1553979600,19,21,40,Clouds
54953,98,1553979600,15,25,40,Clouds
54954,99,1553979600,25,5,30,Clouds
54955,100,1553979600,4,21,25,Clouds
54956,101,1553979600,22,8,30,Clouds
54957,102,1553979600,37,3,40,Clouds
54958,103,1553979600,38,2,40,Clouds
54959,104,1553979600,39,1,40,Clouds
54960,105,1553979600,36,0,36,Clouds
54961,106,1553979600,38,2,40,Clouds
54962,107,1553979600,39,1,40,Clouds
54963,108,1553979600,27,13,40,Clouds
54964,109,1553979600,29,0,29,Clouds
54965,110,1553979600,37,3,40,Clouds
54966,111,1553979600,37,3,40,Clouds
54967,112,1553979600,10,20,30,Clouds
54968,113,1553979600,39,1,40,Clouds
54969,114,1553979600,16,24,40,Clouds
54970,115,1553979600,15,15,30,Clouds
54971,2,1553983200,17,3,20,Clouds
54972,3,1553983200,17,2,19,Clouds
54973,4,1553983200,17,3,20,Clouds
54974,5,1553983200,34,6,40,Clouds
54975,6,1553983200,1,19,20,Clouds
54976,7,1553983200,17,12,29,Clouds
54977,8,1553983200,13,17,30,Clouds
54978,9,1553983200,0,24,24,Clouds
54979,10,1553983200,0,16,16,Clouds
54980,11,1553983200,24,6,30,Clouds
54981,12,1553983200,4,16,20,Clouds
54982,13,1553983200,20,10,30,Clouds
54983,14,1553983200,0,30,30,Clouds
54984,15,1553983200,14,2,16,Clouds
54985,16,1553983200,9,11,20,Clouds
54986,17,1553983200,5,15,20,Clouds
54987,18,1553983200,15,15,30,Clouds
54988,19,1553983200,13,17,30,Clouds
54989,21,1553983200,5,25,30,Clouds
54990,22,1553983200,11,9,20,Clouds
54991,23,1553983200,9,21,30,Clouds
54992,24,1553983200,10,10,20,Clouds
54993,25,1553983200,26,4,30,Clouds
54994,26,1553983200,4,16,20,Clouds
54995,27,1553983200,4,16,20,Clouds
54996,28,1553983200,12,18,30,Clouds
54997,29,1553983200,0,29,29,Clouds
54998,30,1553983200,20,0,20,Clouds
54999,31,1553983200,19,1,20,Clouds
55000,32,1553983200,12,18,30,Clouds
55001,33,1553983200,8,15,23,Clouds
55002,34,1553983200,5,25,30,Clouds
55003,35,1553983200,25,5,30,Clouds
55004,36,1553983200,25,15,40,Clouds
55005,37,1553983200,19,11,30,Clouds
55006,38,1553983200,32,8,40,Clouds
55007,39,1553983200,9,9,18,Clouds
55008,40,1553983200,11,10,21,Clouds
55009,41,1553983200,20,0,20,Clouds
55010,42,1553983200,25,5,30,Clouds
55011,43,1553983200,20,10,30,Clouds
55012,44,1553983200,8,22,30,Clouds
55013,45,1553983200,24,6,30,Clouds
55014,46,1553983200,1,19,20,Clouds
55015,47,1553983200,23,17,40,Clouds
55016,48,1553983200,20,20,40,Clouds
55017,49,1553983200,38,2,40,Clouds
55018,50,1553983200,27,13,40,Clouds
55019,51,1553983200,19,21,40,Clouds
55020,52,1553983200,10,22,32,Clouds
55021,53,1553983200,37,3,40,Clouds
55022,54,1553983200,25,8,33,Clouds
55023,55,1553983200,32,4,36,Clouds
55024,56,1553983200,0,40,40,Clouds
55025,57,1553983200,9,14,23,Clouds
55026,58,1553983200,34,6,40,Clouds
55027,59,1553983200,17,3,20,Clouds
55028,60,1553983200,20,10,30,Clouds
55029,61,1553983200,18,7,25,Clouds
55030,62,1553983200,37,3,40,Clouds
55031,63,1553983200,6,29,35,Clouds
55032,64,1553983200,8,32,40,Clouds
55033,65,1553983200,40,0,40,Clouds
55034,66,1553983200,33,7,40,Clouds
55035,67,1553983200,31,9,40,Clouds
55036,68,1553983200,38,2,40,Clouds
55037,69,1553983200,22,18,40,Clouds
55038,70,1553983200,14,14,28,Clouds
55039,71,1553983200,24,16,40,Clouds
55040,72,1553983200,5,26,31,Clouds
55041,73,1553983200,28,2,30,Clouds
55042,74,1553983200,8,22,30,Clouds
55043,75,1553983200,37,3,40,Clouds
55044,76,1553983200,36,2,38,Clouds
55045,77,1553983200,2,27,29,Clouds
55046,78,1553983200,31,9,40,Clouds
55047,79,1553983200,17,10,27,Clouds
55048,80,1553983200,39,1,40,Clouds
55049,81,1553983200,40,0,40,Clouds
55050,82,1553983200,22,0,22,Clouds
55051,83,1553983200,37,3,40,Clouds
55052,84,1553983200,29,1,30,Clouds
55053,85,1553983200,33,2,35,Clouds
55054,86,1553983200,31,7,38,Clouds
55055,87,1553983200,25,13,38,Clouds
55056,88,1553983200,19,11,30,Clouds
55057,89,1553983200,36,4,40,Clouds
55058,90,1553983200,40,0,40,Clouds
55059,91,1553983200,10,20,30,Clouds
55060,92,1553983200,8,32,40,Clouds
55061,93,1553983200,6,34,40,Clouds
55062,94,1553983200,6,34,40,Clouds
55063,95,1553983200,39,1,40,Clouds
55064,96,1553983200,28,2,30,Clouds
55065,97,1553983200,20,20,40,Clouds
55066,98,1553983200,15,25,40,Clouds
55067,99,1553983200,25,5,30,Clouds
55068,100,1553983200,7,18,25,Clouds
55069,101,1553983200,23,7,30,Clouds
55070,102,1553983200,36,4,40,Clouds
55071,103,1553983200,37,3,40,Clouds
55072,104,1553983200,39,1,40,Clouds
55073,105,1553983200,36,0,36,Clouds
55074,106,1553983200,40,0,40,Clouds
55075,107,1553983200,39,1,40,Clouds
55076,108,1553983200,28,12,40,Clouds
55077,109,1553983200,25,4,29,Clouds
55078,110,1553983200,34,6,40,Clouds
55079,111,1553983200,38,2,40,Clouds
55080,112,1553983200,4,26,30,Clouds
55081,113,1553983200,39,1,40,Clouds
55082,114,1553983200,18,22,40,Clouds
55083,115,1553983200,13,17,30,Clouds
55084,2,1553986800,17,3,20,Clouds
55085,3,1553986800,15,4,19,Clouds
55086,4,1553986800,16,4,20,Clouds
55087,5,1553986800,31,9,40,Clouds
55088,6,1553986800,2,18,20,Clouds
55089,7,1553986800,10,19,29,Clouds
55090,8,1553986800,11,19,30,Clouds
55091,9,1553986800,1,23,24,Clouds
55092,10,1553986800,0,16,16,Clouds
55093,11,1553986800,28,2,30,Clouds
55094,12,1553986800,7,13,20,Clouds
55095,13,1553986800,20,10,30,Clouds
55096,14,1553986800,1,29,30,Clouds
55097,15,1553986800,16,0,16,Clouds
55098,16,1553986800,10,9,19,Clouds
55099,17,1553986800,8,12,20,Clouds
55100,18,1553986800,12,18,30,Clouds
55101,19,1553986800,17,13,30,Clouds
55102,21,1553986800,5,25,30,Clouds
55103,22,1553986800,10,9,19,Clouds
55104,23,1553986800,8,22,30,Clouds
55105,24,1553986800,10,10,20,Clouds
55106,25,1553986800,26,4,30,Clouds
55107,26,1553986800,3,17,20,Clouds
55108,27,1553986800,1,19,20,Clouds
55109,28,1553986800,10,20,30,Clouds
55110,29,1553986800,0,29,29,Clouds
55111,30,1553986800,20,0,20,Clouds
55112,31,1553986800,19,1,20,Clouds
55113,32,1553986800,10,20,30,Clouds
55114,33,1553986800,4,19,23,Clouds
55115,34,1553986800,1,29,30,Clouds
55116,35,1553986800,25,5,30,Clouds
55117,36,1553986800,24,16,40,Clouds
55118,37,1553986800,18,12,30,Clouds
55119,38,1553986800,32,8,40,Clouds
55120,39,1553986800,11,7,18,Clouds
55121,40,1553986800,6,15,21,Clouds
55122,41,1553986800,20,0,20,Clouds
55123,42,1553986800,23,7,30,Clouds
55124,43,1553986800,19,11,30,Clouds
55125,44,1553986800,11,19,30,Clouds
55126,45,1553986800,26,4,30,Clouds
55127,46,1553986800,2,18,20,Clouds
55128,47,1553986800,23,17,40,Clouds
55129,48,1553986800,18,22,40,Clouds
55130,49,1553986800,38,2,40,Clouds
55131,50,1553986800,25,15,40,Clouds
55132,51,1553986800,19,21,40,Clouds
55133,52,1553986800,7,25,32,Clouds
55134,53,1553986800,35,5,40,Clouds
55135,54,1553986800,23,10,33,Clouds
55136,55,1553986800,32,4,36,Clouds
55137,56,1553986800,2,38,40,Clouds
55138,57,1553986800,9,14,23,Clouds
55139,58,1553986800,40,0,40,Clouds
55140,59,1553986800,17,3,20,Clouds
55141,60,1553986800,22,8,30,Clouds
55142,61,1553986800,18,7,25,Clouds
55143,62,1553986800,36,4,40,Clouds
55144,63,1553986800,9,26,35,Clouds
55145,64,1553986800,12,28,40,Clouds
55146,65,1553986800,38,2,40,Clouds
55147,66,1553986800,32,8,40,Clouds
55148,67,1553986800,36,4,40,Clouds
55149,68,1553986800,38,2,40,Clouds
55150,69,1553986800,23,17,40,Clouds
55151,70,1553986800,13,15,28,Clouds
55152,71,1553986800,24,16,40,Clouds
55153,72,1553986800,1,30,31,Clouds
55154,73,1553986800,30,0,30,Clouds
55155,74,1553986800,7,23,30,Clouds
55156,75,1553986800,38,2,40,Clouds
55157,76,1553986800,36,2,38,Clouds
55158,77,1553986800,4,25,29,Clouds
55159,78,1553986800,26,14,40,Clouds
55160,79,1553986800,17,10,27,Clouds
55161,80,1553986800,39,1,40,Clouds
55162,81,1553986800,40,0,40,Clouds
55163,82,1553986800,21,1,22,Clouds
55164,83,1553986800,35,5,40,Clouds
55165,84,1553986800,26,4,30,Clouds
55166,85,1553986800,31,4,35,Clouds
55167,86,1553986800,32,6,38,Clouds
55168,87,1553986800,24,14,38,Clouds
55169,88,1553986800,18,12,30,Clouds
55170,89,1553986800,37,3,40,Clouds
55171,90,1553986800,40,0,40,Clouds
55172,91,1553986800,13,17,30,Clouds
55173,92,1553986800,6,34,40,Clouds
55174,93,1553986800,6,34,40,Clouds
55175,94,1553986800,6,34,40,Clouds
55176,95,1553986800,40,0,40,Clouds
55177,96,1553986800,28,2,30,Clouds
55178,97,1553986800,18,22,40,Clouds
55179,98,1553986800,14,26,40,Clouds
55180,99,1553986800,26,4,30,Clouds
55181,100,1553986800,7,18,25,Clouds
55182,101,1553986800,24,6,30,Clouds
55183,102,1553986800,38,2,40,Clouds
55184,103,1553986800,38,2,40,Clouds
55185,104,1553986800,39,1,40,Clouds
55186,105,1553986800,36,0,36,Clouds
55187,106,1553986800,40,0,40,Clouds
55188,107,1553986800,39,1,40,Clouds
55189,108,1553986800,31,9,40,Clouds
55190,109,1553986800,25,4,29,Clouds
55191,110,1553986800,32,8,40,Clouds
55192,111,1553986800,36,4,40,Clouds
55193,112,1553986800,2,28,30,Clouds
55194,113,1553986800,40,0,40,Clouds
55195,114,1553986800,19,21,40,Clouds
55196,115,1553986800,15,15,30,Clouds
55197,2,1553990400,19,1,20,Clouds
55198,3,1553990400,17,3,20,Clouds
55199,4,1553990400,15,5,20,Clouds
55200,5,1553990400,29,11,40,Clouds
55201,6,1553990400,4,16,20,Clouds
55202,7,1553990400,11,18,29,Clouds
55203,8,1553990400,9,21,30,Clouds
55204,9,1553990400,1,23,24,Clouds
55205,10,1553990400,0,16,16,Clouds
55206,11,1553990400,28,2,30,Clouds
55207,12,1553990400,6,14,20,Clouds
55208,13,1553990400,21,9,30,Clouds
55209,14,1553990400,1,29,30,Clouds
55210,15,1553990400,14,2,16,Clouds
55211,16,1553990400,9,11,20,Clouds
55212,17,1553990400,7,13,20,Clouds
55213,18,1553990400,12,18,30,Clouds
55214,19,1553990400,20,10,30,Clouds
55215,21,1553990400,5,25,30,Clouds
55216,22,1553990400,12,7,19,Clouds
55217,23,1553990400,11,19,30,Clouds
55218,24,1553990400,10,9,19,Clouds
55219,25,1553990400,26,4,30,Clouds
55220,26,1553990400,2,18,20,Clouds
55221,27,1553990400,1,19,20,Clouds
55222,28,1553990400,9,21,30,Clouds
55223,29,1553990400,0,29,29,Clouds
55224,30,1553990400,19,1,20,Clouds
55225,31,1553990400,17,3,20,Clouds
55226,32,1553990400,10,20,30,Clouds
55227,33,1553990400,2,21,23,Clouds
55228,34,1553990400,4,26,30,Clouds
55229,35,1553990400,26,4,30,Clouds
55230,36,1553990400,25,15,40,Clouds
55231,37,1553990400,19,11,30,Clouds
55232,38,1553990400,36,4,40,Clouds
55233,39,1553990400,8,10,18,Clouds
55234,40,1553990400,6,15,21,Clouds
55235,41,1553990400,20,0,20,Clouds
55236,42,1553990400,25,5,30,Clouds
55237,43,1553990400,16,14,30,Clouds
55238,44,1553990400,10,20,30,Clouds
55239,45,1553990400,26,4,30,Clouds
55240,46,1553990400,1,19,20,Clouds
55241,47,1553990400,24,16,40,Clouds
55242,48,1553990400,19,21,40,Clouds
55243,49,1553990400,37,3,40,Clouds
55244,50,1553990400,24,16,40,Clouds
55245,51,1553990400,18,22,40,Clouds
55246,52,1553990400,9,23,32,Clouds
55247,53,1553990400,35,5,40,Clouds
55248,54,1553990400,24,9,33,Clouds
55249,55,1553990400,32,4,36,Clouds
55250,56,1553990400,5,35,40,Clouds
55251,57,1553990400,9,14,23,Clouds
55252,58,1553990400,38,2,40,Clouds
55253,59,1553990400,19,1,20,Clouds
55254,60,1553990400,22,8,30,Clouds
55255,61,1553990400,18,7,25,Clouds
55256,62,1553990400,36,4,40,Clouds
55257,63,1553990400,11,24,35,Clouds
55258,64,1553990400,10,30,40,Clouds
55259,65,1553990400,40,0,40,Clouds
55260,66,1553990400,33,7,40,Clouds
55261,67,1553990400,40,0,40,Clouds
55262,68,1553990400,40,0,40,Clouds
55263,69,1553990400,28,12,40,Clouds
55264,70,1553990400,8,20,28,Clouds
55265,71,1553990400,20,20,40,Clouds
55266,72,1553990400,6,25,31,Clouds
55267,73,1553990400,28,2,30,Clouds
55268,74,1553990400,8,22,30,Clouds
55269,75,1553990400,37,3,40,Clouds
55270,76,1553990400,32,6,38,Clouds
55271,77,1553990400,3,26,29,Clouds
55272,78,1553990400,23,17,40,Clouds
55273,79,1553990400,17,10,27,Clouds
55274,80,1553990400,39,1,40,Clouds
55275,81,1553990400,40,0,40,Clouds
55276,82,1553990400,21,1,22,Clouds
55277,83,1553990400,32,8,40,Clouds
55278,84,1553990400,27,3,30,Clouds
55279,85,1553990400,29,6,35,Clouds
55280,86,1553990400,31,7,38,Clouds
55281,87,1553990400,23,15,38,Clouds
55282,88,1553990400,19,11,30,Clouds
55283,89,1553990400,38,2,40,Clouds
55284,90,1553990400,40,0,40,Clouds
55285,91,1553990400,17,13,30,Clouds
55286,92,1553990400,3,37,40,Clouds
55287,93,1553990400,6,34,40,Clouds
55288,94,1553990400,6,34,40,Clouds
55289,95,1553990400,39,1,40,Clouds
55290,96,1553990400,27,3,30,Clouds
55291,97,1553990400,18,22,40,Clouds
55292,98,1553990400,13,27,40,Clouds
55293,99,1553990400,27,3,30,Clouds
55294,100,1553990400,8,17,25,Clouds
55295,101,1553990400,24,6,30,Clouds
55296,102,1553990400,39,1,40,Clouds
55297,103,1553990400,39,1,40,Clouds
55298,104,1553990400,39,1,40,Clouds
55299,105,1553990400,36,0,36,Clouds
55300,106,1553990400,40,0,40,Clouds
55301,107,1553990400,38,2,40,Clouds
55302,108,1553990400,32,8,40,Clouds
55303,109,1553990400,23,6,29,Clouds
55304,110,1553990400,33,7,40,Clouds
55305,111,1553990400,34,6,40,Clouds
55306,112,1553990400,0,30,30,Clouds
55307,113,1553990400,38,2,40,Clouds
55308,114,1553990400,21,19,40,Clouds
55309,115,1553990400,15,15,30,Clouds
55310,2,1553994000,18,2,20,Clouds
55311,3,1553994000,16,4,20,Clouds
55312,4,1553994000,15,5,20,Clouds
55313,5,1553994000,29,11,40,Clouds
55314,6,1553994000,6,14,20,Clouds
55315,7,1553994000,10,19,29,Clouds
55316,8,1553994000,10,20,30,Clouds
55317,9,1553994000,4,20,24,Clouds
55318,10,1553994000,4,12,16,Clouds
55319,11,1553994000,29,1,30,Clouds
55320,12,1553994000,5,15,20,Clouds
55321,13,1553994000,22,8,30,Clouds
55322,14,1553994000,3,27,30,Clouds
55323,15,1553994000,16,0,16,Clouds
55324,16,1553994000,7,13,20,Clouds
55325,17,1553994000,9,11,20,Clouds
55326,18,1553994000,13,17,30,Clouds
55327,19,1553994000,22,8,30,Clouds
55328,21,1553994000,5,25,30,Clouds
55329,22,1553994000,15,5,20,Clouds
55330,23,1553994000,13,17,30,Clouds
55331,24,1553994000,13,6,19,Clouds
55332,25,1553994000,26,4,30,Clouds
55333,26,1553994000,1,19,20,Clouds
55334,27,1553994000,5,15,20,Clouds
55335,28,1553994000,8,22,30,Clouds
55336,29,1553994000,1,28,29,Clouds
55337,30,1553994000,20,0,20,Clouds
55338,31,1553994000,17,3,20,Clouds
55339,32,1553994000,10,20,30,Clouds
55340,33,1553994000,3,20,23,Clouds
55341,34,1553994000,8,22,30,Clouds
55342,35,1553994000,25,5,30,Clouds
55343,36,1553994000,23,17,40,Clouds
55344,37,1553994000,19,11,30,Clouds
55345,38,1553994000,39,1,40,Clouds
55346,39,1553994000,11,7,18,Clouds
55347,40,1553994000,4,17,21,Clouds
55348,41,1553994000,18,2,20,Clouds
55349,42,1553994000,27,3,30,Clouds
55350,43,1553994000,15,15,30,Clouds
55351,44,1553994000,5,25,30,Clouds
55352,45,1553994000,26,4,30,Clouds
55353,46,1553994000,3,17,20,Clouds
55354,47,1553994000,25,15,40,Clouds
55355,48,1553994000,18,22,40,Clouds
55356,49,1553994000,35,5,40,Clouds
55357,50,1553994000,22,18,40,Clouds
55358,51,1553994000,19,21,40,Clouds
55359,52,1553994000,13,19,32,Clouds
55360,53,1553994000,34,6,40,Clouds
55361,54,1553994000,23,10,33,Clouds
55362,55,1553994000,32,4,36,Clouds
55363,56,1553994000,8,32,40,Clouds
55364,57,1553994000,11,12,23,Clouds
55365,58,1553994000,40,0,40,Clouds
55366,59,1553994000,17,3,20,Clouds
55367,60,1553994000,19,11,30,Clouds
55368,61,1553994000,15,10,25,Clouds
55369,62,1553994000,38,2,40,Clouds
55370,63,1553994000,13,22,35,Clouds
55371,64,1553994000,9,31,40,Clouds
55372,65,1553994000,39,1,40,Clouds
55373,66,1553994000,33,7,40,Clouds
55374,67,1553994000,40,0,40,Clouds
55375,68,1553994000,34,6,40,Clouds
55376,69,1553994000,27,13,40,Clouds
55377,70,1553994000,8,20,28,Clouds
55378,71,1553994000,16,24,40,Clouds
55379,72,1553994000,9,22,31,Clouds
55380,73,1553994000,24,6,30,Clouds
55381,74,1553994000,9,21,30,Clouds
55382,75,1553994000,37,3,40,Clouds
55383,76,1553994000,35,3,38,Clouds
55384,77,1553994000,3,26,29,Clouds
55385,78,1553994000,26,14,40,Clouds
55386,79,1553994000,17,10,27,Clouds
55387,80,1553994000,36,4,40,Clouds
55388,81,1553994000,40,0,40,Clouds
55389,82,1553994000,21,1,22,Clouds
55390,83,1553994000,33,7,40,Clouds
55391,84,1553994000,26,4,30,Clouds
55392,85,1553994000,27,8,35,Clouds
55393,86,1553994000,30,8,38,Clouds
55394,87,1553994000,21,17,38,Clouds
55395,88,1553994000,18,12,30,Clouds
55396,89,1553994000,38,2,40,Clouds
55397,90,1553994000,40,0,40,Clouds
55398,91,1553994000,19,11,30,Clouds
55399,92,1553994000,3,37,40,Clouds
55400,93,1553994000,6,34,40,Clouds
55401,94,1553994000,6,34,40,Clouds
55402,95,1553994000,39,1,40,Clouds
55403,96,1553994000,27,3,30,Clouds
55404,97,1553994000,17,23,40,Clouds
55405,98,1553994000,13,27,40,Clouds
55406,99,1553994000,28,2,30,Clouds
55407,100,1553994000,5,20,25,Clouds
55408,101,1553994000,22,8,30,Clouds
55409,102,1553994000,40,0,40,Clouds
55410,103,1553994000,39,1,40,Clouds
55411,104,1553994000,39,1,40,Clouds
55412,105,1553994000,36,0,36,Clouds
55413,106,1553994000,40,0,40,Clouds
55414,107,1553994000,37,3,40,Clouds
55415,108,1553994000,31,9,40,Clouds
55416,109,1553994000,19,10,29,Clouds
55417,110,1553994000,33,7,40,Clouds
55418,111,1553994000,30,10,40,Clouds
55419,112,1553994000,1,29,30,Clouds
55420,113,1553994000,38,2,40,Clouds
55421,114,1553994000,21,19,40,Clouds
55422,115,1553994000,10,20,30,Clouds
55423,2,1553997600,14,6,20,Clouds
55424,3,1553997600,16,4,20,Clouds
55425,4,1553997600,15,5,20,Clouds
55426,5,1553997600,31,9,40,Clouds
55427,6,1553997600,8,12,20,Clouds
55428,7,1553997600,10,19,29,Clouds
55429,8,1553997600,12,18,30,Clouds
55430,9,1553997600,8,16,24,Clouds
55431,10,1553997600,6,10,16,Clouds
55432,11,1553997600,29,1,30,Clouds
55433,12,1553997600,5,15,20,Clouds
55434,13,1553997600,23,7,30,Clouds
55435,14,1553997600,6,24,30,Clouds
55436,15,1553997600,15,1,16,Clouds
55437,16,1553997600,8,12,20,Clouds
55438,17,1553997600,9,11,20,Clouds
55439,18,1553997600,18,12,30,Clouds
55440,19,1553997600,21,9,30,Clouds
55441,21,1553997600,5,25,30,Clouds
55442,22,1553997600,16,4,20,Clouds
55443,23,1553997600,14,16,30,Clouds
55444,24,1553997600,13,7,20,Clouds
55445,25,1553997600,27,3,30,Clouds
55446,26,1553997600,3,17,20,Clouds
55447,27,1553997600,5,15,20,Clouds
55448,28,1553997600,7,23,30,Clouds
55449,29,1553997600,0,29,29,Clouds
55450,30,1553997600,19,1,20,Clouds
55451,31,1553997600,17,3,20,Clouds
55452,32,1553997600,11,19,30,Clouds
55453,33,1553997600,2,21,23,Clouds
55454,34,1553997600,10,20,30,Clouds
55455,35,1553997600,24,6,30,Clouds
55456,36,1553997600,23,17,40,Clouds
55457,37,1553997600,19,11,30,Clouds
55458,38,1553997600,40,0,40,Clouds
55459,39,1553997600,14,4,18,Clouds
55460,40,1553997600,4,17,21,Clouds
55461,41,1553997600,19,1,20,Clouds
55462,42,1553997600,26,4,30,Clouds
55463,43,1553997600,16,14,30,Clouds
55464,44,1553997600,3,27,30,Clouds
55465,45,1553997600,25,5,30,Clouds
55466,46,1553997600,7,13,20,Clouds
55467,47,1553997600,25,15,40,Clouds
55468,48,1553997600,21,19,40,Clouds
55469,49,1553997600,33,7,40,Clouds
55470,50,1553997600,22,18,40,Clouds
55471,51,1553997600,19,21,40,Clouds
55472,52,1553997600,14,18,32,Clouds
55473,53,1553997600,33,7,40,Clouds
55474,54,1553997600,23,10,33,Clouds
55475,55,1553997600,32,4,36,Clouds
55476,56,1553997600,6,34,40,Clouds
55477,57,1553997600,13,10,23,Clouds
55478,58,1553997600,40,0,40,Clouds
55479,59,1553997600,19,1,20,Clouds
55480,60,1553997600,14,16,30,Clouds
55481,61,1553997600,15,10,25,Clouds
55482,62,1553997600,39,1,40,Clouds
55483,63,1553997600,14,21,35,Clouds
55484,64,1553997600,8,32,40,Clouds
55485,65,1553997600,40,0,40,Clouds
55486,66,1553997600,33,7,40,Clouds
55487,67,1553997600,37,3,40,Clouds
55488,68,1553997600,37,3,40,Clouds
55489,69,1553997600,28,12,40,Clouds
55490,70,1553997600,6,22,28,Clouds
55491,71,1553997600,15,25,40,Clouds
55492,72,1553997600,7,24,31,Clouds
55493,73,1553997600,23,7,30,Clouds
55494,74,1553997600,9,21,30,Clouds
55495,75,1553997600,36,4,40,Clouds
55496,76,1553997600,35,3,38,Clouds
55497,77,1553997600,4,25,29,Clouds
55498,78,1553997600,22,18,40,Clouds
55499,79,1553997600,17,10,27,Clouds
55500,80,1553997600,35,5,40,Clouds
55501,81,1553997600,40,0,40,Clouds
55502,82,1553997600,20,2,22,Clouds
55503,83,1553997600,34,6,40,Clouds
55504,84,1553997600,22,8,30,Clouds
55505,85,1553997600,26,9,35,Clouds
55506,86,1553997600,29,9,38,Clouds
55507,87,1553997600,19,19,38,Clouds
55508,88,1553997600,15,15,30,Clouds
55509,89,1553997600,38,2,40,Clouds
55510,90,1553997600,39,1,40,Clouds
55511,91,1553997600,22,8,30,Clouds
55512,92,1553997600,2,38,40,Clouds
55513,93,1553997600,6,34,40,Clouds
55514,94,1553997600,6,34,40,Clouds
55515,95,1553997600,38,2,40,Clouds
55516,96,1553997600,26,4,30,Clouds
55517,97,1553997600,16,24,40,Clouds
55518,98,1553997600,13,27,40,Clouds
55519,99,1553997600,28,2,30,Clouds
55520,100,1553997600,3,22,25,Clouds
55521,101,1553997600,19,11,30,Clouds
55522,102,1553997600,38,2,40,Clouds
55523,103,1553997600,39,1,40,Clouds
55524,104,1553997600,38,2,40,Clouds
55525,105,1553997600,35,1,36,Clouds
55526,106,1553997600,40,0,40,Clouds
55527,107,1553997600,35,5,40,Clouds
55528,108,1553997600,31,9,40,Clouds
55529,109,1553997600,18,11,29,Clouds
55530,110,1553997600,32,8,40,Clouds
55531,111,1553997600,28,12,40,Clouds
55532,112,1553997600,0,30,30,Clouds
55533,113,1553997600,38,2,40,Clouds
55534,114,1553997600,21,19,40,Clouds
55535,115,1553997600,8,22,30,Clouds
55536,2,1554001200,14,6,20,Clouds
55537,3,1554001200,16,4,20,Clouds
55538,4,1554001200,15,5,20,Clouds
55539,5,1554001200,31,9,40,Clouds
55540,6,1554001200,8,12,20,Clouds
55541,7,1554001200,10,19,29,Clouds
55542,8,1554001200,12,18,30,Clouds
55543,9,1554001200,8,16,24,Clouds
55544,10,1554001200,6,10,16,Clouds
55545,11,1554001200,29,1,30,Clouds
55546,12,1554001200,5,15,20,Clouds
55547,13,1554001200,23,7,30,Clouds
55548,14,1554001200,6,24,30,Clouds
55549,15,1554001200,15,1,16,Clouds
55550,16,1554001200,8,12,20,Clouds
55551,17,1554001200,9,11,20,Clouds
55552,18,1554001200,18,12,30,Clouds
55553,19,1554001200,21,9,30,Clouds
55554,21,1554001200,5,25,30,Clouds
55555,22,1554001200,16,4,20,Clouds
55556,23,1554001200,14,16,30,Clouds
55557,24,1554001200,13,7,20,Clouds
55558,25,1554001200,27,3,30,Clouds
55559,26,1554001200,3,17,20,Clouds
55560,27,1554001200,5,15,20,Clouds
55561,28,1554001200,6,24,30,Clouds
55562,29,1554001200,0,29,29,Clouds
55563,30,1554001200,19,1,20,Clouds
55564,31,1554001200,17,3,20,Clouds
55565,32,1554001200,11,19,30,Clouds
55566,33,1554001200,2,21,23,Clouds
55567,34,1554001200,10,20,30,Clouds
55568,35,1554001200,24,6,30,Clouds
55569,36,1554001200,23,17,40,Clouds
55570,37,1554001200,19,11,30,Clouds
55571,38,1554001200,40,0,40,Clouds
55572,39,1554001200,14,4,18,Clouds
55573,40,1554001200,4,17,21,Clouds
55574,41,1554001200,19,1,20,Clouds
55575,42,1554001200,26,4,30,Clouds
55576,43,1554001200,16,14,30,Clouds
55577,44,1554001200,3,27,30,Clouds
55578,45,1554001200,25,5,30,Clouds
55579,46,1554001200,7,13,20,Clouds
55580,47,1554001200,25,15,40,Clouds
55581,48,1554001200,21,19,40,Clouds
55582,49,1554001200,33,7,40,Clouds
55583,50,1554001200,22,18,40,Clouds
55584,51,1554001200,19,21,40,Clouds
55585,52,1554001200,14,18,32,Clouds
55586,53,1554001200,33,7,40,Clouds
55587,54,1554001200,23,10,33,Clouds
55588,55,1554001200,32,4,36,Clouds
55589,56,1554001200,5,35,40,Clouds
55590,57,1554001200,13,10,23,Clouds
55591,58,1554001200,40,0,40,Clouds
55592,59,1554001200,19,1,20,Clouds
55593,60,1554001200,14,16,30,Clouds
55594,61,1554001200,15,10,25,Clouds
55595,62,1554001200,39,1,40,Clouds
55596,63,1554001200,14,21,35,Clouds
55597,64,1554001200,8,32,40,Clouds
55598,65,1554001200,40,0,40,Clouds
55599,66,1554001200,33,7,40,Clouds
55600,67,1554001200,37,3,40,Clouds
55601,68,1554001200,37,3,40,Clouds
55602,69,1554001200,28,12,40,Clouds
55603,70,1554001200,6,22,28,Clouds
55604,71,1554001200,15,25,40,Clouds
55605,72,1554001200,7,24,31,Clouds
55606,73,1554001200,23,7,30,Clouds
55607,74,1554001200,9,21,30,Clouds
55608,75,1554001200,36,4,40,Clouds
55609,76,1554001200,35,3,38,Clouds
55610,77,1554001200,4,25,29,Clouds
55611,78,1554001200,22,18,40,Clouds
55612,79,1554001200,17,10,27,Clouds
55613,80,1554001200,35,5,40,Clouds
55614,81,1554001200,40,0,40,Clouds
55615,82,1554001200,20,2,22,Clouds
55616,83,1554001200,34,6,40,Clouds
55617,84,1554001200,21,9,30,Clouds
55618,85,1554001200,26,9,35,Clouds
55619,86,1554001200,29,9,38,Clouds
55620,87,1554001200,19,19,38,Clouds
55621,88,1554001200,15,15,30,Clouds
55622,89,1554001200,38,2,40,Clouds
55623,90,1554001200,39,1,40,Clouds
55624,91,1554001200,22,8,30,Clouds
55625,92,1554001200,2,38,40,Clouds
55626,93,1554001200,6,34,40,Clouds
55627,94,1554001200,6,34,40,Clouds
55628,95,1554001200,38,2,40,Clouds
55629,96,1554001200,25,5,30,Clouds
55630,97,1554001200,16,24,40,Clouds
55631,98,1554001200,13,27,40,Clouds
55632,99,1554001200,28,2,30,Clouds
55633,100,1554001200,3,22,25,Clouds
55634,101,1554001200,19,11,30,Clouds
55635,102,1554001200,38,2,40,Clouds
55636,103,1554001200,39,1,40,Clouds
55637,104,1554001200,38,2,40,Clouds
55638,105,1554001200,35,1,36,Clouds
55639,106,1554001200,40,0,40,Clouds
55640,107,1554001200,35,5,40,Clouds
55641,108,1554001200,31,9,40,Clouds
55642,109,1554001200,18,11,29,Clouds
55643,110,1554001200,32,8,40,Clouds
55644,111,1554001200,28,12,40,Clouds
55645,112,1554001200,0,30,30,Clouds
55646,113,1554001200,38,2,40,Clouds
55647,114,1554001200,21,19,40,Clouds
55648,115,1554001200,8,22,30,Clouds
55649,2,1554004800,14,6,20,Clouds
55650,3,1554004800,16,4,20,Clouds
55651,4,1554004800,15,5,20,Clouds
55652,5,1554004800,31,9,40,Clouds
55653,6,1554004800,8,12,20,Clouds
55654,7,1554004800,10,19,29,Clouds
55655,8,1554004800,12,18,30,Clouds
55656,9,1554004800,8,16,24,Clouds
55657,10,1554004800,6,10,16,Clouds
55658,11,1554004800,29,1,30,Clouds
55659,12,1554004800,5,15,20,Clouds
55660,13,1554004800,23,7,30,Clouds
55661,14,1554004800,6,24,30,Clouds
55662,15,1554004800,15,1,16,Clouds
55663,16,1554004800,8,12,20,Clouds
55664,17,1554004800,9,11,20,Clouds
55665,18,1554004800,18,12,30,Clouds
55666,19,1554004800,21,9,30,Clouds
55667,21,1554004800,5,25,30,Clouds
55668,22,1554004800,16,4,20,Clouds
55669,23,1554004800,14,16,30,Clouds
55670,24,1554004800,13,7,20,Clouds
55671,25,1554004800,27,3,30,Clouds
55672,26,1554004800,3,17,20,Clouds
55673,27,1554004800,5,15,20,Clouds
55674,28,1554004800,6,24,30,Clouds
55675,29,1554004800,0,29,29,Clouds
55676,30,1554004800,19,1,20,Clouds
55677,31,1554004800,17,3,20,Clouds
55678,32,1554004800,11,19,30,Clouds
55679,33,1554004800,2,21,23,Clouds
55680,34,1554004800,10,20,30,Clouds
55681,35,1554004800,24,6,30,Clouds
55682,36,1554004800,23,17,40,Clouds
55683,37,1554004800,19,11,30,Clouds
55684,38,1554004800,40,0,40,Clouds
55685,39,1554004800,13,5,18,Clouds
55686,40,1554004800,4,17,21,Clouds
55687,41,1554004800,19,1,20,Clouds
55688,42,1554004800,26,4,30,Clouds
55689,43,1554004800,16,14,30,Clouds
55690,44,1554004800,3,27,30,Clouds
55691,45,1554004800,25,5,30,Clouds
55692,46,1554004800,7,13,20,Clouds
55693,47,1554004800,25,15,40,Clouds
55694,48,1554004800,21,19,40,Clouds
55695,49,1554004800,33,7,40,Clouds
55696,50,1554004800,22,18,40,Clouds
55697,51,1554004800,19,21,40,Clouds
55698,52,1554004800,14,18,32,Clouds
55699,53,1554004800,33,7,40,Clouds
55700,54,1554004800,23,10,33,Clouds
55701,55,1554004800,32,4,36,Clouds
55702,56,1554004800,5,35,40,Clouds
55703,57,1554004800,13,10,23,Clouds
55704,58,1554004800,40,0,40,Clouds
55705,59,1554004800,19,1,20,Clouds
55706,60,1554004800,14,16,30,Clouds
55707,61,1554004800,15,10,25,Clouds
55708,62,1554004800,39,1,40,Clouds
55709,63,1554004800,14,21,35,Clouds
55710,64,1554004800,8,32,40,Clouds
55711,65,1554004800,40,0,40,Clouds
55712,66,1554004800,33,7,40,Clouds
55713,67,1554004800,37,3,40,Clouds
55714,68,1554004800,37,3,40,Clouds
55715,69,1554004800,28,12,40,Clouds
55716,70,1554004800,6,22,28,Clouds
55717,71,1554004800,15,25,40,Clouds
55718,72,1554004800,7,24,31,Clouds
55719,73,1554004800,23,7,30,Clouds
55720,74,1554004800,9,21,30,Clouds
55721,75,1554004800,36,4,40,Clouds
55722,76,1554004800,35,3,38,Clouds
55723,77,1554004800,4,25,29,Clouds
55724,78,1554004800,22,18,40,Clouds
55725,79,1554004800,17,10,27,Clouds
55726,80,1554004800,35,5,40,Clouds
55727,81,1554004800,40,0,40,Clouds
55728,82,1554004800,20,2,22,Clouds
55729,83,1554004800,34,6,40,Clouds
55730,84,1554004800,21,9,30,Clouds
55731,85,1554004800,26,9,35,Clouds
55732,86,1554004800,29,9,38,Clouds
55733,87,1554004800,19,19,38,Clouds
55734,88,1554004800,15,15,30,Clouds
55735,89,1554004800,38,2,40,Clouds
55736,90,1554004800,39,1,40,Clouds
55737,91,1554004800,22,8,30,Clouds
55738,92,1554004800,2,38,40,Clouds
55739,93,1554004800,6,34,40,Clouds
55740,94,1554004800,6,34,40,Clouds
55741,95,1554004800,38,2,40,Clouds
55742,96,1554004800,25,5,30,Clouds
55743,97,1554004800,16,24,40,Clouds
55744,98,1554004800,13,27,40,Clouds
55745,99,1554004800,28,2,30,Clouds
55746,100,1554004800,3,22,25,Clouds
55747,101,1554004800,19,11,30,Clouds
55748,102,1554004800,38,2,40,Clouds
55749,103,1554004800,39,1,40,Clouds
55750,104,1554004800,38,2,40,Clouds
55751,105,1554004800,35,1,36,Clouds
55752,106,1554004800,40,0,40,Clouds
55753,107,1554004800,35,5,40,Clouds
55754,108,1554004800,31,9,40,Clouds
55755,109,1554004800,18,11,29,Clouds
55756,110,1554004800,32,8,40,Clouds
55757,111,1554004800,28,12,40,Clouds
55758,112,1554004800,0,30,30,Clouds
55759,113,1554004800,38,2,40,Clouds
55760,114,1554004800,21,19,40,Clouds
55761,115,1554004800,8,22,30,Clouds
55762,2,1554008400,14,6,20,Clouds
55763,3,1554008400,16,4,20,Clouds
55764,4,1554008400,15,5,20,Clouds
55765,5,1554008400,31,9,40,Clouds
55766,6,1554008400,8,12,20,Clouds
55767,7,1554008400,10,19,29,Clouds
55768,8,1554008400,12,18,30,Clouds
55769,9,1554008400,8,16,24,Clouds
55770,10,1554008400,6,10,16,Clouds
55771,11,1554008400,29,1,30,Clouds
55772,12,1554008400,5,15,20,Clouds
55773,13,1554008400,23,7,30,Clouds
55774,14,1554008400,6,24,30,Clouds
55775,15,1554008400,15,1,16,Clouds
55776,16,1554008400,8,12,20,Clouds
55777,17,1554008400,9,11,20,Clouds
55778,18,1554008400,18,12,30,Clouds
55779,19,1554008400,21,9,30,Clouds
55780,21,1554008400,5,25,30,Clouds
55781,22,1554008400,16,4,20,Clouds
55782,23,1554008400,14,16,30,Clouds
55783,24,1554008400,13,7,20,Clouds
55784,25,1554008400,27,3,30,Clouds
55785,26,1554008400,3,17,20,Clouds
55786,27,1554008400,5,15,20,Clouds
55787,28,1554008400,6,24,30,Clouds
55788,29,1554008400,0,29,29,Clouds
55789,30,1554008400,19,1,20,Clouds
55790,31,1554008400,17,3,20,Clouds
55791,32,1554008400,11,19,30,Clouds
55792,33,1554008400,2,21,23,Clouds
55793,34,1554008400,10,20,30,Clouds
55794,35,1554008400,24,6,30,Clouds
55795,36,1554008400,23,17,40,Clouds
55796,37,1554008400,19,11,30,Clouds
55797,38,1554008400,40,0,40,Clouds
55798,39,1554008400,13,5,18,Clouds
55799,40,1554008400,4,17,21,Clouds
55800,41,1554008400,19,1,20,Clouds
55801,42,1554008400,26,4,30,Clouds
55802,43,1554008400,16,14,30,Clouds
55803,44,1554008400,3,27,30,Clouds
55804,45,1554008400,25,5,30,Clouds
55805,46,1554008400,7,13,20,Clouds
55806,47,1554008400,25,15,40,Clouds
55807,48,1554008400,21,19,40,Clouds
55808,49,1554008400,33,7,40,Clouds
55809,50,1554008400,22,18,40,Clouds
55810,51,1554008400,19,21,40,Clouds
55811,52,1554008400,14,18,32,Clouds
55812,53,1554008400,33,7,40,Clouds
55813,54,1554008400,23,10,33,Clouds
55814,55,1554008400,32,4,36,Clouds
55815,56,1554008400,5,35,40,Clouds
55816,57,1554008400,13,10,23,Clouds
55817,58,1554008400,40,0,40,Clouds
55818,59,1554008400,19,1,20,Clouds
55819,60,1554008400,14,16,30,Clouds
55820,61,1554008400,15,10,25,Clouds
55821,62,1554008400,39,1,40,Clouds
55822,63,1554008400,14,21,35,Clouds
55823,64,1554008400,8,32,40,Clouds
55824,65,1554008400,40,0,40,Clouds
55825,66,1554008400,33,7,40,Clouds
55826,67,1554008400,37,3,40,Clouds
55827,68,1554008400,37,3,40,Clouds
55828,69,1554008400,28,12,40,Clouds
55829,70,1554008400,6,22,28,Clouds
55830,71,1554008400,15,25,40,Clouds
55831,72,1554008400,7,24,31,Clouds
55832,73,1554008400,23,7,30,Clouds
55833,74,1554008400,9,21,30,Clouds
55834,75,1554008400,36,4,40,Clouds
55835,76,1554008400,35,3,38,Clouds
55836,77,1554008400,4,25,29,Clouds
55837,78,1554008400,22,18,40,Clouds
55838,79,1554008400,17,10,27,Clouds
55839,80,1554008400,35,5,40,Clouds
55840,81,1554008400,40,0,40,Clouds
55841,82,1554008400,20,2,22,Clouds
55842,83,1554008400,34,6,40,Clouds
55843,84,1554008400,21,9,30,Clouds
55844,85,1554008400,26,9,35,Clouds
55845,86,1554008400,29,9,38,Clouds
55846,87,1554008400,19,19,38,Clouds
55847,88,1554008400,15,15,30,Clouds
55848,89,1554008400,38,2,40,Clouds
55849,90,1554008400,39,1,40,Clouds
55850,91,1554008400,22,8,30,Clouds
55851,92,1554008400,2,38,40,Clouds
55852,93,1554008400,6,34,40,Clouds
55853,94,1554008400,6,34,40,Clouds
55854,95,1554008400,38,2,40,Clouds
55855,96,1554008400,25,5,30,Clouds
55856,97,1554008400,16,24,40,Clouds
55857,98,1554008400,13,27,40,Clouds
55858,99,1554008400,28,2,30,Clouds
55859,100,1554008400,3,22,25,Clouds
55860,101,1554008400,19,11,30,Clouds
55861,102,1554008400,38,2,40,Clouds
55862,103,1554008400,39,1,40,Clouds
55863,104,1554008400,38,2,40,Clouds
55864,105,1554008400,35,1,36,Clouds
55865,106,1554008400,40,0,40,Clouds
55866,107,1554008400,35,5,40,Clouds
55867,108,1554008400,31,9,40,Clouds
55868,109,1554008400,18,11,29,Clouds
55869,110,1554008400,32,8,40,Clouds
55870,111,1554008400,28,12,40,Clouds
55871,112,1554008400,1,29,30,Clouds
55872,113,1554008400,38,2,40,Clouds
55873,114,1554008400,21,19,40,Clouds
55874,115,1554008400,8,22,30,Clouds
55875,2,1554012000,15,5,20,Clouds
55876,3,1554012000,16,4,20,Clouds
55877,4,1554012000,14,6,20,Clouds
55878,5,1554012000,31,9,40,Clouds
55879,6,1554012000,8,12,20,Clouds
55880,7,1554012000,10,19,29,Clouds
55881,8,1554012000,10,20,30,Clouds
55882,9,1554012000,7,17,24,Clouds
55883,10,1554012000,6,10,16,Clouds
55884,11,1554012000,29,1,30,Clouds
55885,12,1554012000,4,16,20,Clouds
55886,13,1554012000,24,6,30,Clouds
55887,14,1554012000,5,25,30,Clouds
55888,15,1554012000,14,2,16,Clouds
55889,16,1554012000,9,11,20,Clouds
55890,17,1554012000,8,12,20,Clouds
55891,18,1554012000,21,9,30,Clouds
55892,19,1554012000,21,9,30,Clouds
55893,21,1554012000,5,25,30,Clouds
55894,22,1554012000,14,6,20,Clouds
55895,23,1554012000,13,17,30,Clouds
55896,24,1554012000,13,7,20,Clouds
55897,25,1554012000,27,3,30,Clouds
55898,26,1554012000,2,18,20,Clouds
55899,27,1554012000,5,15,20,Clouds
55900,28,1554012000,6,24,30,Clouds
55901,29,1554012000,0,29,29,Clouds
55902,30,1554012000,18,2,20,Clouds
55903,31,1554012000,17,3,20,Clouds
55904,32,1554012000,11,19,30,Clouds
55905,33,1554012000,4,19,23,Clouds
55906,34,1554012000,10,20,30,Clouds
55907,35,1554012000,25,5,30,Clouds
55908,36,1554012000,24,16,40,Clouds
55909,37,1554012000,19,11,30,Clouds
55910,38,1554012000,38,2,40,Clouds
55911,39,1554012000,12,6,18,Clouds
55912,40,1554012000,4,17,21,Clouds
55913,41,1554012000,19,1,20,Clouds
55914,42,1554012000,26,4,30,Clouds
55915,43,1554012000,16,14,30,Clouds
55916,44,1554012000,3,27,30,Clouds
55917,45,1554012000,25,5,30,Clouds
55918,46,1554012000,8,12,20,Clouds
55919,47,1554012000,26,14,40,Clouds
55920,48,1554012000,21,19,40,Clouds
55921,49,1554012000,33,7,40,Clouds
55922,50,1554012000,21,19,40,Clouds
55923,51,1554012000,20,20,40,Clouds
55924,52,1554012000,14,18,32,Clouds
55925,53,1554012000,33,7,40,Clouds
55926,54,1554012000,26,7,33,Clouds
55927,55,1554012000,32,4,36,Clouds
55928,56,1554012000,4,36,40,Clouds
55929,57,1554012000,13,10,23,Clouds
55930,58,1554012000,40,0,40,Clouds
55931,59,1554012000,19,1,20,Clouds
55932,60,1554012000,13,17,30,Clouds
55933,61,1554012000,15,10,25,Clouds
55934,62,1554012000,39,1,40,Clouds
55935,63,1554012000,14,21,35,Clouds
55936,64,1554012000,8,32,40,Clouds
55937,65,1554012000,40,0,40,Clouds
55938,66,1554012000,31,9,40,Clouds
55939,67,1554012000,37,3,40,Clouds
55940,68,1554012000,36,4,40,Clouds
55941,69,1554012000,29,11,40,Clouds
55942,70,1554012000,7,21,28,Clouds
55943,71,1554012000,17,23,40,Clouds
55944,72,1554012000,8,23,31,Clouds
55945,73,1554012000,22,8,30,Clouds
55946,74,1554012000,9,21,30,Clouds
55947,75,1554012000,37,3,40,Clouds
55948,76,1554012000,36,2,38,Clouds
55949,77,1554012000,4,25,29,Clouds
55950,78,1554012000,23,17,40,Clouds
55951,79,1554012000,17,10,27,Clouds
55952,80,1554012000,36,4,40,Clouds
55953,81,1554012000,40,0,40,Clouds
55954,82,1554012000,21,1,22,Clouds
55955,83,1554012000,34,6,40,Clouds
55956,84,1554012000,20,10,30,Clouds
55957,85,1554012000,27,8,35,Clouds
55958,86,1554012000,29,9,38,Clouds
55959,87,1554012000,19,19,38,Clouds
55960,88,1554012000,14,16,30,Clouds
55961,89,1554012000,38,2,40,Clouds
55962,90,1554012000,39,1,40,Clouds
55963,91,1554012000,22,8,30,Clouds
55964,92,1554012000,2,38,40,Clouds
55965,93,1554012000,6,34,40,Clouds
55966,94,1554012000,6,34,40,Clouds
55967,95,1554012000,38,2,40,Clouds
55968,96,1554012000,25,5,30,Clouds
55969,97,1554012000,16,24,40,Clouds
55970,98,1554012000,13,27,40,Clouds
55971,99,1554012000,28,2,30,Clouds
55972,100,1554012000,3,22,25,Clouds
55973,101,1554012000,19,11,30,Clouds
55974,102,1554012000,38,2,40,Clouds
55975,103,1554012000,39,1,40,Clouds
55976,104,1554012000,38,2,40,Clouds
55977,105,1554012000,35,1,36,Clouds
55978,106,1554012000,40,0,40,Clouds
55979,107,1554012000,36,4,40,Clouds
55980,108,1554012000,32,8,40,Clouds
55981,109,1554012000,20,9,29,Clouds
55982,110,1554012000,32,8,40,Clouds
55983,111,1554012000,25,15,40,Clouds
55984,112,1554012000,0,30,30,Clouds
55985,113,1554012000,38,2,40,Clouds
55986,114,1554012000,21,19,40,Clouds
55987,115,1554012000,7,23,30,Clouds
55988,2,1554015600,16,4,20,Clouds
55989,3,1554015600,20,0,20,Clouds
55990,4,1554015600,16,4,20,Clouds
55991,5,1554015600,31,9,40,Clouds
55992,6,1554015600,9,11,20,Clouds
55993,7,1554015600,10,19,29,Clouds
55994,8,1554015600,10,20,30,Clouds
55995,9,1554015600,1,23,24,Clouds
55996,10,1554015600,1,15,16,Clouds
55997,11,1554015600,29,1,30,Clouds
55998,12,1554015600,5,15,20,Clouds
55999,13,1554015600,24,6,30,Clouds
56000,14,1554015600,0,30,30,Clouds
56001,15,1554015600,14,2,16,Clouds
56002,16,1554015600,9,11,20,Clouds
56003,17,1554015600,8,12,20,Clouds
56004,18,1554015600,19,11,30,Clouds
56005,19,1554015600,17,13,30,Clouds
56006,21,1554015600,3,27,30,Clouds
56007,22,1554015600,14,6,20,Clouds
56008,23,1554015600,15,15,30,Clouds
56009,24,1554015600,10,10,20,Clouds
56010,25,1554015600,26,4,30,Clouds
56011,26,1554015600,1,19,20,Clouds
56012,27,1554015600,5,15,20,Clouds
56013,28,1554015600,10,20,30,Clouds
56014,29,1554015600,1,28,29,Clouds
56015,30,1554015600,18,2,20,Clouds
56016,31,1554015600,15,5,20,Clouds
56017,32,1554015600,11,19,30,Clouds
56018,33,1554015600,1,22,23,Clouds
56019,34,1554015600,11,18,29,Clouds
56020,35,1554015600,25,5,30,Clouds
56021,36,1554015600,23,17,40,Clouds
56022,37,1554015600,20,10,30,Clouds
56023,38,1554015600,37,3,40,Clouds
56024,39,1554015600,11,7,18,Clouds
56025,40,1554015600,3,18,21,Clouds
56026,41,1554015600,20,0,20,Clouds
56027,42,1554015600,29,1,30,Clouds
56028,43,1554015600,17,13,30,Clouds
56029,44,1554015600,3,27,30,Clouds
56030,45,1554015600,24,6,30,Clouds
56031,46,1554015600,7,13,20,Clouds
56032,47,1554015600,26,14,40,Clouds
56033,48,1554015600,19,21,40,Clouds
56034,49,1554015600,33,7,40,Clouds
56035,50,1554015600,25,15,40,Clouds
56036,51,1554015600,20,20,40,Clouds
56037,52,1554015600,10,22,32,Clouds
56038,53,1554015600,32,8,40,Clouds
56039,54,1554015600,31,2,33,Clouds
56040,55,1554015600,32,4,36,Clouds
56041,56,1554015600,4,36,40,Clouds
56042,57,1554015600,12,11,23,Clouds
56043,58,1554015600,36,4,40,Clouds
56044,59,1554015600,18,2,20,Clouds
56045,60,1554015600,14,16,30,Clouds
56046,61,1554015600,15,10,25,Clouds
56047,62,1554015600,40,0,40,Clouds
56048,63,1554015600,14,21,35,Clouds
56049,64,1554015600,8,32,40,Clouds
56050,65,1554015600,40,0,40,Clouds
56051,66,1554015600,33,7,40,Clouds
56052,67,1554015600,37,3,40,Clouds
56053,68,1554015600,36,4,40,Clouds
56054,69,1554015600,29,11,40,Clouds
56055,70,1554015600,8,20,28,Clouds
56056,71,1554015600,19,21,40,Clouds
56057,72,1554015600,10,21,31,Clouds
56058,73,1554015600,23,7,30,Clouds
56059,74,1554015600,10,20,30,Clouds
56060,75,1554015600,38,2,40,Clouds
56061,76,1554015600,37,1,38,Clouds
56062,77,1554015600,2,27,29,Clouds
56063,78,1554015600,24,16,40,Clouds
56064,79,1554015600,16,11,27,Clouds
56065,80,1554015600,37,3,40,Clouds
56066,81,1554015600,40,0,40,Clouds
56067,82,1554015600,21,1,22,Clouds
56068,83,1554015600,36,4,40,Clouds
56069,84,1554015600,21,9,30,Clouds
56070,85,1554015600,27,8,35,Clouds
56071,86,1554015600,26,12,38,Clouds
56072,87,1554015600,19,19,38,Clouds
56073,88,1554015600,14,16,30,Clouds
56074,89,1554015600,38,2,40,Clouds
56075,90,1554015600,37,3,40,Clouds
56076,91,1554015600,22,8,30,Clouds
56077,92,1554015600,2,38,40,Clouds
56078,93,1554015600,6,34,40,Clouds
56079,94,1554015600,6,34,40,Clouds
56080,95,1554015600,37,3,40,Clouds
56081,96,1554015600,25,5,30,Clouds
56082,97,1554015600,17,23,40,Clouds
56083,98,1554015600,13,27,40,Clouds
56084,99,1554015600,28,2,30,Clouds
56085,100,1554015600,4,21,25,Clouds
56086,101,1554015600,21,9,30,Clouds
56087,102,1554015600,38,2,40,Clouds
56088,103,1554015600,39,1,40,Clouds
56089,104,1554015600,38,2,40,Clouds
56090,105,1554015600,35,1,36,Clouds
56091,106,1554015600,40,0,40,Clouds
56092,107,1554015600,38,2,40,Clouds
56093,108,1554015600,36,4,40,Clouds
56094,109,1554015600,23,6,29,Clouds
56095,110,1554015600,32,8,40,Clouds
56096,111,1554015600,31,9,40,Clouds
56097,112,1554015600,1,29,30,Clouds
56098,113,1554015600,39,1,40,Clouds
56099,114,1554015600,21,19,40,Clouds
56100,115,1554015600,10,20,30,Clouds
56101,2,1554019200,20,0,20,Clouds
56102,3,1554019200,20,0,20,Clouds
56103,4,1554019200,16,4,20,Clouds
56104,5,1554019200,32,8,40,Clouds
56105,6,1554019200,10,10,20,Clouds
56106,7,1554019200,13,16,29,Clouds
56107,8,1554019200,11,19,30,Clouds
56108,9,1554019200,0,24,24,Clouds
56109,10,1554019200,0,16,16,Clouds
56110,11,1554019200,29,1,30,Clouds
56111,12,1554019200,8,12,20,Clouds
56112,13,1554019200,24,6,30,Clouds
56113,14,1554019200,0,30,30,Clouds
56114,15,1554019200,16,0,16,Clouds
56115,16,1554019200,6,14,20,Clouds
56116,17,1554019200,7,13,20,Clouds
56117,18,1554019200,17,13,30,Clouds
56118,19,1554019200,13,17,30,Clouds
56119,21,1554019200,1,29,30,Clouds
56120,22,1554019200,14,6,20,Clouds
56121,23,1554019200,12,18,30,Clouds
56122,24,1554019200,10,10,20,Clouds
56123,25,1554019200,26,4,30,Clouds
56124,26,1554019200,2,18,20,Clouds
56125,27,1554019200,2,18,20,Clouds
56126,28,1554019200,11,19,30,Clouds
56127,29,1554019200,0,29,29,Clouds
56128,30,1554019200,18,2,20,Clouds
56129,31,1554019200,12,8,20,Clouds
56130,32,1554019200,7,23,30,Clouds
56131,33,1554019200,2,21,23,Clouds
56132,34,1554019200,13,17,30,Clouds
56133,35,1554019200,22,8,30,Clouds
56134,36,1554019200,23,17,40,Clouds
56135,37,1554019200,19,11,30,Clouds
56136,38,1554019200,35,5,40,Clouds
56137,39,1554019200,11,7,18,Clouds
56138,40,1554019200,2,19,21,Clouds
56139,41,1554019200,20,0,20,Clouds
56140,42,1554019200,28,2,30,Clouds
56141,43,1554019200,16,14,30,Clouds
56142,44,1554019200,5,25,30,Clouds
56143,45,1554019200,25,5,30,Clouds
56144,46,1554019200,2,18,20,Clouds
56145,47,1554019200,26,14,40,Clouds
56146,48,1554019200,19,21,40,Clouds
56147,49,1554019200,34,6,40,Clouds
56148,50,1554019200,27,13,40,Clouds
56149,51,1554019200,20,20,40,Clouds
56150,52,1554019200,10,22,32,Clouds
56151,53,1554019200,32,8,40,Clouds
56152,54,1554019200,30,3,33,Clouds
56153,55,1554019200,32,4,36,Clouds
56154,56,1554019200,5,35,40,Clouds
56155,57,1554019200,11,12,23,Clouds
56156,58,1554019200,32,8,40,Clouds
56157,59,1554019200,17,3,20,Clouds
56158,60,1554019200,15,15,30,Clouds
56159,61,1554019200,16,9,25,Clouds
56160,62,1554019200,40,0,40,Clouds
56161,63,1554019200,13,22,35,Clouds
56162,64,1554019200,7,33,40,Clouds
56163,65,1554019200,40,0,40,Clouds
56164,66,1554019200,33,7,40,Clouds
56165,67,1554019200,36,4,40,Clouds
56166,68,1554019200,32,8,40,Clouds
56167,69,1554019200,30,10,40,Clouds
56168,70,1554019200,7,21,28,Clouds
56169,71,1554019200,19,21,40,Clouds
56170,72,1554019200,9,22,31,Clouds
56171,73,1554019200,23,7,30,Clouds
56172,74,1554019200,10,20,30,Clouds
56173,75,1554019200,37,3,40,Clouds
56174,76,1554019200,37,1,38,Clouds
56175,77,1554019200,2,27,29,Clouds
56176,78,1554019200,25,15,40,Clouds
56177,79,1554019200,16,11,27,Clouds
56178,80,1554019200,37,3,40,Clouds
56179,81,1554019200,40,0,40,Clouds
56180,82,1554019200,21,1,22,Clouds
56181,83,1554019200,36,4,40,Clouds
56182,84,1554019200,21,9,30,Clouds
56183,85,1554019200,30,5,35,Clouds
56184,86,1554019200,27,11,38,Clouds
56185,87,1554019200,19,19,38,Clouds
56186,88,1554019200,19,11,30,Clouds
56187,89,1554019200,38,2,40,Clouds
56188,90,1554019200,34,6,40,Clouds
56189,91,1554019200,21,9,30,Clouds
56190,92,1554019200,3,37,40,Clouds
56191,93,1554019200,6,34,40,Clouds
56192,94,1554019200,6,34,40,Clouds
56193,95,1554019200,39,1,40,Clouds
56194,96,1554019200,25,5,30,Clouds
56195,97,1554019200,16,24,40,Clouds
56196,98,1554019200,14,26,40,Clouds
56197,99,1554019200,27,3,30,Clouds
56198,100,1554019200,2,23,25,Clouds
56199,101,1554019200,24,6,30,Clouds
56200,102,1554019200,38,2,40,Clouds
56201,103,1554019200,39,1,40,Clouds
56202,104,1554019200,38,2,40,Clouds
56203,105,1554019200,35,1,36,Clouds
56204,106,1554019200,40,0,40,Clouds
56205,107,1554019200,38,2,40,Clouds
56206,108,1554019200,36,4,40,Clouds
56207,109,1554019200,23,6,29,Clouds
56208,110,1554019200,31,9,40,Clouds
56209,111,1554019200,34,6,40,Clouds
56210,112,1554019200,6,24,30,Clouds
56211,113,1554019200,39,1,40,Clouds
56212,114,1554019200,23,17,40,Clouds
56213,115,1554019200,14,16,30,Clouds
56214,2,1554022800,20,0,20,Clouds
56215,3,1554022800,20,0,20,Clouds
56216,4,1554022800,15,5,20,Clouds
56217,5,1554022800,30,10,40,Clouds
56218,6,1554022800,6,14,20,Clouds
56219,7,1554022800,13,16,29,Clouds
56220,8,1554022800,12,18,30,Clouds
56221,9,1554022800,0,24,24,Clouds
56222,10,1554022800,0,16,16,Clouds
56223,11,1554022800,30,0,30,Clouds
56224,12,1554022800,11,9,20,Clouds
56225,13,1554022800,23,7,30,Clouds
56226,14,1554022800,0,30,30,Clouds
56227,15,1554022800,16,0,16,Clouds
56228,16,1554022800,6,14,20,Clouds
56229,17,1554022800,8,12,20,Clouds
56230,18,1554022800,17,13,30,Clouds
56231,19,1554022800,15,15,30,Clouds
56232,21,1554022800,0,30,30,Clouds
56233,22,1554022800,15,5,20,Clouds
56234,23,1554022800,10,20,30,Clouds
56235,24,1554022800,7,13,20,Clouds
56236,25,1554022800,26,4,30,Clouds
56237,26,1554022800,1,19,20,Clouds
56238,27,1554022800,0,20,20,Clouds
56239,28,1554022800,15,15,30,Clouds
56240,29,1554022800,0,29,29,Clouds
56241,30,1554022800,17,3,20,Clouds
56242,31,1554022800,14,6,20,Clouds
56243,32,1554022800,3,27,30,Clouds
56244,33,1554022800,0,23,23,Clouds
56245,34,1554022800,12,18,30,Clouds
56246,35,1554022800,24,6,30,Clouds
56247,36,1554022800,24,16,40,Clouds
56248,37,1554022800,19,11,30,Clouds
56249,38,1554022800,34,6,40,Clouds
56250,39,1554022800,12,6,18,Clouds
56251,40,1554022800,0,21,21,Clouds
56252,41,1554022800,20,0,20,Clouds
56253,42,1554022800,27,3,30,Clouds
56254,43,1554022800,15,15,30,Clouds
56255,44,1554022800,7,23,30,Clouds
56256,45,1554022800,25,5,30,Clouds
56257,46,1554022800,0,20,20,Clouds
56258,47,1554022800,27,13,40,Clouds
56259,48,1554022800,16,24,40,Clouds
56260,49,1554022800,31,9,40,Clouds
56261,50,1554022800,29,11,40,Clouds
56262,51,1554022800,14,26,40,Clouds
56263,52,1554022800,11,21,32,Clouds
56264,53,1554022800,32,8,40,Clouds
56265,54,1554022800,28,5,33,Clouds
56266,55,1554022800,33,3,36,Clouds
56267,56,1554022800,5,35,40,Clouds
56268,57,1554022800,13,10,23,Clouds
56269,58,1554022800,32,8,40,Clouds
56270,59,1554022800,18,2,20,Clouds
56271,60,1554022800,16,14,30,Clouds
56272,61,1554022800,22,3,25,Clouds
56273,62,1554022800,40,0,40,Clouds
56274,63,1554022800,11,24,35,Clouds
56275,64,1554022800,5,35,40,Clouds
56276,65,1554022800,39,1,40,Clouds
56277,66,1554022800,35,5,40,Clouds
56278,67,1554022800,37,3,40,Clouds
56279,68,1554022800,31,9,40,Clouds
56280,69,1554022800,29,11,40,Clouds
56281,70,1554022800,9,19,28,Clouds
56282,71,1554022800,21,19,40,Clouds
56283,72,1554022800,11,20,31,Clouds
56284,73,1554022800,23,7,30,Clouds
56285,74,1554022800,9,21,30,Clouds
56286,75,1554022800,39,1,40,Clouds
56287,76,1554022800,38,0,38,Clouds
56288,77,1554022800,1,28,29,Clouds
56289,78,1554022800,26,14,40,Clouds
56290,79,1554022800,18,9,27,Clouds
56291,80,1554022800,39,1,40,Clouds
56292,81,1554022800,39,1,40,Clouds
56293,82,1554022800,21,1,22,Clouds
56294,83,1554022800,36,4,40,Clouds
56295,84,1554022800,22,8,30,Clouds
56296,85,1554022800,33,2,35,Clouds
56297,86,1554022800,26,12,38,Clouds
56298,87,1554022800,22,16,38,Clouds
56299,88,1554022800,19,11,30,Clouds
56300,89,1554022800,38,2,40,Clouds
56301,90,1554022800,30,10,40,Clouds
56302,91,1554022800,20,10,30,Clouds
56303,92,1554022800,4,36,40,Clouds
56304,93,1554022800,6,34,40,Clouds
56305,94,1554022800,6,34,40,Clouds
56306,95,1554022800,39,1,40,Clouds
56307,96,1554022800,25,5,30,Clouds
56308,97,1554022800,18,22,40,Clouds
56309,98,1554022800,12,28,40,Clouds
56310,99,1554022800,27,3,30,Clouds
56311,100,1554022800,1,24,25,Clouds
56312,101,1554022800,24,6,30,Clouds
56313,102,1554022800,40,0,40,Clouds
56314,103,1554022800,39,1,40,Clouds
56315,104,1554022800,38,2,40,Clouds
56316,105,1554022800,35,1,36,Clouds
56317,106,1554022800,40,0,40,Clouds
56318,107,1554022800,39,1,40,Clouds
56319,108,1554022800,38,2,40,Clouds
56320,109,1554022800,24,5,29,Clouds
56321,110,1554022800,32,8,40,Clouds
56322,111,1554022800,36,4,40,Clouds
56323,112,1554022800,6,24,30,Clouds
56324,113,1554022800,39,1,40,Clouds
56325,114,1554022800,23,17,40,Clouds
56326,115,1554022800,14,16,30,Clouds
56327,2,1554026400,20,0,20,Clouds
56328,3,1554026400,20,0,20,Clouds
56329,4,1554026400,14,6,20,Clouds
56330,5,1554026400,30,10,40,Clouds
56331,6,1554026400,3,17,20,Clouds
56332,7,1554026400,15,14,29,Clouds
56333,8,1554026400,9,21,30,Clouds
56334,9,1554026400,0,24,24,Clouds
56335,10,1554026400,0,16,16,Clouds
56336,11,1554026400,30,0,30,Clouds
56337,12,1554026400,12,8,20,Clouds
56338,13,1554026400,21,9,30,Clouds
56339,14,1554026400,0,30,30,Clouds
56340,15,1554026400,16,0,16,Clouds
56341,16,1554026400,4,16,20,Clouds
56342,17,1554026400,5,15,20,Clouds
56343,18,1554026400,18,12,30,Clouds
56344,19,1554026400,10,20,30,Clouds
56345,21,1554026400,0,30,30,Clouds
56346,22,1554026400,14,6,20,Clouds
56347,23,1554026400,8,22,30,Clouds
56348,24,1554026400,7,13,20,Clouds
56349,25,1554026400,26,4,30,Clouds
56350,26,1554026400,3,17,20,Clouds
56351,27,1554026400,0,20,20,Clouds
56352,28,1554026400,19,11,30,Clouds
56353,29,1554026400,0,29,29,Clouds
56354,30,1554026400,19,1,20,Clouds
56355,31,1554026400,11,9,20,Clouds
56356,32,1554026400,0,30,30,Clouds
56357,33,1554026400,0,23,23,Clouds
56358,34,1554026400,13,17,30,Clouds
56359,35,1554026400,26,4,30,Clouds
56360,36,1554026400,21,19,40,Clouds
56361,37,1554026400,19,11,30,Clouds
56362,38,1554026400,34,6,40,Clouds
56363,39,1554026400,15,3,18,Clouds
56364,40,1554026400,0,21,21,Clouds
56365,41,1554026400,20,0,20,Clouds
56366,42,1554026400,28,2,30,Clouds
56367,43,1554026400,17,13,30,Clouds
56368,44,1554026400,8,22,30,Clouds
56369,45,1554026400,25,5,30,Clouds
56370,46,1554026400,0,20,20,Clouds
56371,47,1554026400,27,13,40,Clouds
56372,48,1554026400,17,23,40,Clouds
56373,49,1554026400,28,12,40,Clouds
56374,50,1554026400,30,10,40,Clouds
56375,51,1554026400,11,29,40,Clouds
56376,52,1554026400,8,24,32,Clouds
56377,53,1554026400,31,9,40,Clouds
56378,54,1554026400,26,7,33,Clouds
56379,55,1554026400,32,4,36,Clouds
56380,56,1554026400,5,35,40,Clouds
56381,57,1554026400,13,10,23,Clouds
56382,58,1554026400,28,12,40,Clouds
56383,59,1554026400,20,0,20,Clouds
56384,60,1554026400,17,13,30,Clouds
56385,61,1554026400,23,2,25,Clouds
56386,62,1554026400,40,0,40,Clouds
56387,63,1554026400,11,24,35,Clouds
56388,64,1554026400,3,37,40,Clouds
56389,65,1554026400,38,2,40,Clouds
56390,66,1554026400,38,2,40,Clouds
56391,67,1554026400,39,1,40,Clouds
56392,68,1554026400,28,12,40,Clouds
56393,69,1554026400,33,7,40,Clouds
56394,70,1554026400,12,16,28,Clouds
56395,71,1554026400,22,18,40,Clouds
56396,72,1554026400,10,21,31,Clouds
56397,73,1554026400,27,3,30,Clouds
56398,74,1554026400,11,19,30,Clouds
56399,75,1554026400,40,0,40,Clouds
56400,76,1554026400,36,2,38,Clouds
56401,77,1554026400,0,29,29,Clouds
56402,78,1554026400,26,14,40,Clouds
56403,79,1554026400,18,9,27,Clouds
56404,80,1554026400,39,1,40,Clouds
56405,81,1554026400,40,0,40,Clouds
56406,82,1554026400,21,1,22,Clouds
56407,83,1554026400,39,1,40,Clouds
56408,84,1554026400,24,6,30,Clouds
56409,85,1554026400,35,0,35,Clouds
56410,86,1554026400,28,10,38,Clouds
56411,87,1554026400,22,16,38,Clouds
56412,88,1554026400,20,10,30,Clouds
56413,89,1554026400,37,3,40,Clouds
56414,90,1554026400,29,11,40,Clouds
56415,91,1554026400,24,6,30,Clouds
56416,92,1554026400,4,36,40,Clouds
56417,93,1554026400,6,34,40,Clouds
56418,94,1554026400,6,34,40,Clouds
56419,95,1554026400,40,0,40,Clouds
56420,96,1554026400,27,3,30,Clouds
56421,97,1554026400,21,19,40,Clouds
56422,98,1554026400,6,34,40,Clouds
56423,99,1554026400,26,4,30,Clouds
56424,100,1554026400,2,23,25,Clouds
56425,101,1554026400,26,4,30,Clouds
56426,102,1554026400,40,0,40,Clouds
56427,103,1554026400,39,1,40,Clouds
56428,104,1554026400,38,2,40,Clouds
56429,105,1554026400,35,1,36,Clouds
56430,106,1554026400,40,0,40,Clouds
56431,107,1554026400,40,0,40,Clouds
56432,108,1554026400,38,2,40,Clouds
56433,109,1554026400,24,5,29,Clouds
56434,110,1554026400,31,9,40,Clouds
56435,111,1554026400,38,2,40,Clouds
56436,112,1554026400,9,21,30,Clouds
56437,113,1554026400,39,1,40,Clouds
56438,114,1554026400,22,18,40,Clouds
56439,115,1554026400,17,13,30,Clouds
56440,2,1554030000,20,0,20,Clouds
56441,3,1554030000,19,1,20,Clouds
56442,4,1554030000,13,7,20,Clouds
56443,5,1554030000,32,8,40,Clouds
56444,6,1554030000,0,20,20,Clouds
56445,7,1554030000,15,14,29,Clouds
56446,8,1554030000,6,24,30,Clouds
56447,9,1554030000,0,24,24,Clouds
56448,10,1554030000,0,16,16,Clouds
56449,11,1554030000,29,1,30,Clouds
56450,12,1554030000,15,5,20,Clouds
56451,13,1554030000,21,9,30,Clouds
56452,14,1554030000,0,30,30,Clouds
56453,15,1554030000,16,0,16,Clouds
56454,16,1554030000,3,17,20,Clouds
56455,17,1554030000,0,20,20,Clouds
56456,18,1554030000,14,16,30,Clouds
56457,19,1554030000,9,21,30,Clouds
56458,21,1554030000,1,29,30,Clouds
56459,22,1554030000,8,12,20,Clouds
56460,23,1554030000,1,29,30,Clouds
56461,24,1554030000,0,20,20,Clouds
56462,25,1554030000,26,4,30,Clouds
56463,26,1554030000,2,18,20,Clouds
56464,27,1554030000,0,20,20,Clouds
56465,28,1554030000,24,6,30,Clouds
56466,29,1554030000,0,29,29,Clouds
56467,30,1554030000,20,0,20,Clouds
56468,31,1554030000,8,12,20,Clouds
56469,32,1554030000,0,30,30,Clouds
56470,33,1554030000,0,23,23,Clouds
56471,34,1554030000,18,12,30,Clouds
56472,35,1554030000,28,2,30,Clouds
56473,36,1554030000,18,22,40,Clouds
56474,37,1554030000,19,11,30,Clouds
56475,38,1554030000,34,6,40,Clouds
56476,39,1554030000,18,0,18,Clouds
56477,40,1554030000,0,21,21,Clouds
56478,41,1554030000,20,0,20,Clouds
56479,42,1554030000,29,1,30,Clouds
56480,43,1554030000,19,11,30,Clouds
56481,44,1554030000,11,19,30,Clouds
56482,45,1554030000,24,6,30,Clouds
56483,46,1554030000,1,19,20,Clouds
56484,47,1554030000,29,11,40,Clouds
56485,48,1554030000,14,26,40,Clouds
56486,49,1554030000,29,11,40,Clouds
56487,50,1554030000,29,11,40,Clouds
56488,51,1554030000,3,37,40,Clouds
56489,52,1554030000,4,28,32,Clouds
56490,53,1554030000,32,8,40,Clouds
56491,54,1554030000,24,9,33,Clouds
56492,55,1554030000,31,5,36,Clouds
56493,56,1554030000,10,30,40,Clouds
56494,57,1554030000,14,9,23,Clouds
56495,58,1554030000,27,13,40,Clouds
56496,59,1554030000,18,2,20,Clouds
56497,60,1554030000,25,5,30,Clouds
56498,61,1554030000,25,0,25,Clouds
56499,62,1554030000,39,1,40,Clouds
56500,63,1554030000,8,27,35,Clouds
56501,64,1554030000,3,37,40,Clouds
56502,65,1554030000,39,0,39,Clouds
56503,66,1554030000,40,0,40,Clouds
56504,67,1554030000,40,0,40,Clouds
56505,68,1554030000,30,10,40,Clouds
56506,69,1554030000,32,8,40,Clouds
56507,70,1554030000,16,12,28,Clouds
56508,71,1554030000,23,17,40,Clouds
56509,72,1554030000,10,21,31,Clouds
56510,73,1554030000,30,0,30,Clouds
56511,74,1554030000,12,18,30,Clouds
56512,75,1554030000,40,0,40,Clouds
56513,76,1554030000,38,0,38,Clouds
56514,77,1554030000,0,29,29,Clouds
56515,78,1554030000,25,15,40,Clouds
56516,79,1554030000,17,10,27,Clouds
56517,80,1554030000,40,0,40,Clouds
56518,81,1554030000,40,0,40,Clouds
56519,82,1554030000,22,0,22,Clouds
56520,83,1554030000,40,0,40,Clouds
56521,84,1554030000,25,5,30,Clouds
56522,85,1554030000,34,1,35,Clouds
56523,86,1554030000,26,12,38,Clouds
56524,87,1554030000,22,16,38,Clouds
56525,88,1554030000,23,7,30,Clouds
56526,89,1554030000,37,3,40,Clouds
56527,90,1554030000,29,11,40,Clouds
56528,91,1554030000,19,11,30,Clouds
56529,92,1554030000,5,35,40,Clouds
56530,93,1554030000,6,34,40,Clouds
56531,94,1554030000,6,34,40,Clouds
56532,95,1554030000,38,2,40,Clouds
56533,96,1554030000,30,0,30,Clouds
56534,97,1554030000,27,13,40,Clouds
56535,98,1554030000,1,39,40,Clouds
56536,99,1554030000,27,3,30,Clouds
56537,100,1554030000,3,22,25,Clouds
56538,101,1554030000,30,0,30,Clouds
56539,102,1554030000,40,0,40,Clouds
56540,103,1554030000,38,2,40,Clouds
56541,104,1554030000,38,2,40,Clouds
56542,105,1554030000,36,0,36,Clouds
56543,106,1554030000,39,1,40,Clouds
56544,107,1554030000,40,0,40,Clouds
56545,108,1554030000,40,0,40,Clouds
56546,109,1554030000,25,4,29,Clouds
56547,110,1554030000,35,5,40,Clouds
56548,111,1554030000,40,0,40,Clouds
56549,112,1554030000,14,16,30,Clouds
56550,113,1554030000,39,1,40,Clouds
56551,114,1554030000,22,18,40,Clouds
56552,115,1554030000,23,7,30,Clouds
56553,2,1554033600,20,0,20,Clouds
56554,3,1554033600,15,5,20,Clouds
56555,4,1554033600,10,10,20,Clouds
56556,5,1554033600,38,2,40,Clouds
56557,6,1554033600,0,20,20,Clouds
56558,7,1554033600,18,11,29,Clouds
56559,8,1554033600,2,28,30,Clouds
56560,9,1554033600,0,24,24,Clouds
56561,10,1554033600,0,16,16,Clouds
56562,11,1554033600,29,1,30,Clouds
56563,12,1554033600,13,7,20,Clouds
56564,13,1554033600,21,9,30,Clouds
56565,14,1554033600,0,30,30,Clouds
56566,15,1554033600,15,1,16,Clouds
56567,16,1554033600,0,20,20,Clouds
56568,17,1554033600,0,20,20,Clouds
56569,18,1554033600,20,10,30,Clouds
56570,19,1554033600,9,21,30,Clouds
56571,21,1554033600,0,30,30,Clouds
56572,22,1554033600,1,19,20,Clouds
56573,23,1554033600,0,30,30,Clouds
56574,24,1554033600,0,20,20,Clouds
56575,25,1554033600,26,4,30,Clouds
56576,26,1554033600,2,18,20,Clouds
56577,27,1554033600,1,19,20,Clouds
56578,28,1554033600,25,5,30,Clouds
56579,29,1554033600,0,29,29,Clouds
56580,30,1554033600,19,1,20,Clouds
56581,31,1554033600,0,20,20,Clouds
56582,32,1554033600,1,29,30,Clouds
56583,33,1554033600,0,23,23,Clouds
56584,34,1554033600,25,5,30,Clouds
56585,35,1554033600,25,5,30,Clouds
56586,36,1554033600,15,25,40,Clouds
56587,37,1554033600,21,9,30,Clouds
56588,38,1554033600,28,12,40,Clouds
56589,39,1554033600,17,1,18,Clouds
56590,40,1554033600,0,21,21,Clouds
56591,41,1554033600,20,0,20,Clouds
56592,42,1554033600,27,3,30,Clouds
56593,43,1554033600,24,6,30,Clouds
56594,44,1554033600,18,12,30,Clouds
56595,45,1554033600,22,8,30,Clouds
56596,46,1554033600,0,20,20,Clouds
56597,47,1554033600,28,12,40,Clouds
56598,48,1554033600,18,22,40,Clouds
56599,49,1554033600,31,9,40,Clouds
56600,50,1554033600,28,12,40,Clouds
56601,51,1554033600,0,40,40,Clouds
56602,52,1554033600,0,32,32,Clouds
56603,53,1554033600,31,9,40,Clouds
56604,54,1554033600,23,10,33,Clouds
56605,55,1554033600,34,2,36,Clouds
56606,56,1554033600,13,27,40,Clouds
56607,57,1554033600,14,9,23,Clouds
56608,58,1554033600,30,10,40,Clouds
56609,59,1554033600,19,1,20,Clouds
56610,60,1554033600,26,4,30,Clouds
56611,61,1554033600,24,1,25,Clouds
56612,62,1554033600,38,2,40,Clouds
56613,63,1554033600,6,29,35,Clouds
56614,64,1554033600,1,39,40,Clouds
56615,65,1554033600,40,0,40,Clouds
56616,66,1554033600,40,0,40,Clouds
56617,67,1554033600,40,0,40,Clouds
56618,68,1554033600,30,10,40,Clouds
56619,69,1554033600,35,5,40,Clouds
56620,70,1554033600,19,9,28,Clouds
56621,71,1554033600,27,13,40,Clouds
56622,72,1554033600,14,17,31,Clouds
56623,73,1554033600,28,2,30,Clouds
56624,74,1554033600,14,16,30,Clouds
56625,75,1554033600,40,0,40,Clouds
56626,76,1554033600,38,0,38,Clouds
56627,77,1554033600,2,27,29,Clouds
56628,78,1554033600,28,12,40,Clouds
56629,79,1554033600,17,10,27,Clouds
56630,80,1554033600,40,0,40,Clouds
56631,81,1554033600,40,0,40,Clouds
56632,82,1554033600,22,0,22,Clouds
56633,83,1554033600,38,2,40,Clouds
56634,84,1554033600,30,0,30,Clouds
56635,85,1554033600,35,0,35,Clouds
56636,86,1554033600,24,14,38,Clouds
56637,87,1554033600,23,15,38,Clouds
56638,88,1554033600,25,5,30,Clouds
56639,89,1554033600,37,3,40,Clouds
56640,90,1554033600,28,12,40,Clouds
56641,91,1554033600,20,10,30,Clouds
56642,92,1554033600,7,33,40,Clouds
56643,93,1554033600,6,34,40,Clouds
56644,94,1554033600,6,34,40,Clouds
56645,95,1554033600,40,0,40,Clouds
56646,96,1554033600,29,1,30,Clouds
56647,97,1554033600,33,7,40,Clouds
56648,98,1554033600,0,40,40,Clouds
56649,99,1554033600,26,4,30,Clouds
56650,100,1554033600,3,22,25,Clouds
56651,101,1554033600,30,0,30,Clouds
56652,102,1554033600,40,0,40,Clouds
56653,103,1554033600,38,2,40,Clouds
56654,104,1554033600,38,2,40,Clouds
56655,105,1554033600,36,0,36,Clouds
56656,106,1554033600,40,0,40,Clouds
56657,107,1554033600,40,0,40,Clouds
56658,108,1554033600,38,2,40,Clouds
56659,109,1554033600,28,1,29,Clouds
56660,110,1554033600,40,0,40,Clouds
56661,111,1554033600,40,0,40,Clouds
56662,112,1554033600,21,9,30,Clouds
56663,113,1554033600,38,2,40,Clouds
56664,114,1554033600,22,18,40,Clouds
56665,115,1554033600,28,2,30,Clouds
56666,2,1554037200,17,3,20,Clouds
56667,3,1554037200,14,6,20,Clouds
56668,4,1554037200,9,11,20,Clouds
56669,5,1554037200,34,6,40,Clouds
56670,6,1554037200,3,17,20,Clouds
56671,7,1554037200,20,9,29,Clouds
56672,8,1554037200,3,27,30,Clouds
56673,9,1554037200,0,24,24,Clouds
56674,10,1554037200,2,14,16,Clouds
56675,11,1554037200,29,1,30,Clouds
56676,12,1554037200,17,3,20,Clouds
56677,13,1554037200,21,9,30,Clouds
56678,14,1554037200,15,15,30,Clouds
56679,15,1554037200,15,1,16,Clouds
56680,16,1554037200,1,19,20,Clouds
56681,17,1554037200,0,20,20,Clouds
56682,18,1554037200,23,7,30,Clouds
56683,19,1554037200,15,15,30,Clouds
56684,21,1554037200,0,30,30,Clouds
56685,22,1554037200,0,20,20,Clouds
56686,23,1554037200,0,30,30,Clouds
56687,24,1554037200,1,19,20,Clouds
56688,25,1554037200,25,5,30,Clouds
56689,26,1554037200,0,20,20,Clouds
56690,27,1554037200,0,20,20,Clouds
56691,28,1554037200,30,0,30,Clouds
56692,29,1554037200,0,29,29,Clouds
56693,30,1554037200,18,2,20,Clouds
56694,31,1554037200,1,19,20,Clouds
56695,32,1554037200,0,30,30,Clouds
56696,33,1554037200,11,12,23,Clouds
56697,34,1554037200,30,0,30,Clouds
56698,35,1554037200,22,8,30,Clouds
56699,36,1554037200,12,28,40,Clouds
56700,37,1554037200,13,17,30,Clouds
56701,38,1554037200,20,20,40,Clouds
56702,39,1554037200,16,2,18,Clouds
56703,40,1554037200,0,21,21,Clouds
56704,41,1554037200,20,0,20,Clouds
56705,42,1554037200,25,5,30,Clouds
56706,43,1554037200,30,0,30,Clouds
56707,44,1554037200,18,12,30,Clouds
56708,45,1554037200,25,5,30,Clouds
56709,46,1554037200,0,20,20,Clouds
56710,47,1554037200,28,12,40,Clouds
56711,48,1554037200,13,27,40,Clouds
56712,49,1554037200,32,8,40,Clouds
56713,50,1554037200,33,7,40,Clouds
56714,51,1554037200,0,40,40,Clouds
56715,52,1554037200,1,31,32,Clouds
56716,53,1554037200,30,10,40,Clouds
56717,54,1554037200,21,12,33,Clouds
56718,55,1554037200,35,1,36,Clouds
56719,56,1554037200,13,27,40,Clouds
56720,57,1554037200,9,14,23,Clouds
56721,58,1554037200,31,9,40,Clouds
56722,59,1554037200,18,2,20,Clouds
56723,60,1554037200,27,3,30,Clouds
56724,61,1554037200,25,0,25,Clouds
56725,62,1554037200,39,1,40,Clouds
56726,63,1554037200,1,34,35,Clouds
56727,64,1554037200,2,38,40,Clouds
56728,65,1554037200,38,2,40,Clouds
56729,66,1554037200,39,1,40,Clouds
56730,67,1554037200,39,1,40,Clouds
56731,68,1554037200,33,7,40,Clouds
56732,69,1554037200,37,3,40,Clouds
56733,70,1554037200,24,4,28,Clouds
56734,71,1554037200,28,12,40,Clouds
56735,72,1554037200,19,12,31,Clouds
56736,73,1554037200,30,0,30,Clouds
56737,74,1554037200,18,12,30,Clouds
56738,75,1554037200,40,0,40,Clouds
56739,76,1554037200,38,0,38,Clouds
56740,77,1554037200,0,29,29,Clouds
56741,78,1554037200,32,8,40,Clouds
56742,79,1554037200,17,10,27,Clouds
56743,80,1554037200,28,12,40,Clouds
56744,81,1554037200,40,0,40,Clouds
56745,82,1554037200,21,1,22,Clouds
56746,83,1554037200,39,1,40,Clouds
56747,84,1554037200,30,0,30,Clouds
56748,85,1554037200,35,0,35,Clouds
56749,86,1554037200,26,12,38,Clouds
56750,87,1554037200,25,13,38,Clouds
56751,88,1554037200,27,3,30,Clouds
56752,89,1554037200,39,1,40,Clouds
56753,90,1554037200,29,11,40,Clouds
56754,91,1554037200,23,7,30,Clouds
56755,92,1554037200,11,29,40,Clouds
56756,93,1554037200,6,34,40,Clouds
56757,94,1554037200,6,34,40,Clouds
56758,95,1554037200,40,0,40,Clouds
56759,96,1554037200,29,1,30,Clouds
56760,97,1554037200,37,3,40,Clouds
56761,98,1554037200,0,40,40,Clouds
56762,99,1554037200,27,3,30,Clouds
56763,100,1554037200,8,17,25,Clouds
56764,101,1554037200,30,0,30,Clouds
56765,102,1554037200,23,17,40,Clouds
56766,103,1554037200,40,0,40,Clouds
56767,104,1554037200,40,0,40,Clouds
56768,105,1554037200,36,0,36,Clouds
56769,106,1554037200,39,1,40,Clouds
56770,107,1554037200,40,0,40,Clouds
56771,108,1554037200,40,0,40,Clouds
56772,109,1554037200,26,3,29,Clouds
56773,110,1554037200,40,0,40,Clouds
56774,111,1554037200,40,0,40,Clouds
56775,112,1554037200,18,12,30,Clouds
56776,113,1554037200,36,4,40,Clouds
56777,114,1554037200,22,18,40,Clouds
56778,115,1554037200,26,4,30,Clouds
56779,2,1554040800,20,0,20,Clouds
56780,3,1554040800,13,7,20,Clouds
56781,4,1554040800,10,10,20,Clouds
56782,5,1554040800,38,2,40,Clouds
56783,6,1554040800,5,15,20,Clouds
56784,7,1554040800,23,6,29,Clouds
56785,8,1554040800,3,27,30,Clouds
56786,9,1554040800,0,24,24,Clouds
56787,10,1554040800,1,15,16,Clouds
56788,11,1554040800,30,0,30,Clouds
56789,12,1554040800,20,0,20,Clouds
56790,13,1554040800,21,9,30,Clouds
56791,14,1554040800,0,30,30,Clouds
56792,15,1554040800,16,0,16,Clouds
56793,16,1554040800,0,20,20,Clouds
56794,17,1554040800,0,20,20,Clouds
56795,18,1554040800,27,3,30,Clouds
56796,19,1554040800,21,9,30,Clouds
56797,21,1554040800,0,30,30,Clouds
56798,22,1554040800,0,20,20,Clouds
56799,23,1554040800,0,30,30,Clouds
56800,24,1554040800,2,18,20,Clouds
56801,25,1554040800,26,4,30,Clouds
56802,26,1554040800,0,20,20,Clouds
56803,27,1554040800,0,20,20,Clouds
56804,28,1554040800,29,1,30,Clouds
56805,29,1554040800,6,23,29,Clouds
56806,30,1554040800,19,1,20,Clouds
56807,31,1554040800,2,18,20,Clouds
56808,32,1554040800,9,21,30,Clouds
56809,33,1554040800,0,23,23,Clouds
56810,34,1554040800,16,14,30,Clouds
56811,35,1554040800,30,0,30,Clouds
56812,36,1554040800,1,39,40,Clouds
56813,37,1554040800,11,19,30,Clouds
56814,38,1554040800,16,24,40,Clouds
56815,39,1554040800,15,3,18,Clouds
56816,40,1554040800,1,20,21,Clouds
56817,41,1554040800,20,0,20,Clouds
56818,42,1554040800,22,8,30,Clouds
56819,43,1554040800,30,0,30,Clouds
56820,44,1554040800,23,7,30,Clouds
56821,45,1554040800,24,6,30,Clouds
56822,46,1554040800,0,20,20,Clouds
56823,47,1554040800,28,12,40,Clouds
56824,48,1554040800,11,29,40,Clouds
56825,49,1554040800,38,2,40,Clouds
56826,50,1554040800,37,3,40,Clouds
56827,51,1554040800,1,39,40,Clouds
56828,52,1554040800,7,25,32,Clouds
56829,53,1554040800,30,10,40,Clouds
56830,54,1554040800,22,11,33,Clouds
56831,55,1554040800,35,1,36,Clouds
56832,56,1554040800,15,25,40,Clouds
56833,57,1554040800,10,13,23,Clouds
56834,58,1554040800,35,5,40,Clouds
56835,59,1554040800,20,0,20,Clouds
56836,60,1554040800,22,8,30,Clouds
56837,61,1554040800,25,0,25,Clouds
56838,62,1554040800,39,1,40,Clouds
56839,63,1554040800,0,35,35,Clouds
56840,64,1554040800,0,40,40,Clouds
56841,65,1554040800,40,0,40,Clouds
56842,66,1554040800,40,0,40,Clouds
56843,67,1554040800,39,1,40,Clouds
56844,68,1554040800,31,9,40,Clouds
56845,69,1554040800,36,4,40,Clouds
56846,70,1554040800,23,5,28,Clouds
56847,71,1554040800,28,12,40,Clouds
56848,72,1554040800,28,3,31,Clouds
56849,73,1554040800,29,1,30,Clouds
56850,74,1554040800,19,11,30,Clouds
56851,75,1554040800,40,0,40,Clouds
56852,76,1554040800,32,6,38,Clouds
56853,77,1554040800,1,28,29,Clouds
56854,78,1554040800,32,8,40,Clouds
56855,79,1554040800,17,10,27,Clouds
56856,80,1554040800,30,10,40,Clouds
56857,81,1554040800,40,0,40,Clouds
56858,82,1554040800,22,0,22,Clouds
56859,83,1554040800,40,0,40,Clouds
56860,84,1554040800,30,0,30,Clouds
56861,85,1554040800,35,0,35,Clouds
56862,86,1554040800,35,3,38,Clouds
56863,87,1554040800,27,11,38,Clouds
56864,88,1554040800,29,1,30,Clouds
56865,89,1554040800,39,1,40,Clouds
56866,90,1554040800,25,15,40,Clouds
56867,91,1554040800,29,1,30,Clouds
56868,92,1554040800,10,30,40,Clouds
56869,93,1554040800,6,34,40,Clouds
56870,94,1554040800,6,34,40,Clouds
56871,95,1554040800,40,0,40,Clouds
56872,96,1554040800,30,0,30,Clouds
56873,97,1554040800,40,0,40,Clouds
56874,98,1554040800,0,40,40,Clouds
56875,99,1554040800,27,3,30,Clouds
56876,100,1554040800,4,21,25,Clouds
56877,101,1554040800,28,2,30,Clouds
56878,102,1554040800,25,15,40,Clouds
56879,103,1554040800,40,0,40,Clouds
56880,104,1554040800,40,0,40,Clouds
56881,105,1554040800,36,0,36,Clouds
56882,106,1554040800,40,0,40,Clouds
56883,107,1554040800,40,0,40,Clouds
56884,108,1554040800,39,1,40,Clouds
56885,109,1554040800,20,9,29,Clouds
56886,110,1554040800,40,0,40,Clouds
56887,111,1554040800,38,2,40,Clouds
56888,112,1554040800,4,26,30,Clouds
56889,113,1554040800,35,5,40,Clouds
56890,114,1554040800,20,20,40,Clouds
56891,115,1554040800,22,8,30,Clouds
56892,2,1554044400,20,0,20,Clouds
56893,3,1554044400,9,11,20,Clouds
56894,4,1554044400,14,6,20,Clouds
56895,5,1554044400,38,2,40,Clouds
56896,6,1554044400,3,17,20,Clouds
56897,7,1554044400,26,3,29,Clouds
56898,8,1554044400,1,29,30,Clouds
56899,9,1554044400,1,23,24,Clouds
56900,10,1554044400,0,16,16,Clouds
56901,11,1554044400,30,0,30,Clouds
56902,12,1554044400,17,3,20,Clouds
56903,13,1554044400,22,8,30,Clouds
56904,14,1554044400,19,11,30,Clouds
56905,15,1554044400,16,0,16,Clouds
56906,16,1554044400,1,19,20,Clouds
56907,17,1554044400,0,20,20,Clouds
56908,18,1554044400,28,2,30,Clouds
56909,19,1554044400,22,8,30,Clouds
56910,21,1554044400,0,30,30,Clouds
56911,22,1554044400,4,16,20,Clouds
56912,23,1554044400,0,30,30,Clouds
56913,24,1554044400,1,19,20,Clouds
56914,25,1554044400,29,1,30,Clouds
56915,26,1554044400,1,19,20,Clouds
56916,27,1554044400,0,20,20,Clouds
56917,28,1554044400,22,8,30,Clouds
56918,29,1554044400,0,29,29,Clouds
56919,30,1554044400,17,3,20,Clouds
56920,31,1554044400,3,17,20,Clouds
56921,32,1554044400,15,15,30,Clouds
56922,33,1554044400,2,21,23,Clouds
56923,34,1554044400,28,2,30,Clouds
56924,35,1554044400,26,4,30,Clouds
56925,36,1554044400,1,39,40,Clouds
56926,37,1554044400,4,26,30,Clouds
56927,38,1554044400,8,32,40,Clouds
56928,39,1554044400,11,7,18,Clouds
56929,40,1554044400,1,20,21,Clouds
56930,41,1554044400,20,0,20,Clouds
56931,42,1554044400,26,4,30,Clouds
56932,43,1554044400,29,1,30,Clouds
56933,44,1554044400,24,6,30,Clouds
56934,45,1554044400,21,9,30,Clouds
56935,46,1554044400,0,20,20,Clouds
56936,47,1554044400,25,15,40,Clouds
56937,48,1554044400,11,29,40,Clouds
56938,49,1554044400,38,2,40,Clouds
56939,50,1554044400,40,0,40,Clouds
56940,51,1554044400,0,40,40,Clouds
56941,52,1554044400,0,32,32,Clouds
56942,53,1554044400,26,14,40,Clouds
56943,54,1554044400,22,11,33,Clouds
56944,55,1554044400,35,1,36,Clouds
56945,56,1554044400,15,25,40,Clouds
56946,57,1554044400,11,12,23,Clouds
56947,58,1554044400,40,0,40,Clouds
56948,59,1554044400,19,1,20,Clouds
56949,60,1554044400,20,10,30,Clouds
56950,61,1554044400,25,0,25,Clouds
56951,62,1554044400,35,5,40,Clouds
56952,63,1554044400,1,34,35,Clouds
56953,64,1554044400,1,39,40,Clouds
56954,65,1554044400,40,0,40,Clouds
56955,66,1554044400,35,5,40,Clouds
56956,67,1554044400,34,6,40,Clouds
56957,68,1554044400,36,4,40,Clouds
56958,69,1554044400,34,6,40,Clouds
56959,70,1554044400,22,6,28,Clouds
56960,71,1554044400,25,15,40,Clouds
56961,72,1554044400,30,1,31,Clouds
56962,73,1554044400,27,3,30,Clouds
56963,74,1554044400,19,11,30,Clouds
56964,75,1554044400,39,1,40,Clouds
56965,76,1554044400,36,2,38,Clouds
56966,77,1554044400,1,28,29,Clouds
56967,78,1554044400,32,8,40,Clouds
56968,79,1554044400,19,8,27,Clouds
56969,80,1554044400,32,8,40,Clouds
56970,81,1554044400,40,0,40,Clouds
56971,82,1554044400,22,0,22,Clouds
56972,83,1554044400,31,9,40,Clouds
56973,84,1554044400,30,0,30,Clouds
56974,85,1554044400,30,5,35,Clouds
56975,86,1554044400,36,2,38,Clouds
56976,87,1554044400,25,13,38,Clouds
56977,88,1554044400,29,1,30,Clouds
56978,89,1554044400,39,1,40,Clouds
56979,90,1554044400,32,8,40,Clouds
56980,91,1554044400,23,7,30,Clouds
56981,92,1554044400,13,27,40,Clouds
56982,93,1554044400,7,33,40,Clouds
56983,94,1554044400,8,32,40,Clouds
56984,95,1554044400,37,3,40,Clouds
56985,96,1554044400,30,0,30,Clouds
56986,97,1554044400,37,3,40,Clouds
56987,98,1554044400,1,39,40,Clouds
56988,99,1554044400,27,3,30,Clouds
56989,100,1554044400,5,20,25,Clouds
56990,101,1554044400,30,0,30,Clouds
56991,102,1554044400,24,16,40,Clouds
56992,103,1554044400,40,0,40,Clouds
56993,104,1554044400,40,0,40,Clouds
56994,105,1554044400,35,1,36,Clouds
56995,106,1554044400,39,1,40,Clouds
56996,107,1554044400,30,10,40,Clouds
56997,108,1554044400,38,2,40,Clouds
56998,109,1554044400,21,8,29,Clouds
56999,110,1554044400,40,0,40,Clouds
57000,111,1554044400,38,2,40,Clouds
57001,112,1554044400,8,22,30,Clouds
57002,113,1554044400,37,3,40,Clouds
57003,114,1554044400,26,14,40,Clouds
57004,115,1554044400,24,6,30,Clouds
57005,2,1554048000,19,1,20,Clouds
57006,3,1554048000,11,9,20,Clouds
57007,4,1554048000,16,4,20,Clouds
57008,5,1554048000,30,10,40,Clouds
57009,6,1554048000,2,18,20,Clouds
57010,7,1554048000,26,3,29,Clouds
57011,8,1554048000,2,28,30,Clouds
57012,9,1554048000,2,22,24,Clouds
57013,10,1554048000,1,15,16,Clouds
57014,11,1554048000,30,0,30,Clouds
57015,12,1554048000,18,2,20,Clouds
57016,13,1554048000,21,9,30,Clouds
57017,14,1554048000,6,24,30,Clouds
57018,15,1554048000,15,1,16,Clouds
57019,16,1554048000,0,20,20,Clouds
57020,17,1554048000,4,16,20,Clouds
57021,18,1554048000,30,0,30,Clouds
57022,19,1554048000,20,10,30,Clouds
57023,21,1554048000,3,27,30,Clouds
57024,22,1554048000,4,16,20,Clouds
57025,23,1554048000,0,30,30,Clouds
57026,24,1554048000,0,20,20,Clouds
57027,25,1554048000,28,2,30,Clouds
57028,26,1554048000,0,20,20,Clouds
57029,27,1554048000,0,20,20,Clouds
57030,28,1554048000,24,6,30,Clouds
57031,29,1554048000,0,29,29,Clouds
57032,30,1554048000,18,2,20,Clouds
57033,31,1554048000,0,20,20,Clouds
57034,32,1554048000,13,17,30,Clouds
57035,33,1554048000,0,23,23,Clouds
57036,34,1554048000,27,3,30,Clouds
57037,35,1554048000,27,3,30,Clouds
57038,36,1554048000,1,39,40,Clouds
57039,37,1554048000,1,29,30,Clouds
57040,38,1554048000,10,30,40,Clouds
57041,39,1554048000,13,5,18,Clouds
57042,40,1554048000,1,20,21,Clouds
57043,41,1554048000,17,3,20,Clouds
57044,42,1554048000,30,0,30,Clouds
57045,43,1554048000,27,3,30,Clouds
57046,44,1554048000,24,6,30,Clouds
57047,45,1554048000,18,12,30,Clouds
57048,46,1554048000,3,17,20,Clouds
57049,47,1554048000,25,15,40,Clouds
57050,48,1554048000,10,30,40,Clouds
57051,49,1554048000,35,5,40,Clouds
57052,50,1554048000,38,2,40,Clouds
57053,51,1554048000,0,40,40,Clouds
57054,52,1554048000,2,30,32,Clouds
57055,53,1554048000,23,17,40,Clouds
57056,54,1554048000,23,10,33,Clouds
57057,55,1554048000,34,2,36,Clouds
57058,56,1554048000,12,28,40,Clouds
57059,57,1554048000,12,11,23,Clouds
57060,58,1554048000,38,2,40,Clouds
57061,59,1554048000,20,0,20,Clouds
57062,60,1554048000,19,11,30,Clouds
57063,61,1554048000,25,0,25,Clouds
57064,62,1554048000,32,8,40,Clouds
57065,63,1554048000,6,29,35,Clouds
57066,64,1554048000,2,38,40,Clouds
57067,65,1554048000,39,1,40,Clouds
57068,66,1554048000,35,5,40,Clouds
57069,67,1554048000,33,7,40,Clouds
57070,68,1554048000,34,6,40,Clouds
57071,69,1554048000,38,2,40,Clouds
57072,70,1554048000,24,4,28,Clouds
57073,71,1554048000,22,18,40,Clouds
57074,72,1554048000,28,3,31,Clouds
57075,73,1554048000,29,1,30,Clouds
57076,74,1554048000,19,11,30,Clouds
57077,75,1554048000,40,0,40,Clouds
57078,76,1554048000,37,1,38,Clouds
57079,77,1554048000,0,29,29,Clouds
57080,78,1554048000,32,8,40,Clouds
57081,79,1554048000,21,6,27,Clouds
57082,80,1554048000,39,1,40,Clouds
57083,81,1554048000,39,1,40,Clouds
57084,82,1554048000,20,2,22,Clouds
57085,83,1554048000,33,7,40,Clouds
57086,84,1554048000,28,2,30,Clouds
57087,85,1554048000,33,2,35,Clouds
57088,86,1554048000,35,3,38,Clouds
57089,87,1554048000,28,10,38,Clouds
57090,88,1554048000,28,2,30,Clouds
57091,89,1554048000,39,1,40,Clouds
57092,90,1554048000,34,6,40,Clouds
57093,91,1554048000,24,6,30,Clouds
57094,92,1554048000,15,25,40,Clouds
57095,93,1554048000,7,33,40,Clouds
57096,94,1554048000,6,34,40,Clouds
57097,95,1554048000,37,3,40,Clouds
57098,96,1554048000,30,0,30,Clouds
57099,97,1554048000,38,2,40,Clouds
57100,98,1554048000,16,24,40,Clouds
57101,99,1554048000,25,5,30,Clouds
57102,100,1554048000,19,6,25,Clouds
57103,101,1554048000,27,3,30,Clouds
57104,102,1554048000,25,15,40,Clouds
57105,103,1554048000,40,0,40,Clouds
57106,104,1554048000,40,0,40,Clouds
57107,105,1554048000,36,0,36,Clouds
57108,106,1554048000,29,11,40,Clouds
57109,107,1554048000,34,6,40,Clouds
57110,108,1554048000,39,1,40,Clouds
57111,109,1554048000,20,9,29,Clouds
57112,110,1554048000,36,4,40,Clouds
57113,111,1554048000,40,0,40,Clouds
57114,112,1554048000,7,23,30,Clouds
57115,113,1554048000,37,3,40,Clouds
57116,114,1554048000,25,15,40,Clouds
57117,115,1554048000,22,8,30,Clouds
57118,2,1554051600,17,3,20,Clouds
57119,3,1554051600,1,19,20,Clouds
57120,4,1554051600,14,6,20,Clouds
57121,5,1554051600,24,16,40,Clouds
57122,6,1554051600,5,15,20,Clouds
57123,7,1554051600,27,2,29,Clouds
57124,8,1554051600,5,25,30,Clouds
57125,9,1554051600,9,15,24,Clouds
57126,10,1554051600,1,15,16,Clouds
57127,11,1554051600,30,0,30,Clouds
57128,12,1554051600,19,1,20,Clouds
57129,13,1554051600,19,11,30,Clouds
57130,14,1554051600,1,29,30,Clouds
57131,15,1554051600,15,1,16,Clouds
57132,16,1554051600,2,18,20,Clouds
57133,17,1554051600,2,18,20,Clouds
57134,18,1554051600,25,5,30,Clouds
57135,19,1554051600,24,6,30,Clouds
57136,21,1554051600,1,29,30,Clouds
57137,22,1554051600,1,19,20,Clouds
57138,23,1554051600,0,30,30,Clouds
57139,24,1554051600,3,17,20,Clouds
57140,25,1554051600,28,2,30,Clouds
57141,26,1554051600,3,17,20,Clouds
57142,27,1554051600,5,15,20,Clouds
57143,28,1554051600,18,12,30,Clouds
57144,29,1554051600,0,29,29,Clouds
57145,30,1554051600,16,4,20,Clouds
57146,31,1554051600,1,19,20,Clouds
57147,32,1554051600,17,13,30,Clouds
57148,33,1554051600,2,21,23,Clouds
57149,34,1554051600,5,25,30,Clouds
57150,35,1554051600,25,5,30,Clouds
57151,36,1554051600,5,35,40,Clouds
57152,37,1554051600,1,29,30,Clouds
57153,38,1554051600,16,24,40,Clouds
57154,39,1554051600,14,4,18,Clouds
57155,40,1554051600,0,21,21,Clouds
57156,41,1554051600,20,0,20,Clouds
57157,42,1554051600,29,1,30,Clouds
57158,43,1554051600,25,5,30,Clouds
57159,44,1554051600,21,9,30,Clouds
57160,45,1554051600,19,11,30,Clouds
57161,46,1554051600,0,20,20,Clouds
57162,47,1554051600,26,14,40,Clouds
57163,48,1554051600,11,29,40,Clouds
57164,49,1554051600,39,1,40,Clouds
57165,50,1554051600,38,2,40,Clouds
57166,51,1554051600,19,21,40,Clouds
57167,52,1554051600,4,28,32,Clouds
57168,53,1554051600,23,17,40,Clouds
57169,54,1554051600,20,13,33,Clouds
57170,55,1554051600,34,2,36,Clouds
57171,56,1554051600,8,32,40,Clouds
57172,57,1554051600,12,11,23,Clouds
57173,58,1554051600,39,1,40,Clouds
57174,59,1554051600,20,0,20,Clouds
57175,60,1554051600,25,5,30,Clouds
57176,61,1554051600,22,3,25,Clouds
57177,62,1554051600,33,7,40,Clouds
57178,63,1554051600,4,31,35,Clouds
57179,64,1554051600,6,34,40,Clouds
57180,65,1554051600,40,0,40,Clouds
57181,66,1554051600,36,4,40,Clouds
57182,67,1554051600,28,12,40,Clouds
57183,68,1554051600,35,5,40,Clouds
57184,69,1554051600,34,6,40,Clouds
57185,70,1554051600,22,6,28,Clouds
57186,71,1554051600,22,18,40,Clouds
57187,72,1554051600,29,2,31,Clouds
57188,73,1554051600,29,1,30,Clouds
57189,74,1554051600,27,3,30,Clouds
57190,75,1554051600,40,0,40,Clouds
57191,76,1554051600,18,20,38,Clouds
57192,77,1554051600,1,28,29,Clouds
57193,78,1554051600,36,4,40,Clouds
57194,79,1554051600,21,6,27,Clouds
57195,80,1554051600,38,2,40,Clouds
57196,81,1554051600,39,1,40,Clouds
57197,82,1554051600,20,2,22,Clouds
57198,83,1554051600,34,6,40,Clouds
57199,84,1554051600,29,1,30,Clouds
57200,85,1554051600,30,5,35,Clouds
57201,86,1554051600,36,2,38,Clouds
57202,87,1554051600,31,7,38,Clouds
57203,88,1554051600,28,2,30,Clouds
57204,89,1554051600,38,2,40,Clouds
57205,90,1554051600,33,7,40,Clouds
57206,91,1554051600,26,4,30,Clouds
57207,92,1554051600,17,23,40,Clouds
57208,93,1554051600,7,33,40,Clouds
57209,94,1554051600,6,34,40,Clouds
57210,95,1554051600,38,2,40,Clouds
57211,96,1554051600,28,2,30,Clouds
57212,97,1554051600,38,2,40,Clouds
57213,98,1554051600,7,33,40,Clouds
57214,99,1554051600,23,7,30,Clouds
57215,100,1554051600,19,6,25,Clouds
57216,101,1554051600,30,0,30,Clouds
57217,102,1554051600,25,15,40,Clouds
57218,103,1554051600,40,0,40,Clouds
57219,104,1554051600,40,0,40,Clouds
57220,105,1554051600,36,0,36,Clouds
57221,106,1554051600,28,12,40,Clouds
57222,107,1554051600,36,4,40,Clouds
57223,108,1554051600,37,3,40,Clouds
57224,109,1554051600,23,6,29,Clouds
57225,110,1554051600,37,3,40,Clouds
57226,111,1554051600,38,2,40,Clouds
57227,112,1554051600,12,18,30,Clouds
57228,113,1554051600,36,4,40,Clouds
57229,114,1554051600,19,21,40,Clouds
57230,115,1554051600,14,16,30,Clouds
57231,2,1554055200,20,0,20,Clouds
57232,3,1554055200,2,18,20,Clouds
57233,4,1554055200,15,5,20,Clouds
57234,5,1554055200,31,9,40,Clouds
57235,6,1554055200,3,17,20,Clouds
57236,7,1554055200,27,2,29,Clouds
57237,8,1554055200,4,26,30,Clouds
57238,9,1554055200,13,11,24,Clouds
57239,10,1554055200,0,16,16,Clouds
57240,11,1554055200,30,0,30,Clouds
57241,12,1554055200,19,1,20,Clouds
57242,13,1554055200,18,11,29,Clouds
57243,14,1554055200,1,29,30,Clouds
57244,15,1554055200,15,1,16,Clouds
57245,16,1554055200,4,16,20,Clouds
57246,17,1554055200,7,13,20,Clouds
57247,18,1554055200,22,8,30,Clouds
57248,19,1554055200,22,8,30,Clouds
57249,21,1554055200,2,28,30,Clouds
57250,22,1554055200,4,16,20,Clouds
57251,23,1554055200,5,25,30,Clouds
57252,24,1554055200,1,19,20,Clouds
57253,25,1554055200,28,2,30,Clouds
57254,26,1554055200,5,15,20,Clouds
57255,27,1554055200,12,8,20,Clouds
57256,28,1554055200,22,8,30,Clouds
57257,29,1554055200,19,10,29,Clouds
57258,30,1554055200,14,6,20,Clouds
57259,31,1554055200,10,10,20,Clouds
57260,32,1554055200,20,10,30,Clouds
57261,33,1554055200,9,14,23,Clouds
57262,34,1554055200,4,26,30,Clouds
57263,35,1554055200,25,5,30,Clouds
57264,36,1554055200,6,34,40,Clouds
57265,37,1554055200,0,30,30,Clouds
57266,38,1554055200,16,24,40,Clouds
57267,39,1554055200,11,7,18,Clouds
57268,40,1554055200,5,16,21,Clouds
57269,41,1554055200,20,0,20,Clouds
57270,42,1554055200,21,9,30,Clouds
57271,43,1554055200,23,7,30,Clouds
57272,44,1554055200,22,8,30,Clouds
57273,45,1554055200,21,9,30,Clouds
57274,46,1554055200,1,19,20,Clouds
57275,47,1554055200,27,13,40,Clouds
57276,48,1554055200,11,29,40,Clouds
57277,49,1554055200,32,8,40,Clouds
57278,50,1554055200,37,3,40,Clouds
57279,51,1554055200,20,20,40,Clouds
57280,52,1554055200,2,30,32,Clouds
57281,53,1554055200,22,18,40,Clouds
57282,54,1554055200,16,17,33,Clouds
57283,55,1554055200,35,1,36,Clouds
57284,56,1554055200,5,35,40,Clouds
57285,57,1554055200,9,14,23,Clouds
57286,58,1554055200,39,1,40,Clouds
57287,59,1554055200,20,0,20,Clouds
57288,60,1554055200,29,1,30,Clouds
57289,61,1554055200,22,3,25,Clouds
57290,62,1554055200,36,4,40,Clouds
57291,63,1554055200,4,31,35,Clouds
57292,64,1554055200,4,36,40,Clouds
57293,65,1554055200,40,0,40,Clouds
57294,66,1554055200,38,2,40,Clouds
57295,67,1554055200,19,21,40,Clouds
57296,68,1554055200,32,8,40,Clouds
57297,69,1554055200,33,7,40,Clouds
57298,70,1554055200,10,18,28,Clouds
57299,71,1554055200,21,19,40,Clouds
57300,72,1554055200,30,1,31,Clouds
57301,73,1554055200,29,1,30,Clouds
57302,74,1554055200,28,2,30,Clouds
57303,75,1554055200,38,2,40,Clouds
57304,76,1554055200,18,20,38,Clouds
57305,77,1554055200,1,28,29,Clouds
57306,78,1554055200,34,6,40,Clouds
57307,79,1554055200,21,6,27,Clouds
57308,80,1554055200,40,0,40,Clouds
57309,81,1554055200,40,0,40,Clouds
57310,82,1554055200,19,3,22,Clouds
57311,83,1554055200,33,7,40,Clouds
57312,84,1554055200,29,1,30,Clouds
57313,85,1554055200,32,3,35,Clouds
57314,86,1554055200,37,1,38,Clouds
57315,87,1554055200,29,9,38,Clouds
57316,88,1554055200,26,4,30,Clouds
57317,89,1554055200,38,2,40,Clouds
57318,90,1554055200,33,7,40,Clouds
57319,91,1554055200,26,4,30,Clouds
57320,92,1554055200,19,21,40,Clouds
57321,93,1554055200,8,32,40,Clouds
57322,94,1554055200,6,34,40,Clouds
57323,95,1554055200,39,1,40,Clouds
57324,96,1554055200,28,2,30,Clouds
57325,97,1554055200,36,4,40,Clouds
57326,98,1554055200,8,32,40,Clouds
57327,99,1554055200,22,8,30,Clouds
57328,100,1554055200,19,6,25,Clouds
57329,101,1554055200,24,6,30,Clouds
57330,102,1554055200,26,14,40,Clouds
57331,103,1554055200,39,1,40,Clouds
57332,104,1554055200,40,0,40,Clouds
57333,105,1554055200,35,1,36,Clouds
57334,106,1554055200,28,12,40,Clouds
57335,107,1554055200,37,3,40,Clouds
57336,108,1554055200,33,7,40,Clouds
57337,109,1554055200,24,5,29,Clouds
57338,110,1554055200,22,18,40,Clouds
57339,111,1554055200,37,3,40,Clouds
57340,112,1554055200,19,11,30,Clouds
57341,113,1554055200,33,7,40,Clouds
57342,114,1554055200,19,21,40,Clouds
57343,115,1554055200,16,14,30,Clouds
57344,2,1554058800,20,0,20,Clouds
57345,3,1554058800,1,19,20,Clouds
57346,4,1554058800,18,2,20,Clouds
57347,5,1554058800,22,18,40,Clouds
57348,6,1554058800,1,19,20,Clouds
57349,7,1554058800,29,0,29,Clouds
57350,8,1554058800,4,26,30,Clouds
57351,9,1554058800,15,9,24,Clouds
57352,10,1554058800,2,14,16,Clouds
57353,11,1554058800,29,1,30,Clouds
57354,12,1554058800,20,0,20,Clouds
57355,13,1554058800,17,13,30,Clouds
57356,14,1554058800,3,27,30,Clouds
57357,15,1554058800,16,0,16,Clouds
57358,16,1554058800,4,16,20,Clouds
57359,17,1554058800,8,12,20,Clouds
57360,18,1554058800,16,14,30,Clouds
57361,19,1554058800,16,14,30,Clouds
57362,21,1554058800,6,24,30,Clouds
57363,22,1554058800,7,13,20,Clouds
57364,23,1554058800,13,17,30,Clouds
57365,24,1554058800,2,18,20,Clouds
57366,25,1554058800,26,4,30,Clouds
57367,26,1554058800,9,11,20,Clouds
57368,27,1554058800,13,7,20,Clouds
57369,28,1554058800,26,4,30,Clouds
57370,29,1554058800,16,13,29,Clouds
57371,30,1554058800,17,3,20,Clouds
57372,31,1554058800,11,9,20,Clouds
57373,32,1554058800,21,9,30,Clouds
57374,33,1554058800,19,4,23,Clouds
57375,34,1554058800,1,29,30,Clouds
57376,35,1554058800,24,6,30,Clouds
57377,36,1554058800,8,32,40,Clouds
57378,37,1554058800,1,29,30,Clouds
57379,38,1554058800,20,20,40,Clouds
57380,39,1554058800,15,3,18,Clouds
57381,40,1554058800,11,10,21,Clouds
57382,41,1554058800,19,1,20,Clouds
57383,42,1554058800,14,16,30,Clouds
57384,43,1554058800,19,11,30,Clouds
57385,44,1554058800,22,8,30,Clouds
57386,45,1554058800,23,7,30,Clouds
57387,46,1554058800,8,12,20,Clouds
57388,47,1554058800,26,14,40,Clouds
57389,48,1554058800,6,34,40,Clouds
57390,49,1554058800,29,11,40,Clouds
57391,50,1554058800,38,2,40,Clouds
57392,51,1554058800,22,18,40,Clouds
57393,52,1554058800,6,26,32,Clouds
57394,53,1554058800,21,19,40,Clouds
57395,54,1554058800,12,21,33,Clouds
57396,55,1554058800,34,2,36,Clouds
57397,56,1554058800,6,34,40,Clouds
57398,57,1554058800,9,14,23,Clouds
57399,58,1554058800,37,3,40,Clouds
57400,59,1554058800,20,0,20,Clouds
57401,60,1554058800,28,2,30,Clouds
57402,61,1554058800,24,1,25,Clouds
57403,62,1554058800,38,2,40,Clouds
57404,63,1554058800,5,30,35,Clouds
57405,64,1554058800,0,40,40,Clouds
57406,65,1554058800,39,1,40,Clouds
57407,66,1554058800,39,1,40,Clouds
57408,67,1554058800,23,17,40,Clouds
57409,68,1554058800,27,13,40,Clouds
57410,69,1554058800,18,22,40,Clouds
57411,70,1554058800,11,17,28,Clouds
57412,71,1554058800,12,28,40,Clouds
57413,72,1554058800,26,5,31,Clouds
57414,73,1554058800,29,1,30,Clouds
57415,74,1554058800,26,4,30,Clouds
57416,75,1554058800,36,4,40,Clouds
57417,76,1554058800,22,16,38,Clouds
57418,77,1554058800,2,27,29,Clouds
57419,78,1554058800,33,7,40,Clouds
57420,79,1554058800,21,6,27,Clouds
57421,80,1554058800,39,1,40,Clouds
57422,81,1554058800,39,1,40,Clouds
57423,82,1554058800,20,2,22,Clouds
57424,83,1554058800,25,15,40,Clouds
57425,84,1554058800,29,1,30,Clouds
57426,85,1554058800,34,1,35,Clouds
57427,86,1554058800,38,0,38,Clouds
57428,87,1554058800,29,9,38,Clouds
57429,88,1554058800,22,8,30,Clouds
57430,89,1554058800,37,3,40,Clouds
57431,90,1554058800,37,3,40,Clouds
57432,91,1554058800,20,10,30,Clouds
57433,92,1554058800,23,17,40,Clouds
57434,93,1554058800,8,32,40,Clouds
57435,94,1554058800,6,34,40,Clouds
57436,95,1554058800,34,6,40,Clouds
57437,96,1554058800,26,4,30,Clouds
57438,97,1554058800,35,5,40,Clouds
57439,98,1554058800,9,31,40,Clouds
57440,99,1554058800,22,8,30,Clouds
57441,100,1554058800,18,7,25,Clouds
57442,101,1554058800,19,11,30,Clouds
57443,102,1554058800,28,12,40,Clouds
57444,103,1554058800,39,1,40,Clouds
57445,104,1554058800,40,0,40,Clouds
57446,105,1554058800,33,3,36,Clouds
57447,106,1554058800,27,13,40,Clouds
57448,107,1554058800,35,5,40,Clouds
57449,108,1554058800,36,4,40,Clouds
57450,109,1554058800,22,7,29,Clouds
57451,110,1554058800,24,16,40,Clouds
57452,111,1554058800,38,2,40,Clouds
57453,112,1554058800,27,3,30,Clouds
57454,113,1554058800,33,7,40,Clouds
57455,114,1554058800,21,19,40,Clouds
57456,115,1554058800,16,14,30,Clouds
57457,2,1554062400,18,2,20,Clouds
57458,3,1554062400,0,20,20,Clouds
57459,4,1554062400,16,4,20,Clouds
57460,5,1554062400,27,13,40,Clouds
57461,6,1554062400,5,15,20,Clouds
57462,7,1554062400,26,3,29,Clouds
57463,8,1554062400,5,25,30,Clouds
57464,9,1554062400,15,9,24,Clouds
57465,10,1554062400,5,11,16,Clouds
57466,11,1554062400,29,1,30,Clouds
57467,12,1554062400,19,1,20,Clouds
57468,13,1554062400,17,13,30,Clouds
57469,14,1554062400,7,23,30,Clouds
57470,15,1554062400,16,0,16,Clouds
57471,16,1554062400,6,14,20,Clouds
57472,17,1554062400,6,14,20,Clouds
57473,18,1554062400,16,14,30,Clouds
57474,19,1554062400,11,19,30,Clouds
57475,21,1554062400,6,24,30,Clouds
57476,22,1554062400,6,14,20,Clouds
57477,23,1554062400,16,14,30,Clouds
57478,24,1554062400,4,16,20,Clouds
57479,25,1554062400,26,4,30,Clouds
57480,26,1554062400,11,9,20,Clouds
57481,27,1554062400,20,0,20,Clouds
57482,28,1554062400,30,0,30,Clouds
57483,29,1554062400,14,15,29,Clouds
57484,30,1554062400,20,0,20,Clouds
57485,31,1554062400,10,10,20,Clouds
57486,32,1554062400,23,7,30,Clouds
57487,33,1554062400,20,3,23,Clouds
57488,34,1554062400,1,29,30,Clouds
57489,35,1554062400,18,12,30,Clouds
57490,36,1554062400,30,10,40,Clouds
57491,37,1554062400,16,14,30,Clouds
57492,38,1554062400,23,17,40,Clouds
57493,39,1554062400,18,0,18,Clouds
57494,40,1554062400,12,9,21,Clouds
57495,41,1554062400,17,3,20,Clouds
57496,42,1554062400,12,18,30,Clouds
57497,43,1554062400,16,14,30,Clouds
57498,44,1554062400,22,8,30,Clouds
57499,45,1554062400,23,7,30,Clouds
57500,46,1554062400,8,12,20,Clouds
57501,47,1554062400,27,13,40,Clouds
57502,48,1554062400,7,33,40,Clouds
57503,49,1554062400,25,15,40,Clouds
57504,50,1554062400,38,2,40,Clouds
57505,51,1554062400,22,18,40,Clouds
57506,52,1554062400,8,24,32,Clouds
57507,53,1554062400,23,17,40,Clouds
57508,54,1554062400,11,22,33,Clouds
57509,55,1554062400,35,1,36,Clouds
57510,56,1554062400,5,35,40,Clouds
57511,57,1554062400,9,14,23,Clouds
57512,58,1554062400,35,5,40,Clouds
57513,59,1554062400,19,1,20,Clouds
57514,60,1554062400,25,5,30,Clouds
57515,61,1554062400,24,1,25,Clouds
57516,62,1554062400,40,0,40,Clouds
57517,63,1554062400,6,29,35,Clouds
57518,64,1554062400,2,38,40,Clouds
57519,65,1554062400,40,0,40,Clouds
57520,66,1554062400,40,0,40,Clouds
57521,67,1554062400,18,22,40,Clouds
57522,68,1554062400,25,15,40,Clouds
57523,69,1554062400,13,27,40,Clouds
57524,70,1554062400,10,18,28,Clouds
57525,71,1554062400,10,30,40,Clouds
57526,72,1554062400,29,2,31,Clouds
57527,73,1554062400,27,3,30,Clouds
57528,74,1554062400,23,7,30,Clouds
57529,75,1554062400,23,17,40,Clouds
57530,76,1554062400,22,16,38,Clouds
57531,77,1554062400,4,25,29,Clouds
57532,78,1554062400,33,7,40,Clouds
57533,79,1554062400,24,3,27,Clouds
57534,80,1554062400,19,21,40,Clouds
57535,81,1554062400,40,0,40,Clouds
57536,82,1554062400,19,3,22,Clouds
57537,83,1554062400,22,18,40,Clouds
57538,84,1554062400,21,9,30,Clouds
57539,85,1554062400,29,6,35,Clouds
57540,86,1554062400,38,0,38,Clouds
57541,87,1554062400,30,8,38,Clouds
57542,88,1554062400,22,8,30,Clouds
57543,89,1554062400,36,3,39,Clouds
57544,90,1554062400,37,3,40,Clouds
57545,91,1554062400,21,9,30,Clouds
57546,92,1554062400,20,20,40,Clouds
57547,93,1554062400,10,30,40,Clouds
57548,94,1554062400,6,34,40,Clouds
57549,95,1554062400,31,9,40,Clouds
57550,96,1554062400,22,8,30,Clouds
57551,97,1554062400,32,8,40,Clouds
57552,98,1554062400,11,29,40,Clouds
57553,99,1554062400,22,8,30,Clouds
57554,100,1554062400,25,0,25,Clouds
57555,101,1554062400,16,14,30,Clouds
57556,102,1554062400,28,12,40,Clouds
57557,103,1554062400,39,1,40,Clouds
57558,104,1554062400,40,0,40,Clouds
57559,105,1554062400,32,4,36,Clouds
57560,106,1554062400,24,16,40,Clouds
57561,107,1554062400,38,2,40,Clouds
57562,108,1554062400,38,2,40,Clouds
57563,109,1554062400,22,7,29,Clouds
57564,110,1554062400,21,19,40,Clouds
57565,111,1554062400,39,1,40,Clouds
57566,112,1554062400,30,0,30,Clouds
57567,113,1554062400,35,5,40,Clouds
57568,114,1554062400,18,22,40,Clouds
57569,115,1554062400,10,20,30,Clouds
57570,2,1554066000,15,5,20,Clouds
57571,3,1554066000,0,20,20,Clouds
57572,4,1554066000,16,4,20,Clouds
57573,5,1554066000,26,14,40,Clouds
57574,6,1554066000,2,18,20,Clouds
57575,7,1554066000,27,2,29,Clouds
57576,8,1554066000,7,23,30,Clouds
57577,9,1554066000,19,5,24,Clouds
57578,10,1554066000,5,11,16,Clouds
57579,11,1554066000,29,1,30,Clouds
57580,12,1554066000,18,2,20,Clouds
57581,13,1554066000,15,15,30,Clouds
57582,14,1554066000,4,26,30,Clouds
57583,15,1554066000,15,1,16,Clouds
57584,16,1554066000,9,11,20,Clouds
57585,17,1554066000,8,12,20,Clouds
57586,18,1554066000,11,19,30,Clouds
57587,19,1554066000,10,20,30,Clouds
57588,21,1554066000,8,22,30,Clouds
57589,22,1554066000,6,14,20,Clouds
57590,23,1554066000,15,15,30,Clouds
57591,24,1554066000,2,18,20,Clouds
57592,25,1554066000,25,5,30,Clouds
57593,26,1554066000,13,7,20,Clouds
57594,27,1554066000,20,0,20,Clouds
57595,28,1554066000,15,15,30,Clouds
57596,29,1554066000,11,18,29,Clouds
57597,30,1554066000,20,0,20,Clouds
57598,31,1554066000,15,5,20,Clouds
57599,32,1554066000,28,2,30,Clouds
57600,33,1554066000,16,7,23,Clouds
57601,34,1554066000,3,27,30,Clouds
57602,35,1554066000,17,13,30,Clouds
57603,36,1554066000,31,9,40,Clouds
57604,37,1554066000,18,12,30,Clouds
57605,38,1554066000,21,19,40,Clouds
57606,39,1554066000,20,0,20,Clouds
57607,40,1554066000,12,9,21,Clouds
57608,41,1554066000,19,1,20,Clouds
57609,42,1554066000,13,17,30,Clouds
57610,43,1554066000,5,25,30,Clouds
57611,44,1554066000,20,10,30,Clouds
57612,45,1554066000,24,6,30,Clouds
57613,46,1554066000,12,8,20,Clouds
57614,47,1554066000,27,13,40,Clouds
57615,48,1554066000,6,34,40,Clouds
57616,49,1554066000,27,13,40,Clouds
57617,50,1554066000,37,3,40,Clouds
57618,51,1554066000,22,18,40,Clouds
57619,52,1554066000,8,24,32,Clouds
57620,53,1554066000,23,17,40,Clouds
57621,54,1554066000,13,20,33,Clouds
57622,55,1554066000,35,1,36,Clouds
57623,56,1554066000,17,23,40,Clouds
57624,57,1554066000,11,12,23,Clouds
57625,58,1554066000,35,5,40,Clouds
57626,59,1554066000,20,0,20,Clouds
57627,60,1554066000,23,7,30,Clouds
57628,61,1554066000,20,5,25,Clouds
57629,62,1554066000,40,0,40,Clouds
57630,63,1554066000,5,30,35,Clouds
57631,64,1554066000,1,39,40,Clouds
57632,65,1554066000,40,0,40,Clouds
57633,66,1554066000,40,0,40,Clouds
57634,67,1554066000,19,21,40,Clouds
57635,68,1554066000,25,15,40,Clouds
57636,69,1554066000,10,30,40,Clouds
57637,70,1554066000,9,19,28,Clouds
57638,71,1554066000,12,28,40,Clouds
57639,72,1554066000,29,2,31,Clouds
57640,73,1554066000,22,8,30,Clouds
57641,74,1554066000,22,8,30,Clouds
57642,75,1554066000,28,12,40,Clouds
57643,76,1554066000,23,15,38,Clouds
57644,77,1554066000,4,25,29,Clouds
57645,78,1554066000,32,8,40,Clouds
57646,79,1554066000,26,1,27,Clouds
57647,80,1554066000,18,22,40,Clouds
57648,81,1554066000,40,0,40,Clouds
57649,82,1554066000,22,0,22,Clouds
57650,83,1554066000,19,21,40,Clouds
57651,84,1554066000,21,9,30,Clouds
57652,85,1554066000,28,7,35,Clouds
57653,86,1554066000,38,0,38,Clouds
57654,87,1554066000,28,10,38,Clouds
57655,88,1554066000,20,10,30,Clouds
57656,89,1554066000,36,4,40,Clouds
57657,90,1554066000,36,4,40,Clouds
57658,91,1554066000,21,9,30,Clouds
57659,92,1554066000,27,13,40,Clouds
57660,93,1554066000,11,29,40,Clouds
57661,94,1554066000,6,34,40,Clouds
57662,95,1554066000,29,11,40,Clouds
57663,96,1554066000,24,6,30,Clouds
57664,97,1554066000,33,7,40,Clouds
57665,98,1554066000,10,30,40,Clouds
57666,99,1554066000,22,8,30,Clouds
57667,100,1554066000,25,0,25,Clouds
57668,101,1554066000,16,14,30,Clouds
57669,102,1554066000,31,9,40,Clouds
57670,103,1554066000,38,2,40,Clouds
57671,104,1554066000,40,0,40,Clouds
57672,105,1554066000,32,4,36,Clouds
57673,106,1554066000,23,17,40,Clouds
57674,107,1554066000,36,4,40,Clouds
57675,108,1554066000,35,5,40,Clouds
57676,109,1554066000,20,9,29,Clouds
57677,110,1554066000,22,18,40,Clouds
57678,111,1554066000,40,0,40,Clouds
57679,112,1554066000,29,1,30,Clouds
57680,113,1554066000,35,5,40,Clouds
57681,114,1554066000,20,20,40,Clouds
57682,115,1554066000,11,19,30,Clouds
57683,2,1554069600,16,4,20,Clouds
57684,3,1554069600,1,19,20,Clouds
57685,4,1554069600,15,5,20,Clouds
57686,5,1554069600,27,13,40,Clouds
57687,6,1554069600,2,18,20,Clouds
57688,7,1554069600,27,2,29,Clouds
57689,8,1554069600,8,22,30,Clouds
57690,9,1554069600,21,3,24,Clouds
57691,10,1554069600,4,12,16,Clouds
57692,11,1554069600,30,0,30,Clouds
57693,12,1554069600,18,2,20,Clouds
57694,13,1554069600,16,14,30,Clouds
57695,14,1554069600,2,28,30,Clouds
57696,15,1554069600,14,2,16,Clouds
57697,16,1554069600,12,8,20,Clouds
57698,17,1554069600,9,11,20,Clouds
57699,18,1554069600,6,24,30,Clouds
57700,19,1554069600,10,20,30,Clouds
57701,21,1554069600,9,21,30,Clouds
57702,22,1554069600,7,13,20,Clouds
57703,23,1554069600,19,11,30,Clouds
57704,24,1554069600,5,15,20,Clouds
57705,25,1554069600,26,4,30,Clouds
57706,26,1554069600,13,7,20,Clouds
57707,27,1554069600,19,1,20,Clouds
57708,28,1554069600,13,17,30,Clouds
57709,29,1554069600,11,18,29,Clouds
57710,30,1554069600,20,0,20,Clouds
57711,31,1554069600,18,2,20,Clouds
57712,32,1554069600,27,3,30,Clouds
57713,33,1554069600,21,2,23,Clouds
57714,34,1554069600,5,25,30,Clouds
57715,35,1554069600,13,17,30,Clouds
57716,36,1554069600,33,7,40,Clouds
57717,37,1554069600,18,12,30,Clouds
57718,38,1554069600,27,13,40,Clouds
57719,39,1554069600,19,1,20,Clouds
57720,40,1554069600,15,6,21,Clouds
57721,41,1554069600,20,0,20,Clouds
57722,42,1554069600,13,17,30,Clouds
57723,43,1554069600,4,26,30,Clouds
57724,44,1554069600,23,7,30,Clouds
57725,45,1554069600,21,9,30,Clouds
57726,46,1554069600,14,6,20,Clouds
57727,47,1554069600,27,13,40,Clouds
57728,48,1554069600,14,26,40,Clouds
57729,49,1554069600,30,10,40,Clouds
57730,50,1554069600,33,7,40,Clouds
57731,51,1554069600,22,18,40,Clouds
57732,52,1554069600,8,24,32,Clouds
57733,53,1554069600,23,17,40,Clouds
57734,54,1554069600,12,21,33,Clouds
57735,55,1554069600,35,1,36,Clouds
57736,56,1554069600,10,30,40,Clouds
57737,57,1554069600,12,11,23,Clouds
57738,58,1554069600,34,6,40,Clouds
57739,59,1554069600,19,1,20,Clouds
57740,60,1554069600,19,11,30,Clouds
57741,61,1554069600,22,3,25,Clouds
57742,62,1554069600,38,2,40,Clouds
57743,63,1554069600,6,29,35,Clouds
57744,64,1554069600,0,40,40,Clouds
57745,65,1554069600,39,1,40,Clouds
57746,66,1554069600,36,4,40,Clouds
57747,67,1554069600,21,19,40,Clouds
57748,68,1554069600,24,16,40,Clouds
57749,69,1554069600,4,36,40,Clouds
57750,70,1554069600,12,16,28,Clouds
57751,71,1554069600,10,30,40,Clouds
57752,72,1554069600,27,4,31,Clouds
57753,73,1554069600,22,8,30,Clouds
57754,74,1554069600,19,11,30,Clouds
57755,75,1554069600,27,13,40,Clouds
57756,76,1554069600,23,15,38,Clouds
57757,77,1554069600,5,24,29,Clouds
57758,78,1554069600,32,8,40,Clouds
57759,79,1554069600,26,1,27,Clouds
57760,80,1554069600,19,21,40,Clouds
57761,81,1554069600,40,0,40,Clouds
57762,82,1554069600,20,2,22,Clouds
57763,83,1554069600,18,22,40,Clouds
57764,84,1554069600,17,13,30,Clouds
57765,85,1554069600,29,6,35,Clouds
57766,86,1554069600,38,0,38,Clouds
57767,87,1554069600,24,14,38,Clouds
57768,88,1554069600,19,11,30,Clouds
57769,89,1554069600,36,4,40,Clouds
57770,90,1554069600,35,5,40,Clouds
57771,91,1554069600,21,9,30,Clouds
57772,92,1554069600,40,0,40,Clouds
57773,93,1554069600,11,29,40,Clouds
57774,94,1554069600,6,34,40,Clouds
57775,95,1554069600,29,11,40,Clouds
57776,96,1554069600,25,5,30,Clouds
57777,97,1554069600,31,9,40,Clouds
57778,98,1554069600,10,30,40,Clouds
57779,99,1554069600,21,9,30,Clouds
57780,100,1554069600,25,0,25,Clouds
57781,101,1554069600,15,15,30,Clouds
57782,102,1554069600,31,9,40,Clouds
57783,103,1554069600,39,1,40,Clouds
57784,104,1554069600,40,0,40,Clouds
57785,105,1554069600,31,5,36,Clouds
57786,106,1554069600,20,20,40,Clouds
57787,107,1554069600,36,4,40,Clouds
57788,108,1554069600,33,7,40,Clouds
57789,109,1554069600,19,10,29,Clouds
57790,110,1554069600,22,18,40,Clouds
57791,111,1554069600,40,0,40,Clouds
57792,112,1554069600,26,4,30,Clouds
57793,113,1554069600,35,5,40,Clouds
57794,114,1554069600,19,21,40,Clouds
57795,115,1554069600,6,24,30,Clouds
57796,2,1554073200,15,5,20,Clouds
57797,3,1554073200,1,19,20,Clouds
57798,4,1554073200,15,5,20,Clouds
57799,5,1554073200,27,13,40,Clouds
57800,6,1554073200,6,14,20,Clouds
57801,7,1554073200,26,3,29,Clouds
57802,8,1554073200,10,20,30,Clouds
57803,9,1554073200,21,3,24,Clouds
57804,10,1554073200,4,12,16,Clouds
57805,11,1554073200,30,0,30,Clouds
57806,12,1554073200,18,2,20,Clouds
57807,13,1554073200,16,14,30,Clouds
57808,14,1554073200,2,28,30,Clouds
57809,15,1554073200,12,4,16,Clouds
57810,16,1554073200,15,5,20,Clouds
57811,17,1554073200,9,11,20,Clouds
57812,18,1554073200,4,26,30,Clouds
57813,19,1554073200,8,22,30,Clouds
57814,21,1554073200,11,19,30,Clouds
57815,22,1554073200,9,11,20,Clouds
57816,23,1554073200,23,7,30,Clouds
57817,24,1554073200,17,3,20,Clouds
57818,25,1554073200,26,4,30,Clouds
57819,26,1554073200,12,8,20,Clouds
57820,27,1554073200,18,2,20,Clouds
57821,28,1554073200,15,15,30,Clouds
57822,29,1554073200,11,18,29,Clouds
57823,30,1554073200,20,0,20,Clouds
57824,31,1554073200,20,0,20,Clouds
57825,32,1554073200,23,7,30,Clouds
57826,33,1554073200,22,1,23,Clouds
57827,34,1554073200,0,30,30,Clouds
57828,35,1554073200,15,15,30,Clouds
57829,36,1554073200,34,6,40,Clouds
57830,37,1554073200,18,12,30,Clouds
57831,38,1554073200,24,16,40,Clouds
57832,39,1554073200,20,0,20,Clouds
57833,40,1554073200,15,6,21,Clouds
57834,41,1554073200,19,1,20,Clouds
57835,42,1554073200,18,12,30,Clouds
57836,43,1554073200,1,29,30,Clouds
57837,44,1554073200,20,10,30,Clouds
57838,45,1554073200,18,12,30,Clouds
57839,46,1554073200,19,1,20,Clouds
57840,47,1554073200,27,13,40,Clouds
57841,48,1554073200,13,27,40,Clouds
57842,49,1554073200,29,11,40,Clouds
57843,50,1554073200,31,9,40,Clouds
57844,51,1554073200,23,17,40,Clouds
57845,52,1554073200,9,23,32,Clouds
57846,53,1554073200,23,17,40,Clouds
57847,54,1554073200,17,16,33,Clouds
57848,55,1554073200,35,1,36,Clouds
57849,56,1554073200,8,32,40,Clouds
57850,57,1554073200,13,10,23,Clouds
57851,58,1554073200,37,3,40,Clouds
57852,59,1554073200,19,1,20,Clouds
57853,60,1554073200,15,15,30,Clouds
57854,61,1554073200,22,3,25,Clouds
57855,62,1554073200,35,5,40,Clouds
57856,63,1554073200,9,26,35,Clouds
57857,64,1554073200,0,40,40,Clouds
57858,65,1554073200,40,0,40,Clouds
57859,66,1554073200,29,11,40,Clouds
57860,67,1554073200,19,21,40,Clouds
57861,68,1554073200,27,13,40,Clouds
57862,69,1554073200,7,33,40,Clouds
57863,70,1554073200,10,18,28,Clouds
57864,71,1554073200,8,32,40,Clouds
57865,72,1554073200,29,2,31,Clouds
57866,73,1554073200,18,12,30,Clouds
57867,74,1554073200,20,10,30,Clouds
57868,75,1554073200,28,12,40,Clouds
57869,76,1554073200,25,13,38,Clouds
57870,77,1554073200,6,23,29,Clouds
57871,78,1554073200,30,10,40,Clouds
57872,79,1554073200,24,3,27,Clouds
57873,80,1554073200,20,20,40,Clouds
57874,81,1554073200,40,0,40,Clouds
57875,82,1554073200,19,3,22,Clouds
57876,83,1554073200,18,22,40,Clouds
57877,84,1554073200,14,16,30,Clouds
57878,85,1554073200,27,8,35,Clouds
57879,86,1554073200,36,2,38,Clouds
57880,87,1554073200,28,10,38,Clouds
57881,88,1554073200,18,12,30,Clouds
57882,89,1554073200,37,3,40,Clouds
57883,90,1554073200,36,4,40,Clouds
57884,91,1554073200,26,4,30,Clouds
57885,92,1554073200,35,5,40,Clouds
57886,93,1554073200,11,29,40,Clouds
57887,94,1554073200,6,34,40,Clouds
57888,95,1554073200,29,11,40,Clouds
57889,96,1554073200,25,5,30,Clouds
57890,97,1554073200,31,9,40,Clouds
57891,98,1554073200,11,29,40,Clouds
57892,99,1554073200,20,10,30,Clouds
57893,100,1554073200,25,0,25,Clouds
57894,101,1554073200,13,17,30,Clouds
57895,102,1554073200,32,8,40,Clouds
57896,103,1554073200,39,1,40,Clouds
57897,104,1554073200,40,0,40,Clouds
57898,105,1554073200,32,4,36,Clouds
57899,106,1554073200,20,20,40,Clouds
57900,107,1554073200,36,4,40,Clouds
57901,108,1554073200,35,5,40,Clouds
57902,109,1554073200,19,10,29,Clouds
57903,110,1554073200,21,19,40,Clouds
57904,111,1554073200,33,7,40,Clouds
57905,112,1554073200,23,7,30,Clouds
57906,113,1554073200,35,5,40,Clouds
57907,114,1554073200,22,18,40,Clouds
57908,115,1554073200,1,29,30,Clouds
57909,2,1554076800,14,6,20,Clouds
57910,3,1554076800,0,20,20,Clouds
57911,4,1554076800,15,5,20,Clouds
57912,5,1554076800,23,17,40,Clouds
57913,6,1554076800,10,10,20,Clouds
57914,7,1554076800,26,3,29,Clouds
57915,8,1554076800,11,19,30,Clouds
57916,9,1554076800,24,0,24,Clouds
57917,10,1554076800,7,9,16,Clouds
57918,11,1554076800,30,0,30,Clouds
57919,12,1554076800,18,2,20,Clouds
57920,13,1554076800,17,13,30,Clouds
57921,14,1554076800,9,21,30,Clouds
57922,15,1554076800,14,2,16,Clouds
57923,16,1554076800,18,2,20,Clouds
57924,17,1554076800,11,9,20,Clouds
57925,18,1554076800,5,25,30,Clouds
57926,19,1554076800,8,22,30,Clouds
57927,21,1554076800,12,18,30,Clouds
57928,22,1554076800,9,11,20,Clouds
57929,23,1554076800,24,6,30,Clouds
57930,24,1554076800,19,1,20,Clouds
57931,25,1554076800,28,2,30,Clouds
57932,26,1554076800,12,8,20,Clouds
57933,27,1554076800,20,0,20,Clouds
57934,28,1554076800,14,16,30,Clouds
57935,29,1554076800,16,13,29,Clouds
57936,30,1554076800,20,0,20,Clouds
57937,31,1554076800,19,1,20,Clouds
57938,32,1554076800,27,3,30,Clouds
57939,33,1554076800,22,1,23,Clouds
57940,34,1554076800,0,30,30,Clouds
57941,35,1554076800,13,16,29,Clouds
57942,36,1554076800,34,6,40,Clouds
57943,37,1554076800,23,7,30,Clouds
57944,38,1554076800,23,17,40,Clouds
57945,39,1554076800,20,0,20,Clouds
57946,40,1554076800,15,6,21,Clouds
57947,41,1554076800,20,0,20,Clouds
57948,42,1554076800,16,14,30,Clouds
57949,43,1554076800,0,30,30,Clouds
57950,44,1554076800,19,11,30,Clouds
57951,45,1554076800,18,12,30,Clouds
57952,46,1554076800,20,0,20,Clouds
57953,47,1554076800,27,13,40,Clouds
57954,48,1554076800,12,28,40,Clouds
57955,49,1554076800,28,12,40,Clouds
57956,50,1554076800,31,9,40,Clouds
57957,51,1554076800,24,16,40,Clouds
57958,52,1554076800,13,19,32,Clouds
57959,53,1554076800,23,17,40,Clouds
57960,54,1554076800,19,14,33,Clouds
57961,55,1554076800,34,2,36,Clouds
57962,56,1554076800,5,35,40,Clouds
57963,57,1554076800,11,12,23,Clouds
57964,58,1554076800,36,4,40,Clouds
57965,59,1554076800,19,1,20,Clouds
57966,60,1554076800,7,23,30,Clouds
57967,61,1554076800,20,5,25,Clouds
57968,62,1554076800,36,4,40,Clouds
57969,63,1554076800,9,26,35,Clouds
57970,64,1554076800,2,38,40,Clouds
57971,65,1554076800,40,0,40,Clouds
57972,66,1554076800,25,15,40,Clouds
57973,67,1554076800,21,19,40,Clouds
57974,68,1554076800,29,11,40,Clouds
57975,69,1554076800,10,30,40,Clouds
57976,70,1554076800,6,22,28,Clouds
57977,71,1554076800,13,27,40,Clouds
57978,72,1554076800,25,6,31,Clouds
57979,73,1554076800,17,13,30,Clouds
57980,74,1554076800,20,10,30,Clouds
57981,75,1554076800,28,12,40,Clouds
57982,76,1554076800,23,15,38,Clouds
57983,77,1554076800,2,27,29,Clouds
57984,78,1554076800,29,11,40,Clouds
57985,79,1554076800,23,4,27,Clouds
57986,80,1554076800,19,21,40,Clouds
57987,81,1554076800,40,0,40,Clouds
57988,82,1554076800,18,4,22,Clouds
57989,83,1554076800,16,24,40,Clouds
57990,84,1554076800,12,18,30,Clouds
57991,85,1554076800,26,9,35,Clouds
57992,86,1554076800,38,0,38,Clouds
57993,87,1554076800,24,14,38,Clouds
57994,88,1554076800,14,16,30,Clouds
57995,89,1554076800,37,3,40,Clouds
57996,90,1554076800,36,4,40,Clouds
57997,91,1554076800,25,5,30,Clouds
57998,92,1554076800,33,7,40,Clouds
57999,93,1554076800,11,29,40,Clouds
58000,94,1554076800,6,34,40,Clouds
58001,95,1554076800,28,12,40,Clouds
58002,96,1554076800,23,7,30,Clouds
58003,97,1554076800,32,8,40,Clouds
58004,98,1554076800,13,27,40,Clouds
58005,99,1554076800,21,9,30,Clouds
58006,100,1554076800,25,0,25,Clouds
58007,101,1554076800,12,18,30,Clouds
58008,102,1554076800,35,5,40,Clouds
58009,103,1554076800,39,1,40,Clouds
58010,104,1554076800,40,0,40,Clouds
58011,105,1554076800,32,4,36,Clouds
58012,106,1554076800,21,19,40,Clouds
58013,107,1554076800,36,4,40,Clouds
58014,108,1554076800,32,8,40,Clouds
58015,109,1554076800,14,15,29,Clouds
58016,110,1554076800,18,22,40,Clouds
58017,111,1554076800,27,13,40,Clouds
58018,112,1554076800,20,10,30,Clouds
58019,113,1554076800,36,4,40,Clouds
58020,114,1554076800,23,17,40,Clouds
58021,115,1554076800,0,30,30,Clouds
58022,2,1554080400,14,6,20,Clouds
58023,3,1554080400,0,20,20,Clouds
58024,4,1554080400,15,5,20,Clouds
58025,5,1554080400,20,20,40,Clouds
58026,6,1554080400,11,9,20,Clouds
58027,7,1554080400,26,3,29,Clouds
58028,8,1554080400,11,19,30,Clouds
58029,9,1554080400,22,2,24,Clouds
58030,10,1554080400,7,9,16,Clouds
58031,11,1554080400,30,0,30,Clouds
58032,12,1554080400,17,3,20,Clouds
58033,13,1554080400,17,13,30,Clouds
58034,14,1554080400,18,12,30,Clouds
58035,15,1554080400,12,4,16,Clouds
58036,16,1554080400,18,2,20,Clouds
58037,17,1554080400,11,9,20,Clouds
58038,18,1554080400,6,24,30,Clouds
58039,19,1554080400,9,21,30,Clouds
58040,21,1554080400,12,18,30,Clouds
58041,22,1554080400,9,11,20,Clouds
58042,23,1554080400,24,6,30,Clouds
58043,24,1554080400,20,0,20,Clouds
58044,25,1554080400,28,2,30,Clouds
58045,26,1554080400,12,8,20,Clouds
58046,27,1554080400,20,0,20,Clouds
58047,28,1554080400,12,18,30,Clouds
58048,29,1554080400,16,13,29,Clouds
58049,30,1554080400,19,1,20,Clouds
58050,31,1554080400,19,1,20,Clouds
58051,32,1554080400,27,3,30,Clouds
58052,33,1554080400,23,0,23,Clouds
58053,34,1554080400,0,30,30,Clouds
58054,35,1554080400,13,16,29,Clouds
58055,36,1554080400,35,5,40,Clouds
58056,37,1554080400,23,7,30,Clouds
58057,38,1554080400,27,13,40,Clouds
58058,39,1554080400,20,0,20,Clouds
58059,40,1554080400,16,5,21,Clouds
58060,41,1554080400,20,0,20,Clouds
58061,42,1554080400,16,14,30,Clouds
58062,43,1554080400,0,30,30,Clouds
58063,44,1554080400,18,12,30,Clouds
58064,45,1554080400,18,12,30,Clouds
58065,46,1554080400,20,0,20,Clouds
58066,47,1554080400,27,13,40,Clouds
58067,48,1554080400,13,27,40,Clouds
58068,49,1554080400,32,8,40,Clouds
58069,50,1554080400,29,11,40,Clouds
58070,51,1554080400,24,16,40,Clouds
58071,52,1554080400,14,18,32,Clouds
58072,53,1554080400,23,17,40,Clouds
58073,54,1554080400,15,18,33,Clouds
58074,55,1554080400,34,2,36,Clouds
58075,56,1554080400,5,35,40,Clouds
58076,57,1554080400,11,12,23,Clouds
58077,58,1554080400,39,1,40,Clouds
58078,59,1554080400,20,0,20,Clouds
58079,60,1554080400,5,25,30,Clouds
58080,61,1554080400,20,5,25,Clouds
58081,62,1554080400,36,4,40,Clouds
58082,63,1554080400,11,24,35,Clouds
58083,64,1554080400,2,38,40,Clouds
58084,65,1554080400,40,0,40,Clouds
58085,66,1554080400,25,15,40,Clouds
58086,67,1554080400,21,19,40,Clouds
58087,68,1554080400,28,12,40,Clouds
58088,69,1554080400,8,32,40,Clouds
58089,70,1554080400,6,22,28,Clouds
58090,71,1554080400,14,26,40,Clouds
58091,72,1554080400,26,5,31,Clouds
58092,73,1554080400,16,14,30,Clouds
58093,74,1554080400,20,10,30,Clouds
58094,75,1554080400,28,12,40,Clouds
58095,76,1554080400,21,17,38,Clouds
58096,77,1554080400,3,26,29,Clouds
58097,78,1554080400,27,13,40,Clouds
58098,79,1554080400,23,4,27,Clouds
58099,80,1554080400,17,23,40,Clouds
58100,81,1554080400,40,0,40,Clouds
58101,82,1554080400,18,4,22,Clouds
58102,83,1554080400,15,25,40,Clouds
58103,84,1554080400,12,18,30,Clouds
58104,85,1554080400,25,10,35,Clouds
58105,86,1554080400,38,0,38,Clouds
58106,87,1554080400,24,14,38,Clouds
58107,88,1554080400,14,16,30,Clouds
58108,89,1554080400,37,3,40,Clouds
58109,90,1554080400,36,4,40,Clouds
58110,91,1554080400,24,6,30,Clouds
58111,92,1554080400,34,6,40,Clouds
58112,93,1554080400,11,29,40,Clouds
58113,94,1554080400,6,34,40,Clouds
58114,95,1554080400,27,13,40,Clouds
58115,96,1554080400,23,7,30,Clouds
58116,97,1554080400,31,9,40,Clouds
58117,98,1554080400,16,24,40,Clouds
58118,99,1554080400,21,9,30,Clouds
58119,100,1554080400,25,0,25,Clouds
58120,101,1554080400,12,18,30,Clouds
58121,102,1554080400,34,6,40,Clouds
58122,103,1554080400,39,1,40,Clouds
58123,104,1554080400,40,0,40,Clouds
58124,105,1554080400,32,4,36,Clouds
58125,106,1554080400,18,22,40,Clouds
58126,107,1554080400,34,6,40,Clouds
58127,108,1554080400,32,8,40,Clouds
58128,109,1554080400,12,17,29,Clouds
58129,110,1554080400,18,22,40,Clouds
58130,111,1554080400,26,14,40,Clouds
58131,112,1554080400,18,12,30,Clouds
58132,113,1554080400,36,4,40,Clouds
58133,114,1554080400,23,17,40,Clouds
58134,115,1554080400,0,30,30,Clouds
58135,2,1554084000,14,6,20,Clouds
58136,3,1554084000,0,20,20,Clouds
58137,4,1554084000,15,5,20,Clouds
58138,5,1554084000,20,20,40,Clouds
58139,6,1554084000,11,9,20,Clouds
58140,7,1554084000,26,3,29,Clouds
58141,8,1554084000,11,19,30,Clouds
58142,9,1554084000,22,2,24,Clouds
58143,10,1554084000,7,9,16,Clouds
58144,11,1554084000,30,0,30,Clouds
58145,12,1554084000,17,3,20,Clouds
58146,13,1554084000,17,13,30,Clouds
58147,14,1554084000,18,12,30,Clouds
58148,15,1554084000,12,4,16,Clouds
58149,16,1554084000,18,2,20,Clouds
58150,17,1554084000,11,9,20,Clouds
58151,18,1554084000,6,24,30,Clouds
58152,19,1554084000,9,21,30,Clouds
58153,21,1554084000,12,18,30,Clouds
58154,22,1554084000,9,11,20,Clouds
58155,23,1554084000,24,6,30,Clouds
58156,24,1554084000,20,0,20,Clouds
58157,25,1554084000,28,2,30,Clouds
58158,26,1554084000,12,8,20,Clouds
58159,27,1554084000,20,0,20,Clouds
58160,28,1554084000,11,19,30,Clouds
58161,29,1554084000,16,13,29,Clouds
58162,30,1554084000,19,1,20,Clouds
58163,31,1554084000,19,1,20,Clouds
58164,32,1554084000,27,3,30,Clouds
58165,33,1554084000,23,0,23,Clouds
58166,34,1554084000,0,30,30,Clouds
58167,35,1554084000,13,16,29,Clouds
58168,36,1554084000,35,5,40,Clouds
58169,37,1554084000,23,7,30,Clouds
58170,38,1554084000,27,13,40,Clouds
58171,39,1554084000,20,0,20,Clouds
58172,40,1554084000,16,5,21,Clouds
58173,41,1554084000,20,0,20,Clouds
58174,42,1554084000,16,14,30,Clouds
58175,43,1554084000,0,30,30,Clouds
58176,44,1554084000,18,12,30,Clouds
58177,45,1554084000,18,12,30,Clouds
58178,46,1554084000,20,0,20,Clouds
58179,47,1554084000,27,13,40,Clouds
58180,48,1554084000,13,27,40,Clouds
58181,49,1554084000,32,8,40,Clouds
58182,50,1554084000,29,11,40,Clouds
58183,51,1554084000,24,16,40,Clouds
58184,52,1554084000,14,18,32,Clouds
58185,53,1554084000,23,17,40,Clouds
58186,54,1554084000,15,18,33,Clouds
58187,55,1554084000,34,2,36,Clouds
58188,56,1554084000,5,35,40,Clouds
58189,57,1554084000,11,12,23,Clouds
58190,58,1554084000,39,1,40,Clouds
58191,59,1554084000,20,0,20,Clouds
58192,60,1554084000,5,25,30,Clouds
58193,61,1554084000,20,5,25,Clouds
58194,62,1554084000,36,4,40,Clouds
58195,63,1554084000,11,24,35,Clouds
58196,64,1554084000,2,38,40,Clouds
58197,65,1554084000,40,0,40,Clouds
58198,66,1554084000,25,15,40,Clouds
58199,67,1554084000,21,19,40,Clouds
58200,68,1554084000,28,12,40,Clouds
58201,69,1554084000,8,32,40,Clouds
58202,70,1554084000,6,22,28,Clouds
58203,71,1554084000,14,26,40,Clouds
58204,72,1554084000,26,5,31,Clouds
58205,73,1554084000,16,14,30,Clouds
58206,74,1554084000,20,10,30,Clouds
58207,75,1554084000,28,12,40,Clouds
58208,76,1554084000,21,17,38,Clouds
58209,77,1554084000,3,26,29,Clouds
58210,78,1554084000,26,14,40,Clouds
58211,79,1554084000,23,4,27,Clouds
58212,80,1554084000,17,23,40,Clouds
58213,81,1554084000,40,0,40,Clouds
58214,82,1554084000,18,4,22,Clouds
58215,83,1554084000,15,25,40,Clouds
58216,84,1554084000,12,18,30,Clouds
58217,85,1554084000,25,10,35,Clouds
58218,86,1554084000,38,0,38,Clouds
58219,87,1554084000,24,14,38,Clouds
58220,88,1554084000,14,16,30,Clouds
58221,89,1554084000,37,3,40,Clouds
58222,90,1554084000,36,4,40,Clouds
58223,91,1554084000,24,6,30,Clouds
58224,92,1554084000,34,6,40,Clouds
58225,93,1554084000,11,29,40,Clouds
58226,94,1554084000,6,34,40,Clouds
58227,95,1554084000,27,13,40,Clouds
58228,96,1554084000,23,7,30,Clouds
58229,97,1554084000,31,9,40,Clouds
58230,98,1554084000,16,24,40,Clouds
58231,99,1554084000,21,9,30,Clouds
58232,100,1554084000,25,0,25,Clouds
58233,101,1554084000,12,18,30,Clouds
58234,102,1554084000,34,6,40,Clouds
58235,103,1554084000,39,1,40,Clouds
58236,104,1554084000,40,0,40,Clouds
58237,105,1554084000,32,4,36,Clouds
58238,106,1554084000,18,22,40,Clouds
58239,107,1554084000,34,6,40,Clouds
58240,108,1554084000,32,8,40,Clouds
58241,109,1554084000,11,18,29,Clouds
58242,110,1554084000,18,22,40,Clouds
58243,111,1554084000,25,15,40,Clouds
58244,112,1554084000,18,12,30,Clouds
58245,113,1554084000,36,4,40,Clouds
58246,114,1554084000,23,17,40,Clouds
58247,115,1554084000,0,30,30,Clouds
58248,2,1554087600,14,6,20,Clouds
58249,3,1554087600,0,20,20,Clouds
58250,4,1554087600,15,5,20,Clouds
58251,5,1554087600,20,20,40,Clouds
58252,6,1554087600,11,9,20,Clouds
58253,7,1554087600,26,3,29,Clouds
58254,8,1554087600,11,19,30,Clouds
58255,9,1554087600,22,2,24,Clouds
58256,10,1554087600,7,9,16,Clouds
58257,11,1554087600,30,0,30,Clouds
58258,12,1554087600,17,3,20,Clouds
58259,13,1554087600,17,13,30,Clouds
58260,14,1554087600,18,12,30,Clouds
58261,15,1554087600,12,4,16,Clouds
58262,16,1554087600,18,2,20,Clouds
58263,17,1554087600,11,9,20,Clouds
58264,18,1554087600,6,24,30,Clouds
58265,19,1554087600,9,21,30,Clouds
58266,21,1554087600,12,18,30,Clouds
58267,22,1554087600,9,11,20,Clouds
58268,23,1554087600,24,6,30,Clouds
58269,24,1554087600,20,0,20,Clouds
58270,25,1554087600,28,2,30,Clouds
58271,26,1554087600,12,8,20,Clouds
58272,27,1554087600,20,0,20,Clouds
58273,28,1554087600,11,19,30,Clouds
58274,29,1554087600,16,13,29,Clouds
58275,30,1554087600,19,1,20,Clouds
58276,31,1554087600,19,1,20,Clouds
58277,32,1554087600,27,3,30,Clouds
58278,33,1554087600,23,0,23,Clouds
58279,34,1554087600,0,30,30,Clouds
58280,35,1554087600,13,16,29,Clouds
58281,36,1554087600,35,5,40,Clouds
58282,37,1554087600,23,7,30,Clouds
58283,38,1554087600,27,13,40,Clouds
58284,39,1554087600,20,0,20,Clouds
58285,40,1554087600,16,5,21,Clouds
58286,41,1554087600,20,0,20,Clouds
58287,42,1554087600,16,14,30,Clouds
58288,43,1554087600,0,30,30,Clouds
58289,44,1554087600,18,12,30,Clouds
58290,45,1554087600,18,12,30,Clouds
58291,46,1554087600,20,0,20,Clouds
58292,47,1554087600,27,13,40,Clouds
58293,48,1554087600,13,27,40,Clouds
58294,49,1554087600,32,8,40,Clouds
58295,50,1554087600,29,11,40,Clouds
58296,51,1554087600,24,16,40,Clouds
58297,52,1554087600,14,18,32,Clouds
58298,53,1554087600,23,17,40,Clouds
58299,54,1554087600,15,18,33,Clouds
58300,55,1554087600,34,2,36,Clouds
58301,56,1554087600,5,35,40,Clouds
58302,57,1554087600,11,12,23,Clouds
58303,58,1554087600,39,1,40,Clouds
58304,59,1554087600,20,0,20,Clouds
58305,60,1554087600,5,25,30,Clouds
58306,61,1554087600,20,5,25,Clouds
58307,62,1554087600,36,4,40,Clouds
58308,63,1554087600,11,24,35,Clouds
58309,64,1554087600,2,38,40,Clouds
58310,65,1554087600,40,0,40,Clouds
58311,66,1554087600,25,15,40,Clouds
58312,67,1554087600,21,19,40,Clouds
58313,68,1554087600,28,12,40,Clouds
58314,69,1554087600,8,32,40,Clouds
58315,70,1554087600,6,22,28,Clouds
58316,71,1554087600,14,26,40,Clouds
58317,72,1554087600,26,5,31,Clouds
58318,73,1554087600,16,14,30,Clouds
58319,74,1554087600,20,10,30,Clouds
58320,75,1554087600,28,12,40,Clouds
58321,76,1554087600,21,17,38,Clouds
58322,77,1554087600,3,26,29,Clouds
58323,78,1554087600,26,14,40,Clouds
58324,79,1554087600,23,4,27,Clouds
58325,80,1554087600,17,23,40,Clouds
58326,81,1554087600,40,0,40,Clouds
58327,82,1554087600,18,4,22,Clouds
58328,83,1554087600,15,25,40,Clouds
58329,84,1554087600,12,18,30,Clouds
58330,85,1554087600,25,10,35,Clouds
58331,86,1554087600,38,0,38,Clouds
58332,87,1554087600,24,14,38,Clouds
58333,88,1554087600,14,16,30,Clouds
58334,89,1554087600,37,3,40,Clouds
58335,90,1554087600,36,4,40,Clouds
58336,91,1554087600,24,6,30,Clouds
58337,92,1554087600,34,6,40,Clouds
58338,93,1554087600,11,29,40,Clouds
58339,94,1554087600,6,34,40,Clouds
58340,95,1554087600,27,13,40,Clouds
58341,96,1554087600,23,7,30,Clouds
58342,97,1554087600,31,9,40,Clouds
58343,98,1554087600,16,24,40,Clouds
58344,99,1554087600,21,9,30,Clouds
58345,100,1554087600,25,0,25,Clouds
58346,101,1554087600,12,18,30,Clouds
58347,102,1554087600,34,6,40,Clouds
58348,103,1554087600,39,1,40,Clouds
58349,104,1554087600,40,0,40,Clouds
58350,105,1554087600,32,4,36,Clouds
58351,106,1554087600,18,22,40,Clouds
58352,107,1554087600,34,6,40,Clouds
58353,108,1554087600,32,8,40,Clouds
58354,109,1554087600,11,18,29,Clouds
58355,110,1554087600,18,22,40,Clouds
58356,111,1554087600,25,15,40,Clouds
58357,112,1554087600,18,12,30,Clouds
58358,113,1554087600,36,4,40,Clouds
58359,114,1554087600,23,17,40,Clouds
58360,115,1554087600,0,30,30,Clouds
58361,2,1554091200,14,6,20,Clouds
58362,3,1554091200,0,20,20,Clouds
58363,4,1554091200,15,5,20,Clouds
58364,5,1554091200,20,20,40,Clouds
58365,6,1554091200,11,9,20,Clouds
58366,7,1554091200,26,3,29,Clouds
58367,8,1554091200,11,19,30,Clouds
58368,9,1554091200,22,2,24,Clouds
58369,10,1554091200,7,9,16,Clouds
58370,11,1554091200,30,0,30,Clouds
58371,12,1554091200,17,3,20,Clouds
58372,13,1554091200,17,13,30,Clouds
58373,14,1554091200,18,12,30,Clouds
58374,15,1554091200,12,4,16,Clouds
58375,16,1554091200,18,2,20,Clouds
58376,17,1554091200,11,9,20,Clouds
58377,18,1554091200,6,24,30,Clouds
58378,19,1554091200,9,21,30,Clouds
58379,21,1554091200,12,18,30,Clouds
58380,22,1554091200,9,11,20,Clouds
58381,23,1554091200,24,6,30,Clouds
58382,24,1554091200,20,0,20,Clouds
58383,25,1554091200,28,2,30,Clouds
58384,26,1554091200,12,8,20,Clouds
58385,27,1554091200,20,0,20,Clouds
58386,28,1554091200,11,19,30,Clouds
58387,29,1554091200,16,13,29,Clouds
58388,30,1554091200,19,1,20,Clouds
58389,31,1554091200,19,1,20,Clouds
58390,32,1554091200,27,3,30,Clouds
58391,33,1554091200,23,0,23,Clouds
58392,34,1554091200,0,30,30,Clouds
58393,35,1554091200,13,16,29,Clouds
58394,36,1554091200,35,5,40,Clouds
58395,37,1554091200,23,7,30,Clouds
58396,38,1554091200,27,13,40,Clouds
58397,39,1554091200,20,0,20,Clouds
58398,40,1554091200,16,5,21,Clouds
58399,41,1554091200,20,0,20,Clouds
58400,42,1554091200,16,14,30,Clouds
58401,43,1554091200,0,30,30,Clouds
58402,44,1554091200,18,12,30,Clouds
58403,45,1554091200,18,12,30,Clouds
58404,46,1554091200,20,0,20,Clouds
58405,47,1554091200,27,13,40,Clouds
58406,48,1554091200,13,27,40,Clouds
58407,49,1554091200,32,8,40,Clouds
58408,50,1554091200,29,11,40,Clouds
58409,51,1554091200,24,16,40,Clouds
58410,52,1554091200,14,18,32,Clouds
58411,53,1554091200,23,17,40,Clouds
58412,54,1554091200,15,18,33,Clouds
58413,55,1554091200,34,2,36,Clouds
58414,56,1554091200,5,35,40,Clouds
58415,57,1554091200,11,12,23,Clouds
58416,58,1554091200,39,1,40,Clouds
58417,59,1554091200,20,0,20,Clouds
58418,60,1554091200,5,25,30,Clouds
58419,61,1554091200,20,5,25,Clouds
58420,62,1554091200,36,4,40,Clouds
58421,63,1554091200,11,24,35,Clouds
58422,64,1554091200,2,38,40,Clouds
58423,65,1554091200,40,0,40,Clouds
58424,66,1554091200,25,15,40,Clouds
58425,67,1554091200,21,19,40,Clouds
58426,68,1554091200,28,12,40,Clouds
58427,69,1554091200,8,32,40,Clouds
58428,70,1554091200,6,22,28,Clouds
58429,71,1554091200,14,26,40,Clouds
58430,72,1554091200,26,5,31,Clouds
58431,73,1554091200,16,14,30,Clouds
58432,74,1554091200,20,10,30,Clouds
58433,75,1554091200,28,12,40,Clouds
58434,76,1554091200,21,17,38,Clouds
58435,77,1554091200,3,26,29,Clouds
58436,78,1554091200,26,14,40,Clouds
58437,79,1554091200,23,4,27,Clouds
58438,80,1554091200,17,23,40,Clouds
58439,81,1554091200,40,0,40,Clouds
58440,82,1554091200,18,4,22,Clouds
58441,83,1554091200,15,25,40,Clouds
58442,84,1554091200,12,18,30,Clouds
58443,85,1554091200,25,10,35,Clouds
58444,86,1554091200,38,0,38,Clouds
58445,87,1554091200,24,14,38,Clouds
58446,88,1554091200,14,16,30,Clouds
58447,89,1554091200,37,3,40,Clouds
58448,90,1554091200,36,4,40,Clouds
58449,91,1554091200,24,6,30,Clouds
58450,92,1554091200,34,6,40,Clouds
58451,93,1554091200,11,29,40,Clouds
58452,94,1554091200,6,34,40,Clouds
58453,95,1554091200,27,13,40,Clouds
58454,96,1554091200,23,7,30,Clouds
58455,97,1554091200,31,9,40,Clouds
58456,98,1554091200,16,24,40,Clouds
58457,99,1554091200,21,9,30,Clouds
58458,100,1554091200,25,0,25,Clouds
58459,101,1554091200,12,18,30,Clouds
58460,102,1554091200,34,6,40,Clouds
58461,103,1554091200,39,1,40,Clouds
58462,104,1554091200,40,0,40,Clouds
58463,105,1554091200,32,4,36,Clouds
58464,106,1554091200,18,22,40,Clouds
58465,107,1554091200,34,6,40,Clouds
58466,108,1554091200,32,8,40,Clouds
58467,109,1554091200,11,18,29,Clouds
58468,110,1554091200,18,22,40,Clouds
58469,111,1554091200,25,15,40,Clouds
58470,112,1554091200,18,12,30,Clouds
58471,113,1554091200,36,4,40,Clouds
58472,114,1554091200,23,17,40,Clouds
58473,115,1554091200,0,30,30,Clouds
58474,2,1554094800,14,6,20,Clouds
58475,3,1554094800,0,20,20,Clouds
58476,4,1554094800,15,5,20,Clouds
58477,5,1554094800,20,20,40,Clouds
58478,6,1554094800,11,9,20,Clouds
58479,7,1554094800,26,3,29,Clouds
58480,8,1554094800,11,19,30,Clouds
58481,9,1554094800,22,2,24,Clouds
58482,10,1554094800,8,8,16,Clouds
58483,11,1554094800,30,0,30,Clouds
58484,12,1554094800,17,3,20,Clouds
58485,13,1554094800,17,13,30,Clouds
58486,14,1554094800,18,12,30,Clouds
58487,15,1554094800,12,4,16,Clouds
58488,16,1554094800,18,2,20,Clouds
58489,17,1554094800,11,9,20,Clouds
58490,18,1554094800,6,24,30,Clouds
58491,19,1554094800,9,21,30,Clouds
58492,21,1554094800,12,18,30,Clouds
58493,22,1554094800,9,11,20,Clouds
58494,23,1554094800,24,6,30,Clouds
58495,24,1554094800,20,0,20,Clouds
58496,25,1554094800,28,2,30,Clouds
58497,26,1554094800,12,8,20,Clouds
58498,27,1554094800,20,0,20,Clouds
58499,28,1554094800,11,19,30,Clouds
58500,29,1554094800,16,13,29,Clouds
58501,30,1554094800,19,1,20,Clouds
58502,31,1554094800,19,1,20,Clouds
58503,32,1554094800,27,3,30,Clouds
58504,33,1554094800,23,0,23,Clouds
58505,34,1554094800,0,30,30,Clouds
58506,35,1554094800,13,16,29,Clouds
58507,36,1554094800,35,5,40,Clouds
58508,37,1554094800,23,7,30,Clouds
58509,38,1554094800,27,13,40,Clouds
58510,39,1554094800,20,0,20,Clouds
58511,40,1554094800,16,5,21,Clouds
58512,41,1554094800,20,0,20,Clouds
58513,42,1554094800,16,14,30,Clouds
58514,43,1554094800,0,30,30,Clouds
58515,44,1554094800,18,12,30,Clouds
58516,45,1554094800,18,12,30,Clouds
58517,46,1554094800,20,0,20,Clouds
58518,47,1554094800,27,13,40,Clouds
58519,48,1554094800,13,27,40,Clouds
58520,49,1554094800,32,8,40,Clouds
58521,50,1554094800,29,11,40,Clouds
58522,51,1554094800,24,16,40,Clouds
58523,52,1554094800,14,18,32,Clouds
58524,53,1554094800,23,17,40,Clouds
58525,54,1554094800,16,17,33,Clouds
58526,55,1554094800,34,2,36,Clouds
58527,56,1554094800,5,35,40,Clouds
58528,57,1554094800,11,12,23,Clouds
58529,58,1554094800,39,1,40,Clouds
58530,59,1554094800,20,0,20,Clouds
58531,60,1554094800,6,24,30,Clouds
58532,61,1554094800,20,5,25,Clouds
58533,62,1554094800,36,4,40,Clouds
58534,63,1554094800,11,24,35,Clouds
58535,64,1554094800,2,38,40,Clouds
58536,65,1554094800,40,0,40,Clouds
58537,66,1554094800,25,15,40,Clouds
58538,67,1554094800,21,19,40,Clouds
58539,68,1554094800,28,12,40,Clouds
58540,69,1554094800,8,32,40,Clouds
58541,70,1554094800,6,22,28,Clouds
58542,71,1554094800,14,26,40,Clouds
58543,72,1554094800,26,5,31,Clouds
58544,73,1554094800,16,14,30,Clouds
58545,74,1554094800,20,10,30,Clouds
58546,75,1554094800,28,12,40,Clouds
58547,76,1554094800,21,17,38,Clouds
58548,77,1554094800,3,26,29,Clouds
58549,78,1554094800,26,14,40,Clouds
58550,79,1554094800,23,4,27,Clouds
58551,80,1554094800,19,21,40,Clouds
58552,81,1554094800,40,0,40,Clouds
58553,82,1554094800,18,4,22,Clouds
58554,83,1554094800,15,25,40,Clouds
58555,84,1554094800,12,18,30,Clouds
58556,85,1554094800,25,10,35,Clouds
58557,86,1554094800,38,0,38,Clouds
58558,87,1554094800,24,14,38,Clouds
58559,88,1554094800,14,16,30,Clouds
58560,89,1554094800,37,3,40,Clouds
58561,90,1554094800,36,4,40,Clouds
58562,91,1554094800,24,6,30,Clouds
58563,92,1554094800,34,6,40,Clouds
58564,93,1554094800,11,29,40,Clouds
58565,94,1554094800,6,34,40,Clouds
58566,95,1554094800,27,13,40,Clouds
58567,96,1554094800,23,7,30,Clouds
58568,97,1554094800,31,9,40,Clouds
58569,98,1554094800,16,24,40,Clouds
58570,99,1554094800,21,9,30,Clouds
58571,100,1554094800,25,0,25,Clouds
58572,101,1554094800,12,18,30,Clouds
58573,102,1554094800,34,6,40,Clouds
58574,103,1554094800,39,1,40,Clouds
58575,104,1554094800,40,0,40,Clouds
58576,105,1554094800,32,4,36,Clouds
58577,106,1554094800,18,22,40,Clouds
58578,107,1554094800,34,6,40,Clouds
58579,108,1554094800,32,8,40,Clouds
58580,109,1554094800,11,18,29,Clouds
58581,110,1554094800,18,22,40,Clouds
58582,111,1554094800,25,15,40,Clouds
58583,112,1554094800,18,12,30,Clouds
58584,113,1554094800,36,4,40,Clouds
58585,114,1554094800,23,17,40,Clouds
58586,115,1554094800,1,29,30,Clouds
58587,2,1554098400,16,4,20,Clouds
58588,3,1554098400,0,20,20,Clouds
58589,4,1554098400,16,4,20,Clouds
58590,5,1554098400,21,19,40,Clouds
58591,6,1554098400,11,9,20,Clouds
58592,7,1554098400,26,3,29,Clouds
58593,8,1554098400,10,19,29,Clouds
58594,9,1554098400,20,4,24,Clouds
58595,10,1554098400,7,9,16,Clouds
58596,11,1554098400,30,0,30,Clouds
58597,12,1554098400,18,2,20,Clouds
58598,13,1554098400,17,13,30,Clouds
58599,14,1554098400,12,18,30,Clouds
58600,15,1554098400,12,4,16,Clouds
58601,16,1554098400,19,1,20,Clouds
58602,17,1554098400,12,8,20,Clouds
58603,18,1554098400,6,24,30,Clouds
58604,19,1554098400,6,24,30,Clouds
58605,21,1554098400,11,19,30,Clouds
58606,22,1554098400,7,13,20,Clouds
58607,23,1554098400,25,5,30,Clouds
58608,24,1554098400,15,5,20,Clouds
58609,25,1554098400,29,1,30,Clouds
58610,26,1554098400,12,8,20,Clouds
58611,27,1554098400,17,3,20,Clouds
58612,28,1554098400,13,17,30,Clouds
58613,29,1554098400,15,14,29,Clouds
58614,30,1554098400,18,2,20,Clouds
58615,31,1554098400,19,1,20,Clouds
58616,32,1554098400,22,8,30,Clouds
58617,33,1554098400,18,5,23,Clouds
58618,34,1554098400,1,29,30,Clouds
58619,35,1554098400,19,11,30,Clouds
58620,36,1554098400,34,6,40,Clouds
58621,37,1554098400,23,7,30,Clouds
58622,38,1554098400,28,12,40,Clouds
58623,39,1554098400,20,0,20,Clouds
58624,40,1554098400,16,5,21,Clouds
58625,41,1554098400,20,0,20,Clouds
58626,42,1554098400,17,13,30,Clouds
58627,43,1554098400,4,26,30,Clouds
58628,44,1554098400,22,8,30,Clouds
58629,45,1554098400,21,9,30,Clouds
58630,46,1554098400,20,0,20,Clouds
58631,47,1554098400,28,12,40,Clouds
58632,48,1554098400,30,10,40,Clouds
58633,49,1554098400,28,12,40,Clouds
58634,50,1554098400,29,11,40,Clouds
58635,51,1554098400,23,17,40,Clouds
58636,52,1554098400,26,6,32,Clouds
58637,53,1554098400,24,16,40,Clouds
58638,54,1554098400,17,16,33,Clouds
58639,55,1554098400,34,2,36,Clouds
58640,56,1554098400,6,34,40,Clouds
58641,57,1554098400,11,12,23,Clouds
58642,58,1554098400,35,5,40,Clouds
58643,59,1554098400,20,0,20,Clouds
58644,60,1554098400,10,20,30,Clouds
58645,61,1554098400,20,5,25,Clouds
58646,62,1554098400,34,6,40,Clouds
58647,63,1554098400,10,25,35,Clouds
58648,64,1554098400,23,17,40,Clouds
58649,65,1554098400,40,0,40,Clouds
58650,66,1554098400,23,17,40,Clouds
58651,67,1554098400,20,20,40,Clouds
58652,68,1554098400,24,16,40,Clouds
58653,69,1554098400,21,19,40,Clouds
58654,70,1554098400,4,24,28,Clouds
58655,71,1554098400,14,26,40,Clouds
58656,72,1554098400,26,5,31,Clouds
58657,73,1554098400,17,13,30,Clouds
58658,74,1554098400,20,10,30,Clouds
58659,75,1554098400,30,10,40,Clouds
58660,76,1554098400,22,16,38,Clouds
58661,77,1554098400,4,25,29,Clouds
58662,78,1554098400,9,31,40,Clouds
58663,79,1554098400,23,4,27,Clouds
58664,80,1554098400,20,20,40,Clouds
58665,81,1554098400,40,0,40,Clouds
58666,82,1554098400,20,2,22,Clouds
58667,83,1554098400,17,23,40,Clouds
58668,84,1554098400,14,16,30,Clouds
58669,85,1554098400,26,9,35,Clouds
58670,86,1554098400,38,0,38,Clouds
58671,87,1554098400,25,13,38,Clouds
58672,88,1554098400,13,17,30,Clouds
58673,89,1554098400,37,3,40,Clouds
58674,90,1554098400,36,4,40,Clouds
58675,91,1554098400,24,6,30,Clouds
58676,92,1554098400,35,5,40,Clouds
58677,93,1554098400,11,29,40,Clouds
58678,94,1554098400,6,34,40,Clouds
58679,95,1554098400,28,12,40,Clouds
58680,96,1554098400,23,7,30,Clouds
58681,97,1554098400,33,7,40,Clouds
58682,98,1554098400,20,20,40,Clouds
58683,99,1554098400,20,10,30,Clouds
58684,100,1554098400,6,19,25,Clouds
58685,101,1554098400,18,12,30,Clouds
58686,102,1554098400,36,4,40,Clouds
58687,103,1554098400,39,1,40,Clouds
58688,104,1554098400,40,0,40,Clouds
58689,105,1554098400,33,3,36,Clouds
58690,106,1554098400,19,21,40,Clouds
58691,107,1554098400,39,1,40,Clouds
58692,108,1554098400,33,7,40,Clouds
58693,109,1554098400,15,14,29,Clouds
58694,110,1554098400,16,24,40,Clouds
58695,111,1554098400,25,15,40,Clouds
58696,112,1554098400,20,10,30,Clouds
58697,113,1554098400,35,5,40,Clouds
58698,114,1554098400,23,17,40,Clouds
58699,115,1554098400,1,29,30,Clouds
58700,2,1554102000,19,1,20,Clouds
58701,3,1554102000,4,16,20,Clouds
58702,4,1554102000,15,5,20,Clouds
58703,5,1554102000,12,28,40,Clouds
58704,6,1554102000,15,5,20,Clouds
58705,7,1554102000,10,19,29,Clouds
58706,8,1554102000,0,29,29,Clouds
58707,9,1554102000,10,14,24,Clouds
58708,10,1554102000,5,11,16,Clouds
58709,11,1554102000,27,3,30,Clouds
58710,12,1554102000,15,5,20,Clouds
58711,13,1554102000,14,15,29,Clouds
58712,14,1554102000,25,5,30,Clouds
58713,15,1554102000,16,0,16,Clouds
58714,16,1554102000,19,1,20,Clouds
58715,17,1554102000,13,7,20,Clouds
58716,18,1554102000,2,28,30,Clouds
58717,19,1554102000,13,17,30,Clouds
58718,21,1554102000,5,25,30,Clouds
58719,22,1554102000,0,20,20,Clouds
58720,23,1554102000,24,6,30,Clouds
58721,24,1554102000,18,2,20,Clouds
58722,25,1554102000,23,7,30,Clouds
58723,26,1554102000,10,10,20,Clouds
58724,27,1554102000,13,7,20,Clouds
58725,28,1554102000,9,21,30,Clouds
58726,29,1554102000,15,14,29,Clouds
58727,30,1554102000,17,3,20,Clouds
58728,31,1554102000,14,6,20,Clouds
58729,32,1554102000,17,13,30,Clouds
58730,33,1554102000,8,15,23,Clouds
58731,34,1554102000,21,9,30,Clouds
58732,35,1554102000,25,5,30,Clouds
58733,36,1554102000,31,9,40,Clouds
58734,37,1554102000,23,7,30,Clouds
58735,38,1554102000,16,24,40,Clouds
58736,39,1554102000,18,2,20,Clouds
58737,40,1554102000,11,10,21,Clouds
58738,41,1554102000,19,1,20,Clouds
58739,42,1554102000,19,11,30,Clouds
58740,43,1554102000,16,14,30,Clouds
58741,44,1554102000,30,0,30,Clouds
58742,45,1554102000,24,6,30,Clouds
58743,46,1554102000,16,4,20,Clouds
58744,47,1554102000,26,14,40,Clouds
58745,48,1554102000,29,11,40,Clouds
58746,49,1554102000,28,12,40,Clouds
58747,50,1554102000,36,4,40,Clouds
58748,51,1554102000,18,22,40,Clouds
58749,52,1554102000,27,5,32,Clouds
58750,53,1554102000,21,19,40,Clouds
58751,54,1554102000,16,17,33,Clouds
58752,55,1554102000,27,9,36,Clouds
58753,56,1554102000,28,12,40,Clouds
58754,57,1554102000,13,10,23,Clouds
58755,58,1554102000,25,15,40,Clouds
58756,59,1554102000,19,1,20,Clouds
58757,60,1554102000,27,3,30,Clouds
58758,61,1554102000,25,0,25,Clouds
58759,62,1554102000,28,12,40,Clouds
58760,63,1554102000,8,27,35,Clouds
58761,64,1554102000,34,6,40,Clouds
58762,65,1554102000,33,7,40,Clouds
58763,66,1554102000,13,27,40,Clouds
58764,67,1554102000,15,25,40,Clouds
58765,68,1554102000,35,5,40,Clouds
58766,69,1554102000,18,22,40,Clouds
58767,70,1554102000,0,28,28,Clouds
58768,71,1554102000,15,25,40,Clouds
58769,72,1554102000,30,1,31,Clouds
58770,73,1554102000,22,8,30,Clouds
58771,74,1554102000,23,7,30,Clouds
58772,75,1554102000,29,11,40,Clouds
58773,76,1554102000,26,12,38,Clouds
58774,77,1554102000,7,22,29,Clouds
58775,78,1554102000,12,28,40,Clouds
58776,79,1554102000,25,2,27,Clouds
58777,80,1554102000,23,17,40,Clouds
58778,81,1554102000,39,1,40,Clouds
58779,82,1554102000,20,2,22,Clouds
58780,83,1554102000,18,22,40,Clouds
58781,84,1554102000,12,18,30,Clouds
58782,85,1554102000,29,6,35,Clouds
58783,86,1554102000,37,1,38,Clouds
58784,87,1554102000,27,11,38,Clouds
58785,88,1554102000,21,9,30,Clouds
58786,89,1554102000,36,4,40,Clouds
58787,90,1554102000,20,20,40,Clouds
58788,91,1554102000,23,7,30,Clouds
58789,92,1554102000,20,20,40,Clouds
58790,93,1554102000,11,29,40,Clouds
58791,94,1554102000,8,32,40,Clouds
58792,95,1554102000,36,4,40,Clouds
58793,96,1554102000,23,7,30,Clouds
58794,97,1554102000,38,2,40,Clouds
58795,98,1554102000,20,20,40,Clouds
58796,99,1554102000,18,12,30,Clouds
58797,100,1554102000,22,3,25,Clouds
58798,101,1554102000,28,2,30,Clouds
58799,102,1554102000,40,0,40,Clouds
58800,103,1554102000,38,2,40,Clouds
58801,104,1554102000,40,0,40,Clouds
58802,105,1554102000,32,4,36,Clouds
58803,106,1554102000,25,15,40,Clouds
58804,107,1554102000,40,0,40,Clouds
58805,108,1554102000,40,0,40,Clouds
58806,109,1554102000,22,7,29,Clouds
58807,110,1554102000,18,22,40,Clouds
58808,111,1554102000,34,6,40,Clouds
58809,112,1554102000,30,0,30,Clouds
58810,113,1554102000,31,9,40,Clouds
58811,114,1554102000,20,20,40,Clouds
58812,115,1554102000,4,26,30,Clouds
58813,2,1554105600,20,0,20,Clouds
58814,3,1554105600,11,9,20,Clouds
58815,4,1554105600,20,0,20,Clouds
58816,5,1554105600,36,4,40,Clouds
58817,6,1554105600,13,7,20,Clouds
58818,7,1554105600,26,3,29,Clouds
58819,8,1554105600,15,14,29,Clouds
58820,9,1554105600,17,7,24,Clouds
58821,10,1554105600,2,14,16,Clouds
58822,11,1554105600,19,11,30,Clouds
58823,12,1554105600,20,0,20,Clouds
58824,13,1554105600,14,15,29,Clouds
58825,14,1554105600,18,12,30,Clouds
58826,15,1554105600,16,0,16,Clouds
58827,16,1554105600,15,5,20,Clouds
58828,17,1554105600,10,9,19,Clouds
58829,18,1554105600,0,30,30,Clouds
58830,19,1554105600,20,10,30,Clouds
58831,21,1554105600,5,25,30,Clouds
58832,22,1554105600,2,17,19,Clouds
58833,23,1554105600,27,3,30,Clouds
58834,24,1554105600,20,0,20,Clouds
58835,25,1554105600,12,18,30,Clouds
58836,26,1554105600,6,13,19,Clouds
58837,27,1554105600,1,19,20,Clouds
58838,28,1554105600,30,0,30,Clouds
58839,29,1554105600,13,16,29,Clouds
58840,30,1554105600,20,0,20,Clouds
58841,31,1554105600,12,8,20,Clouds
58842,32,1554105600,11,19,30,Clouds
58843,33,1554105600,9,14,23,Clouds
58844,34,1554105600,30,0,30,Clouds
58845,35,1554105600,30,0,30,Clouds
58846,36,1554105600,26,14,40,Clouds
58847,37,1554105600,22,8,30,Clouds
58848,38,1554105600,17,23,40,Clouds
58849,39,1554105600,20,0,20,Clouds
58850,40,1554105600,5,16,21,Clouds
58851,41,1554105600,18,2,20,Clouds
58852,42,1554105600,30,0,30,Clouds
58853,43,1554105600,24,6,30,Clouds
58854,44,1554105600,30,0,30,Clouds
58855,45,1554105600,30,0,30,Clouds
58856,46,1554105600,16,4,20,Clouds
58857,47,1554105600,22,18,40,Clouds
58858,48,1554105600,31,9,40,Clouds
58859,49,1554105600,32,8,40,Clouds
58860,50,1554105600,40,0,40,Clouds
58861,51,1554105600,14,26,40,Clouds
58862,52,1554105600,12,20,32,Clouds
58863,53,1554105600,18,22,40,Clouds
58864,54,1554105600,8,25,33,Clouds
58865,55,1554105600,22,14,36,Clouds
58866,56,1554105600,28,12,40,Clouds
58867,57,1554105600,13,10,23,Clouds
58868,58,1554105600,0,40,40,Clouds
58869,59,1554105600,19,1,20,Clouds
58870,60,1554105600,23,7,30,Clouds
58871,61,1554105600,23,2,25,Clouds
58872,62,1554105600,24,16,40,Clouds
58873,63,1554105600,1,33,34,Clouds
58874,64,1554105600,29,11,40,Clouds
58875,65,1554105600,21,19,40,Clouds
58876,66,1554105600,2,38,40,Clouds
58877,67,1554105600,9,31,40,Clouds
58878,68,1554105600,22,18,40,Clouds
58879,69,1554105600,15,25,40,Clouds
58880,70,1554105600,8,20,28,Clouds
58881,71,1554105600,12,28,40,Clouds
58882,72,1554105600,29,2,31,Clouds
58883,73,1554105600,29,1,30,Clouds
58884,74,1554105600,30,0,30,Clouds
58885,75,1554105600,40,0,40,Clouds
58886,76,1554105600,32,6,38,Clouds
58887,77,1554105600,18,11,29,Clouds
58888,78,1554105600,21,19,40,Clouds
58889,79,1554105600,25,2,27,Clouds
58890,80,1554105600,28,12,40,Clouds
58891,81,1554105600,38,2,40,Clouds
58892,82,1554105600,21,1,22,Clouds
58893,83,1554105600,37,3,40,Clouds
58894,84,1554105600,29,1,30,Clouds
58895,85,1554105600,35,0,35,Clouds
58896,86,1554105600,38,0,38,Clouds
58897,87,1554105600,38,0,38,Clouds
58898,88,1554105600,30,0,30,Clouds
58899,89,1554105600,27,12,39,Clouds
58900,90,1554105600,0,40,40,Clouds
58901,91,1554105600,18,12,30,Clouds
58902,92,1554105600,40,0,40,Clouds
58903,93,1554105600,36,4,40,Clouds
58904,94,1554105600,13,27,40,Clouds
58905,95,1554105600,40,0,40,Clouds
58906,96,1554105600,30,0,30,Clouds
58907,97,1554105600,40,0,40,Clouds
58908,98,1554105600,22,18,40,Clouds
58909,99,1554105600,12,18,30,Clouds
58910,100,1554105600,18,7,25,Clouds
58911,101,1554105600,30,0,30,Clouds
58912,102,1554105600,40,0,40,Clouds
58913,103,1554105600,36,4,40,Clouds
58914,104,1554105600,39,1,40,Clouds
58915,105,1554105600,30,6,36,Clouds
58916,106,1554105600,40,0,40,Clouds
58917,107,1554105600,40,0,40,Clouds
58918,108,1554105600,40,0,40,Clouds
58919,109,1554105600,27,2,29,Clouds
58920,110,1554105600,26,14,40,Clouds
58921,111,1554105600,40,0,40,Clouds
58922,112,1554105600,30,0,30,Clouds
58923,113,1554105600,24,15,39,Clouds
58924,114,1554105600,20,20,40,Clouds
58925,115,1554105600,19,11,30,Clouds
58926,2,1554109200,20,0,20,Clouds
58927,3,1554109200,16,4,20,Clouds
58928,4,1554109200,20,0,20,Clouds
58929,5,1554109200,40,0,40,Clouds
58930,6,1554109200,17,3,20,Clouds
58931,7,1554109200,28,1,29,Clouds
58932,8,1554109200,29,1,30,Clouds
58933,9,1554109200,10,13,23,Clouds
58934,10,1554109200,14,1,15,Clouds
58935,11,1554109200,24,6,30,Clouds
58936,12,1554109200,20,0,20,Clouds
58937,13,1554109200,1,29,30,Clouds
58938,14,1554109200,26,4,30,Clouds
58939,15,1554109200,16,0,16,Clouds
58940,16,1554109200,17,2,19,Clouds
58941,17,1554109200,18,1,19,Clouds
58942,18,1554109200,30,0,30,Clouds
58943,19,1554109200,0,29,29,Clouds
58944,21,1554109200,3,27,30,Clouds
58945,22,1554109200,8,10,18,Clouds
58946,23,1554109200,28,2,30,Clouds
58947,24,1554109200,20,0,20,Clouds
58948,25,1554109200,1,29,30,Clouds
58949,26,1554109200,0,20,20,Clouds
58950,27,1554109200,5,15,20,Clouds
58951,28,1554109200,29,1,30,Clouds
58952,29,1554109200,29,0,29,Clouds
58953,30,1554109200,20,0,20,Clouds
58954,31,1554109200,18,2,20,Clouds
58955,32,1554109200,18,11,29,Clouds
58956,33,1554109200,20,3,23,Clouds
58957,34,1554109200,30,0,30,Clouds
58958,35,1554109200,29,1,30,Clouds
58959,36,1554109200,4,36,40,Clouds
58960,37,1554109200,19,11,30,Clouds
58961,38,1554109200,36,4,40,Clouds
58962,39,1554109200,16,4,20,Clouds
58963,40,1554109200,15,6,21,Clouds
58964,41,1554109200,18,2,20,Clouds
58965,42,1554109200,30,0,30,Clouds
58966,43,1554109200,30,0,30,Clouds
58967,44,1554109200,30,0,30,Clouds
58968,45,1554109200,28,2,30,Clouds
58969,46,1554109200,20,0,20,Clouds
58970,47,1554109200,0,39,39,Clouds
58971,48,1554109200,12,26,38,Clouds
58972,49,1554109200,22,18,40,Clouds
58973,50,1554109200,39,1,40,Clouds
58974,51,1554109200,28,12,40,Clouds
58975,52,1554109200,19,13,32,Clouds
58976,53,1554109200,10,29,39,Clouds
58977,54,1554109200,2,31,33,Clouds
58978,55,1554109200,12,23,35,Clouds
58979,56,1554109200,1,39,40,Clouds
58980,57,1554109200,0,23,23,Clouds
58981,58,1554109200,1,39,40,Clouds
58982,59,1554109200,20,0,20,Clouds
58983,60,1554109200,30,0,30,Clouds
58984,61,1554109200,25,0,25,Clouds
58985,62,1554109200,0,40,40,Clouds
58986,63,1554109200,0,34,34,Clouds
58987,64,1554109200,12,28,40,Clouds
58988,65,1554109200,19,21,40,Clouds
58989,66,1554109200,2,35,37,Clouds
58990,67,1554109200,15,24,39,Clouds
58991,68,1554109200,9,30,39,Clouds
58992,69,1554109200,6,34,40,Clouds
58993,70,1554109200,4,24,28,Clouds
58994,71,1554109200,33,7,40,Clouds
58995,72,1554109200,30,1,31,Clouds
58996,73,1554109200,30,0,30,Clouds
58997,74,1554109200,30,0,30,Clouds
58998,75,1554109200,39,1,40,Clouds
58999,76,1554109200,37,1,38,Clouds
59000,77,1554109200,29,0,29,Clouds
59001,78,1554109200,39,1,40,Clouds
59002,79,1554109200,27,0,27,Clouds
59003,80,1554109200,39,1,40,Clouds
59004,81,1554109200,40,0,40,Clouds
59005,82,1554109200,22,0,22,Clouds
59006,83,1554109200,40,0,40,Clouds
59007,84,1554109200,30,0,30,Clouds
59008,85,1554109200,35,0,35,Clouds
59009,86,1554109200,37,1,38,Clouds
59010,87,1554109200,38,0,38,Clouds
59011,88,1554109200,30,0,30,Clouds
59012,89,1554109200,29,10,39,Clouds
59013,90,1554109200,1,39,40,Clouds
59014,91,1554109200,24,6,30,Clouds
59015,92,1554109200,40,0,40,Clouds
59016,93,1554109200,40,0,40,Clouds
59017,94,1554109200,40,0,40,Clouds
59018,95,1554109200,39,1,40,Clouds
59019,96,1554109200,30,0,30,Clouds
59020,97,1554109200,39,1,40,Clouds
59021,98,1554109200,26,14,40,Clouds
59022,99,1554109200,1,29,30,Clouds
59023,100,1554109200,25,0,25,Clouds
59024,101,1554109200,29,1,30,Clouds
59025,102,1554109200,40,0,40,Clouds
59026,103,1554109200,40,0,40,Clouds
59027,104,1554109200,40,0,40,Clouds
59028,105,1554109200,36,0,36,Clouds
59029,106,1554109200,40,0,40,Clouds
59030,107,1554109200,40,0,40,Clouds
59031,108,1554109200,40,0,40,Clouds
59032,109,1554109200,29,0,29,Clouds
59033,110,1554109200,39,0,39,Clouds
59034,111,1554109200,40,0,40,Clouds
59035,112,1554109200,30,0,30,Clouds
59036,113,1554109200,13,26,39,Clouds
59037,114,1554109200,0,40,40,Clouds
59038,115,1554109200,28,2,30,Clouds
59039,2,1554112800,20,0,20,Clouds
59040,3,1554112800,20,0,20,Clouds
59041,4,1554112800,19,1,20,Clouds
59042,5,1554112800,40,0,40,Clouds
59043,6,1554112800,20,0,20,Clouds
59044,7,1554112800,29,0,29,Clouds
59045,8,1554112800,18,11,29,Clouds
59046,9,1554112800,17,6,23,Clouds
59047,10,1554112800,13,2,15,Clouds
59048,11,1554112800,9,20,29,Clouds
59049,12,1554112800,20,0,20,Clouds
59050,13,1554112800,0,30,30,Clouds
59051,14,1554112800,21,9,30,Clouds
59052,15,1554112800,16,0,16,Clouds
59053,16,1554112800,18,1,19,Clouds
59054,17,1554112800,19,0,19,Clouds
59055,18,1554112800,29,1,30,Clouds
59056,19,1554112800,0,29,29,Clouds
59057,21,1554112800,13,17,30,Clouds
59058,22,1554112800,16,3,19,Clouds
59059,23,1554112800,29,1,30,Clouds
59060,24,1554112800,20,0,20,Clouds
59061,25,1554112800,1,29,30,Clouds
59062,26,1554112800,4,16,20,Clouds
59063,27,1554112800,3,17,20,Clouds
59064,28,1554112800,30,0,30,Clouds
59065,29,1554112800,29,0,29,Clouds
59066,30,1554112800,20,0,20,Clouds
59067,31,1554112800,19,1,20,Clouds
59068,32,1554112800,3,26,29,Clouds
59069,33,1554112800,21,2,23,Clouds
59070,34,1554112800,16,14,30,Clouds
59071,35,1554112800,29,1,30,Clouds
59072,36,1554112800,0,40,40,Clouds
59073,37,1554112800,11,19,30,Clouds
59074,38,1554112800,37,3,40,Clouds
59075,39,1554112800,13,7,20,Clouds
59076,40,1554112800,19,2,21,Clouds
59077,41,1554112800,19,1,20,Clouds
59078,42,1554112800,30,0,30,Clouds
59079,43,1554112800,30,0,30,Clouds
59080,44,1554112800,30,0,30,Clouds
59081,45,1554112800,30,0,30,Clouds
59082,46,1554112800,17,3,20,Clouds
59083,47,1554112800,1,38,39,Clouds
59084,48,1554112800,0,38,38,Clouds
59085,49,1554112800,7,33,40,Clouds
59086,50,1554112800,40,0,40,Clouds
59087,51,1554112800,26,14,40,Clouds
59088,52,1554112800,9,23,32,Clouds
59089,53,1554112800,1,38,39,Clouds
59090,54,1554112800,1,32,33,Clouds
59091,55,1554112800,6,29,35,Clouds
59092,56,1554112800,4,36,40,Clouds
59093,57,1554112800,0,23,23,Clouds
59094,58,1554112800,0,40,40,Clouds
59095,59,1554112800,20,0,20,Clouds
59096,60,1554112800,30,0,30,Clouds
59097,61,1554112800,17,8,25,Clouds
59098,62,1554112800,0,40,40,Clouds
59099,63,1554112800,0,33,33,Clouds
59100,64,1554112800,1,39,40,Clouds
59101,65,1554112800,1,39,40,Clouds
59102,66,1554112800,0,37,37,Clouds
59103,67,1554112800,23,16,39,Clouds
59104,68,1554112800,9,30,39,Clouds
59105,69,1554112800,2,38,40,Clouds
59106,70,1554112800,6,22,28,Clouds
59107,71,1554112800,35,5,40,Clouds
59108,72,1554112800,29,2,31,Clouds
59109,73,1554112800,30,0,30,Clouds
59110,74,1554112800,30,0,30,Clouds
59111,75,1554112800,40,0,40,Clouds
59112,76,1554112800,38,0,38,Clouds
59113,77,1554112800,28,1,29,Clouds
59114,78,1554112800,40,0,40,Clouds
59115,79,1554112800,27,0,27,Clouds
59116,80,1554112800,37,3,40,Clouds
59117,81,1554112800,40,0,40,Clouds
59118,82,1554112800,22,0,22,Clouds
59119,83,1554112800,40,0,40,Clouds
59120,84,1554112800,30,0,30,Clouds
59121,85,1554112800,35,0,35,Clouds
59122,86,1554112800,36,2,38,Clouds
59123,87,1554112800,38,0,38,Clouds
59124,88,1554112800,30,0,30,Clouds
59125,89,1554112800,3,36,39,Clouds
59126,90,1554112800,3,37,40,Clouds
59127,91,1554112800,21,9,30,Clouds
59128,92,1554112800,40,0,40,Clouds
59129,93,1554112800,40,0,40,Clouds
59130,94,1554112800,40,0,40,Clouds
59131,95,1554112800,40,0,40,Clouds
59132,96,1554112800,30,0,30,Clouds
59133,97,1554112800,40,0,40,Clouds
59134,98,1554112800,24,16,40,Clouds
59135,99,1554112800,0,30,30,Clouds
59136,100,1554112800,14,11,25,Clouds
59137,101,1554112800,30,0,30,Clouds
59138,102,1554112800,39,1,40,Clouds
59139,103,1554112800,40,0,40,Clouds
59140,104,1554112800,40,0,40,Clouds
59141,105,1554112800,36,0,36,Clouds
59142,106,1554112800,40,0,40,Clouds
59143,107,1554112800,39,1,40,Clouds
59144,108,1554112800,40,0,40,Clouds
59145,109,1554112800,28,1,29,Clouds
59146,110,1554112800,39,0,39,Clouds
59147,111,1554112800,40,0,40,Clouds
59148,112,1554112800,28,2,30,Clouds
59149,113,1554112800,0,38,38,Clouds
59150,114,1554112800,0,40,40,Clouds
59151,115,1554112800,30,0,30,Clouds
59152,2,1554116400,20,0,20,Clouds
59153,3,1554116400,19,1,20,Clouds
59154,4,1554116400,18,2,20,Clouds
59155,5,1554116400,21,19,40,Clouds
59156,6,1554116400,18,2,20,Clouds
59157,7,1554116400,29,0,29,Clouds
59158,8,1554116400,12,18,30,Clouds
59159,9,1554116400,13,10,23,Clouds
59160,10,1554116400,14,1,15,Clouds
59161,11,1554116400,10,19,29,Clouds
59162,12,1554116400,20,0,20,Clouds
59163,13,1554116400,0,30,30,Clouds
59164,14,1554116400,13,17,30,Clouds
59165,15,1554116400,16,0,16,Clouds
59166,16,1554116400,17,3,20,Clouds
59167,17,1554116400,18,1,19,Clouds
59168,18,1554116400,27,3,30,Clouds
59169,19,1554116400,0,29,29,Clouds
59170,21,1554116400,13,17,30,Clouds
59171,22,1554116400,19,0,19,Clouds
59172,23,1554116400,30,0,30,Clouds
59173,24,1554116400,20,0,20,Clouds
59174,25,1554116400,1,29,30,Clouds
59175,26,1554116400,0,20,20,Clouds
59176,27,1554116400,0,20,20,Clouds
59177,28,1554116400,18,12,30,Clouds
59178,29,1554116400,26,3,29,Clouds
59179,30,1554116400,20,0,20,Clouds
59180,31,1554116400,19,1,20,Clouds
59181,32,1554116400,4,25,29,Clouds
59182,33,1554116400,21,2,23,Clouds
59183,34,1554116400,30,0,30,Clouds
59184,35,1554116400,30,0,30,Clouds
59185,36,1554116400,2,38,40,Clouds
59186,37,1554116400,10,20,30,Clouds
59187,38,1554116400,40,0,40,Clouds
59188,39,1554116400,13,7,20,Clouds
59189,40,1554116400,18,3,21,Clouds
59190,41,1554116400,17,3,20,Clouds
59191,42,1554116400,30,0,30,Clouds
59192,43,1554116400,30,0,30,Clouds
59193,44,1554116400,30,0,30,Clouds
59194,45,1554116400,30,0,30,Clouds
59195,46,1554116400,16,4,20,Clouds
59196,47,1554116400,8,31,39,Clouds
59197,48,1554116400,8,32,40,Clouds
59198,49,1554116400,1,39,40,Clouds
59199,50,1554116400,40,0,40,Clouds
59200,51,1554116400,24,16,40,Clouds
59201,52,1554116400,7,25,32,Clouds
59202,53,1554116400,0,39,39,Clouds
59203,54,1554116400,1,31,32,Clouds
59204,55,1554116400,5,30,35,Clouds
59205,56,1554116400,2,38,40,Clouds
59206,57,1554116400,0,23,23,Clouds
59207,58,1554116400,19,21,40,Clouds
59208,59,1554116400,18,2,20,Clouds
59209,60,1554116400,29,1,30,Clouds
59210,61,1554116400,24,1,25,Clouds
59211,62,1554116400,10,30,40,Clouds
59212,63,1554116400,0,33,33,Clouds
59213,64,1554116400,2,38,40,Clouds
59214,65,1554116400,12,28,40,Clouds
59215,66,1554116400,4,36,40,Clouds
59216,67,1554116400,26,14,40,Clouds
59217,68,1554116400,4,35,39,Clouds
59218,69,1554116400,0,40,40,Clouds
59219,70,1554116400,1,27,28,Clouds
59220,71,1554116400,33,7,40,Clouds
59221,72,1554116400,31,0,31,Clouds
59222,73,1554116400,29,1,30,Clouds
59223,74,1554116400,29,1,30,Clouds
59224,75,1554116400,40,0,40,Clouds
59225,76,1554116400,38,0,38,Clouds
59226,77,1554116400,29,0,29,Clouds
59227,78,1554116400,40,0,40,Clouds
59228,79,1554116400,21,6,27,Clouds
59229,80,1554116400,40,0,40,Clouds
59230,81,1554116400,40,0,40,Clouds
59231,82,1554116400,22,0,22,Clouds
59232,83,1554116400,40,0,40,Clouds
59233,84,1554116400,30,0,30,Clouds
59234,85,1554116400,35,0,35,Clouds
59235,86,1554116400,34,4,38,Clouds
59236,87,1554116400,38,0,38,Clouds
59237,88,1554116400,29,1,30,Clouds
59238,89,1554116400,0,39,39,Clouds
59239,90,1554116400,0,40,40,Clouds
59240,91,1554116400,22,8,30,Clouds
59241,92,1554116400,40,0,40,Clouds
59242,93,1554116400,40,0,40,Clouds
59243,94,1554116400,40,0,40,Clouds
59244,95,1554116400,38,2,40,Clouds
59245,96,1554116400,29,1,30,Clouds
59246,97,1554116400,40,0,40,Clouds
59247,98,1554116400,23,17,40,Clouds
59248,99,1554116400,11,19,30,Clouds
59249,100,1554116400,19,6,25,Clouds
59250,101,1554116400,30,0,30,Clouds
59251,102,1554116400,40,0,40,Clouds
59252,103,1554116400,40,0,40,Clouds
59253,104,1554116400,40,0,40,Clouds
59254,105,1554116400,36,0,36,Clouds
59255,106,1554116400,40,0,40,Clouds
59256,107,1554116400,40,0,40,Clouds
59257,108,1554116400,40,0,40,Clouds
59258,109,1554116400,28,1,29,Clouds
59259,110,1554116400,38,1,39,Clouds
59260,111,1554116400,40,0,40,Clouds
59261,112,1554116400,30,0,30,Clouds
59262,113,1554116400,0,38,38,Clouds
59263,114,1554116400,8,32,40,Clouds
59264,115,1554116400,28,2,30,Clouds
59265,2,1554120000,15,5,20,Clouds
59266,3,1554120000,20,0,20,Clouds
59267,4,1554120000,19,1,20,Clouds
59268,5,1554120000,22,18,40,Clouds
59269,6,1554120000,20,0,20,Clouds
59270,7,1554120000,29,0,29,Clouds
59271,8,1554120000,12,18,30,Clouds
59272,9,1554120000,10,14,24,Clouds
59273,10,1554120000,16,0,16,Clouds
59274,11,1554120000,8,21,29,Clouds
59275,12,1554120000,20,0,20,Clouds
59276,13,1554120000,0,30,30,Clouds
59277,14,1554120000,13,17,30,Clouds
59278,15,1554120000,16,0,16,Clouds
59279,16,1554120000,17,3,20,Clouds
59280,17,1554120000,20,0,20,Clouds
59281,18,1554120000,27,3,30,Clouds
59282,19,1554120000,7,22,29,Clouds
59283,21,1554120000,2,28,30,Clouds
59284,22,1554120000,19,1,20,Clouds
59285,23,1554120000,29,1,30,Clouds
59286,24,1554120000,19,1,20,Clouds
59287,25,1554120000,1,29,30,Clouds
59288,26,1554120000,0,20,20,Clouds
59289,27,1554120000,0,20,20,Clouds
59290,28,1554120000,27,3,30,Clouds
59291,29,1554120000,22,7,29,Clouds
59292,30,1554120000,20,0,20,Clouds
59293,31,1554120000,19,1,20,Clouds
59294,32,1554120000,2,28,30,Clouds
59295,33,1554120000,17,6,23,Clouds
59296,34,1554120000,23,7,30,Clouds
59297,35,1554120000,26,4,30,Clouds
59298,36,1554120000,4,36,40,Clouds
59299,37,1554120000,12,18,30,Clouds
59300,38,1554120000,40,0,40,Clouds
59301,39,1554120000,11,9,20,Clouds
59302,40,1554120000,20,1,21,Clouds
59303,41,1554120000,17,3,20,Clouds
59304,42,1554120000,30,0,30,Clouds
59305,43,1554120000,28,2,30,Clouds
59306,44,1554120000,30,0,30,Clouds
59307,45,1554120000,28,2,30,Clouds
59308,46,1554120000,18,2,20,Clouds
59309,47,1554120000,3,36,39,Clouds
59310,48,1554120000,11,29,40,Clouds
59311,49,1554120000,0,40,40,Clouds
59312,50,1554120000,40,0,40,Clouds
59313,51,1554120000,25,15,40,Clouds
59314,52,1554120000,8,24,32,Clouds
59315,53,1554120000,2,38,40,Clouds
59316,54,1554120000,0,32,32,Clouds
59317,55,1554120000,6,29,35,Clouds
59318,56,1554120000,2,38,40,Clouds
59319,57,1554120000,0,23,23,Clouds
59320,58,1554120000,8,32,40,Clouds
59321,59,1554120000,19,1,20,Clouds
59322,60,1554120000,30,0,30,Clouds
59323,61,1554120000,18,7,25,Clouds
59324,62,1554120000,9,31,40,Clouds
59325,63,1554120000,8,27,35,Clouds
59326,64,1554120000,12,28,40,Clouds
59327,65,1554120000,9,31,40,Clouds
59328,66,1554120000,4,36,40,Clouds
59329,67,1554120000,28,12,40,Clouds
59330,68,1554120000,4,35,39,Clouds
59331,69,1554120000,1,39,40,Clouds
59332,70,1554120000,0,28,28,Clouds
59333,71,1554120000,38,2,40,Clouds
59334,72,1554120000,30,1,31,Clouds
59335,73,1554120000,30,0,30,Clouds
59336,74,1554120000,29,1,30,Clouds
59337,75,1554120000,40,0,40,Clouds
59338,76,1554120000,38,0,38,Clouds
59339,77,1554120000,27,2,29,Clouds
59340,78,1554120000,40,0,40,Clouds
59341,79,1554120000,25,2,27,Clouds
59342,80,1554120000,36,4,40,Clouds
59343,81,1554120000,40,0,40,Clouds
59344,82,1554120000,22,0,22,Clouds
59345,83,1554120000,40,0,40,Clouds
59346,84,1554120000,30,0,30,Clouds
59347,85,1554120000,35,0,35,Clouds
59348,86,1554120000,37,1,38,Clouds
59349,87,1554120000,38,0,38,Clouds
59350,88,1554120000,30,0,30,Clouds
59351,89,1554120000,0,39,39,Clouds
59352,90,1554120000,2,38,40,Clouds
59353,91,1554120000,25,5,30,Clouds
59354,92,1554120000,40,0,40,Clouds
59355,93,1554120000,40,0,40,Clouds
59356,94,1554120000,40,0,40,Clouds
59357,95,1554120000,40,0,40,Clouds
59358,96,1554120000,29,1,30,Clouds
59359,97,1554120000,40,0,40,Clouds
59360,98,1554120000,20,20,40,Clouds
59361,99,1554120000,13,17,30,Clouds
59362,100,1554120000,25,0,25,Clouds
59363,101,1554120000,29,1,30,Clouds
59364,102,1554120000,39,1,40,Clouds
59365,103,1554120000,40,0,40,Clouds
59366,104,1554120000,40,0,40,Clouds
59367,105,1554120000,36,0,36,Clouds
59368,106,1554120000,40,0,40,Clouds
59369,107,1554120000,40,0,40,Clouds
59370,108,1554120000,40,0,40,Clouds
59371,109,1554120000,27,2,29,Clouds
59372,110,1554120000,40,0,40,Clouds
59373,111,1554120000,39,1,40,Clouds
59374,112,1554120000,29,1,30,Clouds
59375,113,1554120000,2,36,38,Clouds
59376,114,1554120000,10,30,40,Clouds
59377,115,1554120000,29,1,30,Clouds
59378,2,1554123600,20,0,20,Clouds
59379,3,1554123600,20,0,20,Clouds
59380,4,1554123600,20,0,20,Clouds
59381,5,1554123600,30,10,40,Clouds
59382,6,1554123600,19,1,20,Clouds
59383,7,1554123600,28,1,29,Clouds
59384,8,1554123600,19,11,30,Clouds
59385,9,1554123600,13,11,24,Clouds
59386,10,1554123600,16,0,16,Clouds
59387,11,1554123600,17,12,29,Clouds
59388,12,1554123600,20,0,20,Clouds
59389,13,1554123600,4,26,30,Clouds
59390,14,1554123600,16,14,30,Clouds
59391,15,1554123600,15,1,16,Clouds
59392,16,1554123600,18,2,20,Clouds
59393,17,1554123600,19,1,20,Clouds
59394,18,1554123600,24,6,30,Clouds
59395,19,1554123600,4,25,29,Clouds
59396,21,1554123600,9,21,30,Clouds
59397,22,1554123600,11,9,20,Clouds
59398,23,1554123600,23,7,30,Clouds
59399,24,1554123600,20,0,20,Clouds
59400,25,1554123600,4,26,30,Clouds
59401,26,1554123600,3,17,20,Clouds
59402,27,1554123600,1,19,20,Clouds
59403,28,1554123600,30,0,30,Clouds
59404,29,1554123600,25,4,29,Clouds
59405,30,1554123600,20,0,20,Clouds
59406,31,1554123600,18,2,20,Clouds
59407,32,1554123600,6,24,30,Clouds
59408,33,1554123600,23,0,23,Clouds
59409,34,1554123600,30,0,30,Clouds
59410,35,1554123600,30,0,30,Clouds
59411,36,1554123600,11,29,40,Clouds
59412,37,1554123600,16,14,30,Clouds
59413,38,1554123600,39,1,40,Clouds
59414,39,1554123600,10,10,20,Clouds
59415,40,1554123600,19,2,21,Clouds
59416,41,1554123600,20,0,20,Clouds
59417,42,1554123600,30,0,30,Clouds
59418,43,1554123600,25,4,29,Clouds
59419,44,1554123600,30,0,30,Clouds
59420,45,1554123600,28,2,30,Clouds
59421,46,1554123600,20,0,20,Clouds
59422,47,1554123600,3,36,39,Clouds
59423,48,1554123600,11,29,40,Clouds
59424,49,1554123600,6,34,40,Clouds
59425,50,1554123600,39,1,40,Clouds
59426,51,1554123600,24,16,40,Clouds
59427,52,1554123600,6,26,32,Clouds
59428,53,1554123600,9,31,40,Clouds
59429,54,1554123600,1,31,32,Clouds
59430,55,1554123600,14,21,35,Clouds
59431,56,1554123600,13,27,40,Clouds
59432,57,1554123600,3,20,23,Clouds
59433,58,1554123600,31,9,40,Clouds
59434,59,1554123600,20,0,20,Clouds
59435,60,1554123600,30,0,30,Clouds
59436,61,1554123600,25,0,25,Clouds
59437,62,1554123600,7,33,40,Clouds
59438,63,1554123600,8,27,35,Clouds
59439,64,1554123600,9,31,40,Clouds
59440,65,1554123600,18,22,40,Clouds
59441,66,1554123600,6,34,40,Clouds
59442,67,1554123600,31,9,40,Clouds
59443,68,1554123600,0,40,40,Clouds
59444,69,1554123600,0,40,40,Clouds
59445,70,1554123600,0,28,28,Clouds
59446,71,1554123600,36,4,40,Clouds
59447,72,1554123600,30,1,31,Clouds
59448,73,1554123600,25,5,30,Clouds
59449,74,1554123600,30,0,30,Clouds
59450,75,1554123600,40,0,40,Clouds
59451,76,1554123600,37,1,38,Clouds
59452,77,1554123600,27,2,29,Clouds
59453,78,1554123600,40,0,40,Clouds
59454,79,1554123600,27,0,27,Clouds
59455,80,1554123600,27,13,40,Clouds
59456,81,1554123600,40,0,40,Clouds
59457,82,1554123600,22,0,22,Clouds
59458,83,1554123600,31,9,40,Clouds
59459,84,1554123600,27,3,30,Clouds
59460,85,1554123600,28,7,35,Clouds
59461,86,1554123600,38,0,38,Clouds
59462,87,1554123600,37,1,38,Clouds
59463,88,1554123600,29,1,30,Clouds
59464,89,1554123600,1,38,39,Clouds
59465,90,1554123600,5,35,40,Clouds
59466,91,1554123600,22,8,30,Clouds
59467,92,1554123600,39,1,40,Clouds
59468,93,1554123600,40,0,40,Clouds
59469,94,1554123600,40,0,40,Clouds
59470,95,1554123600,38,2,40,Clouds
59471,96,1554123600,28,2,30,Clouds
59472,97,1554123600,40,0,40,Clouds
59473,98,1554123600,7,33,40,Clouds
59474,99,1554123600,13,17,30,Clouds
59475,100,1554123600,24,1,25,Clouds
59476,101,1554123600,30,0,30,Clouds
59477,102,1554123600,40,0,40,Clouds
59478,103,1554123600,40,0,40,Clouds
59479,104,1554123600,40,0,40,Clouds
59480,105,1554123600,36,0,36,Clouds
59481,106,1554123600,40,0,40,Clouds
59482,107,1554123600,40,0,40,Clouds
59483,108,1554123600,40,0,40,Clouds
59484,109,1554123600,25,4,29,Clouds
59485,110,1554123600,40,0,40,Clouds
59486,111,1554123600,38,2,40,Clouds
59487,112,1554123600,25,5,30,Clouds
59488,113,1554123600,0,38,38,Clouds
59489,114,1554123600,7,33,40,Clouds
59490,115,1554123600,30,0,30,Clouds
59491,2,1554127200,18,2,20,Rain
59492,3,1554127200,9,11,20,Rain
59493,4,1554127200,20,0,20,Rain
59494,5,1554127200,32,8,40,Rain
59495,6,1554127200,20,0,20,Rain
59496,7,1554127200,12,17,29,Rain
59497,8,1554127200,21,9,30,Rain
59498,9,1554127200,11,13,24,Rain
59499,10,1554127200,13,3,16,Rain
59500,11,1554127200,19,11,30,Rain
59501,12,1554127200,19,1,20,Rain
59502,13,1554127200,8,22,30,Rain
59503,14,1554127200,25,5,30,Rain
59504,15,1554127200,10,6,16,Rain
59505,16,1554127200,18,2,20,Rain
59506,17,1554127200,20,0,20,Rain
59507,18,1554127200,24,6,30,Rain
59508,19,1554127200,8,21,29,Rain
59509,21,1554127200,10,20,30,Rain
59510,22,1554127200,18,2,20,Rain
59511,23,1554127200,21,9,30,Rain
59512,24,1554127200,20,0,20,Rain
59513,25,1554127200,9,21,30,Rain
59514,26,1554127200,6,14,20,Rain
59515,27,1554127200,4,16,20,Rain
59516,28,1554127200,29,1,30,Rain
59517,29,1554127200,23,6,29,Rain
59518,30,1554127200,18,2,20,Rain
59519,31,1554127200,14,6,20,Rain
59520,32,1554127200,18,12,30,Rain
59521,33,1554127200,20,3,23,Rain
59522,34,1554127200,30,0,30,Rain
59523,35,1554127200,27,3,30,Rain
59524,36,1554127200,12,28,40,Rain
59525,37,1554127200,21,9,30,Rain
59526,38,1554127200,34,6,40,Rain
59527,39,1554127200,10,10,20,Rain
59528,40,1554127200,20,1,21,Rain
59529,41,1554127200,13,7,20,Rain
59530,42,1554127200,30,0,30,Rain
59531,43,1554127200,25,5,30,Rain
59532,44,1554127200,29,1,30,Rain
59533,45,1554127200,29,1,30,Rain
59534,46,1554127200,20,0,20,Rain
59535,47,1554127200,1,38,39,Rain
59536,48,1554127200,11,29,40,Rain
59537,49,1554127200,3,37,40,Rain
59538,50,1554127200,39,1,40,Rain
59539,51,1554127200,27,13,40,Rain
59540,52,1554127200,4,28,32,Rain
59541,53,1554127200,8,32,40,Rain
59542,54,1554127200,0,33,33,Rain
59543,55,1554127200,20,16,36,Rain
59544,56,1554127200,1,39,40,Rain
59545,57,1554127200,2,21,23,Rain
59546,58,1554127200,10,30,40,Rain
59547,59,1554127200,8,12,20,Rain
59548,60,1554127200,30,0,30,Rain
59549,61,1554127200,17,8,25,Rain
59550,62,1554127200,11,29,40,Rain
59551,63,1554127200,1,34,35,Rain
59552,64,1554127200,18,22,40,Rain
59553,65,1554127200,16,24,40,Rain
59554,66,1554127200,2,38,40,Rain
59555,67,1554127200,33,7,40,Rain
59556,68,1554127200,3,37,40,Rain
59557,69,1554127200,0,40,40,Rain
59558,70,1554127200,0,28,28,Rain
59559,71,1554127200,38,2,40,Rain
59560,72,1554127200,29,2,31,Rain
59561,73,1554127200,30,0,30,Rain
59562,74,1554127200,30,0,30,Rain
59563,75,1554127200,40,0,40,Rain
59564,76,1554127200,36,2,38,Rain
59565,77,1554127200,24,5,29,Rain
59566,78,1554127200,32,8,40,Rain
59567,79,1554127200,27,0,27,Rain
59568,80,1554127200,12,28,40,Rain
59569,81,1554127200,40,0,40,Rain
59570,82,1554127200,22,0,22,Rain
59571,83,1554127200,32,8,40,Rain
59572,84,1554127200,30,0,30,Rain
59573,85,1554127200,29,6,35,Rain
59574,86,1554127200,38,0,38,Rain
59575,87,1554127200,37,1,38,Rain
59576,88,1554127200,29,1,30,Rain
59577,89,1554127200,5,34,39,Rain
59578,90,1554127200,6,34,40,Rain
59579,91,1554127200,18,12,30,Rain
59580,92,1554127200,37,3,40,Rain
59581,93,1554127200,40,0,40,Rain
59582,94,1554127200,40,0,40,Rain
59583,95,1554127200,33,7,40,Rain
59584,96,1554127200,30,0,30,Rain
59585,97,1554127200,39,1,40,Rain
59586,98,1554127200,13,27,40,Rain
59587,99,1554127200,15,15,30,Rain
59588,100,1554127200,24,1,25,Rain
59589,101,1554127200,29,1,30,Rain
59590,102,1554127200,40,0,40,Rain
59591,103,1554127200,40,0,40,Rain
59592,104,1554127200,40,0,40,Rain
59593,105,1554127200,36,0,36,Rain
59594,106,1554127200,39,1,40,Rain
59595,107,1554127200,40,0,40,Rain
59596,108,1554127200,39,1,40,Rain
59597,109,1554127200,28,1,29,Rain
59598,110,1554127200,40,0,40,Rain
59599,111,1554127200,39,1,40,Rain
59600,112,1554127200,29,1,30,Rain
59601,113,1554127200,0,38,38,Rain
59602,114,1554127200,8,32,40,Rain
59603,115,1554127200,30,0,30,Rain
59604,2,1554130800,20,0,20,Clouds
59605,3,1554130800,9,11,20,Clouds
59606,4,1554130800,18,2,20,Clouds
59607,5,1554130800,34,6,40,Clouds
59608,6,1554130800,18,2,20,Clouds
59609,7,1554130800,13,16,29,Clouds
59610,8,1554130800,18,12,30,Clouds
59611,9,1554130800,16,8,24,Clouds
59612,10,1554130800,16,0,16,Clouds
59613,11,1554130800,20,10,30,Clouds
59614,12,1554130800,20,0,20,Clouds
59615,13,1554130800,8,22,30,Clouds
59616,14,1554130800,25,5,30,Clouds
59617,15,1554130800,11,5,16,Clouds
59618,16,1554130800,16,4,20,Clouds
59619,17,1554130800,20,0,20,Clouds
59620,18,1554130800,27,3,30,Clouds
59621,19,1554130800,11,19,30,Clouds
59622,21,1554130800,5,25,30,Clouds
59623,22,1554130800,14,6,20,Clouds
59624,23,1554130800,15,15,30,Clouds
59625,24,1554130800,20,0,20,Clouds
59626,25,1554130800,7,23,30,Clouds
59627,26,1554130800,7,13,20,Clouds
59628,27,1554130800,6,14,20,Clouds
59629,28,1554130800,29,1,30,Clouds
59630,29,1554130800,22,7,29,Clouds
59631,30,1554130800,11,9,20,Clouds
59632,31,1554130800,17,3,20,Clouds
59633,32,1554130800,20,10,30,Clouds
59634,33,1554130800,16,7,23,Clouds
59635,34,1554130800,29,1,30,Clouds
59636,35,1554130800,24,6,30,Clouds
59637,36,1554130800,9,31,40,Clouds
59638,37,1554130800,23,7,30,Clouds
59639,38,1554130800,30,10,40,Clouds
59640,39,1554130800,10,10,20,Clouds
59641,40,1554130800,19,2,21,Clouds
59642,41,1554130800,16,4,20,Clouds
59643,42,1554130800,29,1,30,Clouds
59644,43,1554130800,24,6,30,Clouds
59645,44,1554130800,28,2,30,Clouds
59646,45,1554130800,29,1,30,Clouds
59647,46,1554130800,18,2,20,Clouds
59648,47,1554130800,1,39,40,Clouds
59649,48,1554130800,10,30,40,Clouds
59650,49,1554130800,4,36,40,Clouds
59651,50,1554130800,40,0,40,Clouds
59652,51,1554130800,29,11,40,Clouds
59653,52,1554130800,5,27,32,Clouds
59654,53,1554130800,8,32,40,Clouds
59655,54,1554130800,0,33,33,Clouds
59656,55,1554130800,14,22,36,Clouds
59657,56,1554130800,0,40,40,Clouds
59658,57,1554130800,2,21,23,Clouds
59659,58,1554130800,8,32,40,Clouds
59660,59,1554130800,6,14,20,Clouds
59661,60,1554130800,30,0,30,Clouds
59662,61,1554130800,18,7,25,Clouds
59663,62,1554130800,11,29,40,Clouds
59664,63,1554130800,0,35,35,Clouds
59665,64,1554130800,13,27,40,Clouds
59666,65,1554130800,4,36,40,Clouds
59667,66,1554130800,3,37,40,Clouds
59668,67,1554130800,26,14,40,Clouds
59669,68,1554130800,0,40,40,Clouds
59670,69,1554130800,1,39,40,Clouds
59671,70,1554130800,2,26,28,Clouds
59672,71,1554130800,40,0,40,Clouds
59673,72,1554130800,30,1,31,Clouds
59674,73,1554130800,27,3,30,Clouds
59675,74,1554130800,27,3,30,Clouds
59676,75,1554130800,39,1,40,Clouds
59677,76,1554130800,37,1,38,Clouds
59678,77,1554130800,29,0,29,Clouds
59679,78,1554130800,36,4,40,Clouds
59680,79,1554130800,27,0,27,Clouds
59681,80,1554130800,14,26,40,Clouds
59682,81,1554130800,39,1,40,Clouds
59683,82,1554130800,22,0,22,Clouds
59684,83,1554130800,33,7,40,Clouds
59685,84,1554130800,30,0,30,Clouds
59686,85,1554130800,31,4,35,Clouds
59687,86,1554130800,37,1,38,Clouds
59688,87,1554130800,36,2,38,Clouds
59689,88,1554130800,30,0,30,Clouds
59690,89,1554130800,7,33,40,Clouds
59691,90,1554130800,5,35,40,Clouds
59692,91,1554130800,10,20,30,Clouds
59693,92,1554130800,37,3,40,Clouds
59694,93,1554130800,40,0,40,Clouds
59695,94,1554130800,40,0,40,Clouds
59696,95,1554130800,35,5,40,Clouds
59697,96,1554130800,29,1,30,Clouds
59698,97,1554130800,39,1,40,Clouds
59699,98,1554130800,14,26,40,Clouds
59700,99,1554130800,17,13,30,Clouds
59701,100,1554130800,16,9,25,Clouds
59702,101,1554130800,28,2,30,Clouds
59703,102,1554130800,40,0,40,Clouds
59704,103,1554130800,40,0,40,Clouds
59705,104,1554130800,40,0,40,Clouds
59706,105,1554130800,36,0,36,Clouds
59707,106,1554130800,40,0,40,Clouds
59708,107,1554130800,39,1,40,Clouds
59709,108,1554130800,40,0,40,Clouds
59710,109,1554130800,29,0,29,Clouds
59711,110,1554130800,40,0,40,Clouds
59712,111,1554130800,38,2,40,Clouds
59713,112,1554130800,28,2,30,Clouds
59714,113,1554130800,2,38,40,Clouds
59715,114,1554130800,12,28,40,Clouds
59716,115,1554130800,27,3,30,Clouds
59717,2,1554134400,20,0,20,Clouds
59718,3,1554134400,9,11,20,Clouds
59719,4,1554134400,20,0,20,Clouds
59720,5,1554134400,33,7,40,Clouds
59721,6,1554134400,20,0,20,Clouds
59722,7,1554134400,15,14,29,Clouds
59723,8,1554134400,16,14,30,Clouds
59724,9,1554134400,24,0,24,Clouds
59725,10,1554134400,15,1,16,Clouds
59726,11,1554134400,27,3,30,Clouds
59727,12,1554134400,19,1,20,Clouds
59728,13,1554134400,9,21,30,Clouds
59729,14,1554134400,23,6,29,Clouds
59730,15,1554134400,13,3,16,Clouds
59731,16,1554134400,19,1,20,Clouds
59732,17,1554134400,16,4,20,Clouds
59733,18,1554134400,30,0,30,Clouds
59734,19,1554134400,17,13,30,Clouds
59735,21,1554134400,1,29,30,Clouds
59736,22,1554134400,11,9,20,Clouds
59737,23,1554134400,7,23,30,Clouds
59738,24,1554134400,20,0,20,Clouds
59739,25,1554134400,9,21,30,Clouds
59740,26,1554134400,4,16,20,Clouds
59741,27,1554134400,10,10,20,Clouds
59742,28,1554134400,30,0,30,Clouds
59743,29,1554134400,23,6,29,Clouds
59744,30,1554134400,12,8,20,Clouds
59745,31,1554134400,15,5,20,Clouds
59746,32,1554134400,23,7,30,Clouds
59747,33,1554134400,5,18,23,Clouds
59748,34,1554134400,27,3,30,Clouds
59749,35,1554134400,30,0,30,Clouds
59750,36,1554134400,15,25,40,Clouds
59751,37,1554134400,24,6,30,Clouds
59752,38,1554134400,32,8,40,Clouds
59753,39,1554134400,4,16,20,Clouds
59754,40,1554134400,21,0,21,Clouds
59755,41,1554134400,16,4,20,Clouds
59756,42,1554134400,27,3,30,Clouds
59757,43,1554134400,25,5,30,Clouds
59758,44,1554134400,27,3,30,Clouds
59759,45,1554134400,24,6,30,Clouds
59760,46,1554134400,15,5,20,Clouds
59761,47,1554134400,4,36,40,Clouds
59762,48,1554134400,16,24,40,Clouds
59763,49,1554134400,1,39,40,Clouds
59764,50,1554134400,37,3,40,Clouds
59765,51,1554134400,30,10,40,Clouds
59766,52,1554134400,7,25,32,Clouds
59767,53,1554134400,7,33,40,Clouds
59768,54,1554134400,3,30,33,Clouds
59769,55,1554134400,17,19,36,Clouds
59770,56,1554134400,3,37,40,Clouds
59771,57,1554134400,1,22,23,Clouds
59772,58,1554134400,5,35,40,Clouds
59773,59,1554134400,13,7,20,Clouds
59774,60,1554134400,27,3,30,Clouds
59775,61,1554134400,20,5,25,Clouds
59776,62,1554134400,15,25,40,Clouds
59777,63,1554134400,1,34,35,Clouds
59778,64,1554134400,10,30,40,Clouds
59779,65,1554134400,1,39,40,Clouds
59780,66,1554134400,3,37,40,Clouds
59781,67,1554134400,24,16,40,Clouds
59782,68,1554134400,3,37,40,Clouds
59783,69,1554134400,8,32,40,Clouds
59784,70,1554134400,2,26,28,Clouds
59785,71,1554134400,38,2,40,Clouds
59786,72,1554134400,31,0,31,Clouds
59787,73,1554134400,17,13,30,Clouds
59788,74,1554134400,25,5,30,Clouds
59789,75,1554134400,35,5,40,Clouds
59790,76,1554134400,37,1,38,Clouds
59791,77,1554134400,26,3,29,Clouds
59792,78,1554134400,30,10,40,Clouds
59793,79,1554134400,27,0,27,Clouds
59794,80,1554134400,22,18,40,Clouds
59795,81,1554134400,40,0,40,Clouds
59796,82,1554134400,21,1,22,Clouds
59797,83,1554134400,36,4,40,Clouds
59798,84,1554134400,30,0,30,Clouds
59799,85,1554134400,34,1,35,Clouds
59800,86,1554134400,36,2,38,Clouds
59801,87,1554134400,36,2,38,Clouds
59802,88,1554134400,27,3,30,Clouds
59803,89,1554134400,7,33,40,Clouds
59804,90,1554134400,16,24,40,Clouds
59805,91,1554134400,15,15,30,Clouds
59806,92,1554134400,40,0,40,Clouds
59807,93,1554134400,40,0,40,Clouds
59808,94,1554134400,39,1,40,Clouds
59809,95,1554134400,32,8,40,Clouds
59810,96,1554134400,29,1,30,Clouds
59811,97,1554134400,40,0,40,Clouds
59812,98,1554134400,15,25,40,Clouds
59813,99,1554134400,18,12,30,Clouds
59814,100,1554134400,20,5,25,Clouds
59815,101,1554134400,28,2,30,Clouds
59816,102,1554134400,40,0,40,Clouds
59817,103,1554134400,32,8,40,Clouds
59818,104,1554134400,32,8,40,Clouds
59819,105,1554134400,36,0,36,Clouds
59820,106,1554134400,40,0,40,Clouds
59821,107,1554134400,40,0,40,Clouds
59822,108,1554134400,39,1,40,Clouds
59823,109,1554134400,29,0,29,Clouds
59824,110,1554134400,39,1,40,Clouds
59825,111,1554134400,39,1,40,Clouds
59826,112,1554134400,26,4,30,Clouds
59827,113,1554134400,4,36,40,Clouds
59828,114,1554134400,10,30,40,Clouds
59829,115,1554134400,24,6,30,Clouds
59830,2,1554138000,16,4,20,Clouds
59831,3,1554138000,19,1,20,Clouds
59832,4,1554138000,20,0,20,Clouds
59833,5,1554138000,31,9,40,Clouds
59834,6,1554138000,20,0,20,Clouds
59835,7,1554138000,20,9,29,Clouds
59836,8,1554138000,13,17,30,Clouds
59837,9,1554138000,24,0,24,Clouds
59838,10,1554138000,16,0,16,Clouds
59839,11,1554138000,30,0,30,Clouds
59840,12,1554138000,13,7,20,Clouds
59841,13,1554138000,14,16,30,Clouds
59842,14,1554138000,21,9,30,Clouds
59843,15,1554138000,14,2,16,Clouds
59844,16,1554138000,12,8,20,Clouds
59845,17,1554138000,19,1,20,Clouds
59846,18,1554138000,30,0,30,Clouds
59847,19,1554138000,27,3,30,Clouds
59848,21,1554138000,1,29,30,Clouds
59849,22,1554138000,11,9,20,Clouds
59850,23,1554138000,20,10,30,Clouds
59851,24,1554138000,20,0,20,Clouds
59852,25,1554138000,21,9,30,Clouds
59853,26,1554138000,4,16,20,Clouds
59854,27,1554138000,10,10,20,Clouds
59855,28,1554138000,29,1,30,Clouds
59856,29,1554138000,27,2,29,Clouds
59857,30,1554138000,20,0,20,Clouds
59858,31,1554138000,19,1,20,Clouds
59859,32,1554138000,7,23,30,Clouds
59860,33,1554138000,2,21,23,Clouds
59861,34,1554138000,22,8,30,Clouds
59862,35,1554138000,29,1,30,Clouds
59863,36,1554138000,34,6,40,Clouds
59864,37,1554138000,25,5,30,Clouds
59865,38,1554138000,22,18,40,Clouds
59866,39,1554138000,12,8,20,Clouds
59867,40,1554138000,17,4,21,Clouds
59868,41,1554138000,17,3,20,Clouds
59869,42,1554138000,25,5,30,Clouds
59870,43,1554138000,19,11,30,Clouds
59871,44,1554138000,25,5,30,Clouds
59872,45,1554138000,21,9,30,Clouds
59873,46,1554138000,18,2,20,Clouds
59874,47,1554138000,10,30,40,Clouds
59875,48,1554138000,5,35,40,Clouds
59876,49,1554138000,1,39,40,Clouds
59877,50,1554138000,36,4,40,Clouds
59878,51,1554138000,35,5,40,Clouds
59879,52,1554138000,15,17,32,Clouds
59880,53,1554138000,19,21,40,Clouds
59881,54,1554138000,17,16,33,Clouds
59882,55,1554138000,36,0,36,Clouds
59883,56,1554138000,25,15,40,Clouds
59884,57,1554138000,9,14,23,Clouds
59885,58,1554138000,16,24,40,Clouds
59886,59,1554138000,19,1,20,Clouds
59887,60,1554138000,22,8,30,Clouds
59888,61,1554138000,25,0,25,Clouds
59889,62,1554138000,21,19,40,Clouds
59890,63,1554138000,3,32,35,Clouds
59891,64,1554138000,15,25,40,Clouds
59892,65,1554138000,1,39,40,Clouds
59893,66,1554138000,31,9,40,Clouds
59894,67,1554138000,21,19,40,Clouds
59895,68,1554138000,12,28,40,Clouds
59896,69,1554138000,6,34,40,Clouds
59897,70,1554138000,2,26,28,Clouds
59898,71,1554138000,40,0,40,Clouds
59899,72,1554138000,29,2,31,Clouds
59900,73,1554138000,17,13,30,Clouds
59901,74,1554138000,18,12,30,Clouds
59902,75,1554138000,28,12,40,Clouds
59903,76,1554138000,20,18,38,Clouds
59904,77,1554138000,28,1,29,Clouds
59905,78,1554138000,36,4,40,Clouds
59906,79,1554138000,27,0,27,Clouds
59907,80,1554138000,35,5,40,Clouds
59908,81,1554138000,40,0,40,Clouds
59909,82,1554138000,20,2,22,Clouds
59910,83,1554138000,31,9,40,Clouds
59911,84,1554138000,26,4,30,Clouds
59912,85,1554138000,28,7,35,Clouds
59913,86,1554138000,31,7,38,Clouds
59914,87,1554138000,36,2,38,Clouds
59915,88,1554138000,25,5,30,Clouds
59916,89,1554138000,18,22,40,Clouds
59917,90,1554138000,18,22,40,Clouds
59918,91,1554138000,17,13,30,Clouds
59919,92,1554138000,33,7,40,Clouds
59920,93,1554138000,29,11,40,Clouds
59921,94,1554138000,40,0,40,Clouds
59922,95,1554138000,29,11,40,Clouds
59923,96,1554138000,27,3,30,Clouds
59924,97,1554138000,40,0,40,Clouds
59925,98,1554138000,18,22,40,Clouds
59926,99,1554138000,13,17,30,Clouds
59927,100,1554138000,0,25,25,Clouds
59928,101,1554138000,28,2,30,Clouds
59929,102,1554138000,39,1,40,Clouds
59930,103,1554138000,34,6,40,Clouds
59931,104,1554138000,33,7,40,Clouds
59932,105,1554138000,36,0,36,Clouds
59933,106,1554138000,39,1,40,Clouds
59934,107,1554138000,40,0,40,Clouds
59935,108,1554138000,38,2,40,Clouds
59936,109,1554138000,23,6,29,Clouds
59937,110,1554138000,39,1,40,Clouds
59938,111,1554138000,37,3,40,Clouds
59939,112,1554138000,24,6,30,Clouds
59940,113,1554138000,6,34,40,Clouds
59941,114,1554138000,40,0,40,Clouds
59942,115,1554138000,23,7,30,Clouds
59943,2,1554141600,17,3,20,Clouds
59944,3,1554141600,16,4,20,Clouds
59945,4,1554141600,20,0,20,Clouds
59946,5,1554141600,27,13,40,Clouds
59947,6,1554141600,19,1,20,Clouds
59948,7,1554141600,18,11,29,Clouds
59949,8,1554141600,17,13,30,Clouds
59950,9,1554141600,20,4,24,Clouds
59951,10,1554141600,14,2,16,Clouds
59952,11,1554141600,17,13,30,Clouds
59953,12,1554141600,9,11,20,Clouds
59954,13,1554141600,23,7,30,Clouds
59955,14,1554141600,22,8,30,Clouds
59956,15,1554141600,16,0,16,Clouds
59957,16,1554141600,10,10,20,Clouds
59958,17,1554141600,20,0,20,Clouds
59959,18,1554141600,30,0,30,Clouds
59960,19,1554141600,30,0,30,Clouds
59961,21,1554141600,1,29,30,Clouds
59962,22,1554141600,3,17,20,Clouds
59963,23,1554141600,2,28,30,Clouds
59964,24,1554141600,19,1,20,Clouds
59965,25,1554141600,30,0,30,Clouds
59966,26,1554141600,7,13,20,Clouds
59967,27,1554141600,20,0,20,Clouds
59968,28,1554141600,24,6,30,Clouds
59969,29,1554141600,27,2,29,Clouds
59970,30,1554141600,20,0,20,Clouds
59971,31,1554141600,5,15,20,Clouds
59972,32,1554141600,15,15,30,Clouds
59973,33,1554141600,2,21,23,Clouds
59974,34,1554141600,0,30,30,Clouds
59975,35,1554141600,25,5,30,Clouds
59976,36,1554141600,39,1,40,Clouds
59977,37,1554141600,30,0,30,Clouds
59978,38,1554141600,30,10,40,Clouds
59979,39,1554141600,19,1,20,Clouds
59980,40,1554141600,11,10,21,Clouds
59981,41,1554141600,19,1,20,Clouds
59982,42,1554141600,26,4,30,Clouds
59983,43,1554141600,3,27,30,Clouds
59984,44,1554141600,18,12,30,Clouds
59985,45,1554141600,20,10,30,Clouds
59986,46,1554141600,19,1,20,Clouds
59987,47,1554141600,39,1,40,Clouds
59988,48,1554141600,10,30,40,Clouds
59989,49,1554141600,11,29,40,Clouds
59990,50,1554141600,30,10,40,Clouds
59991,51,1554141600,35,5,40,Clouds
59992,52,1554141600,29,3,32,Clouds
59993,53,1554141600,40,0,40,Clouds
59994,54,1554141600,33,0,33,Clouds
59995,55,1554141600,36,0,36,Clouds
59996,56,1554141600,40,0,40,Clouds
59997,57,1554141600,22,1,23,Clouds
59998,58,1554141600,40,0,40,Clouds
59999,59,1554141600,17,3,20,Clouds
60000,60,1554141600,6,24,30,Clouds
60001,61,1554141600,25,0,25,Clouds
60002,62,1554141600,39,1,40,Clouds
60003,63,1554141600,15,20,35,Clouds
60004,64,1554141600,14,26,40,Clouds
60005,65,1554141600,37,3,40,Clouds
60006,66,1554141600,38,2,40,Clouds
60007,67,1554141600,25,15,40,Clouds
60008,68,1554141600,23,17,40,Clouds
60009,69,1554141600,17,23,40,Clouds
60010,70,1554141600,13,15,28,Clouds
60011,71,1554141600,35,5,40,Clouds
60012,72,1554141600,12,19,31,Clouds
60013,73,1554141600,28,2,30,Clouds
60014,74,1554141600,20,10,30,Clouds
60015,75,1554141600,17,23,40,Clouds
60016,76,1554141600,17,21,38,Clouds
60017,77,1554141600,25,4,29,Clouds
60018,78,1554141600,31,9,40,Clouds
60019,79,1554141600,24,3,27,Clouds
60020,80,1554141600,28,12,40,Clouds
60021,81,1554141600,40,0,40,Clouds
60022,82,1554141600,17,5,22,Clouds
60023,83,1554141600,27,13,40,Clouds
60024,84,1554141600,22,8,30,Clouds
60025,85,1554141600,26,9,35,Clouds
60026,86,1554141600,20,18,38,Clouds
60027,87,1554141600,33,5,38,Clouds
60028,88,1554141600,19,11,30,Clouds
60029,89,1554141600,40,0,40,Clouds
60030,90,1554141600,38,2,40,Clouds
60031,91,1554141600,16,14,30,Clouds
60032,92,1554141600,8,32,40,Clouds
60033,93,1554141600,0,40,40,Clouds
60034,94,1554141600,16,24,40,Clouds
60035,95,1554141600,21,19,40,Clouds
60036,96,1554141600,25,5,30,Clouds
60037,97,1554141600,30,10,40,Clouds
60038,98,1554141600,24,16,40,Clouds
60039,99,1554141600,25,5,30,Clouds
60040,100,1554141600,0,25,25,Clouds
60041,101,1554141600,26,4,30,Clouds
60042,102,1554141600,39,1,40,Clouds
60043,103,1554141600,38,2,40,Clouds
60044,104,1554141600,36,4,40,Clouds
60045,105,1554141600,35,1,36,Clouds
60046,106,1554141600,36,4,40,Clouds
60047,107,1554141600,32,8,40,Clouds
60048,108,1554141600,31,9,40,Clouds
60049,109,1554141600,26,3,29,Clouds
60050,110,1554141600,38,2,40,Clouds
60051,111,1554141600,37,3,40,Clouds
60052,112,1554141600,25,5,30,Clouds
60053,113,1554141600,21,19,40,Clouds
60054,114,1554141600,39,1,40,Clouds
60055,115,1554141600,19,11,30,Clouds
60056,2,1554145200,17,3,20,Rain
60057,3,1554145200,20,0,20,Rain
60058,4,1554145200,19,1,20,Rain
60059,5,1554145200,10,30,40,Rain
60060,6,1554145200,19,1,20,Rain
60061,7,1554145200,7,22,29,Rain
60062,8,1554145200,30,0,30,Rain
60063,9,1554145200,22,2,24,Rain
60064,10,1554145200,13,3,16,Rain
60065,11,1554145200,30,0,30,Rain
60066,12,1554145200,8,12,20,Rain
60067,13,1554145200,28,2,30,Rain
60068,14,1554145200,14,16,30,Rain
60069,15,1554145200,14,2,16,Rain
60070,16,1554145200,14,6,20,Rain
60071,17,1554145200,18,2,20,Rain
60072,18,1554145200,19,11,30,Rain
60073,19,1554145200,22,8,30,Rain
60074,21,1554145200,2,28,30,Rain
60075,22,1554145200,2,18,20,Rain
60076,23,1554145200,19,11,30,Rain
60077,24,1554145200,19,1,20,Rain
60078,25,1554145200,30,0,30,Rain
60079,26,1554145200,16,4,20,Rain
60080,27,1554145200,19,1,20,Rain
60081,28,1554145200,18,12,30,Rain
60082,29,1554145200,22,7,29,Rain
60083,30,1554145200,20,0,20,Rain
60084,31,1554145200,1,19,20,Rain
60085,32,1554145200,17,13,30,Rain
60086,33,1554145200,22,1,23,Rain
60087,34,1554145200,0,30,30,Rain
60088,35,1554145200,19,11,30,Rain
60089,36,1554145200,40,0,40,Rain
60090,37,1554145200,30,0,30,Rain
60091,38,1554145200,37,3,40,Rain
60092,39,1554145200,11,9,20,Rain
60093,40,1554145200,13,8,21,Rain
60094,41,1554145200,20,0,20,Rain
60095,42,1554145200,11,19,30,Rain
60096,43,1554145200,10,20,30,Rain
60097,44,1554145200,6,24,30,Rain
60098,45,1554145200,16,14,30,Rain
60099,46,1554145200,15,5,20,Rain
60100,47,1554145200,40,0,40,Rain
60101,48,1554145200,9,31,40,Rain
60102,49,1554145200,24,16,40,Rain
60103,50,1554145200,9,31,40,Rain
60104,51,1554145200,40,0,40,Rain
60105,52,1554145200,32,0,32,Rain
60106,53,1554145200,40,0,40,Rain
60107,54,1554145200,33,0,33,Rain
60108,55,1554145200,36,0,36,Rain
60109,56,1554145200,34,6,40,Rain
60110,57,1554145200,22,1,23,Rain
60111,58,1554145200,40,0,40,Rain
60112,59,1554145200,17,3,20,Rain
60113,60,1554145200,8,22,30,Rain
60114,61,1554145200,20,5,25,Rain
60115,62,1554145200,40,0,40,Rain
60116,63,1554145200,29,6,35,Rain
60117,64,1554145200,22,18,40,Rain
60118,65,1554145200,40,0,40,Rain
60119,66,1554145200,35,5,40,Rain
60120,67,1554145200,31,9,40,Rain
60121,68,1554145200,21,19,40,Rain
60122,69,1554145200,37,3,40,Rain
60123,70,1554145200,26,2,28,Rain
60124,71,1554145200,35,5,40,Rain
60125,72,1554145200,9,22,31,Rain
60126,73,1554145200,20,10,30,Rain
60127,74,1554145200,14,16,30,Rain
60128,75,1554145200,2,38,40,Rain
60129,76,1554145200,18,20,38,Rain
60130,77,1554145200,29,0,29,Rain
60131,78,1554145200,32,8,40,Rain
60132,79,1554145200,23,4,27,Rain
60133,80,1554145200,20,20,40,Rain
60134,81,1554145200,22,18,40,Rain
60135,82,1554145200,11,11,22,Rain
60136,83,1554145200,18,22,40,Rain
60137,84,1554145200,19,11,30,Rain
60138,85,1554145200,14,20,34,Rain
60139,86,1554145200,1,37,38,Rain
60140,87,1554145200,29,9,38,Rain
60141,88,1554145200,14,16,30,Rain
60142,89,1554145200,39,1,40,Rain
60143,90,1554145200,32,8,40,Rain
60144,91,1554145200,0,30,30,Rain
60145,92,1554145200,0,40,40,Rain
60146,93,1554145200,0,40,40,Rain
60147,94,1554145200,5,35,40,Rain
60148,95,1554145200,18,22,40,Rain
60149,96,1554145200,22,8,30,Rain
60150,97,1554145200,22,18,40,Rain
60151,98,1554145200,40,0,40,Rain
60152,99,1554145200,30,0,30,Rain
60153,100,1554145200,7,18,25,Rain
60154,101,1554145200,18,12,30,Rain
60155,102,1554145200,36,4,40,Rain
60156,103,1554145200,39,1,40,Rain
60157,104,1554145200,38,2,40,Rain
60158,105,1554145200,35,1,36,Rain
60159,106,1554145200,36,4,40,Rain
60160,107,1554145200,28,12,40,Rain
60161,108,1554145200,28,12,40,Rain
60162,109,1554145200,27,2,29,Rain
60163,110,1554145200,37,3,40,Rain
60164,111,1554145200,32,8,40,Rain
60165,112,1554145200,6,24,30,Rain
60166,113,1554145200,34,6,40,Rain
60167,114,1554145200,40,0,40,Rain
60168,115,1554145200,8,22,30,Rain
60169,2,1554148800,18,2,20,Rain
60170,3,1554148800,17,3,20,Rain
60171,4,1554148800,17,3,20,Rain
60172,5,1554148800,3,37,40,Rain
60173,6,1554148800,18,2,20,Rain
60174,7,1554148800,7,22,29,Rain
60175,8,1554148800,26,4,30,Rain
60176,9,1554148800,23,1,24,Rain
60177,10,1554148800,9,7,16,Rain
60178,11,1554148800,24,6,30,Rain
60179,12,1554148800,6,14,20,Rain
60180,13,1554148800,30,0,30,Rain
60181,14,1554148800,15,15,30,Rain
60182,15,1554148800,13,3,16,Rain
60183,16,1554148800,20,0,20,Rain
60184,17,1554148800,18,2,20,Rain
60185,18,1554148800,17,13,30,Rain
60186,19,1554148800,30,0,30,Rain
60187,21,1554148800,14,16,30,Rain
60188,22,1554148800,9,11,20,Rain
60189,23,1554148800,20,10,30,Rain
60190,24,1554148800,14,6,20,Rain
60191,25,1554148800,30,0,30,Rain
60192,26,1554148800,14,6,20,Rain
60193,27,1554148800,20,0,20,Rain
60194,28,1554148800,11,19,30,Rain
60195,29,1554148800,27,2,29,Rain
60196,30,1554148800,20,0,20,Rain
60197,31,1554148800,6,14,20,Rain
60198,32,1554148800,26,4,30,Rain
60199,33,1554148800,18,5,23,Rain
60200,34,1554148800,0,30,30,Rain
60201,35,1554148800,13,17,30,Rain
60202,36,1554148800,40,0,40,Rain
60203,37,1554148800,30,0,30,Rain
60204,38,1554148800,38,2,40,Rain
60205,39,1554148800,20,0,20,Rain
60206,40,1554148800,19,2,21,Rain
60207,41,1554148800,18,2,20,Rain
60208,42,1554148800,4,26,30,Rain
60209,43,1554148800,0,30,30,Rain
60210,44,1554148800,3,27,30,Rain
60211,45,1554148800,18,12,30,Rain
60212,46,1554148800,15,5,20,Rain
60213,47,1554148800,40,0,40,Rain
60214,48,1554148800,15,25,40,Rain
60215,49,1554148800,33,7,40,Rain
60216,50,1554148800,4,36,40,Rain
60217,51,1554148800,40,0,40,Rain
60218,52,1554148800,32,0,32,Rain
60219,53,1554148800,40,0,40,Rain
60220,54,1554148800,33,0,33,Rain
60221,55,1554148800,36,0,36,Rain
60222,56,1554148800,38,2,40,Rain
60223,57,1554148800,20,3,23,Rain
60224,58,1554148800,28,12,40,Rain
60225,59,1554148800,20,0,20,Rain
60226,60,1554148800,19,11,30,Rain
60227,61,1554148800,19,6,25,Rain
60228,62,1554148800,40,0,40,Rain
60229,63,1554148800,35,0,35,Rain
60230,64,1554148800,27,13,40,Rain
60231,65,1554148800,40,0,40,Rain
60232,66,1554148800,36,4,40,Rain
60233,67,1554148800,28,12,40,Rain
60234,68,1554148800,27,13,40,Rain
60235,69,1554148800,37,3,40,Rain
60236,70,1554148800,19,9,28,Rain
60237,71,1554148800,32,8,40,Rain
60238,72,1554148800,3,28,31,Rain
60239,73,1554148800,13,17,30,Rain
60240,74,1554148800,13,17,30,Rain
60241,75,1554148800,0,40,40,Rain
60242,76,1554148800,19,19,38,Rain
60243,77,1554148800,28,1,29,Rain
60244,78,1554148800,31,9,40,Rain
60245,79,1554148800,21,6,27,Rain
60246,80,1554148800,15,25,40,Rain
60247,81,1554148800,22,18,40,Rain
60248,82,1554148800,8,14,22,Rain
60249,83,1554148800,11,29,40,Rain
60250,84,1554148800,14,16,30,Rain
60251,85,1554148800,10,24,34,Rain
60252,86,1554148800,1,37,38,Rain
60253,87,1554148800,27,11,38,Rain
60254,88,1554148800,13,17,30,Rain
60255,89,1554148800,39,1,40,Rain
60256,90,1554148800,38,2,40,Rain
60257,91,1554148800,17,13,30,Rain
60258,92,1554148800,10,30,40,Rain
60259,93,1554148800,0,40,40,Rain
60260,94,1554148800,5,35,40,Rain
60261,95,1554148800,10,30,40,Rain
60262,96,1554148800,19,11,30,Rain
60263,97,1554148800,17,23,40,Rain
60264,98,1554148800,40,0,40,Rain
60265,99,1554148800,29,1,30,Rain
60266,100,1554148800,5,20,25,Rain
60267,101,1554148800,17,13,30,Rain
60268,102,1554148800,35,5,40,Rain
60269,103,1554148800,24,16,40,Rain
60270,104,1554148800,39,1,40,Rain
60271,105,1554148800,34,2,36,Rain
60272,106,1554148800,35,5,40,Rain
60273,107,1554148800,27,13,40,Rain
60274,108,1554148800,29,11,40,Rain
60275,109,1554148800,26,3,29,Rain
60276,110,1554148800,37,3,40,Rain
60277,111,1554148800,28,12,40,Rain
60278,112,1554148800,1,29,30,Rain
60279,113,1554148800,27,13,40,Rain
60280,114,1554148800,39,1,40,Rain
60281,115,1554148800,0,30,30,Rain
60282,2,1554152400,16,4,20,Rain
60283,3,1554152400,18,2,20,Rain
60284,4,1554152400,13,7,20,Rain
60285,5,1554152400,0,40,40,Rain
60286,6,1554152400,20,0,20,Rain
60287,7,1554152400,11,18,29,Rain
60288,8,1554152400,29,1,30,Rain
60289,9,1554152400,24,0,24,Rain
60290,10,1554152400,12,4,16,Rain
60291,11,1554152400,26,4,30,Rain
60292,12,1554152400,6,13,19,Rain
60293,13,1554152400,27,3,30,Rain
60294,14,1554152400,20,10,30,Rain
60295,15,1554152400,13,3,16,Rain
60296,16,1554152400,20,0,20,Rain
60297,17,1554152400,18,2,20,Rain
60298,18,1554152400,7,23,30,Rain
60299,19,1554152400,30,0,30,Rain
60300,21,1554152400,20,10,30,Rain
60301,22,1554152400,12,8,20,Rain
60302,23,1554152400,17,13,30,Rain
60303,24,1554152400,19,1,20,Rain
60304,25,1554152400,30,0,30,Rain
60305,26,1554152400,16,4,20,Rain
60306,27,1554152400,20,0,20,Rain
60307,28,1554152400,12,18,30,Rain
60308,29,1554152400,26,3,29,Rain
60309,30,1554152400,19,1,20,Rain
60310,31,1554152400,13,7,20,Rain
60311,32,1554152400,25,5,30,Rain
60312,33,1554152400,16,7,23,Rain
60313,34,1554152400,1,29,30,Rain
60314,35,1554152400,8,22,30,Rain
60315,36,1554152400,40,0,40,Rain
60316,37,1554152400,30,0,30,Rain
60317,38,1554152400,37,3,40,Rain
60318,39,1554152400,19,1,20,Rain
60319,40,1554152400,19,2,21,Rain
60320,41,1554152400,15,5,20,Rain
60321,42,1554152400,1,29,30,Rain
60322,43,1554152400,1,29,30,Rain
60323,44,1554152400,2,28,30,Rain
60324,45,1554152400,18,12,30,Rain
60325,46,1554152400,19,1,20,Rain
60326,47,1554152400,39,1,40,Rain
60327,48,1554152400,21,19,40,Rain
60328,49,1554152400,33,7,40,Rain
60329,50,1554152400,5,35,40,Rain
60330,51,1554152400,40,0,40,Rain
60331,52,1554152400,32,0,32,Rain
60332,53,1554152400,40,0,40,Rain
60333,54,1554152400,33,0,33,Rain
60334,55,1554152400,36,0,36,Rain
60335,56,1554152400,34,6,40,Rain
60336,57,1554152400,20,3,23,Rain
60337,58,1554152400,27,13,40,Rain
60338,59,1554152400,20,0,20,Rain
60339,60,1554152400,6,24,30,Rain
60340,61,1554152400,20,5,25,Rain
60341,62,1554152400,38,2,40,Rain
60342,63,1554152400,35,0,35,Rain
60343,64,1554152400,31,9,40,Rain
60344,65,1554152400,39,1,40,Rain
60345,66,1554152400,37,3,40,Rain
60346,67,1554152400,23,17,40,Rain
60347,68,1554152400,33,7,40,Rain
60348,69,1554152400,31,9,40,Rain
60349,70,1554152400,14,14,28,Rain
60350,71,1554152400,40,0,40,Rain
60351,72,1554152400,2,29,31,Rain
60352,73,1554152400,11,19,30,Rain
60353,74,1554152400,11,19,30,Rain
60354,75,1554152400,0,40,40,Rain
60355,76,1554152400,17,21,38,Rain
60356,77,1554152400,25,4,29,Rain
60357,78,1554152400,31,9,40,Rain
60358,79,1554152400,21,6,27,Rain
60359,80,1554152400,17,23,40,Rain
60360,81,1554152400,23,17,40,Rain
60361,82,1554152400,9,13,22,Rain
60362,83,1554152400,8,32,40,Rain
60363,84,1554152400,12,18,30,Rain
60364,85,1554152400,7,27,34,Rain
60365,86,1554152400,2,36,38,Rain
60366,87,1554152400,24,14,38,Rain
60367,88,1554152400,10,20,30,Rain
60368,89,1554152400,38,2,40,Rain
60369,90,1554152400,40,0,40,Rain
60370,91,1554152400,26,4,30,Rain
60371,92,1554152400,12,28,40,Rain
60372,93,1554152400,0,40,40,Rain
60373,94,1554152400,5,35,40,Rain
60374,95,1554152400,4,36,40,Rain
60375,96,1554152400,19,11,30,Rain
60376,97,1554152400,16,24,40,Rain
60377,98,1554152400,40,0,40,Rain
60378,99,1554152400,30,0,30,Rain
60379,100,1554152400,3,22,25,Rain
60380,101,1554152400,11,19,30,Rain
60381,102,1554152400,36,4,40,Rain
60382,103,1554152400,25,15,40,Rain
60383,104,1554152400,39,1,40,Rain
60384,105,1554152400,33,3,36,Rain
60385,106,1554152400,35,5,40,Rain
60386,107,1554152400,25,15,40,Rain
60387,108,1554152400,27,13,40,Rain
60388,109,1554152400,21,8,29,Rain
60389,110,1554152400,36,4,40,Rain
60390,111,1554152400,23,17,40,Rain
60391,112,1554152400,0,30,30,Rain
60392,113,1554152400,28,12,40,Rain
60393,114,1554152400,37,3,40,Rain
60394,115,1554152400,0,30,30,Rain
60395,2,1554156000,14,6,20,Rain
60396,3,1554156000,20,0,20,Rain
60397,4,1554156000,14,6,20,Rain
60398,5,1554156000,14,26,40,Rain
60399,6,1554156000,20,0,20,Rain
60400,7,1554156000,12,17,29,Rain
60401,8,1554156000,30,0,30,Rain
60402,9,1554156000,24,0,24,Rain
60403,10,1554156000,15,1,16,Rain
60404,11,1554156000,24,6,30,Rain
60405,12,1554156000,4,15,19,Rain
60406,13,1554156000,26,4,30,Rain
60407,14,1554156000,28,2,30,Rain
60408,15,1554156000,12,4,16,Rain
60409,16,1554156000,20,0,20,Rain
60410,17,1554156000,20,0,20,Rain
60411,18,1554156000,9,21,30,Rain
60412,19,1554156000,28,2,30,Rain
60413,21,1554156000,29,1,30,Rain
60414,22,1554156000,16,4,20,Rain
60415,23,1554156000,21,9,30,Rain
60416,24,1554156000,15,5,20,Rain
60417,25,1554156000,19,11,30,Rain
60418,26,1554156000,17,3,20,Rain
60419,27,1554156000,20,0,20,Rain
60420,28,1554156000,11,19,30,Rain
60421,29,1554156000,29,0,29,Rain
60422,30,1554156000,19,1,20,Rain
60423,31,1554156000,12,8,20,Rain
60424,32,1554156000,27,3,30,Rain
60425,33,1554156000,21,2,23,Rain
60426,34,1554156000,7,23,30,Rain
60427,35,1554156000,4,26,30,Rain
60428,36,1554156000,31,9,40,Rain
60429,37,1554156000,22,8,30,Rain
60430,38,1554156000,39,1,40,Rain
60431,39,1554156000,16,4,20,Rain
60432,40,1554156000,20,1,21,Rain
60433,41,1554156000,15,5,20,Rain
60434,42,1554156000,1,29,30,Rain
60435,43,1554156000,9,21,30,Rain
60436,44,1554156000,1,29,30,Rain
60437,45,1554156000,18,12,30,Rain
60438,46,1554156000,20,0,20,Rain
60439,47,1554156000,40,0,40,Rain
60440,48,1554156000,26,14,40,Rain
60441,49,1554156000,34,6,40,Rain
60442,50,1554156000,2,38,40,Rain
60443,51,1554156000,40,0,40,Rain
60444,52,1554156000,32,0,32,Rain
60445,53,1554156000,40,0,40,Rain
60446,54,1554156000,33,0,33,Rain
60447,55,1554156000,36,0,36,Rain
60448,56,1554156000,35,5,40,Rain
60449,57,1554156000,18,5,23,Rain
60450,58,1554156000,28,12,40,Rain
60451,59,1554156000,20,0,20,Rain
60452,60,1554156000,2,28,30,Rain
60453,61,1554156000,19,6,25,Rain
60454,62,1554156000,38,2,40,Rain
60455,63,1554156000,35,0,35,Rain
60456,64,1554156000,32,8,40,Rain
60457,65,1554156000,40,0,40,Rain
60458,66,1554156000,38,2,40,Rain
60459,67,1554156000,21,19,40,Rain
60460,68,1554156000,34,6,40,Rain
60461,69,1554156000,29,11,40,Rain
60462,70,1554156000,14,14,28,Rain
60463,71,1554156000,40,0,40,Rain
60464,72,1554156000,1,30,31,Rain
60465,73,1554156000,15,15,30,Rain
60466,74,1554156000,8,22,30,Rain
60467,75,1554156000,1,39,40,Rain
60468,76,1554156000,14,24,38,Rain
60469,77,1554156000,23,6,29,Rain
60470,78,1554156000,31,9,40,Rain
60471,79,1554156000,21,6,27,Rain
60472,80,1554156000,20,20,40,Rain
60473,81,1554156000,26,14,40,Rain
60474,82,1554156000,7,15,22,Rain
60475,83,1554156000,3,37,40,Rain
60476,84,1554156000,9,21,30,Rain
60477,85,1554156000,3,31,34,Rain
60478,86,1554156000,1,37,38,Rain
60479,87,1554156000,24,14,38,Rain
60480,88,1554156000,9,21,30,Rain
60481,89,1554156000,40,0,40,Rain
60482,90,1554156000,39,1,40,Rain
60483,91,1554156000,24,6,30,Rain
60484,92,1554156000,18,22,40,Rain
60485,93,1554156000,0,40,40,Rain
60486,94,1554156000,5,35,40,Rain
60487,95,1554156000,4,36,40,Rain
60488,96,1554156000,19,11,30,Rain
60489,97,1554156000,13,27,40,Rain
60490,98,1554156000,40,0,40,Rain
60491,99,1554156000,30,0,30,Rain
60492,100,1554156000,5,20,25,Rain
60493,101,1554156000,9,21,30,Rain
60494,102,1554156000,37,3,40,Rain
60495,103,1554156000,25,15,40,Rain
60496,104,1554156000,39,1,40,Rain
60497,105,1554156000,33,3,36,Rain
60498,106,1554156000,17,23,40,Rain
60499,107,1554156000,24,16,40,Rain
60500,108,1554156000,26,14,40,Rain
60501,109,1554156000,16,13,29,Rain
60502,110,1554156000,36,4,40,Rain
60503,111,1554156000,17,23,40,Rain
60504,112,1554156000,0,30,30,Rain
60505,113,1554156000,30,10,40,Rain
60506,114,1554156000,36,4,40,Rain
60507,115,1554156000,1,29,30,Rain
60508,2,1554159600,11,9,20,Rain
60509,3,1554159600,17,3,20,Rain
60510,4,1554159600,14,6,20,Rain
60511,5,1554159600,9,31,40,Rain
60512,6,1554159600,20,0,20,Rain
60513,7,1554159600,16,13,29,Rain
60514,8,1554159600,28,2,30,Rain
60515,9,1554159600,16,8,24,Rain
60516,10,1554159600,16,0,16,Rain
60517,11,1554159600,26,4,30,Rain
60518,12,1554159600,2,17,19,Rain
60519,13,1554159600,30,0,30,Rain
60520,14,1554159600,21,9,30,Rain
60521,15,1554159600,13,3,16,Rain
60522,16,1554159600,20,0,20,Rain
60523,17,1554159600,20,0,20,Rain
60524,18,1554159600,6,24,30,Rain
60525,19,1554159600,29,1,30,Rain
60526,21,1554159600,28,2,30,Rain
60527,22,1554159600,19,0,19,Rain
60528,23,1554159600,22,8,30,Rain
60529,24,1554159600,17,3,20,Rain
60530,25,1554159600,19,11,30,Rain
60531,26,1554159600,19,1,20,Rain
60532,27,1554159600,20,0,20,Rain
60533,28,1554159600,9,21,30,Rain
60534,29,1554159600,27,2,29,Rain
60535,30,1554159600,19,1,20,Rain
60536,31,1554159600,17,3,20,Rain
60537,32,1554159600,28,2,30,Rain
60538,33,1554159600,23,0,23,Rain
60539,34,1554159600,3,27,30,Rain
60540,35,1554159600,4,26,30,Rain
60541,36,1554159600,31,9,40,Rain
60542,37,1554159600,24,6,30,Rain
60543,38,1554159600,38,2,40,Rain
60544,39,1554159600,18,2,20,Rain
60545,40,1554159600,19,2,21,Rain
60546,41,1554159600,16,4,20,Rain
60547,42,1554159600,4,26,30,Rain
60548,43,1554159600,5,25,30,Rain
60549,44,1554159600,2,28,30,Rain
60550,45,1554159600,17,13,30,Rain
60551,46,1554159600,20,0,20,Rain
60552,47,1554159600,40,0,40,Rain
60553,48,1554159600,27,13,40,Rain
60554,49,1554159600,36,4,40,Rain
60555,50,1554159600,1,39,40,Rain
60556,51,1554159600,40,0,40,Rain
60557,52,1554159600,31,1,32,Rain
60558,53,1554159600,40,0,40,Rain
60559,54,1554159600,33,0,33,Rain
60560,55,1554159600,36,0,36,Rain
60561,56,1554159600,36,4,40,Rain
60562,57,1554159600,19,4,23,Rain
60563,58,1554159600,27,13,40,Rain
60564,59,1554159600,20,0,20,Rain
60565,60,1554159600,0,30,30,Rain
60566,61,1554159600,20,5,25,Rain
60567,62,1554159600,38,2,40,Rain
60568,63,1554159600,35,0,35,Rain
60569,64,1554159600,34,6,40,Rain
60570,65,1554159600,40,0,40,Rain
60571,66,1554159600,39,1,40,Rain
60572,67,1554159600,19,21,40,Rain
60573,68,1554159600,35,5,40,Rain
60574,69,1554159600,31,9,40,Rain
60575,70,1554159600,17,11,28,Rain
60576,71,1554159600,39,1,40,Rain
60577,72,1554159600,3,28,31,Rain
60578,73,1554159600,13,17,30,Rain
60579,74,1554159600,9,21,30,Rain
60580,75,1554159600,0,40,40,Rain
60581,76,1554159600,11,27,38,Rain
60582,77,1554159600,25,4,29,Rain
60583,78,1554159600,11,29,40,Rain
60584,79,1554159600,21,6,27,Rain
60585,80,1554159600,19,21,40,Rain
60586,81,1554159600,24,16,40,Rain
60587,82,1554159600,7,15,22,Rain
60588,83,1554159600,7,33,40,Rain
60589,84,1554159600,9,21,30,Rain
60590,85,1554159600,7,28,35,Rain
60591,86,1554159600,2,36,38,Rain
60592,87,1554159600,24,14,38,Rain
60593,88,1554159600,8,22,30,Rain
60594,89,1554159600,39,1,40,Rain
60595,90,1554159600,39,1,40,Rain
60596,91,1554159600,27,3,30,Rain
60597,92,1554159600,15,25,40,Rain
60598,93,1554159600,0,40,40,Rain
60599,94,1554159600,5,35,40,Rain
60600,95,1554159600,3,37,40,Rain
60601,96,1554159600,19,11,30,Rain
60602,97,1554159600,8,32,40,Rain
60603,98,1554159600,40,0,40,Rain
60604,99,1554159600,30,0,30,Rain
60605,100,1554159600,4,21,25,Rain
60606,101,1554159600,7,23,30,Rain
60607,102,1554159600,35,5,40,Rain
60608,103,1554159600,27,13,40,Rain
60609,104,1554159600,39,1,40,Rain
60610,105,1554159600,33,3,36,Rain
60611,106,1554159600,17,23,40,Rain
60612,107,1554159600,21,19,40,Rain
60613,108,1554159600,26,14,40,Rain
60614,109,1554159600,8,21,29,Rain
60615,110,1554159600,36,4,40,Rain
60616,111,1554159600,12,28,40,Rain
60617,112,1554159600,0,30,30,Rain
60618,113,1554159600,31,9,40,Rain
60619,114,1554159600,38,2,40,Rain
60620,115,1554159600,3,27,30,Rain
60621,2,1554163200,10,10,20,Clouds
60622,3,1554163200,18,2,20,Clouds
60623,4,1554163200,14,6,20,Clouds
60624,5,1554163200,10,30,40,Clouds
60625,6,1554163200,19,1,20,Clouds
60626,7,1554163200,16,13,29,Clouds
60627,8,1554163200,27,3,30,Clouds
60628,9,1554163200,24,0,24,Clouds
60629,10,1554163200,15,1,16,Clouds
60630,11,1554163200,26,4,30,Clouds
60631,12,1554163200,3,16,19,Clouds
60632,13,1554163200,30,0,30,Clouds
60633,14,1554163200,23,7,30,Clouds
60634,15,1554163200,13,3,16,Clouds
60635,16,1554163200,20,0,20,Clouds
60636,17,1554163200,20,0,20,Clouds
60637,18,1554163200,17,13,30,Clouds
60638,19,1554163200,29,1,30,Clouds
60639,21,1554163200,30,0,30,Clouds
60640,22,1554163200,18,1,19,Clouds
60641,23,1554163200,24,6,30,Clouds
60642,24,1554163200,20,0,20,Clouds
60643,25,1554163200,19,11,30,Clouds
60644,26,1554163200,17,3,20,Clouds
60645,27,1554163200,20,0,20,Clouds
60646,28,1554163200,8,22,30,Clouds
60647,29,1554163200,29,0,29,Clouds
60648,30,1554163200,18,2,20,Clouds
60649,31,1554163200,19,1,20,Clouds
60650,32,1554163200,30,0,30,Clouds
60651,33,1554163200,23,0,23,Clouds
60652,34,1554163200,5,25,30,Clouds
60653,35,1554163200,5,25,30,Clouds
60654,36,1554163200,31,9,40,Clouds
60655,37,1554163200,26,4,30,Clouds
60656,38,1554163200,35,5,40,Clouds
60657,39,1554163200,20,0,20,Clouds
60658,40,1554163200,21,0,21,Clouds
60659,41,1554163200,16,4,20,Clouds
60660,42,1554163200,3,27,30,Clouds
60661,43,1554163200,13,17,30,Clouds
60662,44,1554163200,1,29,30,Clouds
60663,45,1554163200,15,15,30,Clouds
60664,46,1554163200,20,0,20,Clouds
60665,47,1554163200,40,0,40,Clouds
60666,48,1554163200,30,10,40,Clouds
60667,49,1554163200,34,6,40,Clouds
60668,50,1554163200,0,40,40,Clouds
60669,51,1554163200,40,0,40,Clouds
60670,52,1554163200,29,3,32,Clouds
60671,53,1554163200,40,0,40,Clouds
60672,54,1554163200,33,0,33,Clouds
60673,55,1554163200,36,0,36,Clouds
60674,56,1554163200,35,5,40,Clouds
60675,57,1554163200,19,4,23,Clouds
60676,58,1554163200,28,12,40,Clouds
60677,59,1554163200,20,0,20,Clouds
60678,60,1554163200,0,30,30,Clouds
60679,61,1554163200,20,5,25,Clouds
60680,62,1554163200,40,0,40,Clouds
60681,63,1554163200,35,0,35,Clouds
60682,64,1554163200,33,7,40,Clouds
60683,65,1554163200,38,2,40,Clouds
60684,66,1554163200,38,2,40,Clouds
60685,67,1554163200,19,21,40,Clouds
60686,68,1554163200,38,2,40,Clouds
60687,69,1554163200,31,9,40,Clouds
60688,70,1554163200,17,11,28,Clouds
60689,71,1554163200,39,1,40,Clouds
60690,72,1554163200,4,27,31,Clouds
60691,73,1554163200,10,20,30,Clouds
60692,74,1554163200,10,20,30,Clouds
60693,75,1554163200,0,40,40,Clouds
60694,76,1554163200,8,30,38,Clouds
60695,77,1554163200,22,7,29,Clouds
60696,78,1554163200,9,31,40,Clouds
60697,79,1554163200,21,6,27,Clouds
60698,80,1554163200,18,22,40,Clouds
60699,81,1554163200,24,16,40,Clouds
60700,82,1554163200,6,16,22,Clouds
60701,83,1554163200,5,35,40,Clouds
60702,84,1554163200,9,21,30,Clouds
60703,85,1554163200,6,29,35,Clouds
60704,86,1554163200,3,35,38,Clouds
60705,87,1554163200,23,15,38,Clouds
60706,88,1554163200,8,22,30,Clouds
60707,89,1554163200,39,1,40,Clouds
60708,90,1554163200,38,2,40,Clouds
60709,91,1554163200,27,3,30,Clouds
60710,92,1554163200,15,25,40,Clouds
60711,93,1554163200,0,40,40,Clouds
60712,94,1554163200,5,35,40,Clouds
60713,95,1554163200,3,37,40,Clouds
60714,96,1554163200,18,12,30,Clouds
60715,97,1554163200,8,32,40,Clouds
60716,98,1554163200,40,0,40,Clouds
60717,99,1554163200,30,0,30,Clouds
60718,100,1554163200,7,18,25,Clouds
60719,101,1554163200,7,23,30,Clouds
60720,102,1554163200,34,6,40,Clouds
60721,103,1554163200,27,13,40,Clouds
60722,104,1554163200,39,1,40,Clouds
60723,105,1554163200,33,3,36,Clouds
60724,106,1554163200,15,25,40,Clouds
60725,107,1554163200,18,22,40,Clouds
60726,108,1554163200,25,15,40,Clouds
60727,109,1554163200,15,14,29,Clouds
60728,110,1554163200,37,3,40,Clouds
60729,111,1554163200,6,34,40,Clouds
60730,112,1554163200,0,30,30,Clouds
60731,113,1554163200,32,8,40,Clouds
60732,114,1554163200,39,1,40,Clouds
60733,115,1554163200,10,20,30,Clouds
60734,2,1554166800,10,10,20,Clouds
60735,3,1554166800,16,4,20,Clouds
60736,4,1554166800,14,6,20,Clouds
60737,5,1554166800,10,30,40,Clouds
60738,6,1554166800,18,2,20,Clouds
60739,7,1554166800,16,13,29,Clouds
60740,8,1554166800,27,3,30,Clouds
60741,9,1554166800,22,2,24,Clouds
60742,10,1554166800,16,0,16,Clouds
60743,11,1554166800,26,4,30,Clouds
60744,12,1554166800,3,16,19,Clouds
60745,13,1554166800,30,0,30,Clouds
60746,14,1554166800,25,5,30,Clouds
60747,15,1554166800,13,3,16,Clouds
60748,16,1554166800,20,0,20,Clouds
60749,17,1554166800,20,0,20,Clouds
60750,18,1554166800,17,13,30,Clouds
60751,19,1554166800,29,1,30,Clouds
60752,21,1554166800,30,0,30,Clouds
60753,22,1554166800,19,0,19,Clouds
60754,23,1554166800,24,6,30,Clouds
60755,24,1554166800,19,1,20,Clouds
60756,25,1554166800,19,11,30,Clouds
60757,26,1554166800,17,3,20,Clouds
60758,27,1554166800,20,0,20,Clouds
60759,28,1554166800,8,22,30,Clouds
60760,29,1554166800,28,1,29,Clouds
60761,30,1554166800,18,2,20,Clouds
60762,31,1554166800,20,0,20,Clouds
60763,32,1554166800,30,0,30,Clouds
60764,33,1554166800,23,0,23,Clouds
60765,34,1554166800,5,25,30,Clouds
60766,35,1554166800,5,25,30,Clouds
60767,36,1554166800,31,9,40,Clouds
60768,37,1554166800,26,4,30,Clouds
60769,38,1554166800,35,5,40,Clouds
60770,39,1554166800,20,0,20,Clouds
60771,40,1554166800,21,0,21,Clouds
60772,41,1554166800,16,4,20,Clouds
60773,42,1554166800,3,27,30,Clouds
60774,43,1554166800,13,17,30,Clouds
60775,44,1554166800,0,30,30,Clouds
60776,45,1554166800,15,15,30,Clouds
60777,46,1554166800,20,0,20,Clouds
60778,47,1554166800,40,0,40,Clouds
60779,48,1554166800,31,9,40,Clouds
60780,49,1554166800,34,6,40,Clouds
60781,50,1554166800,0,40,40,Clouds
60782,51,1554166800,40,0,40,Clouds
60783,52,1554166800,31,1,32,Clouds
60784,53,1554166800,40,0,40,Clouds
60785,54,1554166800,33,0,33,Clouds
60786,55,1554166800,36,0,36,Clouds
60787,56,1554166800,36,4,40,Clouds
60788,57,1554166800,19,4,23,Clouds
60789,58,1554166800,29,11,40,Clouds
60790,59,1554166800,19,1,20,Clouds
60791,60,1554166800,0,30,30,Clouds
60792,61,1554166800,20,5,25,Clouds
60793,62,1554166800,40,0,40,Clouds
60794,63,1554166800,35,0,35,Clouds
60795,64,1554166800,35,5,40,Clouds
60796,65,1554166800,38,2,40,Clouds
60797,66,1554166800,38,2,40,Clouds
60798,67,1554166800,20,20,40,Clouds
60799,68,1554166800,38,2,40,Clouds
60800,69,1554166800,31,9,40,Clouds
60801,70,1554166800,16,12,28,Clouds
60802,71,1554166800,39,1,40,Clouds
60803,72,1554166800,4,27,31,Clouds
60804,73,1554166800,8,22,30,Clouds
60805,74,1554166800,10,20,30,Clouds
60806,75,1554166800,1,39,40,Clouds
60807,76,1554166800,9,29,38,Clouds
60808,77,1554166800,23,6,29,Clouds
60809,78,1554166800,8,32,40,Clouds
60810,79,1554166800,21,6,27,Clouds
60811,80,1554166800,18,22,40,Clouds
60812,81,1554166800,24,16,40,Clouds
60813,82,1554166800,6,16,22,Clouds
60814,83,1554166800,5,35,40,Clouds
60815,84,1554166800,9,21,30,Clouds
60816,85,1554166800,6,29,35,Clouds
60817,86,1554166800,4,34,38,Clouds
60818,87,1554166800,23,15,38,Clouds
60819,88,1554166800,7,23,30,Clouds
60820,89,1554166800,39,1,40,Clouds
60821,90,1554166800,38,2,40,Clouds
60822,91,1554166800,26,4,30,Clouds
60823,92,1554166800,15,25,40,Clouds
60824,93,1554166800,0,40,40,Clouds
60825,94,1554166800,5,35,40,Clouds
60826,95,1554166800,3,37,40,Clouds
60827,96,1554166800,18,12,30,Clouds
60828,97,1554166800,6,34,40,Clouds
60829,98,1554166800,40,0,40,Clouds
60830,99,1554166800,30,0,30,Clouds
60831,100,1554166800,7,18,25,Clouds
60832,101,1554166800,7,23,30,Clouds
60833,102,1554166800,34,6,40,Clouds
60834,103,1554166800,27,13,40,Clouds
60835,104,1554166800,39,1,40,Clouds
60836,105,1554166800,33,3,36,Clouds
60837,106,1554166800,15,25,40,Clouds
60838,107,1554166800,17,23,40,Clouds
60839,108,1554166800,25,15,40,Clouds
60840,109,1554166800,15,14,29,Clouds
60841,110,1554166800,37,3,40,Clouds
60842,111,1554166800,5,35,40,Clouds
60843,112,1554166800,0,30,30,Clouds
60844,113,1554166800,32,8,40,Clouds
60845,114,1554166800,39,1,40,Clouds
60846,115,1554166800,10,20,30,Clouds
60847,2,1554170400,10,10,20,Clouds
60848,3,1554170400,16,4,20,Clouds
60849,4,1554170400,14,6,20,Clouds
60850,5,1554170400,10,30,40,Clouds
60851,6,1554170400,18,2,20,Clouds
60852,7,1554170400,16,13,29,Clouds
60853,8,1554170400,27,3,30,Clouds
60854,9,1554170400,22,2,24,Clouds
60855,10,1554170400,16,0,16,Clouds
60856,11,1554170400,26,4,30,Clouds
60857,12,1554170400,3,16,19,Clouds
60858,13,1554170400,30,0,30,Clouds
60859,14,1554170400,25,5,30,Clouds
60860,15,1554170400,13,3,16,Clouds
60861,16,1554170400,20,0,20,Clouds
60862,17,1554170400,20,0,20,Clouds
60863,18,1554170400,17,13,30,Clouds
60864,19,1554170400,29,1,30,Clouds
60865,21,1554170400,30,0,30,Clouds
60866,22,1554170400,19,0,19,Clouds
60867,23,1554170400,24,6,30,Clouds
60868,24,1554170400,19,1,20,Clouds
60869,25,1554170400,19,11,30,Clouds
60870,26,1554170400,17,3,20,Clouds
60871,27,1554170400,20,0,20,Clouds
60872,28,1554170400,7,23,30,Clouds
60873,29,1554170400,28,1,29,Clouds
60874,30,1554170400,18,2,20,Clouds
60875,31,1554170400,20,0,20,Clouds
60876,32,1554170400,30,0,30,Clouds
60877,33,1554170400,23,0,23,Clouds
60878,34,1554170400,5,25,30,Clouds
60879,35,1554170400,5,25,30,Clouds
60880,36,1554170400,31,9,40,Clouds
60881,37,1554170400,26,4,30,Clouds
60882,38,1554170400,35,5,40,Clouds
60883,39,1554170400,20,0,20,Clouds
60884,40,1554170400,21,0,21,Clouds
60885,41,1554170400,16,4,20,Clouds
60886,42,1554170400,3,27,30,Clouds
60887,43,1554170400,13,17,30,Clouds
60888,44,1554170400,0,30,30,Clouds
60889,45,1554170400,15,15,30,Clouds
60890,46,1554170400,20,0,20,Clouds
60891,47,1554170400,40,0,40,Clouds
60892,48,1554170400,31,9,40,Clouds
60893,49,1554170400,34,6,40,Clouds
60894,50,1554170400,0,40,40,Clouds
60895,51,1554170400,40,0,40,Clouds
60896,52,1554170400,31,1,32,Clouds
60897,53,1554170400,40,0,40,Clouds
60898,54,1554170400,33,0,33,Clouds
60899,55,1554170400,36,0,36,Clouds
60900,56,1554170400,36,4,40,Clouds
60901,57,1554170400,19,4,23,Clouds
60902,58,1554170400,29,11,40,Clouds
60903,59,1554170400,19,1,20,Clouds
60904,60,1554170400,0,30,30,Clouds
60905,61,1554170400,20,5,25,Clouds
60906,62,1554170400,40,0,40,Clouds
60907,63,1554170400,35,0,35,Clouds
60908,64,1554170400,35,5,40,Clouds
60909,65,1554170400,38,2,40,Clouds
60910,66,1554170400,38,2,40,Clouds
60911,67,1554170400,20,20,40,Clouds
60912,68,1554170400,38,2,40,Clouds
60913,69,1554170400,31,9,40,Clouds
60914,70,1554170400,16,12,28,Clouds
60915,71,1554170400,39,1,40,Clouds
60916,72,1554170400,4,27,31,Clouds
60917,73,1554170400,8,22,30,Clouds
60918,74,1554170400,10,20,30,Clouds
60919,75,1554170400,1,39,40,Clouds
60920,76,1554170400,9,29,38,Clouds
60921,77,1554170400,23,6,29,Clouds
60922,78,1554170400,8,32,40,Clouds
60923,79,1554170400,21,6,27,Clouds
60924,80,1554170400,18,22,40,Clouds
60925,81,1554170400,24,16,40,Clouds
60926,82,1554170400,6,16,22,Clouds
60927,83,1554170400,5,35,40,Clouds
60928,84,1554170400,9,21,30,Clouds
60929,85,1554170400,6,29,35,Clouds
60930,86,1554170400,4,34,38,Clouds
60931,87,1554170400,23,15,38,Clouds
60932,88,1554170400,7,23,30,Clouds
60933,89,1554170400,39,1,40,Clouds
60934,90,1554170400,38,2,40,Clouds
60935,91,1554170400,26,4,30,Clouds
60936,92,1554170400,15,25,40,Clouds
60937,93,1554170400,0,40,40,Clouds
60938,94,1554170400,5,35,40,Clouds
60939,95,1554170400,3,37,40,Clouds
60940,96,1554170400,18,12,30,Clouds
60941,97,1554170400,6,34,40,Clouds
60942,98,1554170400,40,0,40,Clouds
60943,99,1554170400,30,0,30,Clouds
60944,100,1554170400,7,18,25,Clouds
60945,101,1554170400,7,23,30,Clouds
60946,102,1554170400,34,6,40,Clouds
60947,103,1554170400,27,13,40,Clouds
60948,104,1554170400,39,1,40,Clouds
60949,105,1554170400,33,3,36,Clouds
60950,106,1554170400,15,25,40,Clouds
60951,107,1554170400,17,23,40,Clouds
60952,108,1554170400,25,15,40,Clouds
60953,109,1554170400,15,14,29,Clouds
60954,110,1554170400,37,3,40,Clouds
60955,111,1554170400,3,37,40,Clouds
60956,112,1554170400,0,30,30,Clouds
60957,113,1554170400,32,8,40,Clouds
60958,114,1554170400,39,1,40,Clouds
60959,115,1554170400,10,20,30,Clouds
60960,2,1554174000,10,10,20,Clouds
60961,3,1554174000,16,4,20,Clouds
60962,4,1554174000,14,6,20,Clouds
60963,5,1554174000,10,30,40,Clouds
60964,6,1554174000,18,2,20,Clouds
60965,7,1554174000,16,13,29,Clouds
60966,8,1554174000,27,3,30,Clouds
60967,9,1554174000,22,2,24,Clouds
60968,10,1554174000,16,0,16,Clouds
60969,11,1554174000,26,4,30,Clouds
60970,12,1554174000,3,16,19,Clouds
60971,13,1554174000,30,0,30,Clouds
60972,14,1554174000,25,5,30,Clouds
60973,15,1554174000,13,3,16,Clouds
60974,16,1554174000,20,0,20,Clouds
60975,17,1554174000,20,0,20,Clouds
60976,18,1554174000,17,13,30,Clouds
60977,19,1554174000,29,1,30,Clouds
60978,21,1554174000,30,0,30,Clouds
60979,22,1554174000,19,0,19,Clouds
60980,23,1554174000,24,6,30,Clouds
60981,24,1554174000,19,1,20,Clouds
60982,25,1554174000,19,11,30,Clouds
60983,26,1554174000,17,3,20,Clouds
60984,27,1554174000,20,0,20,Clouds
60985,28,1554174000,7,23,30,Clouds
60986,29,1554174000,28,1,29,Clouds
60987,30,1554174000,18,2,20,Clouds
60988,31,1554174000,20,0,20,Clouds
60989,32,1554174000,30,0,30,Clouds
60990,33,1554174000,23,0,23,Clouds
60991,34,1554174000,5,25,30,Clouds
60992,35,1554174000,5,25,30,Clouds
60993,36,1554174000,31,9,40,Clouds
60994,37,1554174000,26,4,30,Clouds
60995,38,1554174000,35,5,40,Clouds
60996,39,1554174000,20,0,20,Clouds
60997,40,1554174000,21,0,21,Clouds
60998,41,1554174000,16,4,20,Clouds
60999,42,1554174000,3,27,30,Clouds
61000,43,1554174000,13,17,30,Clouds
61001,44,1554174000,0,30,30,Clouds
61002,45,1554174000,15,15,30,Clouds
61003,46,1554174000,20,0,20,Clouds
61004,47,1554174000,40,0,40,Clouds
61005,48,1554174000,31,9,40,Clouds
61006,49,1554174000,34,6,40,Clouds
61007,50,1554174000,0,40,40,Clouds
61008,51,1554174000,40,0,40,Clouds
61009,52,1554174000,31,1,32,Clouds
61010,53,1554174000,40,0,40,Clouds
61011,54,1554174000,33,0,33,Clouds
61012,55,1554174000,36,0,36,Clouds
61013,56,1554174000,36,4,40,Clouds
61014,57,1554174000,19,4,23,Clouds
61015,58,1554174000,29,11,40,Clouds
61016,59,1554174000,19,1,20,Clouds
61017,60,1554174000,0,30,30,Clouds
61018,61,1554174000,20,5,25,Clouds
61019,62,1554174000,40,0,40,Clouds
61020,63,1554174000,35,0,35,Clouds
61021,64,1554174000,35,5,40,Clouds
61022,65,1554174000,38,2,40,Clouds
61023,66,1554174000,38,2,40,Clouds
61024,67,1554174000,20,20,40,Clouds
61025,68,1554174000,38,2,40,Clouds
61026,69,1554174000,31,9,40,Clouds
61027,70,1554174000,16,12,28,Clouds
61028,71,1554174000,39,1,40,Clouds
61029,72,1554174000,4,27,31,Clouds
61030,73,1554174000,8,22,30,Clouds
61031,74,1554174000,10,20,30,Clouds
61032,75,1554174000,1,39,40,Clouds
61033,76,1554174000,9,29,38,Clouds
61034,77,1554174000,23,6,29,Clouds
61035,78,1554174000,8,32,40,Clouds
61036,79,1554174000,21,6,27,Clouds
61037,80,1554174000,18,22,40,Clouds
61038,81,1554174000,24,16,40,Clouds
61039,82,1554174000,6,16,22,Clouds
61040,83,1554174000,5,35,40,Clouds
61041,84,1554174000,9,21,30,Clouds
61042,85,1554174000,6,29,35,Clouds
61043,86,1554174000,4,34,38,Clouds
61044,87,1554174000,23,15,38,Clouds
61045,88,1554174000,7,23,30,Clouds
61046,89,1554174000,39,1,40,Clouds
61047,90,1554174000,38,2,40,Clouds
61048,91,1554174000,26,4,30,Clouds
61049,92,1554174000,15,25,40,Clouds
61050,93,1554174000,0,40,40,Clouds
61051,94,1554174000,5,35,40,Clouds
61052,95,1554174000,3,37,40,Clouds
61053,96,1554174000,18,12,30,Clouds
61054,97,1554174000,6,34,40,Clouds
61055,98,1554174000,40,0,40,Clouds
61056,99,1554174000,30,0,30,Clouds
61057,100,1554174000,7,18,25,Clouds
61058,101,1554174000,7,23,30,Clouds
61059,102,1554174000,34,6,40,Clouds
61060,103,1554174000,27,13,40,Clouds
61061,104,1554174000,39,1,40,Clouds
61062,105,1554174000,33,3,36,Clouds
61063,106,1554174000,15,25,40,Clouds
61064,107,1554174000,17,23,40,Clouds
61065,108,1554174000,25,15,40,Clouds
61066,109,1554174000,15,14,29,Clouds
61067,110,1554174000,37,3,40,Clouds
61068,111,1554174000,3,37,40,Clouds
61069,112,1554174000,0,30,30,Clouds
61070,113,1554174000,32,8,40,Clouds
61071,114,1554174000,39,1,40,Clouds
61072,115,1554174000,10,20,30,Clouds
61073,2,1554177600,10,10,20,Clouds
61074,3,1554177600,16,4,20,Clouds
61075,4,1554177600,14,6,20,Clouds
61076,5,1554177600,10,30,40,Clouds
61077,6,1554177600,18,2,20,Clouds
61078,7,1554177600,16,13,29,Clouds
61079,8,1554177600,27,3,30,Clouds
61080,9,1554177600,22,2,24,Clouds
61081,10,1554177600,16,0,16,Clouds
61082,11,1554177600,26,4,30,Clouds
61083,12,1554177600,3,16,19,Clouds
61084,13,1554177600,29,0,29,Clouds
61085,14,1554177600,25,5,30,Clouds
61086,15,1554177600,13,3,16,Clouds
61087,16,1554177600,20,0,20,Clouds
61088,17,1554177600,20,0,20,Clouds
61089,18,1554177600,17,13,30,Clouds
61090,19,1554177600,29,1,30,Clouds
61091,21,1554177600,30,0,30,Clouds
61092,22,1554177600,19,0,19,Clouds
61093,23,1554177600,24,6,30,Clouds
61094,24,1554177600,19,1,20,Clouds
61095,25,1554177600,19,11,30,Clouds
61096,26,1554177600,17,3,20,Clouds
61097,27,1554177600,20,0,20,Clouds
61098,28,1554177600,7,23,30,Clouds
61099,29,1554177600,28,1,29,Clouds
61100,30,1554177600,18,2,20,Clouds
61101,31,1554177600,20,0,20,Clouds
61102,32,1554177600,30,0,30,Clouds
61103,33,1554177600,23,0,23,Clouds
61104,34,1554177600,5,25,30,Clouds
61105,35,1554177600,5,25,30,Clouds
61106,36,1554177600,31,9,40,Clouds
61107,37,1554177600,26,4,30,Clouds
61108,38,1554177600,35,5,40,Clouds
61109,39,1554177600,20,0,20,Clouds
61110,40,1554177600,21,0,21,Clouds
61111,41,1554177600,16,4,20,Clouds
61112,42,1554177600,3,27,30,Clouds
61113,43,1554177600,13,17,30,Clouds
61114,44,1554177600,0,30,30,Clouds
61115,45,1554177600,15,15,30,Clouds
61116,46,1554177600,20,0,20,Clouds
61117,47,1554177600,40,0,40,Clouds
61118,48,1554177600,31,9,40,Clouds
61119,49,1554177600,34,6,40,Clouds
61120,50,1554177600,0,40,40,Clouds
61121,51,1554177600,40,0,40,Clouds
61122,52,1554177600,31,1,32,Clouds
61123,53,1554177600,40,0,40,Clouds
61124,54,1554177600,33,0,33,Clouds
61125,55,1554177600,36,0,36,Clouds
61126,56,1554177600,36,4,40,Clouds
61127,57,1554177600,19,4,23,Clouds
61128,58,1554177600,29,11,40,Clouds
61129,59,1554177600,19,1,20,Clouds
61130,60,1554177600,0,30,30,Clouds
61131,61,1554177600,20,5,25,Clouds
61132,62,1554177600,40,0,40,Clouds
61133,63,1554177600,35,0,35,Clouds
61134,64,1554177600,35,5,40,Clouds
61135,65,1554177600,38,2,40,Clouds
61136,66,1554177600,38,2,40,Clouds
61137,67,1554177600,20,20,40,Clouds
61138,68,1554177600,38,2,40,Clouds
61139,69,1554177600,31,9,40,Clouds
61140,70,1554177600,16,12,28,Clouds
61141,71,1554177600,39,1,40,Clouds
61142,72,1554177600,4,27,31,Clouds
61143,73,1554177600,8,22,30,Clouds
61144,74,1554177600,10,20,30,Clouds
61145,75,1554177600,1,39,40,Clouds
61146,76,1554177600,9,29,38,Clouds
61147,77,1554177600,23,6,29,Clouds
61148,78,1554177600,8,32,40,Clouds
61149,79,1554177600,21,6,27,Clouds
61150,80,1554177600,18,22,40,Clouds
61151,81,1554177600,24,16,40,Clouds
61152,82,1554177600,6,16,22,Clouds
61153,83,1554177600,5,35,40,Clouds
61154,84,1554177600,9,21,30,Clouds
61155,85,1554177600,6,29,35,Clouds
61156,86,1554177600,4,34,38,Clouds
61157,87,1554177600,23,15,38,Clouds
61158,88,1554177600,7,23,30,Clouds
61159,89,1554177600,39,1,40,Clouds
61160,90,1554177600,38,2,40,Clouds
61161,91,1554177600,26,4,30,Clouds
61162,92,1554177600,15,25,40,Clouds
61163,93,1554177600,0,40,40,Clouds
61164,94,1554177600,5,35,40,Clouds
61165,95,1554177600,3,37,40,Clouds
61166,96,1554177600,18,12,30,Clouds
61167,97,1554177600,6,34,40,Clouds
61168,98,1554177600,40,0,40,Clouds
61169,99,1554177600,30,0,30,Clouds
61170,100,1554177600,7,18,25,Clouds
61171,101,1554177600,7,23,30,Clouds
61172,102,1554177600,34,6,40,Clouds
61173,103,1554177600,27,13,40,Clouds
61174,104,1554177600,39,1,40,Clouds
61175,105,1554177600,33,3,36,Clouds
61176,106,1554177600,15,25,40,Clouds
61177,107,1554177600,17,23,40,Clouds
61178,108,1554177600,25,15,40,Clouds
61179,109,1554177600,15,14,29,Clouds
61180,110,1554177600,37,3,40,Clouds
61181,111,1554177600,3,37,40,Clouds
61182,112,1554177600,0,30,30,Clouds
61183,113,1554177600,32,8,40,Clouds
61184,114,1554177600,39,1,40,Clouds
61185,115,1554177600,10,20,30,Clouds
61186,2,1554181200,10,10,20,Clouds
61187,3,1554181200,16,4,20,Clouds
61188,4,1554181200,14,6,20,Clouds
61189,5,1554181200,10,30,40,Clouds
61190,6,1554181200,18,2,20,Clouds
61191,7,1554181200,16,13,29,Clouds
61192,8,1554181200,27,3,30,Clouds
61193,9,1554181200,22,2,24,Clouds
61194,10,1554181200,16,0,16,Clouds
61195,11,1554181200,26,4,30,Clouds
61196,12,1554181200,3,16,19,Clouds
61197,13,1554181200,29,0,29,Clouds
61198,14,1554181200,25,5,30,Clouds
61199,15,1554181200,13,3,16,Clouds
61200,16,1554181200,20,0,20,Clouds
61201,17,1554181200,20,0,20,Clouds
61202,18,1554181200,17,13,30,Clouds
61203,19,1554181200,29,1,30,Clouds
61204,21,1554181200,30,0,30,Clouds
61205,22,1554181200,19,0,19,Clouds
61206,23,1554181200,24,6,30,Clouds
61207,24,1554181200,20,0,20,Clouds
61208,25,1554181200,19,11,30,Clouds
61209,26,1554181200,17,3,20,Clouds
61210,27,1554181200,20,0,20,Clouds
61211,28,1554181200,7,23,30,Clouds
61212,29,1554181200,28,1,29,Clouds
61213,30,1554181200,18,2,20,Clouds
61214,31,1554181200,20,0,20,Clouds
61215,32,1554181200,30,0,30,Clouds
61216,33,1554181200,23,0,23,Clouds
61217,34,1554181200,5,25,30,Clouds
61218,35,1554181200,5,25,30,Clouds
61219,36,1554181200,31,9,40,Clouds
61220,37,1554181200,26,4,30,Clouds
61221,38,1554181200,35,5,40,Clouds
61222,39,1554181200,20,0,20,Clouds
61223,40,1554181200,21,0,21,Clouds
61224,41,1554181200,16,4,20,Clouds
61225,42,1554181200,4,26,30,Clouds
61226,43,1554181200,13,17,30,Clouds
61227,44,1554181200,0,30,30,Clouds
61228,45,1554181200,15,15,30,Clouds
61229,46,1554181200,20,0,20,Clouds
61230,47,1554181200,40,0,40,Clouds
61231,48,1554181200,31,9,40,Clouds
61232,49,1554181200,34,6,40,Clouds
61233,50,1554181200,0,40,40,Clouds
61234,51,1554181200,40,0,40,Clouds
61235,52,1554181200,31,1,32,Clouds
61236,53,1554181200,40,0,40,Clouds
61237,54,1554181200,33,0,33,Clouds
61238,55,1554181200,36,0,36,Clouds
61239,56,1554181200,36,4,40,Clouds
61240,57,1554181200,19,4,23,Clouds
61241,58,1554181200,29,11,40,Clouds
61242,59,1554181200,19,1,20,Clouds
61243,60,1554181200,0,30,30,Clouds
61244,61,1554181200,20,5,25,Clouds
61245,62,1554181200,40,0,40,Clouds
61246,63,1554181200,35,0,35,Clouds
61247,64,1554181200,35,5,40,Clouds
61248,65,1554181200,38,2,40,Clouds
61249,66,1554181200,38,2,40,Clouds
61250,67,1554181200,20,20,40,Clouds
61251,68,1554181200,38,2,40,Clouds
61252,69,1554181200,31,9,40,Clouds
61253,70,1554181200,16,12,28,Clouds
61254,71,1554181200,39,1,40,Clouds
61255,72,1554181200,4,27,31,Clouds
61256,73,1554181200,8,22,30,Clouds
61257,74,1554181200,10,20,30,Clouds
61258,75,1554181200,1,39,40,Clouds
61259,76,1554181200,9,29,38,Clouds
61260,77,1554181200,23,6,29,Clouds
61261,78,1554181200,8,32,40,Clouds
61262,79,1554181200,21,6,27,Clouds
61263,80,1554181200,19,21,40,Clouds
61264,81,1554181200,24,16,40,Clouds
61265,82,1554181200,6,16,22,Clouds
61266,83,1554181200,5,35,40,Clouds
61267,84,1554181200,9,21,30,Clouds
61268,85,1554181200,6,29,35,Clouds
61269,86,1554181200,4,34,38,Clouds
61270,87,1554181200,23,15,38,Clouds
61271,88,1554181200,7,23,30,Clouds
61272,89,1554181200,39,1,40,Clouds
61273,90,1554181200,38,2,40,Clouds
61274,91,1554181200,26,4,30,Clouds
61275,92,1554181200,15,25,40,Clouds
61276,93,1554181200,0,40,40,Clouds
61277,94,1554181200,5,35,40,Clouds
61278,95,1554181200,3,37,40,Clouds
61279,96,1554181200,18,12,30,Clouds
61280,97,1554181200,6,34,40,Clouds
61281,98,1554181200,40,0,40,Clouds
61282,99,1554181200,30,0,30,Clouds
61283,100,1554181200,7,18,25,Clouds
61284,101,1554181200,7,23,30,Clouds
61285,102,1554181200,34,6,40,Clouds
61286,103,1554181200,27,13,40,Clouds
61287,104,1554181200,39,1,40,Clouds
61288,105,1554181200,33,3,36,Clouds
61289,106,1554181200,15,25,40,Clouds
61290,107,1554181200,17,23,40,Clouds
61291,108,1554181200,25,15,40,Clouds
61292,109,1554181200,15,14,29,Clouds
61293,110,1554181200,37,3,40,Clouds
61294,111,1554181200,3,37,40,Clouds
61295,112,1554181200,0,30,30,Clouds
61296,113,1554181200,32,8,40,Clouds
61297,114,1554181200,39,1,40,Clouds
61298,115,1554181200,10,20,30,Clouds
61299,2,1554184800,11,9,20,Clouds
61300,3,1554184800,17,3,20,Clouds
61301,4,1554184800,15,5,20,Clouds
61302,5,1554184800,12,28,40,Clouds
61303,6,1554184800,17,3,20,Clouds
61304,7,1554184800,15,14,29,Clouds
61305,8,1554184800,26,4,30,Clouds
61306,9,1554184800,20,4,24,Clouds
61307,10,1554184800,15,1,16,Clouds
61308,11,1554184800,26,4,30,Clouds
61309,12,1554184800,7,12,19,Clouds
61310,13,1554184800,29,0,29,Clouds
61311,14,1554184800,19,11,30,Clouds
61312,15,1554184800,14,2,16,Clouds
61313,16,1554184800,19,1,20,Clouds
61314,17,1554184800,20,0,20,Clouds
61315,18,1554184800,9,21,30,Clouds
61316,19,1554184800,28,2,30,Clouds
61317,21,1554184800,30,0,30,Clouds
61318,22,1554184800,17,3,20,Clouds
61319,23,1554184800,25,5,30,Clouds
61320,24,1554184800,16,4,20,Clouds
61321,25,1554184800,29,1,30,Clouds
61322,26,1554184800,17,3,20,Clouds
61323,27,1554184800,18,2,20,Clouds
61324,28,1554184800,8,22,30,Clouds
61325,29,1554184800,28,1,29,Clouds
61326,30,1554184800,14,6,20,Clouds
61327,31,1554184800,18,2,20,Clouds
61328,32,1554184800,27,3,30,Clouds
61329,33,1554184800,17,6,23,Clouds
61330,34,1554184800,5,25,30,Clouds
61331,35,1554184800,11,19,30,Clouds
61332,36,1554184800,30,10,40,Clouds
61333,37,1554184800,26,4,30,Clouds
61334,38,1554184800,37,3,40,Clouds
61335,39,1554184800,20,0,20,Clouds
61336,40,1554184800,19,2,21,Clouds
61337,41,1554184800,16,4,20,Clouds
61338,42,1554184800,4,26,30,Clouds
61339,43,1554184800,4,26,30,Clouds
61340,44,1554184800,7,23,30,Clouds
61341,45,1554184800,15,15,30,Clouds
61342,46,1554184800,20,0,20,Clouds
61343,47,1554184800,40,0,40,Clouds
61344,48,1554184800,30,10,40,Clouds
61345,49,1554184800,33,7,40,Clouds
61346,50,1554184800,2,38,40,Clouds
61347,51,1554184800,38,2,40,Clouds
61348,52,1554184800,27,5,32,Clouds
61349,53,1554184800,40,0,40,Clouds
61350,54,1554184800,33,0,33,Clouds
61351,55,1554184800,36,0,36,Clouds
61352,56,1554184800,37,3,40,Clouds
61353,57,1554184800,19,4,23,Clouds
61354,58,1554184800,27,13,40,Clouds
61355,59,1554184800,20,0,20,Clouds
61356,60,1554184800,4,26,30,Clouds
61357,61,1554184800,20,5,25,Clouds
61358,62,1554184800,38,2,40,Clouds
61359,63,1554184800,34,1,35,Clouds
61360,64,1554184800,35,5,40,Clouds
61361,65,1554184800,38,2,40,Clouds
61362,66,1554184800,37,3,40,Clouds
61363,67,1554184800,20,20,40,Clouds
61364,68,1554184800,37,3,40,Clouds
61365,69,1554184800,39,1,40,Clouds
61366,70,1554184800,19,9,28,Clouds
61367,71,1554184800,39,1,40,Clouds
61368,72,1554184800,4,27,31,Clouds
61369,73,1554184800,10,20,30,Clouds
61370,74,1554184800,11,19,30,Clouds
61371,75,1554184800,2,38,40,Clouds
61372,76,1554184800,12,26,38,Clouds
61373,77,1554184800,23,6,29,Clouds
61374,78,1554184800,10,30,40,Clouds
61375,79,1554184800,6,21,27,Clouds
61376,80,1554184800,21,19,40,Clouds
61377,81,1554184800,24,16,40,Clouds
61378,82,1554184800,7,15,22,Clouds
61379,83,1554184800,5,35,40,Clouds
61380,84,1554184800,9,21,30,Clouds
61381,85,1554184800,6,29,35,Clouds
61382,86,1554184800,5,33,38,Clouds
61383,87,1554184800,24,14,38,Clouds
61384,88,1554184800,6,24,30,Clouds
61385,89,1554184800,40,0,40,Clouds
61386,90,1554184800,37,3,40,Clouds
61387,91,1554184800,24,6,30,Clouds
61388,92,1554184800,15,25,40,Clouds
61389,93,1554184800,0,40,40,Clouds
61390,94,1554184800,5,35,40,Clouds
61391,95,1554184800,3,37,40,Clouds
61392,96,1554184800,18,12,30,Clouds
61393,97,1554184800,9,31,40,Clouds
61394,98,1554184800,40,0,40,Clouds
61395,99,1554184800,28,2,30,Clouds
61396,100,1554184800,6,19,25,Clouds
61397,101,1554184800,15,15,30,Clouds
61398,102,1554184800,35,5,40,Clouds
61399,103,1554184800,27,13,40,Clouds
61400,104,1554184800,39,1,40,Clouds
61401,105,1554184800,34,2,36,Clouds
61402,106,1554184800,15,25,40,Clouds
61403,107,1554184800,22,18,40,Clouds
61404,108,1554184800,26,14,40,Clouds
61405,109,1554184800,20,9,29,Clouds
61406,110,1554184800,37,3,40,Clouds
61407,111,1554184800,4,36,40,Clouds
61408,112,1554184800,1,29,30,Clouds
61409,113,1554184800,39,1,40,Clouds
61410,114,1554184800,40,0,40,Clouds
61411,115,1554184800,12,18,30,Clouds
61412,2,1554188400,20,0,20,Clouds
61413,3,1554188400,20,0,20,Clouds
61414,4,1554188400,15,5,20,Clouds
61415,5,1554188400,6,34,40,Clouds
61416,6,1554188400,20,0,20,Clouds
61417,7,1554188400,15,14,29,Clouds
61418,8,1554188400,22,8,30,Clouds
61419,9,1554188400,17,7,24,Clouds
61420,10,1554188400,14,2,16,Clouds
61421,11,1554188400,22,8,30,Clouds
61422,12,1554188400,19,0,19,Clouds
61423,13,1554188400,27,2,29,Clouds
61424,14,1554188400,28,2,30,Clouds
61425,15,1554188400,16,0,16,Clouds
61426,16,1554188400,20,0,20,Clouds
61427,17,1554188400,19,1,20,Clouds
61428,18,1554188400,2,28,30,Clouds
61429,19,1554188400,21,9,30,Clouds
61430,21,1554188400,29,1,30,Clouds
61431,22,1554188400,9,11,20,Clouds
61432,23,1554188400,20,10,30,Clouds
61433,24,1554188400,17,3,20,Clouds
61434,25,1554188400,24,6,30,Clouds
61435,26,1554188400,14,6,20,Clouds
61436,27,1554188400,18,2,20,Clouds
61437,28,1554188400,15,15,30,Clouds
61438,29,1554188400,24,5,29,Clouds
61439,30,1554188400,12,8,20,Clouds
61440,31,1554188400,18,2,20,Clouds
61441,32,1554188400,23,7,30,Clouds
61442,33,1554188400,6,17,23,Clouds
61443,34,1554188400,6,24,30,Clouds
61444,35,1554188400,18,12,30,Clouds
61445,36,1554188400,39,1,40,Clouds
61446,37,1554188400,28,2,30,Clouds
61447,38,1554188400,33,7,40,Clouds
61448,39,1554188400,16,4,20,Clouds
61449,40,1554188400,13,8,21,Clouds
61450,41,1554188400,18,2,20,Clouds
61451,42,1554188400,10,20,30,Clouds
61452,43,1554188400,15,15,30,Clouds
61453,44,1554188400,17,13,30,Clouds
61454,45,1554188400,17,13,30,Clouds
61455,46,1554188400,16,4,20,Clouds
61456,47,1554188400,39,1,40,Clouds
61457,48,1554188400,30,10,40,Clouds
61458,49,1554188400,40,0,40,Clouds
61459,50,1554188400,8,32,40,Clouds
61460,51,1554188400,29,11,40,Clouds
61461,52,1554188400,29,3,32,Clouds
61462,53,1554188400,37,3,40,Clouds
61463,54,1554188400,32,1,33,Clouds
61464,55,1554188400,29,7,36,Clouds
61465,56,1554188400,39,1,40,Clouds
61466,57,1554188400,23,0,23,Clouds
61467,58,1554188400,25,15,40,Clouds
61468,59,1554188400,20,0,20,Clouds
61469,60,1554188400,18,12,30,Clouds
61470,61,1554188400,24,1,25,Clouds
61471,62,1554188400,32,8,40,Clouds
61472,63,1554188400,32,3,35,Clouds
61473,64,1554188400,31,9,40,Clouds
61474,65,1554188400,30,10,40,Clouds
61475,66,1554188400,24,16,40,Clouds
61476,67,1554188400,38,2,40,Clouds
61477,68,1554188400,40,0,40,Clouds
61478,69,1554188400,27,13,40,Clouds
61479,70,1554188400,13,15,28,Clouds
61480,71,1554188400,39,1,40,Clouds
61481,72,1554188400,9,22,31,Clouds
61482,73,1554188400,15,15,30,Clouds
61483,74,1554188400,17,13,30,Clouds
61484,75,1554188400,2,38,40,Clouds
61485,76,1554188400,16,22,38,Clouds
61486,77,1554188400,23,6,29,Clouds
61487,78,1554188400,12,28,40,Clouds
61488,79,1554188400,7,20,27,Clouds
61489,80,1554188400,4,36,40,Clouds
61490,81,1554188400,23,17,40,Clouds
61491,82,1554188400,8,14,22,Clouds
61492,83,1554188400,9,31,40,Clouds
61493,84,1554188400,8,22,30,Clouds
61494,85,1554188400,10,25,35,Clouds
61495,86,1554188400,5,33,38,Clouds
61496,87,1554188400,25,13,38,Clouds
61497,88,1554188400,14,16,30,Clouds
61498,89,1554188400,39,1,40,Clouds
61499,90,1554188400,32,8,40,Clouds
61500,91,1554188400,24,6,30,Clouds
61501,92,1554188400,17,23,40,Clouds
61502,93,1554188400,9,31,40,Clouds
61503,94,1554188400,6,34,40,Clouds
61504,95,1554188400,6,34,40,Clouds
61505,96,1554188400,20,10,30,Clouds
61506,97,1554188400,19,21,40,Clouds
61507,98,1554188400,39,1,40,Clouds
61508,99,1554188400,27,3,30,Clouds
61509,100,1554188400,19,6,25,Clouds
61510,101,1554188400,20,10,30,Clouds
61511,102,1554188400,36,4,40,Clouds
61512,103,1554188400,26,14,40,Clouds
61513,104,1554188400,39,1,40,Clouds
61514,105,1554188400,33,3,36,Clouds
61515,106,1554188400,17,23,40,Clouds
61516,107,1554188400,8,32,40,Clouds
61517,108,1554188400,34,6,40,Clouds
61518,109,1554188400,25,4,29,Clouds
61519,110,1554188400,39,1,40,Clouds
61520,111,1554188400,11,29,40,Clouds
61521,112,1554188400,8,22,30,Clouds
61522,113,1554188400,36,4,40,Clouds
61523,114,1554188400,35,5,40,Clouds
61524,115,1554188400,13,17,30,Clouds
61525,2,1554192000,20,0,20,Clouds
61526,3,1554192000,19,1,20,Clouds
61527,4,1554192000,13,7,20,Clouds
61528,5,1554192000,38,2,40,Clouds
61529,6,1554192000,18,2,20,Clouds
61530,7,1554192000,23,6,29,Clouds
61531,8,1554192000,28,1,29,Clouds
61532,9,1554192000,22,2,24,Clouds
61533,10,1554192000,10,6,16,Clouds
61534,11,1554192000,13,17,30,Clouds
61535,12,1554192000,19,0,19,Clouds
61536,13,1554192000,21,8,29,Clouds
61537,14,1554192000,24,6,30,Clouds
61538,15,1554192000,16,0,16,Clouds
61539,16,1554192000,15,5,20,Clouds
61540,17,1554192000,13,7,20,Clouds
61541,18,1554192000,2,28,30,Clouds
61542,19,1554192000,12,18,30,Clouds
61543,21,1554192000,25,5,30,Clouds
61544,22,1554192000,15,5,20,Clouds
61545,23,1554192000,26,4,30,Clouds
61546,24,1554192000,19,1,20,Clouds
61547,25,1554192000,23,7,30,Clouds
61548,26,1554192000,11,9,20,Clouds
61549,27,1554192000,11,9,20,Clouds
61550,28,1554192000,20,10,30,Clouds
61551,29,1554192000,26,3,29,Clouds
61552,30,1554192000,15,5,20,Clouds
61553,31,1554192000,17,3,20,Clouds
61554,32,1554192000,16,14,30,Clouds
61555,33,1554192000,6,17,23,Clouds
61556,34,1554192000,18,12,30,Clouds
61557,35,1554192000,17,13,30,Clouds
61558,36,1554192000,33,7,40,Clouds
61559,37,1554192000,29,1,30,Clouds
61560,38,1554192000,33,7,40,Clouds
61561,39,1554192000,18,2,20,Clouds
61562,40,1554192000,7,14,21,Clouds
61563,41,1554192000,18,2,20,Clouds
61564,42,1554192000,19,11,30,Clouds
61565,43,1554192000,30,0,30,Clouds
61566,44,1554192000,25,5,30,Clouds
61567,45,1554192000,21,9,30,Clouds
61568,46,1554192000,16,4,20,Clouds
61569,47,1554192000,33,7,40,Clouds
61570,48,1554192000,27,13,40,Clouds
61571,49,1554192000,36,4,40,Clouds
61572,50,1554192000,23,17,40,Clouds
61573,51,1554192000,37,3,40,Clouds
61574,52,1554192000,17,15,32,Clouds
61575,53,1554192000,30,10,40,Clouds
61576,54,1554192000,25,8,33,Clouds
61577,55,1554192000,20,16,36,Clouds
61578,56,1554192000,33,7,40,Clouds
61579,57,1554192000,17,6,23,Clouds
61580,58,1554192000,27,13,40,Clouds
61581,59,1554192000,15,5,20,Clouds
61582,60,1554192000,14,16,30,Clouds
61583,61,1554192000,10,15,25,Clouds
61584,62,1554192000,29,11,40,Clouds
61585,63,1554192000,28,7,35,Clouds
61586,64,1554192000,27,13,40,Clouds
61587,65,1554192000,34,5,39,Clouds
61588,66,1554192000,28,12,40,Clouds
61589,67,1554192000,31,9,40,Clouds
61590,68,1554192000,26,14,40,Clouds
61591,69,1554192000,3,37,40,Clouds
61592,70,1554192000,8,20,28,Clouds
61593,71,1554192000,34,6,40,Clouds
61594,72,1554192000,18,13,31,Clouds
61595,73,1554192000,27,3,30,Clouds
61596,74,1554192000,26,4,30,Clouds
61597,75,1554192000,8,32,40,Clouds
61598,76,1554192000,24,14,38,Clouds
61599,77,1554192000,29,0,29,Clouds
61600,78,1554192000,17,23,40,Clouds
61601,79,1554192000,12,15,27,Clouds
61602,80,1554192000,15,25,40,Clouds
61603,81,1554192000,23,17,40,Clouds
61604,82,1554192000,14,8,22,Clouds
61605,83,1554192000,24,16,40,Clouds
61606,84,1554192000,18,12,30,Clouds
61607,85,1554192000,23,12,35,Clouds
61608,86,1554192000,24,14,38,Clouds
61609,87,1554192000,38,0,38,Clouds
61610,88,1554192000,21,9,30,Clouds
61611,89,1554192000,37,3,40,Clouds
61612,90,1554192000,2,38,40,Clouds
61613,91,1554192000,21,9,30,Clouds
61614,92,1554192000,40,0,40,Clouds
61615,93,1554192000,32,8,40,Clouds
61616,94,1554192000,12,28,40,Clouds
61617,95,1554192000,17,23,40,Clouds
61618,96,1554192000,28,2,30,Clouds
61619,97,1554192000,40,0,40,Clouds
61620,98,1554192000,40,0,40,Clouds
61621,99,1554192000,25,5,30,Clouds
61622,100,1554192000,25,0,25,Clouds
61623,101,1554192000,29,1,30,Clouds
61624,102,1554192000,40,0,40,Clouds
61625,103,1554192000,23,17,40,Clouds
61626,104,1554192000,39,1,40,Clouds
61627,105,1554192000,31,5,36,Clouds
61628,106,1554192000,23,17,40,Clouds
61629,107,1554192000,21,19,40,Clouds
61630,108,1554192000,40,0,40,Clouds
61631,109,1554192000,28,1,29,Clouds
61632,110,1554192000,40,0,40,Clouds
61633,111,1554192000,21,19,40,Clouds
61634,112,1554192000,30,0,30,Clouds
61635,113,1554192000,33,7,40,Clouds
61636,114,1554192000,27,13,40,Clouds
61637,115,1554192000,25,5,30,Clouds
61638,2,1554195600,20,0,20,Clouds
61639,3,1554195600,17,3,20,Clouds
61640,4,1554195600,18,2,20,Clouds
61641,5,1554195600,40,0,40,Clouds
61642,6,1554195600,16,4,20,Clouds
61643,7,1554195600,29,0,29,Clouds
61644,8,1554195600,19,11,30,Clouds
61645,9,1554195600,12,12,24,Clouds
61646,10,1554195600,14,2,16,Clouds
61647,11,1554195600,0,29,29,Clouds
61648,12,1554195600,20,0,20,Clouds
61649,13,1554195600,9,20,29,Clouds
61650,14,1554195600,16,14,30,Clouds
61651,15,1554195600,16,0,16,Clouds
61652,16,1554195600,10,9,19,Clouds
61653,17,1554195600,20,0,20,Clouds
61654,18,1554195600,18,12,30,Clouds
61655,19,1554195600,0,30,30,Clouds
61656,21,1554195600,11,19,30,Clouds
61657,22,1554195600,17,3,20,Clouds
61658,23,1554195600,25,3,28,Clouds
61659,24,1554195600,20,0,20,Clouds
61660,25,1554195600,10,19,29,Clouds
61661,26,1554195600,1,18,19,Clouds
61662,27,1554195600,14,6,20,Clouds
61663,28,1554195600,30,0,30,Clouds
61664,29,1554195600,24,5,29,Clouds
61665,30,1554195600,20,0,20,Clouds
61666,31,1554195600,20,0,20,Clouds
61667,32,1554195600,6,24,30,Clouds
61668,33,1554195600,15,8,23,Clouds
61669,34,1554195600,30,0,30,Clouds
61670,35,1554195600,30,0,30,Clouds
61671,36,1554195600,26,12,38,Clouds
61672,37,1554195600,27,3,30,Clouds
61673,38,1554195600,37,3,40,Clouds
61674,39,1554195600,13,7,20,Clouds
61675,40,1554195600,6,15,21,Clouds
61676,41,1554195600,17,3,20,Clouds
61677,42,1554195600,30,0,30,Clouds
61678,43,1554195600,30,0,30,Clouds
61679,44,1554195600,30,0,30,Clouds
61680,45,1554195600,30,0,30,Clouds
61681,46,1554195600,17,3,20,Clouds
61682,47,1554195600,6,34,40,Clouds
61683,48,1554195600,24,16,40,Clouds
61684,49,1554195600,16,21,37,Clouds
61685,50,1554195600,40,0,40,Clouds
61686,51,1554195600,36,4,40,Clouds
61687,52,1554195600,7,25,32,Clouds
61688,53,1554195600,20,20,40,Clouds
61689,54,1554195600,14,19,33,Clouds
61690,55,1554195600,4,31,35,Clouds
61691,56,1554195600,10,29,39,Clouds
61692,57,1554195600,0,23,23,Clouds
61693,58,1554195600,0,39,39,Clouds
61694,59,1554195600,19,1,20,Clouds
61695,60,1554195600,29,1,30,Clouds
61696,61,1554195600,25,0,25,Clouds
61697,62,1554195600,2,34,36,Clouds
61698,63,1554195600,20,15,35,Clouds
61699,64,1554195600,10,29,39,Clouds
61700,65,1554195600,26,13,39,Clouds
61701,66,1554195600,10,28,38,Clouds
61702,67,1554195600,34,6,40,Clouds
61703,68,1554195600,0,36,36,Clouds
61704,69,1554195600,0,39,39,Clouds
61705,70,1554195600,10,18,28,Clouds
61706,71,1554195600,38,2,40,Clouds
61707,72,1554195600,31,0,31,Clouds
61708,73,1554195600,30,0,30,Clouds
61709,74,1554195600,29,1,30,Clouds
61710,75,1554195600,39,1,40,Clouds
61711,76,1554195600,38,0,38,Clouds
61712,77,1554195600,28,1,29,Clouds
61713,78,1554195600,40,0,40,Clouds
61714,79,1554195600,26,1,27,Clouds
61715,80,1554195600,39,1,40,Clouds
61716,81,1554195600,40,0,40,Clouds
61717,82,1554195600,22,0,22,Clouds
61718,83,1554195600,40,0,40,Clouds
61719,84,1554195600,30,0,30,Clouds
61720,85,1554195600,35,0,35,Clouds
61721,86,1554195600,38,0,38,Clouds
61722,87,1554195600,38,0,38,Clouds
61723,88,1554195600,30,0,30,Clouds
61724,89,1554195600,35,5,40,Clouds
61725,90,1554195600,2,37,39,Clouds
61726,91,1554195600,27,3,30,Clouds
61727,92,1554195600,39,1,40,Clouds
61728,93,1554195600,40,0,40,Clouds
61729,94,1554195600,40,0,40,Clouds
61730,95,1554195600,40,0,40,Clouds
61731,96,1554195600,30,0,30,Clouds
61732,97,1554195600,39,1,40,Clouds
61733,98,1554195600,38,2,40,Clouds
61734,99,1554195600,9,21,30,Clouds
61735,100,1554195600,25,0,25,Clouds
61736,101,1554195600,30,0,30,Clouds
61737,102,1554195600,40,0,40,Clouds
61738,103,1554195600,27,13,40,Clouds
61739,104,1554195600,40,0,40,Clouds
61740,105,1554195600,36,0,36,Clouds
61741,106,1554195600,34,6,40,Clouds
61742,107,1554195600,36,4,40,Clouds
61743,108,1554195600,40,0,40,Clouds
61744,109,1554195600,29,0,29,Clouds
61745,110,1554195600,40,0,40,Clouds
61746,111,1554195600,38,2,40,Clouds
61747,112,1554195600,22,8,30,Clouds
61748,113,1554195600,28,11,39,Clouds
61749,114,1554195600,2,37,39,Clouds
61750,115,1554195600,30,0,30,Clouds
61751,2,1554199200,20,0,20,Clouds
61752,3,1554199200,19,1,20,Clouds
61753,4,1554199200,10,10,20,Clouds
61754,5,1554199200,40,0,40,Clouds
61755,6,1554199200,18,2,20,Clouds
61756,7,1554199200,29,0,29,Clouds
61757,8,1554199200,17,13,30,Clouds
61758,9,1554199200,5,18,23,Clouds
61759,10,1554199200,13,3,16,Clouds
61760,11,1554199200,8,21,29,Clouds
61761,12,1554199200,20,0,20,Clouds
61762,13,1554199200,2,27,29,Clouds
61763,14,1554199200,2,28,30,Clouds
61764,15,1554199200,16,0,16,Clouds
61765,16,1554199200,9,10,19,Clouds
61766,17,1554199200,19,1,20,Clouds
61767,18,1554199200,29,1,30,Clouds
61768,19,1554199200,0,30,30,Clouds
61769,21,1554199200,4,26,30,Clouds
61770,22,1554199200,12,8,20,Clouds
61771,23,1554199200,23,5,28,Clouds
61772,24,1554199200,18,2,20,Clouds
61773,25,1554199200,2,28,30,Clouds
61774,26,1554199200,0,19,19,Clouds
61775,27,1554199200,8,12,20,Clouds
61776,28,1554199200,20,10,30,Clouds
61777,29,1554199200,21,8,29,Clouds
61778,30,1554199200,19,1,20,Clouds
61779,31,1554199200,17,3,20,Clouds
61780,32,1554199200,4,26,30,Clouds
61781,33,1554199200,10,13,23,Clouds
61782,34,1554199200,21,9,30,Clouds
61783,35,1554199200,27,3,30,Clouds
61784,36,1554199200,18,20,38,Clouds
61785,37,1554199200,27,3,30,Clouds
61786,38,1554199200,40,0,40,Clouds
61787,39,1554199200,5,15,20,Clouds
61788,40,1554199200,6,15,21,Clouds
61789,41,1554199200,16,4,20,Clouds
61790,42,1554199200,29,1,30,Clouds
61791,43,1554199200,25,5,30,Clouds
61792,44,1554199200,30,0,30,Clouds
61793,45,1554199200,30,0,30,Clouds
61794,46,1554199200,18,1,19,Clouds
61795,47,1554199200,0,40,40,Clouds
61796,48,1554199200,11,29,40,Clouds
61797,49,1554199200,10,27,37,Clouds
61798,50,1554199200,40,0,40,Clouds
61799,51,1554199200,25,15,40,Clouds
61800,52,1554199200,5,27,32,Clouds
61801,53,1554199200,15,25,40,Clouds
61802,54,1554199200,8,25,33,Clouds
61803,55,1554199200,1,34,35,Clouds
61804,56,1554199200,13,25,38,Clouds
61805,57,1554199200,0,23,23,Clouds
61806,58,1554199200,0,39,39,Clouds
61807,59,1554199200,20,0,20,Clouds
61808,60,1554199200,29,1,30,Clouds
61809,61,1554199200,25,0,25,Clouds
61810,62,1554199200,3,33,36,Clouds
61811,63,1554199200,4,31,35,Clouds
61812,64,1554199200,19,21,40,Clouds
61813,65,1554199200,17,22,39,Clouds
61814,66,1554199200,1,37,38,Clouds
61815,67,1554199200,32,8,40,Clouds
61816,68,1554199200,16,20,36,Clouds
61817,69,1554199200,2,37,39,Clouds
61818,70,1554199200,1,27,28,Clouds
61819,71,1554199200,38,2,40,Clouds
61820,72,1554199200,30,1,31,Clouds
61821,73,1554199200,28,2,30,Clouds
61822,74,1554199200,29,1,30,Clouds
61823,75,1554199200,39,1,40,Clouds
61824,76,1554199200,38,0,38,Clouds
61825,77,1554199200,27,2,29,Clouds
61826,78,1554199200,39,1,40,Clouds
61827,79,1554199200,27,0,27,Clouds
61828,80,1554199200,40,0,40,Clouds
61829,81,1554199200,39,1,40,Clouds
61830,82,1554199200,22,0,22,Clouds
61831,83,1554199200,40,0,40,Clouds
61832,84,1554199200,30,0,30,Clouds
61833,85,1554199200,35,0,35,Clouds
61834,86,1554199200,36,2,38,Clouds
61835,87,1554199200,38,0,38,Clouds
61836,88,1554199200,29,1,30,Clouds
61837,89,1554199200,23,17,40,Clouds
61838,90,1554199200,0,39,39,Clouds
61839,91,1554199200,14,16,30,Clouds
61840,92,1554199200,39,1,40,Clouds
61841,93,1554199200,40,0,40,Clouds
61842,94,1554199200,40,0,40,Clouds
61843,95,1554199200,40,0,40,Clouds
61844,96,1554199200,28,2,30,Clouds
61845,97,1554199200,39,1,40,Clouds
61846,98,1554199200,32,8,40,Clouds
61847,99,1554199200,4,26,30,Clouds
61848,100,1554199200,22,3,25,Clouds
61849,101,1554199200,30,0,30,Clouds
61850,102,1554199200,40,0,40,Clouds
61851,103,1554199200,31,9,40,Clouds
61852,104,1554199200,40,0,40,Clouds
61853,105,1554199200,36,0,36,Clouds
61854,106,1554199200,37,3,40,Clouds
61855,107,1554199200,40,0,40,Clouds
61856,108,1554199200,40,0,40,Clouds
61857,109,1554199200,29,0,29,Clouds
61858,110,1554199200,40,0,40,Clouds
61859,111,1554199200,40,0,40,Clouds
61860,112,1554199200,29,1,30,Clouds
61861,113,1554199200,15,25,40,Clouds
61862,114,1554199200,0,39,39,Clouds
61863,115,1554199200,27,3,30,Clouds
61864,2,1554202800,5,15,20,Clouds
61865,3,1554202800,18,2,20,Clouds
61866,4,1554202800,10,10,20,Clouds
61867,5,1554202800,28,12,40,Clouds
61868,6,1554202800,17,3,20,Clouds
61869,7,1554202800,29,0,29,Clouds
61870,8,1554202800,19,11,30,Clouds
61871,9,1554202800,0,23,23,Clouds
61872,10,1554202800,4,12,16,Clouds
61873,11,1554202800,8,21,29,Clouds
61874,12,1554202800,19,1,20,Clouds
61875,13,1554202800,0,30,30,Clouds
61876,14,1554202800,0,30,30,Clouds
61877,15,1554202800,16,0,16,Clouds
61878,16,1554202800,7,12,19,Clouds
61879,17,1554202800,20,0,20,Clouds
61880,18,1554202800,29,1,30,Clouds
61881,19,1554202800,10,20,30,Clouds
61882,21,1554202800,0,30,30,Clouds
61883,22,1554202800,12,8,20,Clouds
61884,23,1554202800,24,4,28,Clouds
61885,24,1554202800,19,1,20,Clouds
61886,25,1554202800,1,29,30,Clouds
61887,26,1554202800,0,19,19,Clouds
61888,27,1554202800,7,13,20,Clouds
61889,28,1554202800,29,1,30,Clouds
61890,29,1554202800,17,12,29,Clouds
61891,30,1554202800,19,1,20,Clouds
61892,31,1554202800,19,1,20,Clouds
61893,32,1554202800,1,29,30,Clouds
61894,33,1554202800,8,15,23,Clouds
61895,34,1554202800,30,0,30,Clouds
61896,35,1554202800,30,0,30,Clouds
61897,36,1554202800,20,20,40,Clouds
61898,37,1554202800,28,2,30,Clouds
61899,38,1554202800,40,0,40,Clouds
61900,39,1554202800,6,14,20,Clouds
61901,40,1554202800,1,20,21,Clouds
61902,41,1554202800,19,1,20,Clouds
61903,42,1554202800,30,0,30,Clouds
61904,43,1554202800,30,0,30,Clouds
61905,44,1554202800,30,0,30,Clouds
61906,45,1554202800,30,0,30,Clouds
61907,46,1554202800,15,5,20,Clouds
61908,47,1554202800,7,33,40,Clouds
61909,48,1554202800,5,35,40,Clouds
61910,49,1554202800,9,28,37,Clouds
61911,50,1554202800,40,0,40,Clouds
61912,51,1554202800,26,14,40,Clouds
61913,52,1554202800,6,26,32,Clouds
61914,53,1554202800,14,26,40,Clouds
61915,54,1554202800,9,24,33,Clouds
61916,55,1554202800,4,31,35,Clouds
61917,56,1554202800,4,34,38,Clouds
61918,57,1554202800,1,22,23,Clouds
61919,58,1554202800,0,39,39,Clouds
61920,59,1554202800,20,0,20,Clouds
61921,60,1554202800,29,1,30,Clouds
61922,61,1554202800,7,18,25,Clouds
61923,62,1554202800,4,32,36,Clouds
61924,63,1554202800,3,32,35,Clouds
61925,64,1554202800,21,19,40,Clouds
61926,65,1554202800,13,26,39,Clouds
61927,66,1554202800,18,20,38,Clouds
61928,67,1554202800,31,9,40,Clouds
61929,68,1554202800,7,29,36,Clouds
61930,69,1554202800,0,39,39,Clouds
61931,70,1554202800,1,27,28,Clouds
61932,71,1554202800,39,1,40,Clouds
61933,72,1554202800,31,0,31,Clouds
61934,73,1554202800,28,2,30,Clouds
61935,74,1554202800,28,2,30,Clouds
61936,75,1554202800,40,0,40,Clouds
61937,76,1554202800,36,2,38,Clouds
61938,77,1554202800,27,2,29,Clouds
61939,78,1554202800,38,2,40,Clouds
61940,79,1554202800,26,1,27,Clouds
61941,80,1554202800,40,0,40,Clouds
61942,81,1554202800,40,0,40,Clouds
61943,82,1554202800,22,0,22,Clouds
61944,83,1554202800,40,0,40,Clouds
61945,84,1554202800,29,1,30,Clouds
61946,85,1554202800,35,0,35,Clouds
61947,86,1554202800,38,0,38,Clouds
61948,87,1554202800,38,0,38,Clouds
61949,88,1554202800,30,0,30,Clouds
61950,89,1554202800,18,22,40,Clouds
61951,90,1554202800,0,39,39,Clouds
61952,91,1554202800,14,16,30,Clouds
61953,92,1554202800,37,3,40,Clouds
61954,93,1554202800,40,0,40,Clouds
61955,94,1554202800,40,0,40,Clouds
61956,95,1554202800,36,4,40,Clouds
61957,96,1554202800,30,0,30,Clouds
61958,97,1554202800,40,0,40,Clouds
61959,98,1554202800,30,10,40,Clouds
61960,99,1554202800,5,25,30,Clouds
61961,100,1554202800,25,0,25,Clouds
61962,101,1554202800,30,0,30,Clouds
61963,102,1554202800,40,0,40,Clouds
61964,103,1554202800,31,9,40,Clouds
61965,104,1554202800,40,0,40,Clouds
61966,105,1554202800,36,0,36,Clouds
61967,106,1554202800,40,0,40,Clouds
61968,107,1554202800,40,0,40,Clouds
61969,108,1554202800,40,0,40,Clouds
61970,109,1554202800,29,0,29,Clouds
61971,110,1554202800,40,0,40,Clouds
61972,111,1554202800,40,0,40,Clouds
61973,112,1554202800,30,0,30,Clouds
61974,113,1554202800,11,29,40,Clouds
61975,114,1554202800,0,39,39,Clouds
61976,115,1554202800,30,0,30,Clouds
61977,2,1554206400,9,11,20,Clouds
61978,3,1554206400,18,2,20,Clouds
61979,4,1554206400,16,4,20,Clouds
61980,5,1554206400,38,2,40,Clouds
61981,6,1554206400,20,0,20,Clouds
61982,7,1554206400,28,1,29,Clouds
61983,8,1554206400,18,12,30,Clouds
61984,9,1554206400,0,23,23,Clouds
61985,10,1554206400,1,15,16,Clouds
61986,11,1554206400,9,20,29,Clouds
61987,12,1554206400,14,6,20,Clouds
61988,13,1554206400,2,28,30,Clouds
61989,14,1554206400,0,30,30,Clouds
61990,15,1554206400,16,0,16,Clouds
61991,16,1554206400,9,10,19,Clouds
61992,17,1554206400,20,0,20,Clouds
61993,18,1554206400,27,3,30,Clouds
61994,19,1554206400,3,27,30,Clouds
61995,21,1554206400,0,30,30,Clouds
61996,22,1554206400,13,7,20,Clouds
61997,23,1554206400,26,2,28,Clouds
61998,24,1554206400,19,1,20,Clouds
61999,25,1554206400,0,30,30,Clouds
62000,26,1554206400,0,19,19,Clouds
62001,27,1554206400,8,12,20,Clouds
62002,28,1554206400,30,0,30,Clouds
62003,29,1554206400,24,5,29,Clouds
62004,30,1554206400,20,0,20,Clouds
62005,31,1554206400,18,2,20,Clouds
62006,32,1554206400,18,12,30,Clouds
62007,33,1554206400,7,16,23,Clouds
62008,34,1554206400,27,3,30,Clouds
62009,35,1554206400,30,0,30,Clouds
62010,36,1554206400,17,23,40,Clouds
62011,37,1554206400,30,0,30,Clouds
62012,38,1554206400,39,1,40,Clouds
62013,39,1554206400,5,15,20,Clouds
62014,40,1554206400,8,13,21,Clouds
62015,41,1554206400,20,0,20,Clouds
62016,42,1554206400,30,0,30,Clouds
62017,43,1554206400,27,3,30,Clouds
62018,44,1554206400,30,0,30,Clouds
62019,45,1554206400,30,0,30,Clouds
62020,46,1554206400,16,4,20,Clouds
62021,47,1554206400,7,33,40,Clouds
62022,48,1554206400,13,27,40,Clouds
62023,49,1554206400,14,26,40,Clouds
62024,50,1554206400,39,1,40,Clouds
62025,51,1554206400,25,15,40,Clouds
62026,52,1554206400,4,28,32,Clouds
62027,53,1554206400,12,28,40,Clouds
62028,54,1554206400,7,26,33,Clouds
62029,55,1554206400,6,29,35,Clouds
62030,56,1554206400,3,35,38,Clouds
62031,57,1554206400,0,23,23,Clouds
62032,58,1554206400,0,39,39,Clouds
62033,59,1554206400,20,0,20,Clouds
62034,60,1554206400,30,0,30,Clouds
62035,61,1554206400,10,15,25,Clouds
62036,62,1554206400,4,34,38,Clouds
62037,63,1554206400,0,35,35,Clouds
62038,64,1554206400,17,23,40,Clouds
62039,65,1554206400,15,24,39,Clouds
62040,66,1554206400,21,17,38,Clouds
62041,67,1554206400,33,7,40,Clouds
62042,68,1554206400,5,35,40,Clouds
62043,69,1554206400,1,38,39,Clouds
62044,70,1554206400,1,27,28,Clouds
62045,71,1554206400,39,1,40,Clouds
62046,72,1554206400,31,0,31,Clouds
62047,73,1554206400,30,0,30,Clouds
62048,74,1554206400,30,0,30,Clouds
62049,75,1554206400,40,0,40,Clouds
62050,76,1554206400,35,3,38,Clouds
62051,77,1554206400,28,1,29,Clouds
62052,78,1554206400,35,5,40,Clouds
62053,79,1554206400,21,6,27,Clouds
62054,80,1554206400,39,1,40,Clouds
62055,81,1554206400,40,0,40,Clouds
62056,82,1554206400,22,0,22,Clouds
62057,83,1554206400,40,0,40,Clouds
62058,84,1554206400,30,0,30,Clouds
62059,85,1554206400,21,14,35,Clouds
62060,86,1554206400,37,1,38,Clouds
62061,87,1554206400,37,1,38,Clouds
62062,88,1554206400,30,0,30,Clouds
62063,89,1554206400,14,26,40,Clouds
62064,90,1554206400,3,37,40,Clouds
62065,91,1554206400,11,18,29,Clouds
62066,92,1554206400,40,0,40,Clouds
62067,93,1554206400,40,0,40,Clouds
62068,94,1554206400,40,0,40,Clouds
62069,95,1554206400,39,1,40,Clouds
62070,96,1554206400,30,0,30,Clouds
62071,97,1554206400,40,0,40,Clouds
62072,98,1554206400,29,11,40,Clouds
62073,99,1554206400,4,26,30,Clouds
62074,100,1554206400,25,0,25,Clouds
62075,101,1554206400,30,0,30,Clouds
62076,102,1554206400,38,2,40,Clouds
62077,103,1554206400,34,6,40,Clouds
62078,104,1554206400,40,0,40,Clouds
62079,105,1554206400,35,1,36,Clouds
62080,106,1554206400,40,0,40,Clouds
62081,107,1554206400,40,0,40,Clouds
62082,108,1554206400,40,0,40,Clouds
62083,109,1554206400,29,0,29,Clouds
62084,110,1554206400,40,0,40,Clouds
62085,111,1554206400,40,0,40,Clouds
62086,112,1554206400,27,3,30,Clouds
62087,113,1554206400,11,29,40,Clouds
62088,114,1554206400,4,35,39,Clouds
62089,115,1554206400,14,16,30,Clouds
62090,2,1554210000,18,2,20,Rain
62091,3,1554210000,16,4,20,Rain
62092,4,1554210000,20,0,20,Rain
62093,5,1554210000,38,2,40,Rain
62094,6,1554210000,18,2,20,Rain
62095,7,1554210000,29,0,29,Rain
62096,8,1554210000,24,6,30,Rain
62097,9,1554210000,5,18,23,Rain
62098,10,1554210000,3,13,16,Rain
62099,11,1554210000,19,11,30,Rain
62100,12,1554210000,16,4,20,Rain
62101,13,1554210000,6,24,30,Rain
62102,14,1554210000,16,14,30,Rain
62103,15,1554210000,13,3,16,Rain
62104,16,1554210000,12,7,19,Rain
62105,17,1554210000,20,0,20,Rain
62106,18,1554210000,29,1,30,Rain
62107,19,1554210000,5,25,30,Rain
62108,21,1554210000,10,20,30,Rain
62109,22,1554210000,18,2,20,Rain
62110,23,1554210000,28,2,30,Rain
62111,24,1554210000,18,2,20,Rain
62112,25,1554210000,1,29,30,Rain
62113,26,1554210000,0,19,19,Rain
62114,27,1554210000,4,16,20,Rain
62115,28,1554210000,30,0,30,Rain
62116,29,1554210000,23,6,29,Rain
62117,30,1554210000,19,1,20,Rain
62118,31,1554210000,18,2,20,Rain
62119,32,1554210000,11,19,30,Rain
62120,33,1554210000,8,15,23,Rain
62121,34,1554210000,29,1,30,Rain
62122,35,1554210000,29,1,30,Rain
62123,36,1554210000,23,17,40,Rain
62124,37,1554210000,29,1,30,Rain
62125,38,1554210000,39,1,40,Rain
62126,39,1554210000,7,13,20,Rain
62127,40,1554210000,19,2,21,Rain
62128,41,1554210000,18,2,20,Rain
62129,42,1554210000,30,0,30,Rain
62130,43,1554210000,22,8,30,Rain
62131,44,1554210000,28,2,30,Rain
62132,45,1554210000,30,0,30,Rain
62133,46,1554210000,13,7,20,Rain
62134,47,1554210000,12,28,40,Rain
62135,48,1554210000,2,38,40,Rain
62136,49,1554210000,14,26,40,Rain
62137,50,1554210000,39,1,40,Rain
62138,51,1554210000,18,22,40,Rain
62139,52,1554210000,1,31,32,Rain
62140,53,1554210000,11,29,40,Rain
62141,54,1554210000,10,23,33,Rain
62142,55,1554210000,10,26,36,Rain
62143,56,1554210000,10,28,38,Rain
62144,57,1554210000,1,22,23,Rain
62145,58,1554210000,5,34,39,Rain
62146,59,1554210000,20,0,20,Rain
62147,60,1554210000,30,0,30,Rain
62148,61,1554210000,21,4,25,Rain
62149,62,1554210000,11,29,40,Rain
62150,63,1554210000,8,27,35,Rain
62151,64,1554210000,28,12,40,Rain
62152,65,1554210000,23,17,40,Rain
62153,66,1554210000,26,14,40,Rain
62154,67,1554210000,38,2,40,Rain
62155,68,1554210000,0,40,40,Rain
62156,69,1554210000,0,39,39,Rain
62157,70,1554210000,1,27,28,Rain
62158,71,1554210000,36,4,40,Rain
62159,72,1554210000,27,4,31,Rain
62160,73,1554210000,30,0,30,Rain
62161,74,1554210000,23,7,30,Rain
62162,75,1554210000,35,5,40,Rain
62163,76,1554210000,36,2,38,Rain
62164,77,1554210000,27,2,29,Rain
62165,78,1554210000,36,4,40,Rain
62166,79,1554210000,22,5,27,Rain
62167,80,1554210000,30,10,40,Rain
62168,81,1554210000,40,0,40,Rain
62169,82,1554210000,22,0,22,Rain
62170,83,1554210000,38,2,40,Rain
62171,84,1554210000,30,0,30,Rain
62172,85,1554210000,19,16,35,Rain
62173,86,1554210000,38,0,38,Rain
62174,87,1554210000,38,0,38,Rain
62175,88,1554210000,25,5,30,Rain
62176,89,1554210000,13,27,40,Rain
62177,90,1554210000,7,33,40,Rain
62178,91,1554210000,2,27,29,Rain
62179,92,1554210000,38,2,40,Rain
62180,93,1554210000,40,0,40,Rain
62181,94,1554210000,40,0,40,Rain
62182,95,1554210000,40,0,40,Rain
62183,96,1554210000,30,0,30,Rain
62184,97,1554210000,38,2,40,Rain
62185,98,1554210000,18,22,40,Rain
62186,99,1554210000,4,26,30,Rain
62187,100,1554210000,25,0,25,Rain
62188,101,1554210000,30,0,30,Rain
62189,102,1554210000,40,0,40,Rain
62190,103,1554210000,35,5,40,Rain
62191,104,1554210000,40,0,40,Rain
62192,105,1554210000,36,0,36,Rain
62193,106,1554210000,39,1,40,Rain
62194,107,1554210000,39,1,40,Rain
62195,108,1554210000,40,0,40,Rain
62196,109,1554210000,27,2,29,Rain
62197,110,1554210000,39,1,40,Rain
62198,111,1554210000,39,1,40,Rain
62199,112,1554210000,26,4,30,Rain
62200,113,1554210000,8,32,40,Rain
62201,114,1554210000,8,32,40,Rain
62202,115,1554210000,13,17,30,Rain
62203,2,1554213600,20,0,20,Rain
62204,3,1554213600,20,0,20,Rain
62205,4,1554213600,19,1,20,Rain
62206,5,1554213600,32,8,40,Rain
62207,6,1554213600,20,0,20,Rain
62208,7,1554213600,29,0,29,Rain
62209,8,1554213600,23,7,30,Rain
62210,9,1554213600,7,16,23,Rain
62211,10,1554213600,4,12,16,Rain
62212,11,1554213600,25,5,30,Rain
62213,12,1554213600,20,0,20,Rain
62214,13,1554213600,9,21,30,Rain
62215,14,1554213600,22,8,30,Rain
62216,15,1554213600,11,5,16,Rain
62217,16,1554213600,11,8,19,Rain
62218,17,1554213600,13,7,20,Rain
62219,18,1554213600,28,2,30,Rain
62220,19,1554213600,0,30,30,Rain
62221,21,1554213600,2,28,30,Rain
62222,22,1554213600,16,4,20,Rain
62223,23,1554213600,25,5,30,Rain
62224,24,1554213600,16,4,20,Rain
62225,25,1554213600,16,14,30,Rain
62226,26,1554213600,0,19,19,Rain
62227,27,1554213600,6,13,19,Rain
62228,28,1554213600,30,0,30,Rain
62229,29,1554213600,19,10,29,Rain
62230,30,1554213600,20,0,20,Rain
62231,31,1554213600,14,6,20,Rain
62232,32,1554213600,25,5,30,Rain
62233,33,1554213600,13,10,23,Rain
62234,34,1554213600,28,2,30,Rain
62235,35,1554213600,30,0,30,Rain
62236,36,1554213600,23,17,40,Rain
62237,37,1554213600,29,1,30,Rain
62238,38,1554213600,40,0,40,Rain
62239,39,1554213600,7,13,20,Rain
62240,40,1554213600,21,0,21,Rain
62241,41,1554213600,14,6,20,Rain
62242,42,1554213600,26,4,30,Rain
62243,43,1554213600,29,1,30,Rain
62244,44,1554213600,30,0,30,Rain
62245,45,1554213600,28,2,30,Rain
62246,46,1554213600,15,5,20,Rain
62247,47,1554213600,9,31,40,Rain
62248,48,1554213600,6,34,40,Rain
62249,49,1554213600,10,30,40,Rain
62250,50,1554213600,37,3,40,Rain
62251,51,1554213600,29,11,40,Rain
62252,52,1554213600,0,32,32,Rain
62253,53,1554213600,12,28,40,Rain
62254,54,1554213600,9,24,33,Rain
62255,55,1554213600,11,25,36,Rain
62256,56,1554213600,9,29,38,Rain
62257,57,1554213600,0,23,23,Rain
62258,58,1554213600,3,36,39,Rain
62259,59,1554213600,16,4,20,Rain
62260,60,1554213600,28,2,30,Rain
62261,61,1554213600,22,3,25,Rain
62262,62,1554213600,9,31,40,Rain
62263,63,1554213600,5,30,35,Rain
62264,64,1554213600,27,13,40,Rain
62265,65,1554213600,22,18,40,Rain
62266,66,1554213600,27,13,40,Rain
62267,67,1554213600,33,7,40,Rain
62268,68,1554213600,0,40,40,Rain
62269,69,1554213600,0,39,39,Rain
62270,70,1554213600,0,28,28,Rain
62271,71,1554213600,37,3,40,Rain
62272,72,1554213600,31,0,31,Rain
62273,73,1554213600,30,0,30,Rain
62274,74,1554213600,7,23,30,Rain
62275,75,1554213600,33,7,40,Rain
62276,76,1554213600,36,2,38,Rain
62277,77,1554213600,22,7,29,Rain
62278,78,1554213600,37,3,40,Rain
62279,79,1554213600,24,3,27,Rain
62280,80,1554213600,31,9,40,Rain
62281,81,1554213600,22,18,40,Rain
62282,82,1554213600,22,0,22,Rain
62283,83,1554213600,38,2,40,Rain
62284,84,1554213600,30,0,30,Rain
62285,85,1554213600,20,15,35,Rain
62286,86,1554213600,37,1,38,Rain
62287,87,1554213600,38,0,38,Rain
62288,88,1554213600,26,4,30,Rain
62289,89,1554213600,13,27,40,Rain
62290,90,1554213600,6,34,40,Rain
62291,91,1554213600,8,21,29,Rain
62292,92,1554213600,40,0,40,Rain
62293,93,1554213600,40,0,40,Rain
62294,94,1554213600,40,0,40,Rain
62295,95,1554213600,38,2,40,Rain
62296,96,1554213600,30,0,30,Rain
62297,97,1554213600,37,3,40,Rain
62298,98,1554213600,24,16,40,Rain
62299,99,1554213600,1,29,30,Rain
62300,100,1554213600,23,2,25,Rain
62301,101,1554213600,29,1,30,Rain
62302,102,1554213600,40,0,40,Rain
62303,103,1554213600,37,3,40,Rain
62304,104,1554213600,40,0,40,Rain
62305,105,1554213600,36,0,36,Rain
62306,106,1554213600,39,1,40,Rain
62307,107,1554213600,39,1,40,Rain
62308,108,1554213600,30,10,40,Rain
62309,109,1554213600,26,3,29,Rain
62310,110,1554213600,37,3,40,Rain
62311,111,1554213600,39,1,40,Rain
62312,112,1554213600,25,5,30,Rain
62313,113,1554213600,1,39,40,Rain
62314,114,1554213600,1,39,40,Rain
62315,115,1554213600,13,17,30,Rain
62316,2,1554217200,20,0,20,Rain
62317,3,1554217200,20,0,20,Rain
62318,4,1554217200,18,2,20,Rain
62319,5,1554217200,29,11,40,Rain
62320,6,1554217200,14,6,20,Rain
62321,7,1554217200,29,0,29,Rain
62322,8,1554217200,17,13,30,Rain
62323,9,1554217200,6,17,23,Rain
62324,10,1554217200,4,12,16,Rain
62325,11,1554217200,24,6,30,Rain
62326,12,1554217200,16,4,20,Rain
62327,13,1554217200,6,24,30,Rain
62328,14,1554217200,22,8,30,Rain
62329,15,1554217200,13,3,16,Rain
62330,16,1554217200,9,10,19,Rain
62331,17,1554217200,14,6,20,Rain
62332,18,1554217200,26,4,30,Rain
62333,19,1554217200,3,27,30,Rain
62334,21,1554217200,2,28,30,Rain
62335,22,1554217200,15,5,20,Rain
62336,23,1554217200,18,12,30,Rain
62337,24,1554217200,20,0,20,Rain
62338,25,1554217200,16,14,30,Rain
62339,26,1554217200,0,20,20,Rain
62340,27,1554217200,12,8,20,Rain
62341,28,1554217200,28,2,30,Rain
62342,29,1554217200,23,6,29,Rain
62343,30,1554217200,8,12,20,Rain
62344,31,1554217200,15,5,20,Rain
62345,32,1554217200,23,7,30,Rain
62346,33,1554217200,16,7,23,Rain
62347,34,1554217200,25,5,30,Rain
62348,35,1554217200,29,1,30,Rain
62349,36,1554217200,16,24,40,Rain
62350,37,1554217200,28,2,30,Rain
62351,38,1554217200,31,9,40,Rain
62352,39,1554217200,10,10,20,Rain
62353,40,1554217200,17,4,21,Rain
62354,41,1554217200,16,4,20,Rain
62355,42,1554217200,30,0,30,Rain
62356,43,1554217200,22,8,30,Rain
62357,44,1554217200,29,1,30,Rain
62358,45,1554217200,29,1,30,Rain
62359,46,1554217200,17,3,20,Rain
62360,47,1554217200,5,35,40,Rain
62361,48,1554217200,6,34,40,Rain
62362,49,1554217200,11,29,40,Rain
62363,50,1554217200,34,6,40,Rain
62364,51,1554217200,29,11,40,Rain
62365,52,1554217200,16,16,32,Rain
62366,53,1554217200,13,27,40,Rain
62367,54,1554217200,9,24,33,Rain
62368,55,1554217200,12,24,36,Rain
62369,56,1554217200,4,36,40,Rain
62370,57,1554217200,4,19,23,Rain
62371,58,1554217200,2,38,40,Rain
62372,59,1554217200,18,2,20,Rain
62373,60,1554217200,27,3,30,Rain
62374,61,1554217200,23,2,25,Rain
62375,62,1554217200,8,32,40,Rain
62376,63,1554217200,2,33,35,Rain
62377,64,1554217200,26,14,40,Rain
62378,65,1554217200,16,24,40,Rain
62379,66,1554217200,27,13,40,Rain
62380,67,1554217200,27,13,40,Rain
62381,68,1554217200,3,37,40,Rain
62382,69,1554217200,7,33,40,Rain
62383,70,1554217200,1,27,28,Rain
62384,71,1554217200,36,4,40,Rain
62385,72,1554217200,28,3,31,Rain
62386,73,1554217200,28,2,30,Rain
62387,74,1554217200,6,24,30,Rain
62388,75,1554217200,36,4,40,Rain
62389,76,1554217200,37,1,38,Rain
62390,77,1554217200,26,3,29,Rain
62391,78,1554217200,39,1,40,Rain
62392,79,1554217200,26,1,27,Rain
62393,80,1554217200,30,10,40,Rain
62394,81,1554217200,22,18,40,Rain
62395,82,1554217200,22,0,22,Rain
62396,83,1554217200,39,1,40,Rain
62397,84,1554217200,29,1,30,Rain
62398,85,1554217200,23,12,35,Rain
62399,86,1554217200,37,1,38,Rain
62400,87,1554217200,38,0,38,Rain
62401,88,1554217200,25,5,30,Rain
62402,89,1554217200,6,34,40,Rain
62403,90,1554217200,5,35,40,Rain
62404,91,1554217200,6,23,29,Rain
62405,92,1554217200,40,0,40,Rain
62406,93,1554217200,40,0,40,Rain
62407,94,1554217200,40,0,40,Rain
62408,95,1554217200,39,1,40,Rain
62409,96,1554217200,30,0,30,Rain
62410,97,1554217200,38,2,40,Rain
62411,98,1554217200,28,12,40,Rain
62412,99,1554217200,3,27,30,Rain
62413,100,1554217200,17,8,25,Rain
62414,101,1554217200,28,2,30,Rain
62415,102,1554217200,29,11,40,Rain
62416,103,1554217200,40,0,40,Rain
62417,104,1554217200,40,0,40,Rain
62418,105,1554217200,36,0,36,Rain
62419,106,1554217200,40,0,40,Rain
62420,107,1554217200,39,1,40,Rain
62421,108,1554217200,27,13,40,Rain
62422,109,1554217200,26,3,29,Rain
62423,110,1554217200,37,3,40,Rain
62424,111,1554217200,39,1,40,Rain
62425,112,1554217200,29,1,30,Rain
62426,113,1554217200,1,39,40,Rain
62427,114,1554217200,2,38,40,Rain
62428,115,1554217200,15,15,30,Rain
62429,2,1554220800,20,0,20,Clouds
62430,3,1554220800,20,0,20,Clouds
62431,4,1554220800,13,7,20,Clouds
62432,5,1554220800,39,1,40,Clouds
62433,6,1554220800,20,0,20,Clouds
62434,7,1554220800,29,0,29,Clouds
62435,8,1554220800,10,20,30,Clouds
62436,9,1554220800,4,19,23,Clouds
62437,10,1554220800,0,16,16,Clouds
62438,11,1554220800,28,2,30,Clouds
62439,12,1554220800,17,3,20,Clouds
62440,13,1554220800,7,23,30,Clouds
62441,14,1554220800,23,7,30,Clouds
62442,15,1554220800,14,2,16,Clouds
62443,16,1554220800,13,7,20,Clouds
62444,17,1554220800,17,3,20,Clouds
62445,18,1554220800,25,5,30,Clouds
62446,19,1554220800,10,20,30,Clouds
62447,21,1554220800,4,26,30,Clouds
62448,22,1554220800,13,7,20,Clouds
62449,23,1554220800,16,14,30,Clouds
62450,24,1554220800,20,0,20,Clouds
62451,25,1554220800,14,16,30,Clouds
62452,26,1554220800,1,19,20,Clouds
62453,27,1554220800,16,4,20,Clouds
62454,28,1554220800,30,0,30,Clouds
62455,29,1554220800,26,3,29,Clouds
62456,30,1554220800,14,6,20,Clouds
62457,31,1554220800,16,4,20,Clouds
62458,32,1554220800,20,10,30,Clouds
62459,33,1554220800,5,18,23,Clouds
62460,34,1554220800,19,11,30,Clouds
62461,35,1554220800,25,5,30,Clouds
62462,36,1554220800,16,24,40,Clouds
62463,37,1554220800,29,1,30,Clouds
62464,38,1554220800,33,7,40,Clouds
62465,39,1554220800,11,9,20,Clouds
62466,40,1554220800,15,6,21,Clouds
62467,41,1554220800,14,6,20,Clouds
62468,42,1554220800,26,4,30,Clouds
62469,43,1554220800,22,8,30,Clouds
62470,44,1554220800,27,3,30,Clouds
62471,45,1554220800,23,7,30,Clouds
62472,46,1554220800,14,6,20,Clouds
62473,47,1554220800,9,31,40,Clouds
62474,48,1554220800,9,31,40,Clouds
62475,49,1554220800,6,34,40,Clouds
62476,50,1554220800,36,4,40,Clouds
62477,51,1554220800,32,8,40,Clouds
62478,52,1554220800,21,11,32,Clouds
62479,53,1554220800,13,27,40,Clouds
62480,54,1554220800,10,23,33,Clouds
62481,55,1554220800,23,13,36,Clouds
62482,56,1554220800,12,28,40,Clouds
62483,57,1554220800,4,19,23,Clouds
62484,58,1554220800,4,36,40,Clouds
62485,59,1554220800,20,0,20,Clouds
62486,60,1554220800,26,4,30,Clouds
62487,61,1554220800,25,0,25,Clouds
62488,62,1554220800,8,32,40,Clouds
62489,63,1554220800,0,35,35,Clouds
62490,64,1554220800,27,13,40,Clouds
62491,65,1554220800,16,24,40,Clouds
62492,66,1554220800,32,8,40,Clouds
62493,67,1554220800,29,11,40,Clouds
62494,68,1554220800,4,36,40,Clouds
62495,69,1554220800,13,27,40,Clouds
62496,70,1554220800,15,13,28,Clouds
62497,71,1554220800,39,1,40,Clouds
62498,72,1554220800,28,3,31,Clouds
62499,73,1554220800,27,3,30,Clouds
62500,74,1554220800,7,23,30,Clouds
62501,75,1554220800,36,4,40,Clouds
62502,76,1554220800,35,3,38,Clouds
62503,77,1554220800,27,2,29,Clouds
62504,78,1554220800,38,2,40,Clouds
62505,79,1554220800,26,1,27,Clouds
62506,80,1554220800,14,26,40,Clouds
62507,81,1554220800,22,18,40,Clouds
62508,82,1554220800,21,1,22,Clouds
62509,83,1554220800,40,0,40,Clouds
62510,84,1554220800,29,1,30,Clouds
62511,85,1554220800,22,13,35,Clouds
62512,86,1554220800,34,4,38,Clouds
62513,87,1554220800,36,2,38,Clouds
62514,88,1554220800,24,6,30,Clouds
62515,89,1554220800,7,33,40,Clouds
62516,90,1554220800,9,31,40,Clouds
62517,91,1554220800,3,26,29,Clouds
62518,92,1554220800,39,1,40,Clouds
62519,93,1554220800,39,1,40,Clouds
62520,94,1554220800,39,1,40,Clouds
62521,95,1554220800,40,0,40,Clouds
62522,96,1554220800,30,0,30,Clouds
62523,97,1554220800,36,4,40,Clouds
62524,98,1554220800,34,6,40,Clouds
62525,99,1554220800,1,29,30,Clouds
62526,100,1554220800,11,14,25,Clouds
62527,101,1554220800,30,0,30,Clouds
62528,102,1554220800,29,11,40,Clouds
62529,103,1554220800,32,8,40,Clouds
62530,104,1554220800,31,9,40,Clouds
62531,105,1554220800,36,0,36,Clouds
62532,106,1554220800,39,1,40,Clouds
62533,107,1554220800,40,0,40,Clouds
62534,108,1554220800,24,16,40,Clouds
62535,109,1554220800,25,4,29,Clouds
62536,110,1554220800,40,0,40,Clouds
62537,111,1554220800,40,0,40,Clouds
62538,112,1554220800,25,5,30,Clouds
62539,113,1554220800,1,39,40,Clouds
62540,114,1554220800,5,35,40,Clouds
62541,115,1554220800,19,11,30,Clouds
62542,2,1554224400,19,1,20,Rain
62543,3,1554224400,20,0,20,Rain
62544,4,1554224400,16,4,20,Rain
62545,5,1554224400,27,13,40,Rain
62546,6,1554224400,20,0,20,Rain
62547,7,1554224400,27,2,29,Rain
62548,8,1554224400,10,20,30,Rain
62549,9,1554224400,13,11,24,Rain
62550,10,1554224400,5,11,16,Rain
62551,11,1554224400,30,0,30,Rain
62552,12,1554224400,14,6,20,Rain
62553,13,1554224400,11,19,30,Rain
62554,14,1554224400,20,9,29,Rain
62555,15,1554224400,16,0,16,Rain
62556,16,1554224400,11,9,20,Rain
62557,17,1554224400,20,0,20,Rain
62558,18,1554224400,30,0,30,Rain
62559,19,1554224400,25,5,30,Rain
62560,21,1554224400,0,30,30,Rain
62561,22,1554224400,7,13,20,Rain
62562,23,1554224400,4,26,30,Rain
62563,24,1554224400,18,2,20,Rain
62564,25,1554224400,17,13,30,Rain
62565,26,1554224400,0,20,20,Rain
62566,27,1554224400,9,11,20,Rain
62567,28,1554224400,29,1,30,Rain
62568,29,1554224400,28,1,29,Rain
62569,30,1554224400,18,2,20,Rain
62570,31,1554224400,16,4,20,Rain
62571,32,1554224400,0,29,29,Rain
62572,33,1554224400,5,18,23,Rain
62573,34,1554224400,26,4,30,Rain
62574,35,1554224400,30,0,30,Rain
62575,36,1554224400,31,9,40,Rain
62576,37,1554224400,30,0,30,Rain
62577,38,1554224400,27,13,40,Rain
62578,39,1554224400,13,7,20,Rain
62579,40,1554224400,17,4,21,Rain
62580,41,1554224400,19,1,20,Rain
62581,42,1554224400,27,3,30,Rain
62582,43,1554224400,27,3,30,Rain
62583,44,1554224400,28,2,30,Rain
62584,45,1554224400,22,8,30,Rain
62585,46,1554224400,11,9,20,Rain
62586,47,1554224400,19,21,40,Rain
62587,48,1554224400,2,38,40,Rain
62588,49,1554224400,10,30,40,Rain
62589,50,1554224400,38,2,40,Rain
62590,51,1554224400,40,0,40,Rain
62591,52,1554224400,24,8,32,Rain
62592,53,1554224400,26,14,40,Rain
62593,54,1554224400,17,16,33,Rain
62594,55,1554224400,36,0,36,Rain
62595,56,1554224400,29,11,40,Rain
62596,57,1554224400,16,7,23,Rain
62597,58,1554224400,12,28,40,Rain
62598,59,1554224400,20,0,20,Rain
62599,60,1554224400,21,9,30,Rain
62600,61,1554224400,25,0,25,Rain
62601,62,1554224400,17,23,40,Rain
62602,63,1554224400,2,33,35,Rain
62603,64,1554224400,21,18,39,Rain
62604,65,1554224400,23,17,40,Rain
62605,66,1554224400,40,0,40,Rain
62606,67,1554224400,27,13,40,Rain
62607,68,1554224400,20,20,40,Rain
62608,69,1554224400,20,20,40,Rain
62609,70,1554224400,12,16,28,Rain
62610,71,1554224400,40,0,40,Rain
62611,72,1554224400,29,2,31,Rain
62612,73,1554224400,26,4,30,Rain
62613,74,1554224400,5,25,30,Rain
62614,75,1554224400,17,23,40,Rain
62615,76,1554224400,33,5,38,Rain
62616,77,1554224400,27,2,29,Rain
62617,78,1554224400,39,1,40,Rain
62618,79,1554224400,27,0,27,Rain
62619,80,1554224400,25,15,40,Rain
62620,81,1554224400,25,15,40,Rain
62621,82,1554224400,20,2,22,Rain
62622,83,1554224400,38,2,40,Rain
62623,84,1554224400,28,2,30,Rain
62624,85,1554224400,21,14,35,Rain
62625,86,1554224400,21,17,38,Rain
62626,87,1554224400,34,4,38,Rain
62627,88,1554224400,27,3,30,Rain
62628,89,1554224400,13,27,40,Rain
62629,90,1554224400,29,11,40,Rain
62630,91,1554224400,15,15,30,Rain
62631,92,1554224400,24,16,40,Rain
62632,93,1554224400,28,12,40,Rain
62633,94,1554224400,39,1,40,Rain
62634,95,1554224400,36,4,40,Rain
62635,96,1554224400,29,1,30,Rain
62636,97,1554224400,38,2,40,Rain
62637,98,1554224400,38,2,40,Rain
62638,99,1554224400,0,30,30,Rain
62639,100,1554224400,0,25,25,Rain
62640,101,1554224400,30,0,30,Rain
62641,102,1554224400,30,10,40,Rain
62642,103,1554224400,34,6,40,Rain
62643,104,1554224400,32,8,40,Rain
62644,105,1554224400,35,1,36,Rain
62645,106,1554224400,35,5,40,Rain
62646,107,1554224400,37,3,40,Rain
62647,108,1554224400,25,15,40,Rain
62648,109,1554224400,23,6,29,Rain
62649,110,1554224400,39,1,40,Rain
62650,111,1554224400,38,2,40,Rain
62651,112,1554224400,24,6,30,Rain
62652,113,1554224400,1,39,40,Rain
62653,114,1554224400,40,0,40,Rain
62654,115,1554224400,16,14,30,Rain
62655,2,1554228000,18,2,20,Clouds
62656,3,1554228000,15,5,20,Clouds
62657,4,1554228000,20,0,20,Clouds
62658,5,1554228000,21,19,40,Clouds
62659,6,1554228000,17,3,20,Clouds
62660,7,1554228000,22,7,29,Clouds
62661,8,1554228000,3,27,30,Clouds
62662,9,1554228000,16,8,24,Clouds
62663,10,1554228000,1,15,16,Clouds
62664,11,1554228000,30,0,30,Clouds
62665,12,1554228000,15,5,20,Clouds
62666,13,1554228000,28,2,30,Clouds
62667,14,1554228000,15,15,30,Clouds
62668,15,1554228000,15,1,16,Clouds
62669,16,1554228000,0,20,20,Clouds
62670,17,1554228000,20,0,20,Clouds
62671,18,1554228000,18,12,30,Clouds
62672,19,1554228000,30,0,30,Clouds
62673,21,1554228000,0,30,30,Clouds
62674,22,1554228000,0,20,20,Clouds
62675,23,1554228000,0,30,30,Clouds
62676,24,1554228000,17,3,20,Clouds
62677,25,1554228000,30,0,30,Clouds
62678,26,1554228000,6,14,20,Clouds
62679,27,1554228000,18,1,19,Clouds
62680,28,1554228000,29,1,30,Clouds
62681,29,1554228000,26,3,29,Clouds
62682,30,1554228000,17,3,20,Clouds
62683,31,1554228000,10,10,20,Clouds
62684,32,1554228000,0,29,29,Clouds
62685,33,1554228000,0,23,23,Clouds
62686,34,1554228000,5,25,30,Clouds
62687,35,1554228000,29,1,30,Clouds
62688,36,1554228000,40,0,40,Clouds
62689,37,1554228000,30,0,30,Clouds
62690,38,1554228000,26,14,40,Clouds
62691,39,1554228000,20,0,20,Clouds
62692,40,1554228000,21,0,21,Clouds
62693,41,1554228000,20,0,20,Clouds
62694,42,1554228000,25,5,30,Clouds
62695,43,1554228000,13,17,30,Clouds
62696,44,1554228000,19,11,30,Clouds
62697,45,1554228000,18,12,30,Clouds
62698,46,1554228000,16,4,20,Clouds
62699,47,1554228000,39,1,40,Clouds
62700,48,1554228000,0,40,40,Clouds
62701,49,1554228000,19,21,40,Clouds
62702,50,1554228000,21,19,40,Clouds
62703,51,1554228000,36,4,40,Clouds
62704,52,1554228000,31,1,32,Clouds
62705,53,1554228000,39,1,40,Clouds
62706,54,1554228000,32,1,33,Clouds
62707,55,1554228000,36,0,36,Clouds
62708,56,1554228000,36,4,40,Clouds
62709,57,1554228000,23,0,23,Clouds
62710,58,1554228000,38,2,40,Clouds
62711,59,1554228000,17,3,20,Clouds
62712,60,1554228000,25,5,30,Clouds
62713,61,1554228000,24,1,25,Clouds
62714,62,1554228000,36,4,40,Clouds
62715,63,1554228000,2,33,35,Clouds
62716,64,1554228000,10,29,39,Clouds
62717,65,1554228000,40,0,40,Clouds
62718,66,1554228000,38,2,40,Clouds
62719,67,1554228000,37,3,40,Clouds
62720,68,1554228000,40,0,40,Clouds
62721,69,1554228000,40,0,40,Clouds
62722,70,1554228000,26,2,28,Clouds
62723,71,1554228000,34,6,40,Clouds
62724,72,1554228000,27,4,31,Clouds
62725,73,1554228000,24,6,30,Clouds
62726,74,1554228000,12,18,30,Clouds
62727,75,1554228000,14,26,40,Clouds
62728,76,1554228000,15,23,38,Clouds
62729,77,1554228000,28,1,29,Clouds
62730,78,1554228000,35,5,40,Clouds
62731,79,1554228000,27,0,27,Clouds
62732,80,1554228000,24,16,40,Clouds
62733,81,1554228000,28,12,40,Clouds
62734,82,1554228000,16,6,22,Clouds
62735,83,1554228000,32,8,40,Clouds
62736,84,1554228000,21,9,30,Clouds
62737,85,1554228000,17,18,35,Clouds
62738,86,1554228000,5,33,38,Clouds
62739,87,1554228000,32,6,38,Clouds
62740,88,1554228000,23,7,30,Clouds
62741,89,1554228000,30,10,40,Clouds
62742,90,1554228000,40,0,40,Clouds
62743,91,1554228000,5,25,30,Clouds
62744,92,1554228000,3,37,40,Clouds
62745,93,1554228000,0,40,40,Clouds
62746,94,1554228000,10,30,40,Clouds
62747,95,1554228000,30,10,40,Clouds
62748,96,1554228000,24,6,30,Clouds
62749,97,1554228000,31,9,40,Clouds
62750,98,1554228000,40,0,40,Clouds
62751,99,1554228000,5,25,30,Clouds
62752,100,1554228000,0,25,25,Clouds
62753,101,1554228000,24,6,30,Clouds
62754,102,1554228000,31,9,40,Clouds
62755,103,1554228000,39,1,40,Clouds
62756,104,1554228000,31,9,40,Clouds
62757,105,1554228000,35,1,36,Clouds
62758,106,1554228000,36,4,40,Clouds
62759,107,1554228000,34,6,40,Clouds
62760,108,1554228000,20,20,40,Clouds
62761,109,1554228000,26,3,29,Clouds
62762,110,1554228000,38,2,40,Clouds
62763,111,1554228000,38,2,40,Clouds
62764,112,1554228000,19,11,30,Clouds
62765,113,1554228000,19,21,40,Clouds
62766,114,1554228000,40,0,40,Clouds
62767,115,1554228000,10,20,30,Clouds
62768,2,1554231600,11,9,20,Clouds
62769,3,1554231600,20,0,20,Clouds
62770,4,1554231600,19,1,20,Clouds
62771,5,1554231600,31,9,40,Clouds
62772,6,1554231600,18,2,20,Clouds
62773,7,1554231600,18,11,29,Clouds
62774,8,1554231600,10,20,30,Clouds
62775,9,1554231600,12,12,24,Clouds
62776,10,1554231600,1,15,16,Clouds
62777,11,1554231600,29,1,30,Clouds
62778,12,1554231600,10,10,20,Clouds
62779,13,1554231600,30,0,30,Clouds
62780,14,1554231600,19,11,30,Clouds
62781,15,1554231600,16,0,16,Clouds
62782,16,1554231600,2,18,20,Clouds
62783,17,1554231600,20,0,20,Clouds
62784,18,1554231600,13,17,30,Clouds
62785,19,1554231600,30,0,30,Clouds
62786,21,1554231600,8,22,30,Clouds
62787,22,1554231600,0,20,20,Clouds
62788,23,1554231600,2,28,30,Clouds
62789,24,1554231600,15,5,20,Clouds
62790,25,1554231600,30,0,30,Clouds
62791,26,1554231600,14,6,20,Clouds
62792,27,1554231600,20,0,20,Clouds
62793,28,1554231600,19,11,30,Clouds
62794,29,1554231600,29,0,29,Clouds
62795,30,1554231600,19,1,20,Clouds
62796,31,1554231600,18,2,20,Clouds
62797,32,1554231600,1,28,29,Clouds
62798,33,1554231600,6,17,23,Clouds
62799,34,1554231600,0,29,29,Clouds
62800,35,1554231600,25,5,30,Clouds
62801,36,1554231600,40,0,40,Clouds
62802,37,1554231600,30,0,30,Clouds
62803,38,1554231600,21,19,40,Clouds
62804,39,1554231600,20,0,20,Clouds
62805,40,1554231600,16,5,21,Clouds
62806,41,1554231600,19,1,20,Clouds
62807,42,1554231600,16,14,30,Clouds
62808,43,1554231600,16,14,30,Clouds
62809,44,1554231600,18,12,30,Clouds
62810,45,1554231600,13,17,30,Clouds
62811,46,1554231600,3,17,20,Clouds
62812,47,1554231600,40,0,40,Clouds
62813,48,1554231600,1,39,40,Clouds
62814,49,1554231600,32,8,40,Clouds
62815,50,1554231600,23,17,40,Clouds
62816,51,1554231600,38,2,40,Clouds
62817,52,1554231600,32,0,32,Clouds
62818,53,1554231600,39,1,40,Clouds
62819,54,1554231600,33,0,33,Clouds
62820,55,1554231600,36,0,36,Clouds
62821,56,1554231600,40,0,40,Clouds
62822,57,1554231600,21,2,23,Clouds
62823,58,1554231600,39,1,40,Clouds
62824,59,1554231600,17,3,20,Clouds
62825,60,1554231600,20,10,30,Clouds
62826,61,1554231600,23,2,25,Clouds
62827,62,1554231600,40,0,40,Clouds
62828,63,1554231600,11,24,35,Clouds
62829,64,1554231600,5,34,39,Clouds
62830,65,1554231600,38,2,40,Clouds
62831,66,1554231600,34,6,40,Clouds
62832,67,1554231600,38,2,40,Clouds
62833,68,1554231600,39,1,40,Clouds
62834,69,1554231600,40,0,40,Clouds
62835,70,1554231600,27,1,28,Clouds
62836,71,1554231600,37,3,40,Clouds
62837,72,1554231600,6,25,31,Clouds
62838,73,1554231600,25,5,30,Clouds
62839,74,1554231600,7,23,30,Clouds
62840,75,1554231600,7,33,40,Clouds
62841,76,1554231600,9,29,38,Clouds
62842,77,1554231600,28,1,29,Clouds
62843,78,1554231600,32,8,40,Clouds
62844,79,1554231600,24,3,27,Clouds
62845,80,1554231600,26,14,40,Clouds
62846,81,1554231600,30,10,40,Clouds
62847,82,1554231600,14,8,22,Clouds
62848,83,1554231600,23,17,40,Clouds
62849,84,1554231600,18,12,30,Clouds
62850,85,1554231600,8,27,35,Clouds
62851,86,1554231600,1,37,38,Clouds
62852,87,1554231600,28,10,38,Clouds
62853,88,1554231600,15,15,30,Clouds
62854,89,1554231600,40,0,40,Clouds
62855,90,1554231600,40,0,40,Clouds
62856,91,1554231600,1,29,30,Clouds
62857,92,1554231600,0,40,40,Clouds
62858,93,1554231600,0,40,40,Clouds
62859,94,1554231600,10,30,40,Clouds
62860,95,1554231600,23,17,40,Clouds
62861,96,1554231600,23,7,30,Clouds
62862,97,1554231600,21,19,40,Clouds
62863,98,1554231600,40,0,40,Clouds
62864,99,1554231600,19,11,30,Clouds
62865,100,1554231600,12,13,25,Clouds
62866,101,1554231600,21,9,30,Clouds
62867,102,1554231600,33,7,40,Clouds
62868,103,1554231600,40,0,40,Clouds
62869,104,1554231600,34,6,40,Clouds
62870,105,1554231600,35,1,36,Clouds
62871,106,1554231600,34,6,40,Clouds
62872,107,1554231600,35,5,40,Clouds
62873,108,1554231600,18,22,40,Clouds
62874,109,1554231600,20,9,29,Clouds
62875,110,1554231600,33,7,40,Clouds
62876,111,1554231600,36,4,40,Clouds
62877,112,1554231600,13,17,30,Clouds
62878,113,1554231600,32,8,40,Clouds
62879,114,1554231600,40,0,40,Clouds
62880,115,1554231600,0,30,30,Clouds
62881,2,1554235200,9,10,19,Clouds
62882,3,1554235200,20,0,20,Clouds
62883,4,1554235200,18,2,20,Clouds
62884,5,1554235200,29,11,40,Clouds
62885,6,1554235200,11,9,20,Clouds
62886,7,1554235200,18,11,29,Clouds
62887,8,1554235200,22,8,30,Clouds
62888,9,1554235200,20,4,24,Clouds
62889,10,1554235200,5,11,16,Clouds
62890,11,1554235200,30,0,30,Clouds
62891,12,1554235200,6,14,20,Clouds
62892,13,1554235200,29,1,30,Clouds
62893,14,1554235200,13,17,30,Clouds
62894,15,1554235200,16,0,16,Clouds
62895,16,1554235200,1,19,20,Clouds
62896,17,1554235200,19,1,20,Clouds
62897,18,1554235200,18,12,30,Clouds
62898,19,1554235200,30,0,30,Clouds
62899,21,1554235200,22,8,30,Clouds
62900,22,1554235200,0,20,20,Clouds
62901,23,1554235200,19,11,30,Clouds
62902,24,1554235200,12,8,20,Clouds
62903,25,1554235200,30,0,30,Clouds
62904,26,1554235200,18,2,20,Clouds
62905,27,1554235200,19,1,20,Clouds
62906,28,1554235200,5,25,30,Clouds
62907,29,1554235200,29,0,29,Clouds
62908,30,1554235200,20,0,20,Clouds
62909,31,1554235200,18,2,20,Clouds
62910,32,1554235200,2,27,29,Clouds
62911,33,1554235200,1,22,23,Clouds
62912,34,1554235200,9,21,30,Clouds
62913,35,1554235200,20,10,30,Clouds
62914,36,1554235200,40,0,40,Clouds
62915,37,1554235200,30,0,30,Clouds
62916,38,1554235200,27,13,40,Clouds
62917,39,1554235200,17,3,20,Clouds
62918,40,1554235200,21,0,21,Clouds
62919,41,1554235200,20,0,20,Clouds
62920,42,1554235200,11,19,30,Clouds
62921,43,1554235200,12,18,30,Clouds
62922,44,1554235200,14,16,30,Clouds
62923,45,1554235200,10,20,30,Clouds
62924,46,1554235200,4,16,20,Clouds
62925,47,1554235200,40,0,40,Clouds
62926,48,1554235200,9,31,40,Clouds
62927,49,1554235200,34,6,40,Clouds
62928,50,1554235200,24,16,40,Clouds
62929,51,1554235200,24,16,40,Clouds
62930,52,1554235200,32,0,32,Clouds
62931,53,1554235200,40,0,40,Clouds
62932,54,1554235200,33,0,33,Clouds
62933,55,1554235200,35,1,36,Clouds
62934,56,1554235200,40,0,40,Clouds
62935,57,1554235200,21,2,23,Clouds
62936,58,1554235200,37,3,40,Clouds
62937,59,1554235200,19,1,20,Clouds
62938,60,1554235200,14,16,30,Clouds
62939,61,1554235200,25,0,25,Clouds
62940,62,1554235200,40,0,40,Clouds
62941,63,1554235200,15,20,35,Clouds
62942,64,1554235200,4,35,39,Clouds
62943,65,1554235200,40,0,40,Clouds
62944,66,1554235200,39,1,40,Clouds
62945,67,1554235200,37,3,40,Clouds
62946,68,1554235200,40,0,40,Clouds
62947,69,1554235200,40,0,40,Clouds
62948,70,1554235200,24,4,28,Clouds
62949,71,1554235200,40,0,40,Clouds
62950,72,1554235200,4,27,31,Clouds
62951,73,1554235200,18,12,30,Clouds
62952,74,1554235200,16,14,30,Clouds
62953,75,1554235200,8,32,40,Clouds
62954,76,1554235200,12,26,38,Clouds
62955,77,1554235200,29,0,29,Clouds
62956,78,1554235200,32,8,40,Clouds
62957,79,1554235200,5,22,27,Clouds
62958,80,1554235200,24,16,40,Clouds
62959,81,1554235200,30,10,40,Clouds
62960,82,1554235200,11,11,22,Clouds
62961,83,1554235200,22,18,40,Clouds
62962,84,1554235200,14,16,30,Clouds
62963,85,1554235200,6,29,35,Clouds
62964,86,1554235200,1,37,38,Clouds
62965,87,1554235200,21,17,38,Clouds
62966,88,1554235200,8,22,30,Clouds
62967,89,1554235200,40,0,40,Clouds
62968,90,1554235200,40,0,40,Clouds
62969,91,1554235200,4,26,30,Clouds
62970,92,1554235200,3,37,40,Clouds
62971,93,1554235200,0,40,40,Clouds
62972,94,1554235200,9,31,40,Clouds
62973,95,1554235200,15,25,40,Clouds
62974,96,1554235200,21,9,30,Clouds
62975,97,1554235200,15,25,40,Clouds
62976,98,1554235200,40,0,40,Clouds
62977,99,1554235200,24,6,30,Clouds
62978,100,1554235200,1,24,25,Clouds
62979,101,1554235200,17,13,30,Clouds
62980,102,1554235200,32,8,40,Clouds
62981,103,1554235200,39,1,40,Clouds
62982,104,1554235200,38,2,40,Clouds
62983,105,1554235200,35,1,36,Clouds
62984,106,1554235200,33,7,40,Clouds
62985,107,1554235200,32,8,40,Clouds
62986,108,1554235200,17,23,40,Clouds
62987,109,1554235200,11,18,29,Clouds
62988,110,1554235200,26,14,40,Clouds
62989,111,1554235200,32,8,40,Clouds
62990,112,1554235200,1,29,30,Clouds
62991,113,1554235200,38,2,40,Clouds
62992,114,1554235200,38,2,40,Clouds
62993,115,1554235200,0,30,30,Clouds
62994,2,1554238800,8,11,19,Clouds
62995,3,1554238800,19,1,20,Clouds
62996,4,1554238800,18,2,20,Clouds
62997,5,1554238800,29,11,40,Clouds
62998,6,1554238800,11,9,20,Clouds
62999,7,1554238800,22,7,29,Clouds
63000,8,1554238800,30,0,30,Clouds
63001,9,1554238800,23,1,24,Clouds
63002,10,1554238800,10,6,16,Clouds
63003,11,1554238800,30,0,30,Clouds
63004,12,1554238800,9,11,20,Clouds
63005,13,1554238800,30,0,30,Clouds
63006,14,1554238800,19,11,30,Clouds
63007,15,1554238800,16,0,16,Clouds
63008,16,1554238800,1,19,20,Clouds
63009,17,1554238800,16,4,20,Clouds
63010,18,1554238800,19,11,30,Clouds
63011,19,1554238800,28,2,30,Clouds
63012,21,1554238800,26,4,30,Clouds
63013,22,1554238800,2,18,20,Clouds
63014,23,1554238800,18,12,30,Clouds
63015,24,1554238800,15,5,20,Clouds
63016,25,1554238800,30,0,30,Clouds
63017,26,1554238800,19,1,20,Clouds
63018,27,1554238800,19,1,20,Clouds
63019,28,1554238800,3,27,30,Clouds
63020,29,1554238800,19,10,29,Clouds
63021,30,1554238800,18,2,20,Clouds
63022,31,1554238800,20,0,20,Clouds
63023,32,1554238800,12,17,29,Clouds
63024,33,1554238800,6,17,23,Clouds
63025,34,1554238800,1,29,30,Clouds
63026,35,1554238800,24,6,30,Clouds
63027,36,1554238800,40,0,40,Clouds
63028,37,1554238800,30,0,30,Clouds
63029,38,1554238800,29,11,40,Clouds
63030,39,1554238800,20,0,20,Clouds
63031,40,1554238800,19,2,21,Clouds
63032,41,1554238800,17,3,20,Clouds
63033,42,1554238800,8,22,30,Clouds
63034,43,1554238800,9,21,30,Clouds
63035,44,1554238800,9,21,30,Clouds
63036,45,1554238800,13,17,30,Clouds
63037,46,1554238800,11,9,20,Clouds
63038,47,1554238800,40,0,40,Clouds
63039,48,1554238800,30,10,40,Clouds
63040,49,1554238800,36,4,40,Clouds
63041,50,1554238800,20,20,40,Clouds
63042,51,1554238800,30,10,40,Clouds
63043,52,1554238800,32,0,32,Clouds
63044,53,1554238800,40,0,40,Clouds
63045,54,1554238800,32,1,33,Clouds
63046,55,1554238800,36,0,36,Clouds
63047,56,1554238800,40,0,40,Clouds
63048,57,1554238800,22,1,23,Clouds
63049,58,1554238800,36,4,40,Clouds
63050,59,1554238800,20,0,20,Clouds
63051,60,1554238800,10,20,30,Clouds
63052,61,1554238800,25,0,25,Clouds
63053,62,1554238800,40,0,40,Clouds
63054,63,1554238800,20,15,35,Clouds
63055,64,1554238800,7,32,39,Clouds
63056,65,1554238800,40,0,40,Clouds
63057,66,1554238800,34,6,40,Clouds
63058,67,1554238800,34,6,40,Clouds
63059,68,1554238800,38,2,40,Clouds
63060,69,1554238800,38,2,40,Clouds
63061,70,1554238800,24,4,28,Clouds
63062,71,1554238800,40,0,40,Clouds
63063,72,1554238800,0,31,31,Clouds
63064,73,1554238800,17,13,30,Clouds
63065,74,1554238800,16,14,30,Clouds
63066,75,1554238800,5,35,40,Clouds
63067,76,1554238800,13,25,38,Clouds
63068,77,1554238800,26,3,29,Clouds
63069,78,1554238800,29,11,40,Clouds
63070,79,1554238800,5,22,27,Clouds
63071,80,1554238800,24,16,40,Clouds
63072,81,1554238800,31,9,40,Clouds
63073,82,1554238800,11,11,22,Clouds
63074,83,1554238800,16,24,40,Clouds
63075,84,1554238800,9,21,30,Clouds
63076,85,1554238800,0,35,35,Clouds
63077,86,1554238800,0,38,38,Clouds
63078,87,1554238800,18,20,38,Clouds
63079,88,1554238800,2,28,30,Clouds
63080,89,1554238800,40,0,40,Clouds
63081,90,1554238800,39,1,40,Clouds
63082,91,1554238800,0,30,30,Clouds
63083,92,1554238800,0,40,40,Clouds
63084,93,1554238800,0,40,40,Clouds
63085,94,1554238800,3,37,40,Clouds
63086,95,1554238800,12,28,40,Clouds
63087,96,1554238800,19,11,30,Clouds
63088,97,1554238800,16,24,40,Clouds
63089,98,1554238800,40,0,40,Clouds
63090,99,1554238800,30,0,30,Clouds
63091,100,1554238800,0,25,25,Clouds
63092,101,1554238800,15,15,30,Clouds
63093,102,1554238800,29,11,40,Clouds
63094,103,1554238800,40,0,40,Clouds
63095,104,1554238800,38,2,40,Clouds
63096,105,1554238800,35,1,36,Clouds
63097,106,1554238800,33,7,40,Clouds
63098,107,1554238800,31,9,40,Clouds
63099,108,1554238800,14,26,40,Clouds
63100,109,1554238800,4,25,29,Clouds
63101,110,1554238800,22,18,40,Clouds
63102,111,1554238800,32,8,40,Clouds
63103,112,1554238800,1,29,30,Clouds
63104,113,1554238800,40,0,40,Clouds
63105,114,1554238800,37,3,40,Clouds
63106,115,1554238800,0,30,30,Clouds
63107,2,1554242400,7,12,19,Clouds
63108,3,1554242400,13,7,20,Clouds
63109,4,1554242400,19,1,20,Clouds
63110,5,1554242400,25,15,40,Clouds
63111,6,1554242400,12,8,20,Clouds
63112,7,1554242400,21,8,29,Clouds
63113,8,1554242400,29,1,30,Clouds
63114,9,1554242400,24,0,24,Clouds
63115,10,1554242400,13,3,16,Clouds
63116,11,1554242400,30,0,30,Clouds
63117,12,1554242400,8,12,20,Clouds
63118,13,1554242400,30,0,30,Clouds
63119,14,1554242400,21,9,30,Clouds
63120,15,1554242400,15,1,16,Clouds
63121,16,1554242400,4,16,20,Clouds
63122,17,1554242400,20,0,20,Clouds
63123,18,1554242400,24,6,30,Clouds
63124,19,1554242400,30,0,30,Clouds
63125,21,1554242400,30,0,30,Clouds
63126,22,1554242400,6,14,20,Clouds
63127,23,1554242400,16,14,30,Clouds
63128,24,1554242400,17,3,20,Clouds
63129,25,1554242400,30,0,30,Clouds
63130,26,1554242400,20,0,20,Clouds
63131,27,1554242400,20,0,20,Clouds
63132,28,1554242400,0,30,30,Clouds
63133,29,1554242400,20,9,29,Clouds
63134,30,1554242400,20,0,20,Clouds
63135,31,1554242400,13,7,20,Clouds
63136,32,1554242400,17,12,29,Clouds
63137,33,1554242400,8,15,23,Clouds
63138,34,1554242400,2,28,30,Clouds
63139,35,1554242400,26,4,30,Clouds
63140,36,1554242400,40,0,40,Clouds
63141,37,1554242400,30,0,30,Clouds
63142,38,1554242400,27,13,40,Clouds
63143,39,1554242400,17,3,20,Clouds
63144,40,1554242400,21,0,21,Clouds
63145,41,1554242400,20,0,20,Clouds
63146,42,1554242400,6,24,30,Clouds
63147,43,1554242400,7,23,30,Clouds
63148,44,1554242400,6,24,30,Clouds
63149,45,1554242400,11,19,30,Clouds
63150,46,1554242400,10,10,20,Clouds
63151,47,1554242400,40,0,40,Clouds
63152,48,1554242400,40,0,40,Clouds
63153,49,1554242400,39,1,40,Clouds
63154,50,1554242400,14,26,40,Clouds
63155,51,1554242400,36,4,40,Clouds
63156,52,1554242400,32,0,32,Clouds
63157,53,1554242400,40,0,40,Clouds
63158,54,1554242400,32,1,33,Clouds
63159,55,1554242400,36,0,36,Clouds
63160,56,1554242400,37,3,40,Clouds
63161,57,1554242400,22,1,23,Clouds
63162,58,1554242400,39,1,40,Clouds
63163,59,1554242400,19,1,20,Clouds
63164,60,1554242400,2,28,30,Clouds
63165,61,1554242400,25,0,25,Clouds
63166,62,1554242400,39,1,40,Clouds
63167,63,1554242400,27,8,35,Clouds
63168,64,1554242400,9,30,39,Clouds
63169,65,1554242400,40,0,40,Clouds
63170,66,1554242400,40,0,40,Clouds
63171,67,1554242400,26,14,40,Clouds
63172,68,1554242400,38,2,40,Clouds
63173,69,1554242400,40,0,40,Clouds
63174,70,1554242400,26,2,28,Clouds
63175,71,1554242400,35,5,40,Clouds
63176,72,1554242400,2,29,31,Clouds
63177,73,1554242400,12,18,30,Clouds
63178,74,1554242400,14,16,30,Clouds
63179,75,1554242400,6,34,40,Clouds
63180,76,1554242400,10,28,38,Clouds
63181,77,1554242400,26,3,29,Clouds
63182,78,1554242400,25,15,40,Clouds
63183,79,1554242400,5,22,27,Clouds
63184,80,1554242400,21,19,40,Clouds
63185,81,1554242400,30,10,40,Clouds
63186,82,1554242400,13,9,22,Clouds
63187,83,1554242400,14,26,40,Clouds
63188,84,1554242400,3,27,30,Clouds
63189,85,1554242400,0,35,35,Clouds
63190,86,1554242400,1,37,38,Clouds
63191,87,1554242400,15,23,38,Clouds
63192,88,1554242400,2,28,30,Clouds
63193,89,1554242400,40,0,40,Clouds
63194,90,1554242400,39,1,40,Clouds
63195,91,1554242400,0,30,30,Clouds
63196,92,1554242400,18,22,40,Clouds
63197,93,1554242400,0,40,40,Clouds
63198,94,1554242400,3,37,40,Clouds
63199,95,1554242400,8,32,40,Clouds
63200,96,1554242400,19,11,30,Clouds
63201,97,1554242400,16,24,40,Clouds
63202,98,1554242400,40,0,40,Clouds
63203,99,1554242400,28,2,30,Clouds
63204,100,1554242400,1,24,25,Clouds
63205,101,1554242400,13,17,30,Clouds
63206,102,1554242400,30,10,40,Clouds
63207,103,1554242400,34,6,40,Clouds
63208,104,1554242400,39,1,40,Clouds
63209,105,1554242400,34,2,36,Clouds
63210,106,1554242400,31,9,40,Clouds
63211,107,1554242400,12,28,40,Clouds
63212,108,1554242400,15,25,40,Clouds
63213,109,1554242400,0,29,29,Clouds
63214,110,1554242400,23,17,40,Clouds
63215,111,1554242400,24,16,40,Clouds
63216,112,1554242400,0,30,30,Clouds
63217,113,1554242400,40,0,40,Clouds
63218,114,1554242400,39,1,40,Clouds
63219,115,1554242400,0,30,30,Clouds
63220,2,1554246000,4,15,19,Clouds
63221,3,1554246000,12,8,20,Clouds
63222,4,1554246000,19,1,20,Clouds
63223,5,1554246000,7,33,40,Clouds
63224,6,1554246000,14,6,20,Clouds
63225,7,1554246000,19,10,29,Clouds
63226,8,1554246000,30,0,30,Clouds
63227,9,1554246000,16,8,24,Clouds
63228,10,1554246000,16,0,16,Clouds
63229,11,1554246000,30,0,30,Clouds
63230,12,1554246000,7,13,20,Clouds
63231,13,1554246000,29,1,30,Clouds
63232,14,1554246000,28,2,30,Clouds
63233,15,1554246000,14,2,16,Clouds
63234,16,1554246000,6,14,20,Clouds
63235,17,1554246000,20,0,20,Clouds
63236,18,1554246000,27,3,30,Clouds
63237,19,1554246000,28,2,30,Clouds
63238,21,1554246000,30,0,30,Clouds
63239,22,1554246000,10,10,20,Clouds
63240,23,1554246000,17,13,30,Clouds
63241,24,1554246000,19,1,20,Clouds
63242,25,1554246000,30,0,30,Clouds
63243,26,1554246000,20,0,20,Clouds
63244,27,1554246000,20,0,20,Clouds
63245,28,1554246000,2,28,30,Clouds
63246,29,1554246000,21,8,29,Clouds
63247,30,1554246000,20,0,20,Clouds
63248,31,1554246000,7,13,20,Clouds
63249,32,1554246000,24,5,29,Clouds
63250,33,1554246000,9,14,23,Clouds
63251,34,1554246000,13,16,29,Clouds
63252,35,1554246000,28,2,30,Clouds
63253,36,1554246000,40,0,40,Clouds
63254,37,1554246000,30,0,30,Clouds
63255,38,1554246000,23,17,40,Clouds
63256,39,1554246000,20,0,20,Clouds
63257,40,1554246000,18,3,21,Clouds
63258,41,1554246000,20,0,20,Clouds
63259,42,1554246000,5,25,30,Clouds
63260,43,1554246000,6,24,30,Clouds
63261,44,1554246000,7,23,30,Clouds
63262,45,1554246000,8,22,30,Clouds
63263,46,1554246000,13,7,20,Clouds
63264,47,1554246000,40,0,40,Clouds
63265,48,1554246000,40,0,40,Clouds
63266,49,1554246000,39,1,40,Clouds
63267,50,1554246000,11,29,40,Clouds
63268,51,1554246000,31,9,40,Clouds
63269,52,1554246000,32,0,32,Clouds
63270,53,1554246000,40,0,40,Clouds
63271,54,1554246000,33,0,33,Clouds
63272,55,1554246000,36,0,36,Clouds
63273,56,1554246000,37,3,40,Clouds
63274,57,1554246000,20,3,23,Clouds
63275,58,1554246000,38,2,40,Clouds
63276,59,1554246000,20,0,20,Clouds
63277,60,1554246000,1,29,30,Clouds
63278,61,1554246000,24,1,25,Clouds
63279,62,1554246000,40,0,40,Clouds
63280,63,1554246000,31,4,35,Clouds
63281,64,1554246000,26,14,40,Clouds
63282,65,1554246000,39,1,40,Clouds
63283,66,1554246000,36,4,40,Clouds
63284,67,1554246000,29,11,40,Clouds
63285,68,1554246000,39,1,40,Clouds
63286,69,1554246000,38,2,40,Clouds
63287,70,1554246000,21,7,28,Clouds
63288,71,1554246000,37,3,40,Clouds
63289,72,1554246000,2,29,31,Clouds
63290,73,1554246000,8,22,30,Clouds
63291,74,1554246000,17,13,30,Clouds
63292,75,1554246000,5,35,40,Clouds
63293,76,1554246000,8,30,38,Clouds
63294,77,1554246000,25,4,29,Clouds
63295,78,1554246000,24,16,40,Clouds
63296,79,1554246000,5,22,27,Clouds
63297,80,1554246000,21,19,40,Clouds
63298,81,1554246000,32,8,40,Clouds
63299,82,1554246000,11,11,22,Clouds
63300,83,1554246000,13,27,40,Clouds
63301,84,1554246000,3,27,30,Clouds
63302,85,1554246000,7,28,35,Clouds
63303,86,1554246000,0,38,38,Clouds
63304,87,1554246000,14,24,38,Clouds
63305,88,1554246000,2,28,30,Clouds
63306,89,1554246000,40,0,40,Clouds
63307,90,1554246000,40,0,40,Clouds
63308,91,1554246000,3,27,30,Clouds
63309,92,1554246000,18,22,40,Clouds
63310,93,1554246000,0,40,40,Clouds
63311,94,1554246000,3,37,40,Clouds
63312,95,1554246000,6,34,40,Clouds
63313,96,1554246000,19,11,30,Clouds
63314,97,1554246000,14,26,40,Clouds
63315,98,1554246000,40,0,40,Clouds
63316,99,1554246000,29,1,30,Clouds
63317,100,1554246000,0,25,25,Clouds
63318,101,1554246000,8,22,30,Clouds
63319,102,1554246000,28,12,40,Clouds
63320,103,1554246000,22,18,40,Clouds
63321,104,1554246000,40,0,40,Clouds
63322,105,1554246000,34,2,36,Clouds
63323,106,1554246000,30,10,40,Clouds
63324,107,1554246000,13,27,40,Clouds
63325,108,1554246000,15,25,40,Clouds
63326,109,1554246000,1,28,29,Clouds
63327,110,1554246000,25,15,40,Clouds
63328,111,1554246000,19,21,40,Clouds
63329,112,1554246000,0,30,30,Clouds
63330,113,1554246000,40,0,40,Clouds
63331,114,1554246000,38,2,40,Clouds
63332,115,1554246000,1,29,30,Clouds
63333,2,1554249600,2,17,19,Clouds
63334,3,1554249600,14,6,20,Clouds
63335,4,1554249600,19,1,20,Clouds
63336,5,1554249600,5,35,40,Clouds
63337,6,1554249600,20,0,20,Clouds
63338,7,1554249600,21,8,29,Clouds
63339,8,1554249600,30,0,30,Clouds
63340,9,1554249600,24,0,24,Clouds
63341,10,1554249600,16,0,16,Clouds
63342,11,1554249600,29,1,30,Clouds
63343,12,1554249600,7,13,20,Clouds
63344,13,1554249600,30,0,30,Clouds
63345,14,1554249600,30,0,30,Clouds
63346,15,1554249600,11,5,16,Clouds
63347,16,1554249600,8,12,20,Clouds
63348,17,1554249600,20,0,20,Clouds
63349,18,1554249600,30,0,30,Clouds
63350,19,1554249600,29,1,30,Clouds
63351,21,1554249600,30,0,30,Clouds
63352,22,1554249600,13,7,20,Clouds
63353,23,1554249600,15,15,30,Clouds
63354,24,1554249600,17,3,20,Clouds
63355,25,1554249600,30,0,30,Clouds
63356,26,1554249600,20,0,20,Clouds
63357,27,1554249600,20,0,20,Clouds
63358,28,1554249600,9,21,30,Clouds
63359,29,1554249600,28,1,29,Clouds
63360,30,1554249600,18,1,19,Clouds
63361,31,1554249600,7,13,20,Clouds
63362,32,1554249600,23,6,29,Clouds
63363,33,1554249600,22,1,23,Clouds
63364,34,1554249600,12,18,30,Clouds
63365,35,1554249600,27,3,30,Clouds
63366,36,1554249600,40,0,40,Clouds
63367,37,1554249600,30,0,30,Clouds
63368,38,1554249600,28,12,40,Clouds
63369,39,1554249600,18,2,20,Clouds
63370,40,1554249600,20,1,21,Clouds
63371,41,1554249600,20,0,20,Clouds
63372,42,1554249600,1,29,30,Clouds
63373,43,1554249600,2,28,30,Clouds
63374,44,1554249600,11,19,30,Clouds
63375,45,1554249600,9,21,30,Clouds
63376,46,1554249600,20,0,20,Clouds
63377,47,1554249600,40,0,40,Clouds
63378,48,1554249600,40,0,40,Clouds
63379,49,1554249600,40,0,40,Clouds
63380,50,1554249600,7,33,40,Clouds
63381,51,1554249600,30,10,40,Clouds
63382,52,1554249600,32,0,32,Clouds
63383,53,1554249600,40,0,40,Clouds
63384,54,1554249600,31,2,33,Clouds
63385,55,1554249600,36,0,36,Clouds
63386,56,1554249600,39,1,40,Clouds
63387,57,1554249600,20,3,23,Clouds
63388,58,1554249600,40,0,40,Clouds
63389,59,1554249600,17,3,20,Clouds
63390,60,1554249600,0,30,30,Clouds
63391,61,1554249600,24,1,25,Clouds
63392,62,1554249600,40,0,40,Clouds
63393,63,1554249600,32,3,35,Clouds
63394,64,1554249600,28,12,40,Clouds
63395,65,1554249600,40,0,40,Clouds
63396,66,1554249600,31,9,40,Clouds
63397,67,1554249600,27,13,40,Clouds
63398,68,1554249600,39,1,40,Clouds
63399,69,1554249600,32,8,40,Clouds
63400,70,1554249600,19,9,28,Clouds
63401,71,1554249600,38,2,40,Clouds
63402,72,1554249600,5,26,31,Clouds
63403,73,1554249600,6,24,30,Clouds
63404,74,1554249600,15,15,30,Clouds
63405,75,1554249600,4,36,40,Clouds
63406,76,1554249600,11,27,38,Clouds
63407,77,1554249600,25,4,29,Clouds
63408,78,1554249600,21,19,40,Clouds
63409,79,1554249600,5,22,27,Clouds
63410,80,1554249600,20,20,40,Clouds
63411,81,1554249600,32,8,40,Clouds
63412,82,1554249600,9,13,22,Clouds
63413,83,1554249600,12,28,40,Clouds
63414,84,1554249600,1,29,30,Clouds
63415,85,1554249600,5,30,35,Clouds
63416,86,1554249600,2,36,38,Clouds
63417,87,1554249600,16,22,38,Clouds
63418,88,1554249600,0,30,30,Clouds
63419,89,1554249600,40,0,40,Clouds
63420,90,1554249600,40,0,40,Clouds
63421,91,1554249600,3,27,30,Clouds
63422,92,1554249600,16,24,40,Clouds
63423,93,1554249600,0,40,40,Clouds
63424,94,1554249600,3,37,40,Clouds
63425,95,1554249600,6,34,40,Clouds
63426,96,1554249600,18,12,30,Clouds
63427,97,1554249600,13,27,40,Clouds
63428,98,1554249600,40,0,40,Clouds
63429,99,1554249600,30,0,30,Clouds
63430,100,1554249600,0,25,25,Clouds
63431,101,1554249600,7,23,30,Clouds
63432,102,1554249600,28,12,40,Clouds
63433,103,1554249600,22,18,40,Clouds
63434,104,1554249600,40,0,40,Clouds
63435,105,1554249600,33,3,36,Clouds
63436,106,1554249600,30,10,40,Clouds
63437,107,1554249600,12,28,40,Clouds
63438,108,1554249600,14,26,40,Clouds
63439,109,1554249600,0,29,29,Clouds
63440,110,1554249600,22,18,40,Clouds
63441,111,1554249600,12,28,40,Clouds
63442,112,1554249600,7,23,30,Clouds
63443,113,1554249600,40,0,40,Clouds
63444,114,1554249600,40,0,40,Clouds
63445,115,1554249600,8,22,30,Clouds
63446,2,1554253200,3,16,19,Clouds
63447,3,1554253200,14,6,20,Clouds
63448,4,1554253200,19,1,20,Clouds
63449,5,1554253200,6,34,40,Clouds
63450,6,1554253200,20,0,20,Clouds
63451,7,1554253200,25,4,29,Clouds
63452,8,1554253200,30,0,30,Clouds
63453,9,1554253200,24,0,24,Clouds
63454,10,1554253200,16,0,16,Clouds
63455,11,1554253200,29,1,30,Clouds
63456,12,1554253200,6,14,20,Clouds
63457,13,1554253200,30,0,30,Clouds
63458,14,1554253200,30,0,30,Clouds
63459,15,1554253200,10,6,16,Clouds
63460,16,1554253200,8,12,20,Clouds
63461,17,1554253200,20,0,20,Clouds
63462,18,1554253200,29,1,30,Clouds
63463,19,1554253200,28,2,30,Clouds
63464,21,1554253200,30,0,30,Clouds
63465,22,1554253200,14,6,20,Clouds
63466,23,1554253200,17,13,30,Clouds
63467,24,1554253200,18,2,20,Clouds
63468,25,1554253200,30,0,30,Clouds
63469,26,1554253200,20,0,20,Clouds
63470,27,1554253200,20,0,20,Clouds
63471,28,1554253200,8,22,30,Clouds
63472,29,1554253200,28,1,29,Clouds
63473,30,1554253200,18,1,19,Clouds
63474,31,1554253200,7,13,20,Clouds
63475,32,1554253200,24,5,29,Clouds
63476,33,1554253200,22,1,23,Clouds
63477,34,1554253200,13,17,30,Clouds
63478,35,1554253200,26,4,30,Clouds
63479,36,1554253200,40,0,40,Clouds
63480,37,1554253200,30,0,30,Clouds
63481,38,1554253200,27,13,40,Clouds
63482,39,1554253200,18,2,20,Clouds
63483,40,1554253200,20,1,21,Clouds
63484,41,1554253200,20,0,20,Clouds
63485,42,1554253200,0,30,30,Clouds
63486,43,1554253200,2,28,30,Clouds
63487,44,1554253200,10,20,30,Clouds
63488,45,1554253200,9,21,30,Clouds
63489,46,1554253200,20,0,20,Clouds
63490,47,1554253200,40,0,40,Clouds
63491,48,1554253200,40,0,40,Clouds
63492,49,1554253200,40,0,40,Clouds
63493,50,1554253200,7,33,40,Clouds
63494,51,1554253200,30,10,40,Clouds
63495,52,1554253200,32,0,32,Clouds
63496,53,1554253200,40,0,40,Clouds
63497,54,1554253200,33,0,33,Clouds
63498,55,1554253200,36,0,36,Clouds
63499,56,1554253200,38,2,40,Clouds
63500,57,1554253200,21,2,23,Clouds
63501,58,1554253200,40,0,40,Clouds
63502,59,1554253200,17,3,20,Clouds
63503,60,1554253200,0,30,30,Clouds
63504,61,1554253200,25,0,25,Clouds
63505,62,1554253200,40,0,40,Clouds
63506,63,1554253200,32,3,35,Clouds
63507,64,1554253200,28,12,40,Clouds
63508,65,1554253200,40,0,40,Clouds
63509,66,1554253200,31,9,40,Clouds
63510,67,1554253200,27,13,40,Clouds
63511,68,1554253200,39,1,40,Clouds
63512,69,1554253200,33,7,40,Clouds
63513,70,1554253200,19,9,28,Clouds
63514,71,1554253200,37,3,40,Clouds
63515,72,1554253200,7,24,31,Clouds
63516,73,1554253200,7,23,30,Clouds
63517,74,1554253200,15,15,30,Clouds
63518,75,1554253200,1,39,40,Clouds
63519,76,1554253200,10,28,38,Clouds
63520,77,1554253200,25,4,29,Clouds
63521,78,1554253200,20,20,40,Clouds
63522,79,1554253200,5,22,27,Clouds
63523,80,1554253200,20,20,40,Clouds
63524,81,1554253200,32,8,40,Clouds
63525,82,1554253200,9,13,22,Clouds
63526,83,1554253200,12,28,40,Clouds
63527,84,1554253200,0,30,30,Clouds
63528,85,1554253200,3,32,35,Clouds
63529,86,1554253200,4,34,38,Clouds
63530,87,1554253200,16,22,38,Clouds
63531,88,1554253200,0,30,30,Clouds
63532,89,1554253200,40,0,40,Clouds
63533,90,1554253200,40,0,40,Clouds
63534,91,1554253200,4,26,30,Clouds
63535,92,1554253200,16,24,40,Clouds
63536,93,1554253200,0,40,40,Clouds
63537,94,1554253200,3,37,40,Clouds
63538,95,1554253200,6,34,40,Clouds
63539,96,1554253200,17,13,30,Clouds
63540,97,1554253200,13,27,40,Clouds
63541,98,1554253200,40,0,40,Clouds
63542,99,1554253200,30,0,30,Clouds
63543,100,1554253200,0,25,25,Clouds
63544,101,1554253200,5,25,30,Clouds
63545,102,1554253200,28,12,40,Clouds
63546,103,1554253200,22,18,40,Clouds
63547,104,1554253200,40,0,40,Clouds
63548,105,1554253200,33,3,36,Clouds
63549,106,1554253200,29,11,40,Clouds
63550,107,1554253200,9,31,40,Clouds
63551,108,1554253200,14,26,40,Clouds
63552,109,1554253200,0,29,29,Clouds
63553,110,1554253200,22,18,40,Clouds
63554,111,1554253200,12,28,40,Clouds
63555,112,1554253200,4,26,30,Clouds
63556,113,1554253200,40,0,40,Clouds
63557,114,1554253200,40,0,40,Clouds
63558,115,1554253200,6,24,30,Clouds
63559,2,1554256800,3,16,19,Clouds
63560,3,1554256800,14,6,20,Clouds
63561,4,1554256800,19,1,20,Clouds
63562,5,1554256800,6,34,40,Clouds
63563,6,1554256800,20,0,20,Clouds
63564,7,1554256800,25,4,29,Clouds
63565,8,1554256800,30,0,30,Clouds
63566,9,1554256800,24,0,24,Clouds
63567,10,1554256800,16,0,16,Clouds
63568,11,1554256800,29,1,30,Clouds
63569,12,1554256800,6,14,20,Clouds
63570,13,1554256800,30,0,30,Clouds
63571,14,1554256800,30,0,30,Clouds
63572,15,1554256800,10,6,16,Clouds
63573,16,1554256800,8,12,20,Clouds
63574,17,1554256800,20,0,20,Clouds
63575,18,1554256800,29,1,30,Clouds
63576,19,1554256800,28,2,30,Clouds
63577,21,1554256800,30,0,30,Clouds
63578,22,1554256800,14,6,20,Clouds
63579,23,1554256800,17,13,30,Clouds
63580,24,1554256800,18,2,20,Clouds
63581,25,1554256800,30,0,30,Clouds
63582,26,1554256800,20,0,20,Clouds
63583,27,1554256800,20,0,20,Clouds
63584,28,1554256800,6,24,30,Clouds
63585,29,1554256800,28,1,29,Clouds
63586,30,1554256800,18,1,19,Clouds
63587,31,1554256800,7,13,20,Clouds
63588,32,1554256800,24,5,29,Clouds
63589,33,1554256800,22,1,23,Clouds
63590,34,1554256800,13,17,30,Clouds
63591,35,1554256800,26,4,30,Clouds
63592,36,1554256800,40,0,40,Clouds
63593,37,1554256800,30,0,30,Clouds
63594,38,1554256800,27,13,40,Clouds
63595,39,1554256800,18,2,20,Clouds
63596,40,1554256800,20,1,21,Clouds
63597,41,1554256800,20,0,20,Clouds
63598,42,1554256800,0,30,30,Clouds
63599,43,1554256800,2,28,30,Clouds
63600,44,1554256800,10,20,30,Clouds
63601,45,1554256800,9,21,30,Clouds
63602,46,1554256800,20,0,20,Clouds
63603,47,1554256800,40,0,40,Clouds
63604,48,1554256800,40,0,40,Clouds
63605,49,1554256800,40,0,40,Clouds
63606,50,1554256800,7,33,40,Clouds
63607,51,1554256800,30,10,40,Clouds
63608,52,1554256800,32,0,32,Clouds
63609,53,1554256800,40,0,40,Clouds
63610,54,1554256800,33,0,33,Clouds
63611,55,1554256800,36,0,36,Clouds
63612,56,1554256800,38,2,40,Clouds
63613,57,1554256800,21,2,23,Clouds
63614,58,1554256800,40,0,40,Clouds
63615,59,1554256800,17,3,20,Clouds
63616,60,1554256800,0,30,30,Clouds
63617,61,1554256800,25,0,25,Clouds
63618,62,1554256800,40,0,40,Clouds
63619,63,1554256800,32,3,35,Clouds
63620,64,1554256800,28,12,40,Clouds
63621,65,1554256800,40,0,40,Clouds
63622,66,1554256800,30,10,40,Clouds
63623,67,1554256800,27,13,40,Clouds
63624,68,1554256800,39,1,40,Clouds
63625,69,1554256800,33,7,40,Clouds
63626,70,1554256800,19,9,28,Clouds
63627,71,1554256800,37,3,40,Clouds
63628,72,1554256800,7,24,31,Clouds
63629,73,1554256800,7,23,30,Clouds
63630,74,1554256800,15,15,30,Clouds
63631,75,1554256800,1,39,40,Clouds
63632,76,1554256800,10,28,38,Clouds
63633,77,1554256800,25,4,29,Clouds
63634,78,1554256800,20,20,40,Clouds
63635,79,1554256800,5,22,27,Clouds
63636,80,1554256800,20,20,40,Clouds
63637,81,1554256800,32,8,40,Clouds
63638,82,1554256800,9,13,22,Clouds
63639,83,1554256800,12,28,40,Clouds
63640,84,1554256800,0,30,30,Clouds
63641,85,1554256800,3,32,35,Clouds
63642,86,1554256800,4,34,38,Clouds
63643,87,1554256800,16,22,38,Clouds
63644,88,1554256800,0,30,30,Clouds
63645,89,1554256800,40,0,40,Clouds
63646,90,1554256800,40,0,40,Clouds
63647,91,1554256800,4,26,30,Clouds
63648,92,1554256800,16,24,40,Clouds
63649,93,1554256800,0,40,40,Clouds
63650,94,1554256800,3,37,40,Clouds
63651,95,1554256800,6,34,40,Clouds
63652,96,1554256800,17,13,30,Clouds
63653,97,1554256800,13,27,40,Clouds
63654,98,1554256800,40,0,40,Clouds
63655,99,1554256800,30,0,30,Clouds
63656,100,1554256800,0,25,25,Clouds
63657,101,1554256800,5,25,30,Clouds
63658,102,1554256800,28,12,40,Clouds
63659,103,1554256800,22,18,40,Clouds
63660,104,1554256800,40,0,40,Clouds
63661,105,1554256800,33,3,36,Clouds
63662,106,1554256800,29,11,40,Clouds
63663,107,1554256800,9,31,40,Clouds
63664,108,1554256800,14,26,40,Clouds
63665,109,1554256800,0,29,29,Clouds
63666,110,1554256800,22,18,40,Clouds
63667,111,1554256800,12,28,40,Clouds
63668,112,1554256800,3,27,30,Clouds
63669,113,1554256800,40,0,40,Clouds
63670,114,1554256800,40,0,40,Clouds
63671,115,1554256800,6,24,30,Clouds
63672,2,1554260400,3,16,19,Clouds
63673,3,1554260400,14,6,20,Clouds
63674,4,1554260400,19,1,20,Clouds
63675,5,1554260400,6,34,40,Clouds
63676,6,1554260400,20,0,20,Clouds
63677,7,1554260400,25,4,29,Clouds
63678,8,1554260400,30,0,30,Clouds
63679,9,1554260400,24,0,24,Clouds
63680,10,1554260400,16,0,16,Clouds
63681,11,1554260400,29,1,30,Clouds
63682,12,1554260400,6,14,20,Clouds
63683,13,1554260400,30,0,30,Clouds
63684,14,1554260400,30,0,30,Clouds
63685,15,1554260400,10,6,16,Clouds
63686,16,1554260400,8,12,20,Clouds
63687,17,1554260400,20,0,20,Clouds
63688,18,1554260400,29,1,30,Clouds
63689,19,1554260400,28,2,30,Clouds
63690,21,1554260400,30,0,30,Clouds
63691,22,1554260400,14,6,20,Clouds
63692,23,1554260400,17,13,30,Clouds
63693,24,1554260400,18,2,20,Clouds
63694,25,1554260400,30,0,30,Clouds
63695,26,1554260400,20,0,20,Clouds
63696,27,1554260400,20,0,20,Clouds
63697,28,1554260400,6,24,30,Clouds
63698,29,1554260400,28,1,29,Clouds
63699,30,1554260400,18,1,19,Clouds
63700,31,1554260400,7,13,20,Clouds
63701,32,1554260400,24,5,29,Clouds
63702,33,1554260400,22,1,23,Clouds
63703,34,1554260400,13,17,30,Clouds
63704,35,1554260400,26,4,30,Clouds
63705,36,1554260400,40,0,40,Clouds
63706,37,1554260400,30,0,30,Clouds
63707,38,1554260400,27,13,40,Clouds
63708,39,1554260400,18,2,20,Clouds
63709,40,1554260400,20,1,21,Clouds
63710,41,1554260400,20,0,20,Clouds
63711,42,1554260400,0,30,30,Clouds
63712,43,1554260400,2,28,30,Clouds
63713,44,1554260400,10,20,30,Clouds
63714,45,1554260400,9,21,30,Clouds
63715,46,1554260400,20,0,20,Clouds
63716,47,1554260400,40,0,40,Clouds
63717,48,1554260400,40,0,40,Clouds
63718,49,1554260400,40,0,40,Clouds
63719,50,1554260400,7,33,40,Clouds
63720,51,1554260400,30,10,40,Clouds
63721,52,1554260400,32,0,32,Clouds
63722,53,1554260400,40,0,40,Clouds
63723,54,1554260400,33,0,33,Clouds
63724,55,1554260400,36,0,36,Clouds
63725,56,1554260400,38,2,40,Clouds
63726,57,1554260400,21,2,23,Clouds
63727,58,1554260400,40,0,40,Clouds
63728,59,1554260400,17,3,20,Clouds
63729,60,1554260400,0,30,30,Clouds
63730,61,1554260400,25,0,25,Clouds
63731,62,1554260400,40,0,40,Clouds
63732,63,1554260400,32,3,35,Clouds
63733,64,1554260400,28,12,40,Clouds
63734,65,1554260400,40,0,40,Clouds
63735,66,1554260400,30,10,40,Clouds
63736,67,1554260400,27,13,40,Clouds
63737,68,1554260400,39,1,40,Clouds
63738,69,1554260400,33,7,40,Clouds
63739,70,1554260400,19,9,28,Clouds
63740,71,1554260400,37,3,40,Clouds
63741,72,1554260400,7,24,31,Clouds
63742,73,1554260400,7,23,30,Clouds
63743,74,1554260400,15,15,30,Clouds
63744,75,1554260400,1,39,40,Clouds
63745,76,1554260400,10,28,38,Clouds
63746,77,1554260400,25,4,29,Clouds
63747,78,1554260400,20,20,40,Clouds
63748,79,1554260400,5,22,27,Clouds
63749,80,1554260400,20,20,40,Clouds
63750,81,1554260400,32,8,40,Clouds
63751,82,1554260400,9,13,22,Clouds
63752,83,1554260400,12,28,40,Clouds
63753,84,1554260400,0,30,30,Clouds
63754,85,1554260400,3,32,35,Clouds
63755,86,1554260400,4,34,38,Clouds
63756,87,1554260400,16,22,38,Clouds
63757,88,1554260400,0,30,30,Clouds
63758,89,1554260400,40,0,40,Clouds
63759,90,1554260400,40,0,40,Clouds
63760,91,1554260400,4,26,30,Clouds
63761,92,1554260400,16,24,40,Clouds
63762,93,1554260400,0,40,40,Clouds
63763,94,1554260400,3,37,40,Clouds
63764,95,1554260400,6,34,40,Clouds
63765,96,1554260400,17,13,30,Clouds
63766,97,1554260400,13,27,40,Clouds
63767,98,1554260400,40,0,40,Clouds
63768,99,1554260400,30,0,30,Clouds
63769,100,1554260400,0,25,25,Clouds
63770,101,1554260400,5,25,30,Clouds
63771,102,1554260400,28,12,40,Clouds
63772,103,1554260400,22,18,40,Clouds
63773,104,1554260400,40,0,40,Clouds
63774,105,1554260400,33,3,36,Clouds
63775,106,1554260400,29,11,40,Clouds
63776,107,1554260400,9,31,40,Clouds
63777,108,1554260400,14,26,40,Clouds
63778,109,1554260400,0,29,29,Clouds
63779,110,1554260400,22,18,40,Clouds
63780,111,1554260400,12,28,40,Clouds
63781,112,1554260400,3,27,30,Clouds
63782,113,1554260400,40,0,40,Clouds
63783,114,1554260400,40,0,40,Clouds
63784,115,1554260400,6,24,30,Clouds
63785,2,1554264000,3,16,19,Clouds
63786,3,1554264000,14,6,20,Clouds
63787,4,1554264000,19,1,20,Clouds
63788,5,1554264000,6,34,40,Clouds
63789,6,1554264000,20,0,20,Clouds
63790,7,1554264000,25,4,29,Clouds
63791,8,1554264000,30,0,30,Clouds
63792,9,1554264000,24,0,24,Clouds
63793,10,1554264000,16,0,16,Clouds
63794,11,1554264000,29,1,30,Clouds
63795,12,1554264000,6,14,20,Clouds
63796,13,1554264000,30,0,30,Clouds
63797,14,1554264000,30,0,30,Clouds
63798,15,1554264000,10,6,16,Clouds
63799,16,1554264000,8,12,20,Clouds
63800,17,1554264000,20,0,20,Clouds
63801,18,1554264000,29,1,30,Clouds
63802,19,1554264000,28,2,30,Clouds
63803,21,1554264000,30,0,30,Clouds
63804,22,1554264000,14,6,20,Clouds
63805,23,1554264000,17,13,30,Clouds
63806,24,1554264000,18,2,20,Clouds
63807,25,1554264000,30,0,30,Clouds
63808,26,1554264000,20,0,20,Clouds
63809,27,1554264000,20,0,20,Clouds
63810,28,1554264000,6,24,30,Clouds
63811,29,1554264000,28,1,29,Clouds
63812,30,1554264000,18,1,19,Clouds
63813,31,1554264000,7,13,20,Clouds
63814,32,1554264000,24,5,29,Clouds
63815,33,1554264000,22,1,23,Clouds
63816,34,1554264000,13,17,30,Clouds
63817,35,1554264000,26,4,30,Clouds
63818,36,1554264000,40,0,40,Clouds
63819,37,1554264000,30,0,30,Clouds
63820,38,1554264000,27,13,40,Clouds
63821,39,1554264000,18,2,20,Clouds
63822,40,1554264000,20,1,21,Clouds
63823,41,1554264000,20,0,20,Clouds
63824,42,1554264000,0,30,30,Clouds
63825,43,1554264000,2,28,30,Clouds
63826,44,1554264000,10,20,30,Clouds
63827,45,1554264000,9,21,30,Clouds
63828,46,1554264000,20,0,20,Clouds
63829,47,1554264000,40,0,40,Clouds
63830,48,1554264000,40,0,40,Clouds
63831,49,1554264000,40,0,40,Clouds
63832,50,1554264000,7,33,40,Clouds
63833,51,1554264000,30,10,40,Clouds
63834,52,1554264000,32,0,32,Clouds
63835,53,1554264000,40,0,40,Clouds
63836,54,1554264000,33,0,33,Clouds
63837,55,1554264000,36,0,36,Clouds
63838,56,1554264000,38,2,40,Clouds
63839,57,1554264000,21,2,23,Clouds
63840,58,1554264000,40,0,40,Clouds
63841,59,1554264000,17,3,20,Clouds
63842,60,1554264000,0,30,30,Clouds
63843,61,1554264000,25,0,25,Clouds
63844,62,1554264000,40,0,40,Clouds
63845,63,1554264000,32,3,35,Clouds
63846,64,1554264000,28,12,40,Clouds
63847,65,1554264000,40,0,40,Clouds
63848,66,1554264000,30,10,40,Clouds
63849,67,1554264000,27,13,40,Clouds
63850,68,1554264000,39,1,40,Clouds
63851,69,1554264000,33,7,40,Clouds
63852,70,1554264000,19,9,28,Clouds
63853,71,1554264000,37,3,40,Clouds
63854,72,1554264000,7,24,31,Clouds
63855,73,1554264000,7,23,30,Clouds
63856,74,1554264000,15,15,30,Clouds
63857,75,1554264000,1,39,40,Clouds
63858,76,1554264000,10,28,38,Clouds
63859,77,1554264000,25,4,29,Clouds
63860,78,1554264000,20,20,40,Clouds
63861,79,1554264000,5,22,27,Clouds
63862,80,1554264000,20,20,40,Clouds
63863,81,1554264000,32,8,40,Clouds
63864,82,1554264000,9,13,22,Clouds
63865,83,1554264000,12,28,40,Clouds
63866,84,1554264000,0,30,30,Clouds
63867,85,1554264000,3,32,35,Clouds
63868,86,1554264000,4,34,38,Clouds
63869,87,1554264000,16,22,38,Clouds
63870,88,1554264000,0,30,30,Clouds
63871,89,1554264000,40,0,40,Clouds
63872,90,1554264000,40,0,40,Clouds
63873,91,1554264000,4,26,30,Clouds
63874,92,1554264000,16,24,40,Clouds
63875,93,1554264000,0,40,40,Clouds
63876,94,1554264000,3,37,40,Clouds
63877,95,1554264000,6,34,40,Clouds
63878,96,1554264000,17,13,30,Clouds
63879,97,1554264000,13,27,40,Clouds
63880,98,1554264000,40,0,40,Clouds
63881,99,1554264000,30,0,30,Clouds
63882,100,1554264000,0,25,25,Clouds
63883,101,1554264000,5,25,30,Clouds
63884,102,1554264000,28,12,40,Clouds
63885,103,1554264000,22,18,40,Clouds
63886,104,1554264000,40,0,40,Clouds
63887,105,1554264000,33,3,36,Clouds
63888,106,1554264000,29,11,40,Clouds
63889,107,1554264000,9,31,40,Clouds
63890,108,1554264000,14,26,40,Clouds
63891,109,1554264000,0,29,29,Clouds
63892,110,1554264000,22,18,40,Clouds
63893,111,1554264000,12,28,40,Clouds
63894,112,1554264000,3,27,30,Clouds
63895,113,1554264000,40,0,40,Clouds
63896,114,1554264000,40,0,40,Clouds
63897,115,1554264000,6,24,30,Clouds
63898,2,1554267600,3,16,19,Clouds
63899,3,1554267600,14,6,20,Clouds
63900,4,1554267600,19,1,20,Clouds
63901,5,1554267600,6,34,40,Clouds
63902,6,1554267600,20,0,20,Clouds
63903,7,1554267600,25,4,29,Clouds
63904,8,1554267600,30,0,30,Clouds
63905,9,1554267600,24,0,24,Clouds
63906,10,1554267600,16,0,16,Clouds
63907,11,1554267600,29,1,30,Clouds
63908,12,1554267600,6,14,20,Clouds
63909,13,1554267600,30,0,30,Clouds
63910,14,1554267600,30,0,30,Clouds
63911,15,1554267600,10,6,16,Clouds
63912,16,1554267600,8,12,20,Clouds
63913,17,1554267600,20,0,20,Clouds
63914,18,1554267600,29,1,30,Clouds
63915,19,1554267600,28,2,30,Clouds
63916,21,1554267600,30,0,30,Clouds
63917,22,1554267600,14,6,20,Clouds
63918,23,1554267600,17,13,30,Clouds
63919,24,1554267600,18,2,20,Clouds
63920,25,1554267600,30,0,30,Clouds
63921,26,1554267600,20,0,20,Clouds
63922,27,1554267600,20,0,20,Clouds
63923,28,1554267600,6,24,30,Clouds
63924,29,1554267600,28,1,29,Clouds
63925,30,1554267600,18,1,19,Clouds
63926,31,1554267600,7,13,20,Clouds
63927,32,1554267600,24,5,29,Clouds
63928,33,1554267600,22,1,23,Clouds
63929,34,1554267600,13,17,30,Clouds
63930,35,1554267600,26,4,30,Clouds
63931,36,1554267600,40,0,40,Clouds
63932,37,1554267600,30,0,30,Clouds
63933,38,1554267600,27,13,40,Clouds
63934,39,1554267600,18,2,20,Clouds
63935,40,1554267600,20,1,21,Clouds
63936,41,1554267600,20,0,20,Clouds
63937,42,1554267600,0,30,30,Clouds
63938,43,1554267600,2,28,30,Clouds
63939,44,1554267600,10,20,30,Clouds
63940,45,1554267600,9,21,30,Clouds
63941,46,1554267600,20,0,20,Clouds
63942,47,1554267600,40,0,40,Clouds
63943,48,1554267600,40,0,40,Clouds
63944,49,1554267600,40,0,40,Clouds
63945,50,1554267600,7,33,40,Clouds
63946,51,1554267600,30,10,40,Clouds
63947,52,1554267600,32,0,32,Clouds
63948,53,1554267600,40,0,40,Clouds
63949,54,1554267600,33,0,33,Clouds
63950,55,1554267600,36,0,36,Clouds
63951,56,1554267600,38,2,40,Clouds
63952,57,1554267600,21,2,23,Clouds
63953,58,1554267600,40,0,40,Clouds
63954,59,1554267600,17,3,20,Clouds
63955,60,1554267600,1,29,30,Clouds
63956,61,1554267600,25,0,25,Clouds
63957,62,1554267600,40,0,40,Clouds
63958,63,1554267600,32,3,35,Clouds
63959,64,1554267600,28,12,40,Clouds
63960,65,1554267600,40,0,40,Clouds
63961,66,1554267600,30,10,40,Clouds
63962,67,1554267600,27,13,40,Clouds
63963,68,1554267600,39,1,40,Clouds
63964,69,1554267600,33,7,40,Clouds
63965,70,1554267600,19,9,28,Clouds
63966,71,1554267600,37,3,40,Clouds
63967,72,1554267600,7,24,31,Clouds
63968,73,1554267600,7,23,30,Clouds
63969,74,1554267600,15,15,30,Clouds
63970,75,1554267600,1,39,40,Clouds
63971,76,1554267600,10,28,38,Clouds
63972,77,1554267600,25,4,29,Clouds
63973,78,1554267600,20,20,40,Clouds
63974,79,1554267600,5,22,27,Clouds
63975,80,1554267600,20,20,40,Clouds
63976,81,1554267600,32,8,40,Clouds
63977,82,1554267600,9,13,22,Clouds
63978,83,1554267600,12,28,40,Clouds
63979,84,1554267600,1,29,30,Clouds
63980,85,1554267600,3,32,35,Clouds
63981,86,1554267600,4,34,38,Clouds
63982,87,1554267600,16,22,38,Clouds
63983,88,1554267600,0,30,30,Clouds
63984,89,1554267600,40,0,40,Clouds
63985,90,1554267600,40,0,40,Clouds
63986,91,1554267600,4,26,30,Clouds
63987,92,1554267600,16,24,40,Clouds
63988,93,1554267600,0,40,40,Clouds
63989,94,1554267600,3,37,40,Clouds
63990,95,1554267600,6,34,40,Clouds
63991,96,1554267600,17,13,30,Clouds
63992,97,1554267600,13,27,40,Clouds
63993,98,1554267600,40,0,40,Clouds
63994,99,1554267600,30,0,30,Clouds
63995,100,1554267600,0,25,25,Clouds
63996,101,1554267600,5,25,30,Clouds
63997,102,1554267600,28,12,40,Clouds
63998,103,1554267600,22,18,40,Clouds
63999,104,1554267600,40,0,40,Clouds
64000,105,1554267600,33,3,36,Clouds
64001,106,1554267600,29,11,40,Clouds
64002,107,1554267600,9,31,40,Clouds
64003,108,1554267600,14,26,40,Clouds
64004,109,1554267600,1,28,29,Clouds
64005,110,1554267600,22,18,40,Clouds
64006,111,1554267600,12,28,40,Clouds
64007,112,1554267600,3,27,30,Clouds
64008,113,1554267600,40,0,40,Clouds
64009,114,1554267600,40,0,40,Clouds
64010,115,1554267600,6,24,30,Clouds
64011,2,1554271200,3,17,20,Clouds
64012,3,1554271200,16,4,20,Clouds
64013,4,1554271200,20,0,20,Clouds
64014,5,1554271200,7,33,40,Clouds
64015,6,1554271200,19,1,20,Clouds
64016,7,1554271200,26,3,29,Clouds
64017,8,1554271200,25,5,30,Clouds
64018,9,1554271200,21,3,24,Clouds
64019,10,1554271200,16,0,16,Clouds
64020,11,1554271200,29,1,30,Clouds
64021,12,1554271200,7,13,20,Clouds
64022,13,1554271200,30,0,30,Clouds
64023,14,1554271200,25,5,30,Clouds
64024,15,1554271200,11,5,16,Clouds
64025,16,1554271200,19,1,20,Clouds
64026,17,1554271200,18,2,20,Clouds
64027,18,1554271200,10,20,30,Clouds
64028,19,1554271200,27,3,30,Clouds
64029,21,1554271200,29,1,30,Clouds
64030,22,1554271200,14,6,20,Clouds
64031,23,1554271200,25,5,30,Clouds
64032,24,1554271200,16,4,20,Clouds
64033,25,1554271200,30,0,30,Clouds
64034,26,1554271200,19,1,20,Clouds
64035,27,1554271200,20,0,20,Clouds
64036,28,1554271200,7,23,30,Clouds
64037,29,1554271200,27,2,29,Clouds
64038,30,1554271200,17,3,20,Clouds
64039,31,1554271200,14,6,20,Clouds
64040,32,1554271200,21,9,30,Clouds
64041,33,1554271200,16,7,23,Clouds
64042,34,1554271200,14,16,30,Clouds
64043,35,1554271200,28,2,30,Clouds
64044,36,1554271200,36,4,40,Clouds
64045,37,1554271200,30,0,30,Clouds
64046,38,1554271200,27,13,40,Clouds
64047,39,1554271200,18,2,20,Clouds
64048,40,1554271200,20,1,21,Clouds
64049,41,1554271200,20,0,20,Clouds
64050,42,1554271200,1,29,30,Clouds
64051,43,1554271200,8,22,30,Clouds
64052,44,1554271200,16,14,30,Clouds
64053,45,1554271200,9,21,30,Clouds
64054,46,1554271200,19,1,20,Clouds
64055,47,1554271200,40,0,40,Clouds
64056,48,1554271200,39,1,40,Clouds
64057,49,1554271200,38,2,40,Clouds
64058,50,1554271200,8,32,40,Clouds
64059,51,1554271200,30,10,40,Clouds
64060,52,1554271200,29,3,32,Clouds
64061,53,1554271200,40,0,40,Clouds
64062,54,1554271200,33,0,33,Clouds
64063,55,1554271200,36,0,36,Clouds
64064,56,1554271200,38,2,40,Clouds
64065,57,1554271200,21,2,23,Clouds
64066,58,1554271200,38,2,40,Clouds
64067,59,1554271200,17,3,20,Clouds
64068,60,1554271200,5,25,30,Clouds
64069,61,1554271200,9,16,25,Clouds
64070,62,1554271200,38,2,40,Clouds
64071,63,1554271200,31,4,35,Clouds
64072,64,1554271200,37,3,40,Clouds
64073,65,1554271200,40,0,40,Clouds
64074,66,1554271200,28,12,40,Clouds
64075,67,1554271200,26,14,40,Clouds
64076,68,1554271200,39,1,40,Clouds
64077,69,1554271200,38,2,40,Clouds
64078,70,1554271200,17,11,28,Clouds
64079,71,1554271200,36,4,40,Clouds
64080,72,1554271200,7,24,31,Clouds
64081,73,1554271200,7,23,30,Clouds
64082,74,1554271200,17,13,30,Clouds
64083,75,1554271200,2,38,40,Clouds
64084,76,1554271200,12,26,38,Clouds
64085,77,1554271200,23,6,29,Clouds
64086,78,1554271200,6,34,40,Clouds
64087,79,1554271200,5,22,27,Clouds
64088,80,1554271200,21,19,40,Clouds
64089,81,1554271200,32,8,40,Clouds
64090,82,1554271200,9,13,22,Clouds
64091,83,1554271200,14,26,40,Clouds
64092,84,1554271200,2,28,30,Clouds
64093,85,1554271200,3,32,35,Clouds
64094,86,1554271200,5,33,38,Clouds
64095,87,1554271200,18,20,38,Clouds
64096,88,1554271200,3,27,30,Clouds
64097,89,1554271200,40,0,40,Clouds
64098,90,1554271200,39,1,40,Clouds
64099,91,1554271200,6,24,30,Clouds
64100,92,1554271200,16,24,40,Clouds
64101,93,1554271200,0,40,40,Clouds
64102,94,1554271200,3,37,40,Clouds
64103,95,1554271200,8,32,40,Clouds
64104,96,1554271200,17,13,30,Clouds
64105,97,1554271200,17,23,40,Clouds
64106,98,1554271200,40,0,40,Clouds
64107,99,1554271200,30,0,30,Clouds
64108,100,1554271200,0,25,25,Clouds
64109,101,1554271200,11,19,30,Clouds
64110,102,1554271200,28,12,40,Clouds
64111,103,1554271200,22,18,40,Clouds
64112,104,1554271200,40,0,40,Clouds
64113,105,1554271200,34,2,36,Clouds
64114,106,1554271200,29,11,40,Clouds
64115,107,1554271200,14,26,40,Clouds
64116,108,1554271200,17,23,40,Clouds
64117,109,1554271200,7,22,29,Clouds
64118,110,1554271200,22,18,40,Clouds
64119,111,1554271200,14,26,40,Clouds
64120,112,1554271200,6,24,30,Clouds
64121,113,1554271200,39,1,40,Clouds
64122,114,1554271200,40,0,40,Clouds
64123,115,1554271200,7,23,30,Clouds
64124,2,1554274800,15,5,20,Clouds
64125,3,1554274800,18,2,20,Clouds
64126,4,1554274800,17,3,20,Clouds
64127,5,1554274800,4,36,40,Clouds
64128,6,1554274800,19,1,20,Clouds
64129,7,1554274800,8,20,28,Clouds
64130,8,1554274800,18,12,30,Clouds
64131,9,1554274800,21,3,24,Clouds
64132,10,1554274800,14,2,16,Clouds
64133,11,1554274800,26,4,30,Clouds
64134,12,1554274800,19,1,20,Clouds
64135,13,1554274800,29,1,30,Clouds
64136,14,1554274800,21,9,30,Clouds
64137,15,1554274800,14,2,16,Clouds
64138,16,1554274800,19,1,20,Clouds
64139,17,1554274800,19,1,20,Clouds
64140,18,1554274800,9,21,30,Clouds
64141,19,1554274800,28,2,30,Clouds
64142,21,1554274800,25,5,30,Clouds
64143,22,1554274800,16,4,20,Clouds
64144,23,1554274800,26,4,30,Clouds
64145,24,1554274800,13,7,20,Clouds
64146,25,1554274800,23,7,30,Clouds
64147,26,1554274800,12,8,20,Clouds
64148,27,1554274800,16,4,20,Clouds
64149,28,1554274800,17,13,30,Clouds
64150,29,1554274800,27,2,29,Clouds
64151,30,1554274800,14,6,20,Clouds
64152,31,1554274800,10,10,20,Clouds
64153,32,1554274800,28,2,30,Clouds
64154,33,1554274800,5,18,23,Clouds
64155,34,1554274800,20,10,30,Clouds
64156,35,1554274800,28,2,30,Clouds
64157,36,1554274800,34,6,40,Clouds
64158,37,1554274800,30,0,30,Clouds
64159,38,1554274800,20,20,40,Clouds
64160,39,1554274800,14,6,20,Clouds
64161,40,1554274800,17,4,21,Clouds
64162,41,1554274800,20,0,20,Clouds
64163,42,1554274800,11,19,30,Clouds
64164,43,1554274800,13,17,30,Clouds
64165,44,1554274800,26,4,30,Clouds
64166,45,1554274800,12,18,30,Clouds
64167,46,1554274800,14,6,20,Clouds
64168,47,1554274800,40,0,40,Clouds
64169,48,1554274800,38,2,40,Clouds
64170,49,1554274800,38,2,40,Clouds
64171,50,1554274800,11,29,40,Clouds
64172,51,1554274800,34,6,40,Clouds
64173,52,1554274800,26,6,32,Clouds
64174,53,1554274800,36,4,40,Clouds
64175,54,1554274800,31,2,33,Clouds
64176,55,1554274800,29,7,36,Clouds
64177,56,1554274800,37,3,40,Clouds
64178,57,1554274800,23,0,23,Clouds
64179,58,1554274800,32,8,40,Clouds
64180,59,1554274800,18,2,20,Clouds
64181,60,1554274800,5,25,30,Clouds
64182,61,1554274800,16,9,25,Clouds
64183,62,1554274800,34,5,39,Clouds
64184,63,1554274800,34,1,35,Clouds
64185,64,1554274800,37,3,40,Clouds
64186,65,1554274800,34,6,40,Clouds
64187,66,1554274800,33,7,40,Clouds
64188,67,1554274800,22,18,40,Clouds
64189,68,1554274800,24,16,40,Clouds
64190,69,1554274800,29,11,40,Clouds
64191,70,1554274800,14,14,28,Clouds
64192,71,1554274800,38,2,40,Clouds
64193,72,1554274800,10,21,31,Clouds
64194,73,1554274800,13,17,30,Clouds
64195,74,1554274800,20,10,30,Clouds
64196,75,1554274800,5,35,40,Clouds
64197,76,1554274800,19,19,38,Clouds
64198,77,1554274800,29,0,29,Clouds
64199,78,1554274800,9,31,40,Clouds
64200,79,1554274800,5,22,27,Clouds
64201,80,1554274800,23,17,40,Clouds
64202,81,1554274800,32,8,40,Clouds
64203,82,1554274800,13,9,22,Clouds
64204,83,1554274800,16,24,40,Clouds
64205,84,1554274800,1,29,30,Clouds
64206,85,1554274800,8,27,35,Clouds
64207,86,1554274800,5,33,38,Clouds
64208,87,1554274800,19,19,38,Clouds
64209,88,1554274800,12,18,30,Clouds
64210,89,1554274800,39,1,40,Clouds
64211,90,1554274800,24,16,40,Clouds
64212,91,1554274800,25,5,30,Clouds
64213,92,1554274800,21,19,40,Clouds
64214,93,1554274800,0,40,40,Clouds
64215,94,1554274800,5,35,40,Clouds
64216,95,1554274800,15,25,40,Clouds
64217,96,1554274800,17,13,30,Clouds
64218,97,1554274800,22,18,40,Clouds
64219,98,1554274800,39,1,40,Clouds
64220,99,1554274800,27,3,30,Clouds
64221,100,1554274800,14,11,25,Clouds
64222,101,1554274800,20,10,30,Clouds
64223,102,1554274800,31,9,40,Clouds
64224,103,1554274800,21,19,40,Clouds
64225,104,1554274800,40,0,40,Clouds
64226,105,1554274800,33,3,36,Clouds
64227,106,1554274800,32,8,40,Clouds
64228,107,1554274800,16,24,40,Clouds
64229,108,1554274800,21,19,40,Clouds
64230,109,1554274800,14,15,29,Clouds
64231,110,1554274800,27,13,40,Clouds
64232,111,1554274800,21,19,40,Clouds
64233,112,1554274800,12,18,30,Clouds
64234,113,1554274800,37,3,40,Clouds
64235,114,1554274800,29,11,40,Clouds
64236,115,1554274800,10,20,30,Clouds
64237,2,1554278400,20,0,20,Clouds
64238,3,1554278400,20,0,20,Clouds
64239,4,1554278400,15,5,20,Clouds
64240,5,1554278400,34,6,40,Clouds
64241,6,1554278400,17,3,20,Clouds
64242,7,1554278400,17,10,27,Clouds
64243,8,1554278400,28,2,30,Clouds
64244,9,1554278400,21,3,24,Clouds
64245,10,1554278400,14,2,16,Clouds
64246,11,1554278400,15,15,30,Clouds
64247,12,1554278400,20,0,20,Clouds
64248,13,1554278400,25,5,30,Clouds
64249,14,1554278400,23,7,30,Clouds
64250,15,1554278400,16,0,16,Clouds
64251,16,1554278400,16,4,20,Clouds
64252,17,1554278400,18,2,20,Clouds
64253,18,1554278400,15,15,30,Clouds
64254,19,1554278400,29,1,30,Clouds
64255,21,1554278400,23,7,30,Clouds
64256,22,1554278400,10,10,20,Clouds
64257,23,1554278400,21,9,30,Clouds
64258,24,1554278400,18,2,20,Clouds
64259,25,1554278400,11,18,29,Clouds
64260,26,1554278400,12,8,20,Clouds
64261,27,1554278400,6,14,20,Clouds
64262,28,1554278400,12,18,30,Clouds
64263,29,1554278400,28,1,29,Clouds
64264,30,1554278400,16,4,20,Clouds
64265,31,1554278400,7,13,20,Clouds
64266,32,1554278400,23,7,30,Clouds
64267,33,1554278400,2,21,23,Clouds
64268,34,1554278400,20,10,30,Clouds
64269,35,1554278400,28,2,30,Clouds
64270,36,1554278400,25,15,40,Clouds
64271,37,1554278400,29,1,30,Clouds
64272,38,1554278400,15,25,40,Clouds
64273,39,1554278400,17,3,20,Clouds
64274,40,1554278400,9,12,21,Clouds
64275,41,1554278400,20,0,20,Clouds
64276,42,1554278400,29,1,30,Clouds
64277,43,1554278400,21,9,30,Clouds
64278,44,1554278400,30,0,30,Clouds
64279,45,1554278400,11,19,30,Clouds
64280,46,1554278400,13,7,20,Clouds
64281,47,1554278400,35,5,40,Clouds
64282,48,1554278400,31,9,40,Clouds
64283,49,1554278400,34,6,40,Clouds
64284,50,1554278400,32,8,40,Clouds
64285,51,1554278400,30,10,40,Clouds
64286,52,1554278400,6,26,32,Clouds
64287,53,1554278400,34,6,40,Clouds
64288,54,1554278400,24,9,33,Clouds
64289,55,1554278400,22,14,36,Clouds
64290,56,1554278400,30,10,40,Clouds
64291,57,1554278400,19,4,23,Clouds
64292,58,1554278400,9,31,40,Clouds
64293,59,1554278400,17,3,20,Clouds
64294,60,1554278400,27,3,30,Clouds
64295,61,1554278400,20,5,25,Clouds
64296,62,1554278400,32,7,39,Clouds
64297,63,1554278400,30,5,35,Clouds
64298,64,1554278400,38,2,40,Clouds
64299,65,1554278400,36,4,40,Clouds
64300,66,1554278400,8,32,40,Clouds
64301,67,1554278400,17,23,40,Clouds
64302,68,1554278400,11,29,40,Clouds
64303,69,1554278400,20,20,40,Clouds
64304,70,1554278400,23,5,28,Clouds
64305,71,1554278400,36,4,40,Clouds
64306,72,1554278400,15,16,31,Clouds
64307,73,1554278400,30,0,30,Clouds
64308,74,1554278400,28,2,30,Clouds
64309,75,1554278400,17,23,40,Clouds
64310,76,1554278400,24,14,38,Clouds
64311,77,1554278400,27,2,29,Clouds
64312,78,1554278400,16,24,40,Clouds
64313,79,1554278400,8,19,27,Clouds
64314,80,1554278400,28,12,40,Clouds
64315,81,1554278400,30,10,40,Clouds
64316,82,1554278400,19,3,22,Clouds
64317,83,1554278400,25,15,40,Clouds
64318,84,1554278400,9,21,30,Clouds
64319,85,1554278400,27,8,35,Clouds
64320,86,1554278400,36,2,38,Clouds
64321,87,1554278400,27,11,38,Clouds
64322,88,1554278400,17,13,30,Clouds
64323,89,1554278400,34,6,40,Clouds
64324,90,1554278400,0,40,40,Clouds
64325,91,1554278400,27,3,30,Clouds
64326,92,1554278400,40,0,40,Clouds
64327,93,1554278400,15,25,40,Clouds
64328,94,1554278400,6,34,40,Clouds
64329,95,1554278400,30,10,40,Clouds
64330,96,1554278400,25,5,30,Clouds
64331,97,1554278400,36,4,40,Clouds
64332,98,1554278400,37,3,40,Clouds
64333,99,1554278400,27,3,30,Clouds
64334,100,1554278400,25,0,25,Clouds
64335,101,1554278400,30,0,30,Clouds
64336,102,1554278400,40,0,40,Clouds
64337,103,1554278400,17,23,40,Clouds
64338,104,1554278400,39,1,40,Clouds
64339,105,1554278400,29,7,36,Clouds
64340,106,1554278400,31,9,40,Clouds
64341,107,1554278400,29,11,40,Clouds
64342,108,1554278400,28,12,40,Clouds
64343,109,1554278400,18,11,29,Clouds
64344,110,1554278400,33,7,40,Clouds
64345,111,1554278400,32,8,40,Clouds
64346,112,1554278400,28,2,30,Clouds
64347,113,1554278400,33,7,40,Clouds
64348,114,1554278400,30,10,40,Clouds
64349,115,1554278400,18,12,30,Clouds
64350,2,1554282000,20,0,20,Clouds
64351,3,1554282000,17,3,20,Clouds
64352,4,1554282000,20,0,20,Clouds
64353,5,1554282000,38,2,40,Clouds
64354,6,1554282000,16,4,20,Clouds
64355,7,1554282000,27,1,28,Clouds
64356,8,1554282000,16,14,30,Clouds
64357,9,1554282000,14,10,24,Clouds
64358,10,1554282000,15,1,16,Clouds
64359,11,1554282000,0,30,30,Clouds
64360,12,1554282000,20,0,20,Clouds
64361,13,1554282000,14,16,30,Clouds
64362,14,1554282000,22,8,30,Clouds
64363,15,1554282000,15,1,16,Clouds
64364,16,1554282000,11,9,20,Clouds
64365,17,1554282000,20,0,20,Clouds
64366,18,1554282000,30,0,30,Clouds
64367,19,1554282000,8,22,30,Clouds
64368,21,1554282000,11,19,30,Clouds
64369,22,1554282000,13,7,20,Clouds
64370,23,1554282000,20,10,30,Clouds
64371,24,1554282000,20,0,20,Clouds
64372,25,1554282000,0,29,29,Clouds
64373,26,1554282000,8,12,20,Clouds
64374,27,1554282000,6,14,20,Clouds
64375,28,1554282000,30,0,30,Clouds
64376,29,1554282000,29,0,29,Clouds
64377,30,1554282000,20,0,20,Clouds
64378,31,1554282000,10,10,20,Clouds
64379,32,1554282000,28,2,30,Clouds
64380,33,1554282000,1,22,23,Clouds
64381,34,1554282000,28,2,30,Clouds
64382,35,1554282000,29,1,30,Clouds
64383,36,1554282000,8,32,40,Clouds
64384,37,1554282000,23,7,30,Clouds
64385,38,1554282000,17,23,40,Clouds
64386,39,1554282000,20,0,20,Clouds
64387,40,1554282000,16,5,21,Clouds
64388,41,1554282000,19,1,20,Clouds
64389,42,1554282000,30,0,30,Clouds
64390,43,1554282000,30,0,30,Clouds
64391,44,1554282000,26,4,30,Clouds
64392,45,1554282000,21,9,30,Clouds
64393,46,1554282000,13,7,20,Clouds
64394,47,1554282000,8,31,39,Clouds
64395,48,1554282000,28,12,40,Clouds
64396,49,1554282000,19,20,39,Clouds
64397,50,1554282000,40,0,40,Clouds
64398,51,1554282000,27,13,40,Clouds
64399,52,1554282000,20,11,31,Clouds
64400,53,1554282000,20,20,40,Clouds
64401,54,1554282000,20,13,33,Clouds
64402,55,1554282000,1,35,36,Clouds
64403,56,1554282000,0,39,39,Clouds
64404,57,1554282000,3,20,23,Clouds
64405,58,1554282000,16,24,40,Clouds
64406,59,1554282000,18,2,20,Clouds
64407,60,1554282000,30,0,30,Clouds
64408,61,1554282000,25,0,25,Clouds
64409,62,1554282000,2,37,39,Clouds
64410,63,1554282000,22,13,35,Clouds
64411,64,1554282000,21,19,40,Clouds
64412,65,1554282000,20,20,40,Clouds
64413,66,1554282000,5,34,39,Clouds
64414,67,1554282000,29,11,40,Clouds
64415,68,1554282000,0,40,40,Clouds
64416,69,1554282000,5,34,39,Clouds
64417,70,1554282000,15,13,28,Clouds
64418,71,1554282000,39,1,40,Clouds
64419,72,1554282000,31,0,31,Clouds
64420,73,1554282000,29,1,30,Clouds
64421,74,1554282000,29,1,30,Clouds
64422,75,1554282000,39,1,40,Clouds
64423,76,1554282000,38,0,38,Clouds
64424,77,1554282000,27,2,29,Clouds
64425,78,1554282000,39,1,40,Clouds
64426,79,1554282000,25,2,27,Clouds
64427,80,1554282000,40,0,40,Clouds
64428,81,1554282000,40,0,40,Clouds
64429,82,1554282000,22,0,22,Clouds
64430,83,1554282000,40,0,40,Clouds
64431,84,1554282000,30,0,30,Clouds
64432,85,1554282000,35,0,35,Clouds
64433,86,1554282000,38,0,38,Clouds
64434,87,1554282000,37,1,38,Clouds
64435,88,1554282000,30,0,30,Clouds
64436,89,1554282000,21,19,40,Clouds
64437,90,1554282000,0,39,39,Clouds
64438,91,1554282000,23,6,29,Clouds
64439,92,1554282000,39,1,40,Clouds
64440,93,1554282000,40,0,40,Clouds
64441,94,1554282000,40,0,40,Clouds
64442,95,1554282000,40,0,40,Clouds
64443,96,1554282000,26,4,30,Clouds
64444,97,1554282000,37,3,40,Clouds
64445,98,1554282000,38,2,40,Clouds
64446,99,1554282000,8,22,30,Clouds
64447,100,1554282000,23,2,25,Clouds
64448,101,1554282000,29,1,30,Clouds
64449,102,1554282000,40,0,40,Clouds
64450,103,1554282000,19,21,40,Clouds
64451,104,1554282000,38,2,40,Clouds
64452,105,1554282000,33,3,36,Clouds
64453,106,1554282000,40,0,40,Clouds
64454,107,1554282000,40,0,40,Clouds
64455,108,1554282000,40,0,40,Clouds
64456,109,1554282000,26,3,29,Clouds
64457,110,1554282000,40,0,40,Clouds
64458,111,1554282000,38,2,40,Clouds
64459,112,1554282000,30,0,30,Clouds
64460,113,1554282000,21,19,40,Clouds
64461,114,1554282000,1,38,39,Clouds
64462,115,1554282000,30,0,30,Clouds
64463,2,1554285600,20,0,20,Clouds
64464,3,1554285600,14,6,20,Clouds
64465,4,1554285600,16,4,20,Clouds
64466,5,1554285600,32,8,40,Clouds
64467,6,1554285600,20,0,20,Clouds
64468,7,1554285600,27,1,28,Clouds
64469,8,1554285600,4,26,30,Clouds
64470,9,1554285600,14,10,24,Clouds
64471,10,1554285600,14,2,16,Clouds
64472,11,1554285600,0,30,30,Clouds
64473,12,1554285600,20,0,20,Clouds
64474,13,1554285600,12,18,30,Clouds
64475,14,1554285600,23,7,30,Clouds
64476,15,1554285600,16,0,16,Clouds
64477,16,1554285600,10,10,20,Clouds
64478,17,1554285600,18,2,20,Clouds
64479,18,1554285600,28,2,30,Clouds
64480,19,1554285600,1,29,30,Clouds
64481,21,1554285600,14,16,30,Clouds
64482,22,1554285600,13,7,20,Clouds
64483,23,1554285600,24,6,30,Clouds
64484,24,1554285600,20,0,20,Clouds
64485,25,1554285600,2,27,29,Clouds
64486,26,1554285600,6,14,20,Clouds
64487,27,1554285600,0,19,19,Clouds
64488,28,1554285600,29,1,30,Clouds
64489,29,1554285600,21,8,29,Clouds
64490,30,1554285600,20,0,20,Clouds
64491,31,1554285600,13,7,20,Clouds
64492,32,1554285600,23,7,30,Clouds
64493,33,1554285600,1,22,23,Clouds
64494,34,1554285600,29,1,30,Clouds
64495,35,1554285600,30,0,30,Clouds
64496,36,1554285600,2,38,40,Clouds
64497,37,1554285600,24,6,30,Clouds
64498,38,1554285600,15,25,40,Clouds
64499,39,1554285600,18,2,20,Clouds
64500,40,1554285600,11,10,21,Clouds
64501,41,1554285600,9,11,20,Clouds
64502,42,1554285600,29,1,30,Clouds
64503,43,1554285600,29,1,30,Clouds
64504,44,1554285600,30,0,30,Clouds
64505,45,1554285600,25,5,30,Clouds
64506,46,1554285600,15,5,20,Clouds
64507,47,1554285600,3,36,39,Clouds
64508,48,1554285600,15,25,40,Clouds
64509,49,1554285600,6,32,38,Clouds
64510,50,1554285600,39,1,40,Clouds
64511,51,1554285600,36,4,40,Clouds
64512,52,1554285600,17,14,31,Clouds
64513,53,1554285600,8,32,40,Clouds
64514,54,1554285600,14,19,33,Clouds
64515,55,1554285600,1,35,36,Clouds
64516,56,1554285600,8,31,39,Clouds
64517,57,1554285600,1,22,23,Clouds
64518,58,1554285600,0,40,40,Clouds
64519,59,1554285600,19,1,20,Clouds
64520,60,1554285600,30,0,30,Clouds
64521,61,1554285600,21,4,25,Clouds
64522,62,1554285600,9,31,40,Clouds
64523,63,1554285600,14,21,35,Clouds
64524,64,1554285600,1,39,40,Clouds
64525,65,1554285600,3,37,40,Clouds
64526,66,1554285600,0,38,38,Clouds
64527,67,1554285600,26,14,40,Clouds
64528,68,1554285600,5,35,40,Clouds
64529,69,1554285600,0,39,39,Clouds
64530,70,1554285600,0,28,28,Clouds
64531,71,1554285600,37,3,40,Clouds
64532,72,1554285600,31,0,31,Clouds
64533,73,1554285600,30,0,30,Clouds
64534,74,1554285600,30,0,30,Clouds
64535,75,1554285600,40,0,40,Clouds
64536,76,1554285600,37,1,38,Clouds
64537,77,1554285600,28,1,29,Clouds
64538,78,1554285600,40,0,40,Clouds
64539,79,1554285600,22,5,27,Clouds
64540,80,1554285600,40,0,40,Clouds
64541,81,1554285600,40,0,40,Clouds
64542,82,1554285600,22,0,22,Clouds
64543,83,1554285600,40,0,40,Clouds
64544,84,1554285600,30,0,30,Clouds
64545,85,1554285600,35,0,35,Clouds
64546,86,1554285600,38,0,38,Clouds
64547,87,1554285600,37,1,38,Clouds
64548,88,1554285600,30,0,30,Clouds
64549,89,1554285600,10,30,40,Clouds
64550,90,1554285600,0,39,39,Clouds
64551,91,1554285600,11,18,29,Clouds
64552,92,1554285600,40,0,40,Clouds
64553,93,1554285600,40,0,40,Clouds
64554,94,1554285600,40,0,40,Clouds
64555,95,1554285600,40,0,40,Clouds
64556,96,1554285600,26,0,26,Clouds
64557,97,1554285600,38,0,38,Clouds
64558,98,1554285600,32,8,40,Clouds
64559,99,1554285600,1,29,30,Clouds
64560,100,1554285600,25,0,25,Clouds
64561,101,1554285600,30,0,30,Clouds
64562,102,1554285600,40,0,40,Clouds
64563,103,1554285600,20,20,40,Clouds
64564,104,1554285600,39,1,40,Clouds
64565,105,1554285600,36,0,36,Clouds
64566,106,1554285600,40,0,40,Clouds
64567,107,1554285600,40,0,40,Clouds
64568,108,1554285600,40,0,40,Clouds
64569,109,1554285600,29,0,29,Clouds
64570,110,1554285600,40,0,40,Clouds
64571,111,1554285600,39,1,40,Clouds
64572,112,1554285600,30,0,30,Clouds
64573,113,1554285600,6,34,40,Clouds
64574,114,1554285600,0,39,39,Clouds
64575,115,1554285600,30,0,30,Clouds
64576,2,1554292800,19,1,20,Rain
64577,3,1554292800,20,0,20,Rain
64578,4,1554292800,19,1,20,Rain
64579,5,1554292800,38,2,40,Rain
64580,6,1554292800,20,0,20,Rain
64581,7,1554292800,28,0,28,Rain
64582,8,1554292800,0,30,30,Rain
64583,9,1554292800,4,20,24,Rain
64584,10,1554292800,9,7,16,Rain
64585,11,1554292800,16,14,30,Rain
64586,12,1554292800,20,0,20,Rain
64587,13,1554292800,14,16,30,Rain
64588,14,1554292800,24,6,30,Rain
64589,15,1554292800,16,0,16,Rain
64590,16,1554292800,12,8,20,Rain
64591,17,1554292800,20,0,20,Rain
64592,18,1554292800,26,4,30,Rain
64593,19,1554292800,10,19,29,Rain
64594,21,1554292800,10,20,30,Rain
64595,22,1554292800,12,8,20,Rain
64596,23,1554292800,15,15,30,Rain
64597,24,1554292800,13,7,20,Rain
64598,25,1554292800,2,26,28,Rain
64599,26,1554292800,7,13,20,Rain
64600,27,1554292800,2,17,19,Rain
64601,28,1554292800,24,6,30,Rain
64602,29,1554292800,27,2,29,Rain
64603,30,1554292800,20,0,20,Rain
64604,31,1554292800,14,6,20,Rain
64605,32,1554292800,16,14,30,Rain
64606,33,1554292800,1,22,23,Rain
64607,34,1554292800,29,1,30,Rain
64608,35,1554292800,26,4,30,Rain
64609,36,1554292800,0,39,39,Rain
64610,37,1554292800,22,8,30,Rain
64611,38,1554292800,20,20,40,Rain
64612,39,1554292800,18,2,20,Rain
64613,40,1554292800,13,8,21,Rain
64614,41,1554292800,12,8,20,Rain
64615,42,1554292800,30,0,30,Rain
64616,43,1554292800,28,2,30,Rain
64617,44,1554292800,28,2,30,Rain
64618,45,1554292800,25,5,30,Rain
64619,46,1554292800,14,5,19,Rain
64620,47,1554292800,3,36,39,Rain
64621,48,1554292800,10,30,40,Rain
64622,49,1554292800,7,31,38,Rain
64623,50,1554292800,40,0,40,Rain
64624,51,1554292800,34,6,40,Rain
64625,52,1554292800,12,19,31,Rain
64626,53,1554292800,4,35,39,Rain
64627,54,1554292800,16,17,33,Rain
64628,55,1554292800,2,34,36,Rain
64629,56,1554292800,15,24,39,Rain
64630,57,1554292800,2,21,23,Rain
64631,58,1554292800,16,24,40,Rain
64632,59,1554292800,19,1,20,Rain
64633,60,1554292800,30,0,30,Rain
64634,61,1554292800,14,11,25,Rain
64635,62,1554292800,7,33,40,Rain
64636,63,1554292800,14,21,35,Rain
64637,64,1554292800,6,34,40,Rain
64638,65,1554292800,2,37,39,Rain
64639,66,1554292800,18,21,39,Rain
64640,67,1554292800,30,10,40,Rain
64641,68,1554292800,5,35,40,Rain
64642,69,1554292800,7,32,39,Rain
64643,70,1554292800,1,27,28,Rain
64644,71,1554292800,36,4,40,Rain
64645,72,1554292800,31,0,31,Rain
64646,73,1554292800,30,0,30,Rain
64647,74,1554292800,30,0,30,Rain
64648,75,1554292800,40,0,40,Rain
64649,76,1554292800,38,0,38,Rain
64650,77,1554292800,29,0,29,Rain
64651,78,1554292800,39,1,40,Rain
64652,79,1554292800,25,2,27,Rain
64653,80,1554292800,39,1,40,Rain
64654,81,1554292800,40,0,40,Rain
64655,82,1554292800,22,0,22,Rain
64656,83,1554292800,40,0,40,Rain
64657,84,1554292800,30,0,30,Rain
64658,85,1554292800,35,0,35,Rain
64659,86,1554292800,37,1,38,Rain
64660,87,1554292800,35,2,37,Rain
64661,88,1554292800,29,1,30,Rain
64662,89,1554292800,8,32,40,Rain
64663,90,1554292800,3,36,39,Rain
64664,91,1554292800,8,21,29,Rain
64665,92,1554292800,40,0,40,Rain
64666,93,1554292800,40,0,40,Rain
64667,94,1554292800,40,0,40,Rain
64668,95,1554292800,40,0,40,Rain
64669,96,1554292800,26,0,26,Rain
64670,97,1554292800,37,1,38,Rain
64671,98,1554292800,29,11,40,Rain
64672,99,1554292800,1,29,30,Rain
64673,100,1554292800,25,0,25,Rain
64674,101,1554292800,29,1,30,Rain
64675,102,1554292800,40,0,40,Rain
64676,103,1554292800,25,13,38,Rain
64677,104,1554292800,40,0,40,Rain
64678,105,1554292800,36,0,36,Rain
64679,106,1554292800,40,0,40,Rain
64680,107,1554292800,39,1,40,Rain
64681,108,1554292800,40,0,40,Rain
64682,109,1554292800,27,2,29,Rain
64683,110,1554292800,38,2,40,Rain
64684,111,1554292800,30,10,40,Rain
64685,112,1554292800,26,4,30,Rain
64686,113,1554292800,2,37,39,Rain
64687,114,1554292800,4,36,40,Rain
64688,115,1554292800,26,4,30,Rain
64689,2,1554300000,17,3,20,Rain
64690,3,1554300000,8,12,20,Rain
64691,4,1554300000,20,0,20,Rain
64692,5,1554300000,37,3,40,Rain
64693,6,1554300000,19,1,20,Rain
64694,7,1554300000,27,1,28,Rain
64695,8,1554300000,0,30,30,Rain
64696,9,1554300000,21,3,24,Rain
64697,10,1554300000,16,0,16,Rain
64698,11,1554300000,26,4,30,Rain
64699,12,1554300000,18,2,20,Rain
64700,13,1554300000,16,14,30,Rain
64701,14,1554300000,21,9,30,Rain
64702,15,1554300000,14,2,16,Rain
64703,16,1554300000,17,3,20,Rain
64704,17,1554300000,17,3,20,Rain
64705,18,1554300000,26,4,30,Rain
64706,19,1554300000,0,29,29,Rain
64707,21,1554300000,9,21,30,Rain
64708,22,1554300000,19,1,20,Rain
64709,23,1554300000,13,17,30,Rain
64710,24,1554300000,14,6,20,Rain
64711,25,1554300000,3,26,29,Rain
64712,26,1554300000,4,16,20,Rain
64713,27,1554300000,2,18,20,Rain
64714,28,1554300000,29,1,30,Rain
64715,29,1554300000,21,8,29,Rain
64716,30,1554300000,12,8,20,Rain
64717,31,1554300000,14,6,20,Rain
64718,32,1554300000,14,16,30,Rain
64719,33,1554300000,3,20,23,Rain
64720,34,1554300000,28,2,30,Rain
64721,35,1554300000,28,2,30,Rain
64722,36,1554300000,0,40,40,Rain
64723,37,1554300000,23,7,30,Rain
64724,38,1554300000,24,16,40,Rain
64725,39,1554300000,19,1,20,Rain
64726,40,1554300000,19,2,21,Rain
64727,41,1554300000,12,8,20,Rain
64728,42,1554300000,25,5,30,Rain
64729,43,1554300000,27,3,30,Rain
64730,44,1554300000,29,1,30,Rain
64731,45,1554300000,28,2,30,Rain
64732,46,1554300000,19,0,19,Rain
64733,47,1554300000,0,39,39,Rain
64734,48,1554300000,6,34,40,Rain
64735,49,1554300000,6,32,38,Rain
64736,50,1554300000,39,1,40,Rain
64737,51,1554300000,27,13,40,Rain
64738,52,1554300000,21,10,31,Rain
64739,53,1554300000,5,34,39,Rain
64740,54,1554300000,15,18,33,Rain
64741,55,1554300000,6,30,36,Rain
64742,56,1554300000,6,33,39,Rain
64743,57,1554300000,6,17,23,Rain
64744,58,1554300000,18,22,40,Rain
64745,59,1554300000,18,2,20,Rain
64746,60,1554300000,30,0,30,Rain
64747,61,1554300000,24,1,25,Rain
64748,62,1554300000,17,23,40,Rain
64749,63,1554300000,6,29,35,Rain
64750,64,1554300000,15,25,40,Rain
64751,65,1554300000,9,30,39,Rain
64752,66,1554300000,24,15,39,Rain
64753,67,1554300000,25,15,40,Rain
64754,68,1554300000,5,35,40,Rain
64755,69,1554300000,2,37,39,Rain
64756,70,1554300000,8,20,28,Rain
64757,71,1554300000,33,7,40,Rain
64758,72,1554300000,31,0,31,Rain
64759,73,1554300000,27,3,30,Rain
64760,74,1554300000,29,1,30,Rain
64761,75,1554300000,36,0,36,Rain
64762,76,1554300000,38,0,38,Rain
64763,77,1554300000,24,5,29,Rain
64764,78,1554300000,38,2,40,Rain
64765,79,1554300000,25,2,27,Rain
64766,80,1554300000,29,11,40,Rain
64767,81,1554300000,24,16,40,Rain
64768,82,1554300000,22,0,22,Rain
64769,83,1554300000,32,8,40,Rain
64770,84,1554300000,30,0,30,Rain
64771,85,1554300000,31,4,35,Rain
64772,86,1554300000,36,2,38,Rain
64773,87,1554300000,36,1,37,Rain
64774,88,1554300000,29,1,30,Rain
64775,89,1554300000,7,33,40,Rain
64776,90,1554300000,3,36,39,Rain
64777,91,1554300000,16,13,29,Rain
64778,92,1554300000,40,0,40,Rain
64779,93,1554300000,40,0,40,Rain
64780,94,1554300000,40,0,40,Rain
64781,95,1554300000,36,4,40,Rain
64782,96,1554300000,25,1,26,Rain
64783,97,1554300000,37,3,40,Rain
64784,98,1554300000,22,18,40,Rain
64785,99,1554300000,8,22,30,Rain
64786,100,1554300000,22,3,25,Rain
64787,101,1554300000,30,0,30,Rain
64788,102,1554300000,40,0,40,Rain
64789,103,1554300000,29,11,40,Rain
64790,104,1554300000,40,0,40,Rain
64791,105,1554300000,36,0,36,Rain
64792,106,1554300000,40,0,40,Rain
64793,107,1554300000,34,6,40,Rain
64794,108,1554300000,34,6,40,Rain
64795,109,1554300000,29,0,29,Rain
64796,110,1554300000,40,0,40,Rain
64797,111,1554300000,40,0,40,Rain
64798,112,1554300000,26,4,30,Rain
64799,113,1554300000,8,32,40,Rain
64800,114,1554300000,1,39,40,Rain
64801,115,1554300000,24,6,30,Rain
64802,2,1554303600,15,5,20,Rain
64803,3,1554303600,10,10,20,Rain
64804,4,1554303600,19,1,20,Rain
64805,5,1554303600,35,5,40,Rain
64806,6,1554303600,19,1,20,Rain
64807,7,1554303600,27,1,28,Rain
64808,8,1554303600,0,30,30,Rain
64809,9,1554303600,21,3,24,Rain
64810,10,1554303600,15,1,16,Rain
64811,11,1554303600,25,5,30,Rain
64812,12,1554303600,18,2,20,Rain
64813,13,1554303600,15,15,30,Rain
64814,14,1554303600,23,7,30,Rain
64815,15,1554303600,7,9,16,Rain
64816,16,1554303600,14,6,20,Rain
64817,17,1554303600,18,2,20,Rain
64818,18,1554303600,30,0,30,Rain
64819,19,1554303600,0,29,29,Rain
64820,21,1554303600,9,21,30,Rain
64821,22,1554303600,16,4,20,Rain
64822,23,1554303600,23,7,30,Rain
64823,24,1554303600,14,6,20,Rain
64824,25,1554303600,5,24,29,Rain
64825,26,1554303600,5,15,20,Rain
64826,27,1554303600,8,12,20,Rain
64827,28,1554303600,30,0,30,Rain
64828,29,1554303600,20,9,29,Rain
64829,30,1554303600,16,4,20,Rain
64830,31,1554303600,14,6,20,Rain
64831,32,1554303600,18,12,30,Rain
64832,33,1554303600,0,23,23,Rain
64833,34,1554303600,27,3,30,Rain
64834,35,1554303600,26,4,30,Rain
64835,36,1554303600,0,40,40,Rain
64836,37,1554303600,21,9,30,Rain
64837,38,1554303600,26,14,40,Rain
64838,39,1554303600,16,4,20,Rain
64839,40,1554303600,17,4,21,Rain
64840,41,1554303600,8,12,20,Rain
64841,42,1554303600,30,0,30,Rain
64842,43,1554303600,28,2,30,Rain
64843,44,1554303600,28,2,30,Rain
64844,45,1554303600,29,1,30,Rain
64845,46,1554303600,19,0,19,Rain
64846,47,1554303600,1,38,39,Rain
64847,48,1554303600,7,33,40,Rain
64848,49,1554303600,6,32,38,Rain
64849,50,1554303600,38,2,40,Rain
64850,51,1554303600,28,12,40,Rain
64851,52,1554303600,25,6,31,Rain
64852,53,1554303600,3,36,39,Rain
64853,54,1554303600,17,16,33,Rain
64854,55,1554303600,6,30,36,Rain
64855,56,1554303600,6,33,39,Rain
64856,57,1554303600,3,20,23,Rain
64857,58,1554303600,17,23,40,Rain
64858,59,1554303600,20,0,20,Rain
64859,60,1554303600,21,9,30,Rain
64860,61,1554303600,25,0,25,Rain
64861,62,1554303600,13,27,40,Rain
64862,63,1554303600,6,29,35,Rain
64863,64,1554303600,16,24,40,Rain
64864,65,1554303600,5,34,39,Rain
64865,66,1554303600,3,35,38,Rain
64866,67,1554303600,21,19,40,Rain
64867,68,1554303600,6,34,40,Rain
64868,69,1554303600,3,36,39,Rain
64869,70,1554303600,13,15,28,Rain
64870,71,1554303600,34,6,40,Rain
64871,72,1554303600,28,3,31,Rain
64872,73,1554303600,23,7,30,Rain
64873,74,1554303600,26,4,30,Rain
64874,75,1554303600,40,0,40,Rain
64875,76,1554303600,37,1,38,Rain
64876,77,1554303600,28,1,29,Rain
64877,78,1554303600,38,2,40,Rain
64878,79,1554303600,25,2,27,Rain
64879,80,1554303600,34,6,40,Rain
64880,81,1554303600,26,14,40,Rain
64881,82,1554303600,22,0,22,Rain
64882,83,1554303600,31,9,40,Rain
64883,84,1554303600,29,1,30,Rain
64884,85,1554303600,30,5,35,Rain
64885,86,1554303600,35,3,38,Rain
64886,87,1554303600,38,0,38,Rain
64887,88,1554303600,28,2,30,Rain
64888,89,1554303600,7,33,40,Rain
64889,90,1554303600,2,37,39,Rain
64890,91,1554303600,14,15,29,Rain
64891,92,1554303600,38,2,40,Rain
64892,93,1554303600,40,0,40,Rain
64893,94,1554303600,40,0,40,Rain
64894,95,1554303600,35,5,40,Rain
64895,96,1554303600,29,1,30,Rain
64896,97,1554303600,38,2,40,Rain
64897,98,1554303600,25,15,40,Rain
64898,99,1554303600,10,20,30,Rain
64899,100,1554303600,12,13,25,Rain
64900,101,1554303600,26,4,30,Rain
64901,102,1554303600,40,0,40,Rain
64902,103,1554303600,31,9,40,Rain
64903,104,1554303600,40,0,40,Rain
64904,105,1554303600,36,0,36,Rain
64905,106,1554303600,40,0,40,Rain
64906,107,1554303600,32,8,40,Rain
64907,108,1554303600,33,7,40,Rain
64908,109,1554303600,26,3,29,Rain
64909,110,1554303600,40,0,40,Rain
64910,111,1554303600,31,9,40,Rain
64911,112,1554303600,25,5,30,Rain
64912,113,1554303600,7,33,40,Rain
64913,114,1554303600,3,37,40,Rain
64914,115,1554303600,25,5,30,Rain
64915,2,1554307200,20,0,20,Rain
64916,3,1554307200,13,7,20,Rain
64917,4,1554307200,20,0,20,Rain
64918,5,1554307200,31,9,40,Rain
64919,6,1554307200,17,3,20,Rain
64920,7,1554307200,28,0,28,Rain
64921,8,1554307200,0,30,30,Rain
64922,9,1554307200,20,4,24,Rain
64923,10,1554307200,15,1,16,Rain
64924,11,1554307200,28,2,30,Rain
64925,12,1554307200,19,1,20,Rain
64926,13,1554307200,2,28,30,Rain
64927,14,1554307200,14,16,30,Rain
64928,15,1554307200,11,5,16,Rain
64929,16,1554307200,14,6,20,Rain
64930,17,1554307200,17,3,20,Rain
64931,18,1554307200,28,2,30,Rain
64932,19,1554307200,2,28,30,Rain
64933,21,1554307200,18,12,30,Rain
64934,22,1554307200,16,4,20,Rain
64935,23,1554307200,22,8,30,Rain
64936,24,1554307200,10,10,20,Rain
64937,25,1554307200,6,23,29,Rain
64938,26,1554307200,4,16,20,Rain
64939,27,1554307200,11,9,20,Rain
64940,28,1554307200,27,3,30,Rain
64941,29,1554307200,23,6,29,Rain
64942,30,1554307200,19,1,20,Rain
64943,31,1554307200,10,10,20,Rain
64944,32,1554307200,28,2,30,Rain
64945,33,1554307200,0,23,23,Rain
64946,34,1554307200,21,9,30,Rain
64947,35,1554307200,27,3,30,Rain
64948,36,1554307200,10,30,40,Rain
64949,37,1554307200,24,6,30,Rain
64950,38,1554307200,17,23,40,Rain
64951,39,1554307200,18,2,20,Rain
64952,40,1554307200,17,4,21,Rain
64953,41,1554307200,7,13,20,Rain
64954,42,1554307200,29,1,30,Rain
64955,43,1554307200,24,6,30,Rain
64956,44,1554307200,25,5,30,Rain
64957,45,1554307200,26,4,30,Rain
64958,46,1554307200,17,3,20,Rain
64959,47,1554307200,5,35,40,Rain
64960,48,1554307200,0,40,40,Rain
64961,49,1554307200,0,38,38,Rain
64962,50,1554307200,37,3,40,Rain
64963,51,1554307200,30,10,40,Rain
64964,52,1554307200,30,2,32,Rain
64965,53,1554307200,9,31,40,Rain
64966,54,1554307200,19,14,33,Rain
64967,55,1554307200,13,23,36,Rain
64968,56,1554307200,12,28,40,Rain
64969,57,1554307200,3,20,23,Rain
64970,58,1554307200,0,40,40,Rain
64971,59,1554307200,20,0,20,Rain
64972,60,1554307200,15,15,30,Rain
64973,61,1554307200,25,0,25,Rain
64974,62,1554307200,15,25,40,Rain
64975,63,1554307200,5,30,35,Rain
64976,64,1554307200,19,21,40,Rain
64977,65,1554307200,6,33,39,Rain
64978,66,1554307200,4,34,38,Rain
64979,67,1554307200,19,21,40,Rain
64980,68,1554307200,10,30,40,Rain
64981,69,1554307200,9,30,39,Rain
64982,70,1554307200,25,3,28,Rain
64983,71,1554307200,39,1,40,Rain
64984,72,1554307200,29,2,31,Rain
64985,73,1554307200,11,19,30,Rain
64986,74,1554307200,24,6,30,Rain
64987,75,1554307200,35,5,40,Rain
64988,76,1554307200,37,1,38,Rain
64989,77,1554307200,29,0,29,Rain
64990,78,1554307200,36,4,40,Rain
64991,79,1554307200,27,0,27,Rain
64992,80,1554307200,38,2,40,Rain
64993,81,1554307200,26,14,40,Rain
64994,82,1554307200,21,1,22,Rain
64995,83,1554307200,34,6,40,Rain
64996,84,1554307200,30,0,30,Rain
64997,85,1554307200,31,4,35,Rain
64998,86,1554307200,38,0,38,Rain
64999,87,1554307200,38,0,38,Rain
65000,88,1554307200,29,1,30,Rain
65001,89,1554307200,4,36,40,Rain
65002,90,1554307200,1,39,40,Rain
65003,91,1554307200,16,13,29,Rain
65004,92,1554307200,40,0,40,Rain
65005,93,1554307200,40,0,40,Rain
65006,94,1554307200,39,1,40,Rain
65007,95,1554307200,34,6,40,Rain
65008,96,1554307200,29,1,30,Rain
65009,97,1554307200,39,1,40,Rain
65010,98,1554307200,28,12,40,Rain
65011,99,1554307200,6,24,30,Rain
65012,100,1554307200,4,21,25,Rain
65013,101,1554307200,28,1,29,Rain
65014,102,1554307200,39,1,40,Rain
65015,103,1554307200,35,5,40,Rain
65016,104,1554307200,40,0,40,Rain
65017,105,1554307200,36,0,36,Rain
65018,106,1554307200,39,1,40,Rain
65019,107,1554307200,33,7,40,Rain
65020,108,1554307200,35,5,40,Rain
65021,109,1554307200,23,6,29,Rain
65022,110,1554307200,39,1,40,Rain
65023,111,1554307200,37,3,40,Rain
65024,112,1554307200,24,6,30,Rain
65025,113,1554307200,8,32,40,Rain
65026,114,1554307200,5,35,40,Rain
65027,115,1554307200,26,4,30,Rain
65028,2,1554310800,17,3,20,Rain
65029,3,1554310800,16,4,20,Rain
65030,4,1554310800,20,0,20,Rain
65031,5,1554310800,37,3,40,Rain
65032,6,1554310800,14,6,20,Rain
65033,7,1554310800,26,2,28,Rain
65034,8,1554310800,0,30,30,Rain
65035,9,1554310800,21,3,24,Rain
65036,10,1554310800,16,0,16,Rain
65037,11,1554310800,30,0,30,Rain
65038,12,1554310800,19,1,20,Rain
65039,13,1554310800,5,25,30,Rain
65040,14,1554310800,20,10,30,Rain
65041,15,1554310800,16,0,16,Rain
65042,16,1554310800,15,5,20,Rain
65043,17,1554310800,20,0,20,Rain
65044,18,1554310800,22,8,30,Rain
65045,19,1554310800,30,0,30,Rain
65046,21,1554310800,19,11,30,Rain
65047,22,1554310800,8,12,20,Rain
65048,23,1554310800,18,12,30,Rain
65049,24,1554310800,6,14,20,Rain
65050,25,1554310800,23,6,29,Rain
65051,26,1554310800,2,18,20,Rain
65052,27,1554310800,11,9,20,Rain
65053,28,1554310800,30,0,30,Rain
65054,29,1554310800,28,1,29,Rain
65055,30,1554310800,19,1,20,Rain
65056,31,1554310800,6,14,20,Rain
65057,32,1554310800,15,15,30,Rain
65058,33,1554310800,1,22,23,Rain
65059,34,1554310800,18,12,30,Rain
65060,35,1554310800,30,0,30,Rain
65061,36,1554310800,26,14,40,Rain
65062,37,1554310800,27,3,30,Rain
65063,38,1554310800,6,34,40,Rain
65064,39,1554310800,20,0,20,Rain
65065,40,1554310800,21,0,21,Rain
65066,41,1554310800,12,8,20,Rain
65067,42,1554310800,25,5,30,Rain
65068,43,1554310800,20,10,30,Rain
65069,44,1554310800,21,9,30,Rain
65070,45,1554310800,22,8,30,Rain
65071,46,1554310800,16,4,20,Rain
65072,47,1554310800,13,27,40,Rain
65073,48,1554310800,0,40,40,Rain
65074,49,1554310800,6,34,40,Rain
65075,50,1554310800,38,2,40,Rain
65076,51,1554310800,35,5,40,Rain
65077,52,1554310800,30,2,32,Rain
65078,53,1554310800,18,22,40,Rain
65079,54,1554310800,23,10,33,Rain
65080,55,1554310800,30,6,36,Rain
65081,56,1554310800,12,28,40,Rain
65082,57,1554310800,13,10,23,Rain
65083,58,1554310800,13,27,40,Rain
65084,59,1554310800,20,0,20,Rain
65085,60,1554310800,13,17,30,Rain
65086,61,1554310800,25,0,25,Rain
65087,62,1554310800,17,23,40,Rain
65088,63,1554310800,3,32,35,Rain
65089,64,1554310800,20,20,40,Rain
65090,65,1554310800,1,39,40,Rain
65091,66,1554310800,15,25,40,Rain
65092,67,1554310800,13,27,40,Rain
65093,68,1554310800,10,30,40,Rain
65094,69,1554310800,14,25,39,Rain
65095,70,1554310800,21,6,27,Rain
65096,71,1554310800,40,0,40,Rain
65097,72,1554310800,25,6,31,Rain
65098,73,1554310800,18,12,30,Rain
65099,74,1554310800,22,8,30,Rain
65100,75,1554310800,34,6,40,Rain
65101,76,1554310800,24,14,38,Rain
65102,77,1554310800,29,0,29,Rain
65103,78,1554310800,37,3,40,Rain
65104,79,1554310800,27,0,27,Rain
65105,80,1554310800,40,0,40,Rain
65106,81,1554310800,28,12,40,Rain
65107,82,1554310800,21,1,22,Rain
65108,83,1554310800,33,7,40,Rain
65109,84,1554310800,25,5,30,Rain
65110,85,1554310800,29,6,35,Rain
65111,86,1554310800,32,6,38,Rain
65112,87,1554310800,36,2,38,Rain
65113,88,1554310800,29,1,30,Rain
65114,89,1554310800,11,29,40,Rain
65115,90,1554310800,23,17,40,Rain
65116,91,1554310800,16,13,29,Rain
65117,92,1554310800,24,16,40,Rain
65118,93,1554310800,31,9,40,Rain
65119,94,1554310800,39,1,40,Rain
65120,95,1554310800,30,10,40,Rain
65121,96,1554310800,29,1,30,Rain
65122,97,1554310800,40,0,40,Rain
65123,98,1554310800,30,10,40,Rain
65124,99,1554310800,0,30,30,Rain
65125,100,1554310800,1,24,25,Rain
65126,101,1554310800,26,4,30,Rain
65127,102,1554310800,38,2,40,Rain
65128,103,1554310800,20,20,40,Rain
65129,104,1554310800,40,0,40,Rain
65130,105,1554310800,36,0,36,Rain
65131,106,1554310800,38,2,40,Rain
65132,107,1554310800,30,10,40,Rain
65133,108,1554310800,37,3,40,Rain
65134,109,1554310800,21,8,29,Rain
65135,110,1554310800,40,0,40,Rain
65136,111,1554310800,36,4,40,Rain
65137,112,1554310800,24,6,30,Rain
65138,113,1554310800,9,31,40,Rain
65139,114,1554310800,36,4,40,Rain
65140,115,1554310800,26,4,30,Rain
65141,2,1554314400,17,3,20,Rain
65142,3,1554314400,14,6,20,Rain
65143,4,1554314400,18,2,20,Rain
65144,5,1554314400,37,3,40,Rain
65145,6,1554314400,18,2,20,Rain
65146,7,1554314400,26,2,28,Rain
65147,8,1554314400,3,27,30,Rain
65148,9,1554314400,24,0,24,Rain
65149,10,1554314400,10,6,16,Rain
65150,11,1554314400,30,0,30,Rain
65151,12,1554314400,20,0,20,Rain
65152,13,1554314400,12,18,30,Rain
65153,14,1554314400,12,18,30,Rain
65154,15,1554314400,15,1,16,Rain
65155,16,1554314400,14,6,20,Rain
65156,17,1554314400,18,2,20,Rain
65157,18,1554314400,20,10,30,Rain
65158,19,1554314400,30,0,30,Rain
65159,21,1554314400,8,22,30,Rain
65160,22,1554314400,7,13,20,Rain
65161,23,1554314400,20,10,30,Rain
65162,24,1554314400,3,17,20,Rain
65163,25,1554314400,23,6,29,Rain
65164,26,1554314400,1,19,20,Rain
65165,27,1554314400,8,12,20,Rain
65166,28,1554314400,30,0,30,Rain
65167,29,1554314400,28,1,29,Rain
65168,30,1554314400,20,0,20,Rain
65169,31,1554314400,8,12,20,Rain
65170,32,1554314400,2,28,30,Rain
65171,33,1554314400,2,21,23,Rain
65172,34,1554314400,3,27,30,Rain
65173,35,1554314400,28,2,30,Rain
65174,36,1554314400,36,4,40,Rain
65175,37,1554314400,29,1,30,Rain
65176,38,1554314400,0,40,40,Rain
65177,39,1554314400,15,5,20,Rain
65178,40,1554314400,16,5,21,Rain
65179,41,1554314400,19,1,20,Rain
65180,42,1554314400,19,11,30,Rain
65181,43,1554314400,12,18,30,Rain
65182,44,1554314400,13,17,30,Rain
65183,45,1554314400,22,8,30,Rain
65184,46,1554314400,18,2,20,Rain
65185,47,1554314400,38,2,40,Rain
65186,48,1554314400,0,40,40,Rain
65187,49,1554314400,2,38,40,Rain
65188,50,1554314400,33,7,40,Rain
65189,51,1554314400,38,2,40,Rain
65190,52,1554314400,31,1,32,Rain
65191,53,1554314400,27,13,40,Rain
65192,54,1554314400,33,0,33,Rain
65193,55,1554314400,36,0,36,Rain
65194,56,1554314400,27,13,40,Rain
65195,57,1554314400,17,6,23,Rain
65196,58,1554314400,39,1,40,Rain
65197,59,1554314400,20,0,20,Rain
65198,60,1554314400,8,22,30,Rain
65199,61,1554314400,25,0,25,Rain
65200,62,1554314400,35,5,40,Rain
65201,63,1554314400,9,26,35,Rain
65202,64,1554314400,24,16,40,Rain
65203,65,1554314400,1,39,40,Rain
65204,66,1554314400,32,8,40,Rain
65205,67,1554314400,9,31,40,Rain
65206,68,1554314400,18,22,40,Rain
65207,69,1554314400,25,14,39,Rain
65208,70,1554314400,26,2,28,Rain
65209,71,1554314400,35,5,40,Rain
65210,72,1554314400,10,21,31,Rain
65211,73,1554314400,22,8,30,Rain
65212,74,1554314400,23,7,30,Rain
65213,75,1554314400,23,17,40,Rain
65214,76,1554314400,16,22,38,Rain
65215,77,1554314400,26,3,29,Rain
65216,78,1554314400,36,4,40,Rain
65217,79,1554314400,27,0,27,Rain
65218,80,1554314400,36,4,40,Rain
65219,81,1554314400,30,10,40,Rain
65220,82,1554314400,19,3,22,Rain
65221,83,1554314400,30,10,40,Rain
65222,84,1554314400,26,4,30,Rain
65223,85,1554314400,28,7,35,Rain
65224,86,1554314400,28,10,38,Rain
65225,87,1554314400,36,2,38,Rain
65226,88,1554314400,23,7,30,Rain
65227,89,1554314400,18,22,40,Rain
65228,90,1554314400,40,0,40,Rain
65229,91,1554314400,17,12,29,Rain
65230,92,1554314400,14,26,40,Rain
65231,93,1554314400,3,37,40,Rain
65232,94,1554314400,38,2,40,Rain
65233,95,1554314400,29,11,40,Rain
65234,96,1554314400,27,3,30,Rain
65235,97,1554314400,36,4,40,Rain
65236,98,1554314400,29,11,40,Rain
65237,99,1554314400,5,25,30,Rain
65238,100,1554314400,11,14,25,Rain
65239,101,1554314400,25,5,30,Rain
65240,102,1554314400,38,2,40,Rain
65241,103,1554314400,27,13,40,Rain
65242,104,1554314400,40,0,40,Rain
65243,105,1554314400,36,0,36,Rain
65244,106,1554314400,36,4,40,Rain
65245,107,1554314400,25,15,40,Rain
65246,108,1554314400,35,5,40,Rain
65247,109,1554314400,19,10,29,Rain
65248,110,1554314400,39,1,40,Rain
65249,111,1554314400,37,3,40,Rain
65250,112,1554314400,19,11,30,Rain
65251,113,1554314400,19,21,40,Rain
65252,114,1554314400,40,0,40,Rain
65253,115,1554314400,21,9,30,Rain
65254,2,1554318000,15,5,20,Rain
65255,3,1554318000,20,0,20,Rain
65256,4,1554318000,18,2,20,Rain
65257,5,1554318000,23,17,40,Rain
65258,6,1554318000,19,1,20,Rain
65259,7,1554318000,28,0,28,Rain
65260,8,1554318000,13,17,30,Rain
65261,9,1554318000,22,2,24,Rain
65262,10,1554318000,4,12,16,Rain
65263,11,1554318000,30,0,30,Rain
65264,12,1554318000,19,1,20,Rain
65265,13,1554318000,14,16,30,Rain
65266,14,1554318000,3,27,30,Rain
65267,15,1554318000,12,4,16,Rain
65268,16,1554318000,16,4,20,Rain
65269,17,1554318000,19,1,20,Rain
65270,18,1554318000,19,11,30,Rain
65271,19,1554318000,30,0,30,Rain
65272,21,1554318000,7,23,30,Rain
65273,22,1554318000,1,19,20,Rain
65274,23,1554318000,17,13,30,Rain
65275,24,1554318000,2,18,20,Rain
65276,25,1554318000,27,3,30,Rain
65277,26,1554318000,2,18,20,Rain
65278,27,1554318000,10,10,20,Rain
65279,28,1554318000,28,2,30,Rain
65280,29,1554318000,29,0,29,Rain
65281,30,1554318000,19,1,20,Rain
65282,31,1554318000,8,12,20,Rain
65283,32,1554318000,2,28,30,Rain
65284,33,1554318000,1,22,23,Rain
65285,34,1554318000,18,12,30,Rain
65286,35,1554318000,30,0,30,Rain
65287,36,1554318000,36,4,40,Rain
65288,37,1554318000,30,0,30,Rain
65289,38,1554318000,1,39,40,Rain
65290,39,1554318000,17,3,20,Rain
65291,40,1554318000,16,5,21,Rain
65292,41,1554318000,18,2,20,Rain
65293,42,1554318000,13,17,30,Rain
65294,43,1554318000,1,29,30,Rain
65295,44,1554318000,10,20,30,Rain
65296,45,1554318000,13,17,30,Rain
65297,46,1554318000,19,1,20,Rain
65298,47,1554318000,40,0,40,Rain
65299,48,1554318000,1,39,40,Rain
65300,49,1554318000,3,37,40,Rain
65301,50,1554318000,36,4,40,Rain
65302,51,1554318000,34,6,40,Rain
65303,52,1554318000,29,3,32,Rain
65304,53,1554318000,37,3,40,Rain
65305,54,1554318000,33,0,33,Rain
65306,55,1554318000,36,0,36,Rain
65307,56,1554318000,19,21,40,Rain
65308,57,1554318000,17,6,23,Rain
65309,58,1554318000,38,2,40,Rain
65310,59,1554318000,20,0,20,Rain
65311,60,1554318000,9,21,30,Rain
65312,61,1554318000,24,1,25,Rain
65313,62,1554318000,37,3,40,Rain
65314,63,1554318000,11,24,35,Rain
65315,64,1554318000,25,15,40,Rain
65316,65,1554318000,4,36,40,Rain
65317,66,1554318000,34,6,40,Rain
65318,67,1554318000,7,33,40,Rain
65319,68,1554318000,17,23,40,Rain
65320,69,1554318000,34,5,39,Rain
65321,70,1554318000,25,3,28,Rain
65322,71,1554318000,39,1,40,Rain
65323,72,1554318000,13,18,31,Rain
65324,73,1554318000,23,7,30,Rain
65325,74,1554318000,24,6,30,Rain
65326,75,1554318000,19,21,40,Rain
65327,76,1554318000,14,24,38,Rain
65328,77,1554318000,23,6,29,Rain
65329,78,1554318000,33,7,40,Rain
65330,79,1554318000,25,2,27,Rain
65331,80,1554318000,40,0,40,Rain
65332,81,1554318000,12,28,40,Rain
65333,82,1554318000,18,4,22,Rain
65334,83,1554318000,26,14,40,Rain
65335,84,1554318000,24,6,30,Rain
65336,85,1554318000,25,10,35,Rain
65337,86,1554318000,19,19,38,Rain
65338,87,1554318000,33,5,38,Rain
65339,88,1554318000,20,10,30,Rain
65340,89,1554318000,21,19,40,Rain
65341,90,1554318000,40,0,40,Rain
65342,91,1554318000,6,23,29,Rain
65343,92,1554318000,11,29,40,Rain
65344,93,1554318000,0,40,40,Rain
65345,94,1554318000,36,4,40,Rain
65346,95,1554318000,24,16,40,Rain
65347,96,1554318000,25,5,30,Rain
65348,97,1554318000,32,8,40,Rain
65349,98,1554318000,33,7,40,Rain
65350,99,1554318000,5,25,30,Rain
65351,100,1554318000,12,13,25,Rain
65352,101,1554318000,25,5,30,Rain
65353,102,1554318000,36,4,40,Rain
65354,103,1554318000,28,12,40,Rain
65355,104,1554318000,40,0,40,Rain
65356,105,1554318000,35,1,36,Rain
65357,106,1554318000,36,4,40,Rain
65358,107,1554318000,22,18,40,Rain
65359,108,1554318000,33,7,40,Rain
65360,109,1554318000,21,8,29,Rain
65361,110,1554318000,40,0,40,Rain
65362,111,1554318000,31,9,40,Rain
65363,112,1554318000,18,12,30,Rain
65364,113,1554318000,21,19,40,Rain
65365,114,1554318000,39,1,40,Rain
65366,115,1554318000,12,18,30,Rain
65367,2,1554321600,15,5,20,Rain
65368,3,1554321600,19,1,20,Rain
65369,4,1554321600,18,2,20,Rain
65370,5,1554321600,16,24,40,Rain
65371,6,1554321600,20,0,20,Rain
65372,7,1554321600,27,1,28,Rain
65373,8,1554321600,24,6,30,Rain
65374,9,1554321600,23,1,24,Rain
65375,10,1554321600,8,8,16,Rain
65376,11,1554321600,30,0,30,Rain
65377,12,1554321600,15,5,20,Rain
65378,13,1554321600,17,13,30,Rain
65379,14,1554321600,3,27,30,Rain
65380,15,1554321600,12,4,16,Rain
65381,16,1554321600,17,3,20,Rain
65382,17,1554321600,20,0,20,Rain
65383,18,1554321600,21,9,30,Rain
65384,19,1554321600,21,9,30,Rain
65385,21,1554321600,9,21,30,Rain
65386,22,1554321600,0,20,20,Rain
65387,23,1554321600,11,19,30,Rain
65388,24,1554321600,10,10,20,Rain
65389,25,1554321600,27,3,30,Rain
65390,26,1554321600,5,15,20,Rain
65391,27,1554321600,17,3,20,Rain
65392,28,1554321600,16,14,30,Rain
65393,29,1554321600,28,1,29,Rain
65394,30,1554321600,19,1,20,Rain
65395,31,1554321600,15,5,20,Rain
65396,32,1554321600,19,11,30,Rain
65397,33,1554321600,2,21,23,Rain
65398,34,1554321600,4,26,30,Rain
65399,35,1554321600,27,3,30,Rain
65400,36,1554321600,24,16,40,Rain
65401,37,1554321600,30,0,30,Rain
65402,38,1554321600,3,37,40,Rain
65403,39,1554321600,13,7,20,Rain
65404,40,1554321600,20,1,21,Rain
65405,41,1554321600,20,0,20,Rain
65406,42,1554321600,9,21,30,Rain
65407,43,1554321600,0,30,30,Rain
65408,44,1554321600,6,24,30,Rain
65409,45,1554321600,10,20,30,Rain
65410,46,1554321600,20,0,20,Rain
65411,47,1554321600,40,0,40,Rain
65412,48,1554321600,14,26,40,Rain
65413,49,1554321600,0,40,40,Rain
65414,50,1554321600,31,9,40,Rain
65415,51,1554321600,40,0,40,Rain
65416,52,1554321600,32,0,32,Rain
65417,53,1554321600,39,1,40,Rain
65418,54,1554321600,33,0,33,Rain
65419,55,1554321600,36,0,36,Rain
65420,56,1554321600,25,15,40,Rain
65421,57,1554321600,20,2,22,Rain
65422,58,1554321600,40,0,40,Rain
65423,59,1554321600,19,1,20,Rain
65424,60,1554321600,1,29,30,Rain
65425,61,1554321600,24,1,25,Rain
65426,62,1554321600,38,2,40,Rain
65427,63,1554321600,9,26,35,Rain
65428,64,1554321600,27,13,40,Rain
65429,65,1554321600,18,22,40,Rain
65430,66,1554321600,40,0,40,Rain
65431,67,1554321600,1,39,40,Rain
65432,68,1554321600,26,14,40,Rain
65433,69,1554321600,29,11,40,Rain
65434,70,1554321600,26,2,28,Rain
65435,71,1554321600,39,1,40,Rain
65436,72,1554321600,13,18,31,Rain
65437,73,1554321600,19,11,30,Rain
65438,74,1554321600,26,4,30,Rain
65439,75,1554321600,17,23,40,Rain
65440,76,1554321600,11,27,38,Rain
65441,77,1554321600,23,6,29,Rain
65442,78,1554321600,35,5,40,Rain
65443,79,1554321600,25,2,27,Rain
65444,80,1554321600,38,2,40,Rain
65445,81,1554321600,13,27,40,Rain
65446,82,1554321600,14,8,22,Rain
65447,83,1554321600,28,12,40,Rain
65448,84,1554321600,23,7,30,Rain
65449,85,1554321600,24,11,35,Rain
65450,86,1554321600,16,22,38,Rain
65451,87,1554321600,32,6,38,Rain
65452,88,1554321600,18,12,30,Rain
65453,89,1554321600,22,18,40,Rain
65454,90,1554321600,34,6,40,Rain
65455,91,1554321600,5,25,30,Rain
65456,92,1554321600,10,30,40,Rain
65457,93,1554321600,0,40,40,Rain
65458,94,1554321600,36,4,40,Rain
65459,95,1554321600,24,16,40,Rain
65460,96,1554321600,23,7,30,Rain
65461,97,1554321600,27,13,40,Rain
65462,98,1554321600,36,4,40,Rain
65463,99,1554321600,4,26,30,Rain
65464,100,1554321600,8,17,25,Rain
65465,101,1554321600,20,10,30,Rain
65466,102,1554321600,34,6,40,Rain
65467,103,1554321600,27,13,40,Rain
65468,104,1554321600,40,0,40,Rain
65469,105,1554321600,35,1,36,Rain
65470,106,1554321600,34,6,40,Rain
65471,107,1554321600,22,18,40,Rain
65472,108,1554321600,31,9,40,Rain
65473,109,1554321600,19,10,29,Rain
65474,110,1554321600,38,2,40,Rain
65475,111,1554321600,25,15,40,Rain
65476,112,1554321600,11,19,30,Rain
65477,113,1554321600,20,20,40,Rain
65478,114,1554321600,40,0,40,Rain
65479,115,1554321600,5,25,30,Rain
65480,2,1554325200,12,8,20,Rain
65481,3,1554325200,18,2,20,Rain
65482,4,1554325200,17,3,20,Rain
65483,5,1554325200,11,29,40,Rain
65484,6,1554325200,18,2,20,Rain
65485,7,1554325200,27,1,28,Rain
65486,8,1554325200,28,2,30,Rain
65487,9,1554325200,24,0,24,Rain
65488,10,1554325200,7,9,16,Rain
65489,11,1554325200,30,0,30,Rain
65490,12,1554325200,14,6,20,Rain
65491,13,1554325200,19,11,30,Rain
65492,14,1554325200,9,21,30,Rain
65493,15,1554325200,16,0,16,Rain
65494,16,1554325200,14,6,20,Rain
65495,17,1554325200,20,0,20,Rain
65496,18,1554325200,25,5,30,Rain
65497,19,1554325200,21,9,30,Rain
65498,21,1554325200,11,19,30,Rain
65499,22,1554325200,1,19,20,Rain
65500,23,1554325200,11,19,30,Rain
65501,24,1554325200,11,9,20,Rain
65502,25,1554325200,29,1,30,Rain
65503,26,1554325200,5,15,20,Rain
65504,27,1554325200,20,0,20,Rain
65505,28,1554325200,10,20,30,Rain
65506,29,1554325200,24,5,29,Rain
65507,30,1554325200,20,0,20,Rain
65508,31,1554325200,20,0,20,Rain
65509,32,1554325200,16,14,30,Rain
65510,33,1554325200,7,16,23,Rain
65511,34,1554325200,4,26,30,Rain
65512,35,1554325200,25,5,30,Rain
65513,36,1554325200,26,14,40,Rain
65514,37,1554325200,30,0,30,Rain
65515,38,1554325200,4,36,40,Rain
65516,39,1554325200,12,8,20,Rain
65517,40,1554325200,21,0,21,Rain
65518,41,1554325200,20,0,20,Rain
65519,42,1554325200,6,24,30,Rain
65520,43,1554325200,4,26,30,Rain
65521,44,1554325200,2,28,30,Rain
65522,45,1554325200,10,20,30,Rain
65523,46,1554325200,18,2,20,Rain
65524,47,1554325200,40,0,40,Rain
65525,48,1554325200,10,30,40,Rain
65526,49,1554325200,2,38,40,Rain
65527,50,1554325200,33,7,40,Rain
65528,51,1554325200,40,0,40,Rain
65529,52,1554325200,32,0,32,Rain
65530,53,1554325200,40,0,40,Rain
65531,54,1554325200,32,1,33,Rain
65532,55,1554325200,35,1,36,Rain
65533,56,1554325200,22,18,40,Rain
65534,57,1554325200,20,2,22,Rain
65535,58,1554325200,40,0,40,Rain
65536,59,1554325200,20,0,20,Rain
65537,60,1554325200,0,30,30,Rain
65538,61,1554325200,24,1,25,Rain
65539,62,1554325200,39,1,40,Rain
65540,63,1554325200,8,27,35,Rain
65541,64,1554325200,28,12,40,Rain
65542,65,1554325200,21,19,40,Rain
65543,66,1554325200,33,7,40,Rain
65544,67,1554325200,0,40,40,Rain
65545,68,1554325200,26,14,40,Rain
65546,69,1554325200,34,6,40,Rain
65547,70,1554325200,25,3,28,Rain
65548,71,1554325200,37,3,40,Rain
65549,72,1554325200,13,18,31,Rain
65550,73,1554325200,13,17,30,Rain
65551,74,1554325200,24,6,30,Rain
65552,75,1554325200,16,24,40,Rain
65553,76,1554325200,11,27,38,Rain
65554,77,1554325200,19,10,29,Rain
65555,78,1554325200,37,3,40,Rain
65556,79,1554325200,24,3,27,Rain
65557,80,1554325200,37,3,40,Rain
65558,81,1554325200,14,26,40,Rain
65559,82,1554325200,13,9,22,Rain
65560,83,1554325200,25,15,40,Rain
65561,84,1554325200,21,9,30,Rain
65562,85,1554325200,21,14,35,Rain
65563,86,1554325200,19,19,38,Rain
65564,87,1554325200,30,8,38,Rain
65565,88,1554325200,14,16,30,Rain
65566,89,1554325200,25,15,40,Rain
65567,90,1554325200,37,3,40,Rain
65568,91,1554325200,3,27,30,Rain
65569,92,1554325200,9,31,40,Rain
65570,93,1554325200,0,40,40,Rain
65571,94,1554325200,35,5,40,Rain
65572,95,1554325200,22,18,40,Rain
65573,96,1554325200,23,7,30,Rain
65574,97,1554325200,25,15,40,Rain
65575,98,1554325200,37,3,40,Rain
65576,99,1554325200,7,23,30,Rain
65577,100,1554325200,2,23,25,Rain
65578,101,1554325200,18,12,30,Rain
65579,102,1554325200,32,8,40,Rain
65580,103,1554325200,27,13,40,Rain
65581,104,1554325200,40,0,40,Rain
65582,105,1554325200,35,1,36,Rain
65583,106,1554325200,32,8,40,Rain
65584,107,1554325200,23,17,40,Rain
65585,108,1554325200,29,11,40,Rain
65586,109,1554325200,19,10,29,Rain
65587,110,1554325200,35,5,40,Rain
65588,111,1554325200,23,17,40,Rain
65589,112,1554325200,7,23,30,Rain
65590,113,1554325200,21,19,40,Rain
65591,114,1554325200,36,4,40,Rain
65592,115,1554325200,4,26,30,Rain
65593,2,1554328800,10,10,20,Rain
65594,3,1554328800,18,2,20,Rain
65595,4,1554328800,16,4,20,Rain
65596,5,1554328800,12,28,40,Rain
65597,6,1554328800,20,0,20,Rain
65598,7,1554328800,9,20,29,Rain
65599,8,1554328800,29,1,30,Rain
65600,9,1554328800,24,0,24,Rain
65601,10,1554328800,11,5,16,Rain
65602,11,1554328800,30,0,30,Rain
65603,12,1554328800,12,8,20,Rain
65604,13,1554328800,19,11,30,Rain
65605,14,1554328800,10,20,30,Rain
65606,15,1554328800,14,2,16,Rain
65607,16,1554328800,15,5,20,Rain
65608,17,1554328800,19,1,20,Rain
65609,18,1554328800,27,3,30,Rain
65610,19,1554328800,24,6,30,Rain
65611,21,1554328800,15,15,30,Rain
65612,22,1554328800,9,11,20,Rain
65613,23,1554328800,21,9,30,Rain
65614,24,1554328800,10,10,20,Rain
65615,25,1554328800,29,1,30,Rain
65616,26,1554328800,5,15,20,Rain
65617,27,1554328800,20,0,20,Rain
65618,28,1554328800,11,19,30,Rain
65619,29,1554328800,25,4,29,Rain
65620,30,1554328800,19,1,20,Rain
65621,31,1554328800,16,4,20,Rain
65622,32,1554328800,20,10,30,Rain
65623,33,1554328800,13,10,23,Rain
65624,34,1554328800,5,25,30,Rain
65625,35,1554328800,24,6,30,Rain
65626,36,1554328800,26,14,40,Rain
65627,37,1554328800,30,0,30,Rain
65628,38,1554328800,4,36,40,Rain
65629,39,1554328800,17,3,20,Rain
65630,40,1554328800,21,0,21,Rain
65631,41,1554328800,20,0,20,Rain
65632,42,1554328800,1,29,30,Rain
65633,43,1554328800,21,9,30,Rain
65634,44,1554328800,1,29,30,Rain
65635,45,1554328800,9,21,30,Rain
65636,46,1554328800,18,2,20,Rain
65637,47,1554328800,39,1,40,Rain
65638,48,1554328800,14,26,40,Rain
65639,49,1554328800,24,16,40,Rain
65640,50,1554328800,28,12,40,Rain
65641,51,1554328800,40,0,40,Rain
65642,52,1554328800,31,1,32,Rain
65643,53,1554328800,40,0,40,Rain
65644,54,1554328800,33,0,33,Rain
65645,55,1554328800,36,0,36,Rain
65646,56,1554328800,20,20,40,Rain
65647,57,1554328800,20,3,23,Rain
65648,58,1554328800,38,2,40,Rain
65649,59,1554328800,20,0,20,Rain
65650,60,1554328800,0,30,30,Rain
65651,61,1554328800,25,0,25,Rain
65652,62,1554328800,40,0,40,Rain
65653,63,1554328800,9,26,35,Rain
65654,64,1554328800,27,13,40,Rain
65655,65,1554328800,20,20,40,Rain
65656,66,1554328800,34,6,40,Rain
65657,67,1554328800,20,20,40,Rain
65658,68,1554328800,32,8,40,Rain
65659,69,1554328800,39,1,40,Rain
65660,70,1554328800,26,2,28,Rain
65661,71,1554328800,37,3,40,Rain
65662,72,1554328800,14,17,31,Rain
65663,73,1554328800,13,17,30,Rain
65664,74,1554328800,24,6,30,Rain
65665,75,1554328800,14,26,40,Rain
65666,76,1554328800,11,27,38,Rain
65667,77,1554328800,18,11,29,Rain
65668,78,1554328800,34,6,40,Rain
65669,79,1554328800,24,3,27,Rain
65670,80,1554328800,36,4,40,Rain
65671,81,1554328800,13,27,40,Rain
65672,82,1554328800,14,8,22,Rain
65673,83,1554328800,18,22,40,Rain
65674,84,1554328800,19,11,30,Rain
65675,85,1554328800,22,13,35,Rain
65676,86,1554328800,18,20,38,Rain
65677,87,1554328800,26,12,38,Rain
65678,88,1554328800,13,17,30,Rain
65679,89,1554328800,25,15,40,Rain
65680,90,1554328800,38,2,40,Rain
65681,91,1554328800,0,30,30,Rain
65682,92,1554328800,7,33,40,Rain
65683,93,1554328800,0,40,40,Rain
65684,94,1554328800,35,5,40,Rain
65685,95,1554328800,19,21,40,Rain
65686,96,1554328800,14,16,30,Rain
65687,97,1554328800,25,15,40,Rain
65688,98,1554328800,40,0,40,Rain
65689,99,1554328800,7,23,30,Rain
65690,100,1554328800,0,25,25,Rain
65691,101,1554328800,17,13,30,Rain
65692,102,1554328800,31,9,40,Rain
65693,103,1554328800,28,12,40,Rain
65694,104,1554328800,22,18,40,Rain
65695,105,1554328800,35,1,36,Rain
65696,106,1554328800,30,10,40,Rain
65697,107,1554328800,20,20,40,Rain
65698,108,1554328800,29,11,40,Rain
65699,109,1554328800,18,11,29,Rain
65700,110,1554328800,35,5,40,Rain
65701,111,1554328800,25,15,40,Rain
65702,112,1554328800,8,22,30,Rain
65703,113,1554328800,23,17,40,Rain
65704,114,1554328800,36,4,40,Rain
65705,115,1554328800,3,27,30,Rain
65706,2,1554332400,11,9,20,Rain
65707,3,1554332400,17,3,20,Rain
65708,4,1554332400,14,6,20,Rain
65709,5,1554332400,17,23,40,Rain
65710,6,1554332400,20,0,20,Rain
65711,7,1554332400,9,20,29,Rain
65712,8,1554332400,28,2,30,Rain
65713,9,1554332400,24,0,24,Rain
65714,10,1554332400,16,0,16,Rain
65715,11,1554332400,30,0,30,Rain
65716,12,1554332400,11,9,20,Rain
65717,13,1554332400,23,7,30,Rain
65718,14,1554332400,30,0,30,Rain
65719,15,1554332400,14,2,16,Rain
65720,16,1554332400,16,4,20,Rain
65721,17,1554332400,20,0,20,Rain
65722,18,1554332400,27,3,30,Rain
65723,19,1554332400,27,3,30,Rain
65724,21,1554332400,19,11,30,Rain
65725,22,1554332400,10,10,20,Rain
65726,23,1554332400,21,9,30,Rain
65727,24,1554332400,11,9,20,Rain
65728,25,1554332400,29,1,30,Rain
65729,26,1554332400,5,15,20,Rain
65730,27,1554332400,19,1,20,Rain
65731,28,1554332400,10,20,30,Rain
65732,29,1554332400,25,4,29,Rain
65733,30,1554332400,18,2,20,Rain
65734,31,1554332400,15,5,20,Rain
65735,32,1554332400,25,5,30,Rain
65736,33,1554332400,8,15,23,Rain
65737,34,1554332400,4,26,30,Rain
65738,35,1554332400,21,9,30,Rain
65739,36,1554332400,38,2,40,Rain
65740,37,1554332400,30,0,30,Rain
65741,38,1554332400,3,37,40,Rain
65742,39,1554332400,17,3,20,Rain
65743,40,1554332400,20,1,21,Rain
65744,41,1554332400,20,0,20,Rain
65745,42,1554332400,2,28,30,Rain
65746,43,1554332400,22,8,30,Rain
65747,44,1554332400,0,30,30,Rain
65748,45,1554332400,7,23,30,Rain
65749,46,1554332400,19,1,20,Rain
65750,47,1554332400,39,1,40,Rain
65751,48,1554332400,12,28,40,Rain
65752,49,1554332400,24,16,40,Rain
65753,50,1554332400,24,16,40,Rain
65754,51,1554332400,40,0,40,Rain
65755,52,1554332400,30,2,32,Rain
65756,53,1554332400,40,0,40,Rain
65757,54,1554332400,33,0,33,Rain
65758,55,1554332400,36,0,36,Rain
65759,56,1554332400,17,23,40,Rain
65760,57,1554332400,19,4,23,Rain
65761,58,1554332400,39,1,40,Rain
65762,59,1554332400,20,0,20,Rain
65763,60,1554332400,1,29,30,Rain
65764,61,1554332400,7,18,25,Rain
65765,62,1554332400,40,0,40,Rain
65766,63,1554332400,25,10,35,Rain
65767,64,1554332400,30,10,40,Rain
65768,65,1554332400,22,18,40,Rain
65769,66,1554332400,32,8,40,Rain
65770,67,1554332400,18,22,40,Rain
65771,68,1554332400,35,5,40,Rain
65772,69,1554332400,36,4,40,Rain
65773,70,1554332400,20,8,28,Rain
65774,71,1554332400,37,3,40,Rain
65775,72,1554332400,18,13,31,Rain
65776,73,1554332400,16,14,30,Rain
65777,74,1554332400,26,4,30,Rain
65778,75,1554332400,14,26,40,Rain
65779,76,1554332400,12,26,38,Rain
65780,77,1554332400,16,13,29,Rain
65781,78,1554332400,31,9,40,Rain
65782,79,1554332400,23,4,27,Rain
65783,80,1554332400,36,4,40,Rain
65784,81,1554332400,14,26,40,Rain
65785,82,1554332400,14,8,22,Rain
65786,83,1554332400,15,25,40,Rain
65787,84,1554332400,15,15,30,Rain
65788,85,1554332400,20,15,35,Rain
65789,86,1554332400,16,22,38,Rain
65790,87,1554332400,27,11,38,Rain
65791,88,1554332400,15,15,30,Rain
65792,89,1554332400,25,15,40,Rain
65793,90,1554332400,39,1,40,Rain
65794,91,1554332400,0,30,30,Rain
65795,92,1554332400,6,34,40,Rain
65796,93,1554332400,0,40,40,Rain
65797,94,1554332400,17,23,40,Rain
65798,95,1554332400,19,21,40,Rain
65799,96,1554332400,13,17,30,Rain
65800,97,1554332400,22,18,40,Rain
65801,98,1554332400,40,0,40,Rain
65802,99,1554332400,7,23,30,Rain
65803,100,1554332400,0,25,25,Rain
65804,101,1554332400,15,15,30,Rain
65805,102,1554332400,30,10,40,Rain
65806,103,1554332400,29,11,40,Rain
65807,104,1554332400,22,18,40,Rain
65808,105,1554332400,34,2,36,Rain
65809,106,1554332400,30,10,40,Rain
65810,107,1554332400,21,19,40,Rain
65811,108,1554332400,28,12,40,Rain
65812,109,1554332400,19,10,29,Rain
65813,110,1554332400,23,17,40,Rain
65814,111,1554332400,19,21,40,Rain
65815,112,1554332400,7,23,30,Rain
65816,113,1554332400,23,17,40,Rain
65817,114,1554332400,37,3,40,Rain
65818,115,1554332400,7,23,30,Rain
65819,2,1554336000,10,10,20,Rain
65820,3,1554336000,18,2,20,Rain
65821,4,1554336000,14,6,20,Rain
65822,5,1554336000,21,19,40,Rain
65823,6,1554336000,20,0,20,Rain
65824,7,1554336000,13,16,29,Rain
65825,8,1554336000,26,4,30,Rain
65826,9,1554336000,24,0,24,Rain
65827,10,1554336000,16,0,16,Rain
65828,11,1554336000,30,0,30,Rain
65829,12,1554336000,9,11,20,Rain
65830,13,1554336000,23,7,30,Rain
65831,14,1554336000,29,1,30,Rain
65832,15,1554336000,10,6,16,Rain
65833,16,1554336000,17,3,20,Rain
65834,17,1554336000,20,0,20,Rain
65835,18,1554336000,26,4,30,Rain
65836,19,1554336000,27,3,30,Rain
65837,21,1554336000,22,8,30,Rain
65838,22,1554336000,12,8,20,Rain
65839,23,1554336000,26,4,30,Rain
65840,24,1554336000,11,9,20,Rain
65841,25,1554336000,29,1,30,Rain
65842,26,1554336000,8,12,20,Rain
65843,27,1554336000,20,0,20,Rain
65844,28,1554336000,7,23,30,Rain
65845,29,1554336000,29,0,29,Rain
65846,30,1554336000,18,2,20,Rain
65847,31,1554336000,14,6,20,Rain
65848,32,1554336000,26,4,30,Rain
65849,33,1554336000,9,14,23,Rain
65850,34,1554336000,3,27,30,Rain
65851,35,1554336000,21,9,30,Rain
65852,36,1554336000,39,1,40,Rain
65853,37,1554336000,30,0,30,Rain
65854,38,1554336000,6,34,40,Rain
65855,39,1554336000,17,3,20,Rain
65856,40,1554336000,18,3,21,Rain
65857,41,1554336000,19,1,20,Rain
65858,42,1554336000,1,29,30,Rain
65859,43,1554336000,23,7,30,Rain
65860,44,1554336000,0,30,30,Rain
65861,45,1554336000,7,23,30,Rain
65862,46,1554336000,20,0,20,Rain
65863,47,1554336000,39,1,40,Rain
65864,48,1554336000,13,27,40,Rain
65865,49,1554336000,24,16,40,Rain
65866,50,1554336000,20,20,40,Rain
65867,51,1554336000,40,0,40,Rain
65868,52,1554336000,32,0,32,Rain
65869,53,1554336000,40,0,40,Rain
65870,54,1554336000,33,0,33,Rain
65871,55,1554336000,36,0,36,Rain
65872,56,1554336000,15,25,40,Rain
65873,57,1554336000,19,4,23,Rain
65874,58,1554336000,39,1,40,Rain
65875,59,1554336000,19,1,20,Rain
65876,60,1554336000,0,30,30,Rain
65877,61,1554336000,5,20,25,Rain
65878,62,1554336000,40,0,40,Rain
65879,63,1554336000,35,0,35,Rain
65880,64,1554336000,40,0,40,Rain
65881,65,1554336000,22,18,40,Rain
65882,66,1554336000,30,10,40,Rain
65883,67,1554336000,17,23,40,Rain
65884,68,1554336000,33,7,40,Rain
65885,69,1554336000,32,8,40,Rain
65886,70,1554336000,20,8,28,Rain
65887,71,1554336000,40,0,40,Rain
65888,72,1554336000,19,12,31,Rain
65889,73,1554336000,9,21,30,Rain
65890,74,1554336000,25,5,30,Rain
65891,75,1554336000,11,29,40,Rain
65892,76,1554336000,15,23,38,Rain
65893,77,1554336000,15,14,29,Rain
65894,78,1554336000,29,11,40,Rain
65895,79,1554336000,23,4,27,Rain
65896,80,1554336000,36,4,40,Rain
65897,81,1554336000,13,27,40,Rain
65898,82,1554336000,14,8,22,Rain
65899,83,1554336000,15,25,40,Rain
65900,84,1554336000,13,17,30,Rain
65901,85,1554336000,19,16,35,Rain
65902,86,1554336000,18,20,38,Rain
65903,87,1554336000,26,12,38,Rain
65904,88,1554336000,16,14,30,Rain
65905,89,1554336000,25,15,40,Rain
65906,90,1554336000,39,1,40,Rain
65907,91,1554336000,0,30,30,Rain
65908,92,1554336000,6,34,40,Rain
65909,93,1554336000,0,40,40,Rain
65910,94,1554336000,17,23,40,Rain
65911,95,1554336000,19,21,40,Rain
65912,96,1554336000,12,18,30,Rain
65913,97,1554336000,22,18,40,Rain
65914,98,1554336000,40,0,40,Rain
65915,99,1554336000,8,22,30,Rain
65916,100,1554336000,2,23,25,Rain
65917,101,1554336000,14,16,30,Rain
65918,102,1554336000,29,11,40,Rain
65919,103,1554336000,29,11,40,Rain
65920,104,1554336000,22,18,40,Rain
65921,105,1554336000,34,2,36,Rain
65922,106,1554336000,30,10,40,Rain
65923,107,1554336000,20,20,40,Rain
65924,108,1554336000,27,13,40,Rain
65925,109,1554336000,19,10,29,Rain
65926,110,1554336000,23,17,40,Rain
65927,111,1554336000,16,24,40,Rain
65928,112,1554336000,5,25,30,Rain
65929,113,1554336000,24,16,40,Rain
65930,114,1554336000,39,1,40,Rain
65931,115,1554336000,5,25,30,Rain
65932,2,1554339600,10,10,20,Rain
65933,3,1554339600,17,3,20,Rain
65934,4,1554339600,14,6,20,Rain
65935,5,1554339600,21,19,40,Rain
65936,6,1554339600,20,0,20,Rain
65937,7,1554339600,14,15,29,Rain
65938,8,1554339600,27,3,30,Rain
65939,9,1554339600,24,0,24,Rain
65940,10,1554339600,16,0,16,Rain
65941,11,1554339600,30,0,30,Rain
65942,12,1554339600,8,12,20,Rain
65943,13,1554339600,23,7,30,Rain
65944,14,1554339600,30,0,30,Rain
65945,15,1554339600,10,6,16,Rain
65946,16,1554339600,17,3,20,Rain
65947,17,1554339600,20,0,20,Rain
65948,18,1554339600,27,3,30,Rain
65949,19,1554339600,27,3,30,Rain
65950,21,1554339600,23,7,30,Rain
65951,22,1554339600,14,6,20,Rain
65952,23,1554339600,27,3,30,Rain
65953,24,1554339600,11,9,20,Rain
65954,25,1554339600,29,1,30,Rain
65955,26,1554339600,8,12,20,Rain
65956,27,1554339600,20,0,20,Rain
65957,28,1554339600,6,24,30,Rain
65958,29,1554339600,29,0,29,Rain
65959,30,1554339600,18,2,20,Rain
65960,31,1554339600,13,7,20,Rain
65961,32,1554339600,27,3,30,Rain
65962,33,1554339600,11,12,23,Rain
65963,34,1554339600,3,27,30,Rain
65964,35,1554339600,21,9,30,Rain
65965,36,1554339600,39,1,40,Rain
65966,37,1554339600,30,0,30,Rain
65967,38,1554339600,7,33,40,Rain
65968,39,1554339600,17,3,20,Rain
65969,40,1554339600,19,2,21,Rain
65970,41,1554339600,19,1,20,Rain
65971,42,1554339600,1,29,30,Rain
65972,43,1554339600,23,7,30,Rain
65973,44,1554339600,0,30,30,Rain
65974,45,1554339600,7,23,30,Rain
65975,46,1554339600,20,0,20,Rain
65976,47,1554339600,39,1,40,Rain
65977,48,1554339600,13,27,40,Rain
65978,49,1554339600,24,16,40,Rain
65979,50,1554339600,20,20,40,Rain
65980,51,1554339600,40,0,40,Rain
65981,52,1554339600,31,1,32,Rain
65982,53,1554339600,40,0,40,Rain
65983,54,1554339600,33,0,33,Rain
65984,55,1554339600,36,0,36,Rain
65985,56,1554339600,16,24,40,Rain
65986,57,1554339600,19,4,23,Rain
65987,58,1554339600,39,1,40,Rain
65988,59,1554339600,18,2,20,Rain
65989,60,1554339600,0,30,30,Rain
65990,61,1554339600,4,21,25,Rain
65991,62,1554339600,40,0,40,Rain
65992,63,1554339600,35,0,35,Rain
65993,64,1554339600,40,0,40,Rain
65994,65,1554339600,22,18,40,Rain
65995,66,1554339600,30,10,40,Rain
65996,67,1554339600,17,23,40,Rain
65997,68,1554339600,33,7,40,Rain
65998,69,1554339600,32,8,40,Rain
65999,70,1554339600,19,9,28,Rain
66000,71,1554339600,40,0,40,Rain
66001,72,1554339600,19,12,31,Rain
66002,73,1554339600,9,21,30,Rain
66003,74,1554339600,25,5,30,Rain
66004,75,1554339600,11,29,40,Rain
66005,76,1554339600,12,26,38,Rain
66006,77,1554339600,15,14,29,Rain
66007,78,1554339600,29,11,40,Rain
66008,79,1554339600,23,4,27,Rain
66009,80,1554339600,36,4,40,Rain
66010,81,1554339600,13,27,40,Rain
66011,82,1554339600,14,8,22,Rain
66012,83,1554339600,13,27,40,Rain
66013,84,1554339600,13,17,30,Rain
66014,85,1554339600,19,16,35,Rain
66015,86,1554339600,17,21,38,Rain
66016,87,1554339600,26,12,38,Rain
66017,88,1554339600,16,14,30,Rain
66018,89,1554339600,25,15,40,Rain
66019,90,1554339600,39,1,40,Rain
66020,91,1554339600,0,30,30,Rain
66021,92,1554339600,6,34,40,Rain
66022,93,1554339600,0,40,40,Rain
66023,94,1554339600,17,23,40,Rain
66024,95,1554339600,19,21,40,Rain
66025,96,1554339600,12,18,30,Rain
66026,97,1554339600,22,18,40,Rain
66027,98,1554339600,39,1,40,Rain
66028,99,1554339600,8,22,30,Rain
66029,100,1554339600,2,23,25,Rain
66030,101,1554339600,14,16,30,Rain
66031,102,1554339600,29,11,40,Rain
66032,103,1554339600,29,11,40,Rain
66033,104,1554339600,22,18,40,Rain
66034,105,1554339600,34,2,36,Rain
66035,106,1554339600,30,10,40,Rain
66036,107,1554339600,19,21,40,Rain
66037,108,1554339600,27,13,40,Rain
66038,109,1554339600,19,10,29,Rain
66039,110,1554339600,23,17,40,Rain
66040,111,1554339600,15,25,40,Rain
66041,112,1554339600,5,25,30,Rain
66042,113,1554339600,24,16,40,Rain
66043,114,1554339600,39,1,40,Rain
66044,115,1554339600,4,26,30,Rain
66045,2,1554343200,10,10,20,Rain
66046,3,1554343200,17,3,20,Rain
66047,4,1554343200,14,6,20,Rain
66048,5,1554343200,21,19,40,Rain
66049,6,1554343200,20,0,20,Rain
66050,7,1554343200,14,15,29,Rain
66051,8,1554343200,27,3,30,Rain
66052,9,1554343200,24,0,24,Rain
66053,10,1554343200,16,0,16,Rain
66054,11,1554343200,30,0,30,Rain
66055,12,1554343200,8,12,20,Rain
66056,13,1554343200,23,7,30,Rain
66057,14,1554343200,30,0,30,Rain
66058,15,1554343200,10,6,16,Rain
66059,16,1554343200,17,3,20,Rain
66060,17,1554343200,20,0,20,Rain
66061,18,1554343200,27,3,30,Rain
66062,19,1554343200,27,3,30,Rain
66063,21,1554343200,23,7,30,Rain
66064,22,1554343200,14,6,20,Rain
66065,23,1554343200,27,3,30,Rain
66066,24,1554343200,11,9,20,Rain
66067,25,1554343200,29,1,30,Rain
66068,26,1554343200,8,12,20,Rain
66069,27,1554343200,20,0,20,Rain
66070,28,1554343200,6,24,30,Rain
66071,29,1554343200,29,0,29,Rain
66072,30,1554343200,18,2,20,Rain
66073,31,1554343200,13,7,20,Rain
66074,32,1554343200,27,3,30,Rain
66075,33,1554343200,11,12,23,Rain
66076,34,1554343200,3,27,30,Rain
66077,35,1554343200,21,9,30,Rain
66078,36,1554343200,39,1,40,Rain
66079,37,1554343200,30,0,30,Rain
66080,38,1554343200,7,33,40,Rain
66081,39,1554343200,17,3,20,Rain
66082,40,1554343200,19,2,21,Rain
66083,41,1554343200,19,1,20,Rain
66084,42,1554343200,1,29,30,Rain
66085,43,1554343200,23,7,30,Rain
66086,44,1554343200,0,30,30,Rain
66087,45,1554343200,7,23,30,Rain
66088,46,1554343200,20,0,20,Rain
66089,47,1554343200,39,1,40,Rain
66090,48,1554343200,13,27,40,Rain
66091,49,1554343200,24,16,40,Rain
66092,50,1554343200,20,20,40,Rain
66093,51,1554343200,40,0,40,Rain
66094,52,1554343200,31,1,32,Rain
66095,53,1554343200,40,0,40,Rain
66096,54,1554343200,33,0,33,Rain
66097,55,1554343200,36,0,36,Rain
66098,56,1554343200,16,24,40,Rain
66099,57,1554343200,19,4,23,Rain
66100,58,1554343200,39,1,40,Rain
66101,59,1554343200,18,2,20,Rain
66102,60,1554343200,0,30,30,Rain
66103,61,1554343200,4,21,25,Rain
66104,62,1554343200,40,0,40,Rain
66105,63,1554343200,35,0,35,Rain
66106,64,1554343200,40,0,40,Rain
66107,65,1554343200,22,18,40,Rain
66108,66,1554343200,30,10,40,Rain
66109,67,1554343200,17,23,40,Rain
66110,68,1554343200,33,7,40,Rain
66111,69,1554343200,32,8,40,Rain
66112,70,1554343200,19,9,28,Rain
66113,71,1554343200,40,0,40,Rain
66114,72,1554343200,19,12,31,Rain
66115,73,1554343200,9,21,30,Rain
66116,74,1554343200,25,5,30,Rain
66117,75,1554343200,11,29,40,Rain
66118,76,1554343200,12,26,38,Rain
66119,77,1554343200,15,14,29,Rain
66120,78,1554343200,29,11,40,Rain
66121,79,1554343200,23,4,27,Rain
66122,80,1554343200,36,4,40,Rain
66123,81,1554343200,13,27,40,Rain
66124,82,1554343200,14,8,22,Rain
66125,83,1554343200,13,27,40,Rain
66126,84,1554343200,13,17,30,Rain
66127,85,1554343200,19,16,35,Rain
66128,86,1554343200,17,21,38,Rain
66129,87,1554343200,26,12,38,Rain
66130,88,1554343200,16,14,30,Rain
66131,89,1554343200,25,15,40,Rain
66132,90,1554343200,39,1,40,Rain
66133,91,1554343200,0,30,30,Rain
66134,92,1554343200,6,34,40,Rain
66135,93,1554343200,0,40,40,Rain
66136,94,1554343200,17,23,40,Rain
66137,95,1554343200,19,21,40,Rain
66138,96,1554343200,12,18,30,Rain
66139,97,1554343200,22,18,40,Rain
66140,98,1554343200,39,1,40,Rain
66141,99,1554343200,8,22,30,Rain
66142,100,1554343200,2,23,25,Rain
66143,101,1554343200,14,16,30,Rain
66144,102,1554343200,29,11,40,Rain
66145,103,1554343200,29,11,40,Rain
66146,104,1554343200,22,18,40,Rain
66147,105,1554343200,34,2,36,Rain
66148,106,1554343200,30,10,40,Rain
66149,107,1554343200,19,21,40,Rain
66150,108,1554343200,27,13,40,Rain
66151,109,1554343200,19,10,29,Rain
66152,110,1554343200,23,17,40,Rain
66153,111,1554343200,15,25,40,Rain
66154,112,1554343200,5,25,30,Rain
66155,113,1554343200,24,16,40,Rain
66156,114,1554343200,39,1,40,Rain
66157,115,1554343200,4,26,30,Rain
66158,2,1554346800,10,10,20,Clouds
66159,3,1554346800,17,3,20,Clouds
66160,4,1554346800,14,6,20,Clouds
66161,5,1554346800,21,19,40,Clouds
66162,6,1554346800,20,0,20,Clouds
66163,7,1554346800,14,15,29,Clouds
66164,8,1554346800,27,3,30,Clouds
66165,9,1554346800,24,0,24,Clouds
66166,10,1554346800,16,0,16,Clouds
66167,11,1554346800,30,0,30,Clouds
66168,12,1554346800,8,12,20,Clouds
66169,13,1554346800,23,7,30,Clouds
66170,14,1554346800,30,0,30,Clouds
66171,15,1554346800,10,6,16,Clouds
66172,16,1554346800,17,3,20,Clouds
66173,17,1554346800,20,0,20,Clouds
66174,18,1554346800,27,3,30,Clouds
66175,19,1554346800,27,3,30,Clouds
66176,21,1554346800,23,7,30,Clouds
66177,22,1554346800,14,6,20,Clouds
66178,23,1554346800,27,3,30,Clouds
66179,24,1554346800,11,9,20,Clouds
66180,25,1554346800,29,1,30,Clouds
66181,26,1554346800,8,12,20,Clouds
66182,27,1554346800,20,0,20,Clouds
66183,28,1554346800,6,24,30,Clouds
66184,29,1554346800,29,0,29,Clouds
66185,30,1554346800,18,2,20,Clouds
66186,31,1554346800,13,7,20,Clouds
66187,32,1554346800,27,3,30,Clouds
66188,33,1554346800,11,12,23,Clouds
66189,34,1554346800,3,27,30,Clouds
66190,35,1554346800,21,9,30,Clouds
66191,36,1554346800,39,1,40,Clouds
66192,37,1554346800,30,0,30,Clouds
66193,38,1554346800,7,33,40,Clouds
66194,39,1554346800,17,3,20,Clouds
66195,40,1554346800,19,2,21,Clouds
66196,41,1554346800,19,1,20,Clouds
66197,42,1554346800,1,29,30,Clouds
66198,43,1554346800,23,7,30,Clouds
66199,44,1554346800,0,30,30,Clouds
66200,45,1554346800,7,23,30,Clouds
66201,46,1554346800,20,0,20,Clouds
66202,47,1554346800,39,1,40,Clouds
66203,48,1554346800,13,27,40,Clouds
66204,49,1554346800,24,16,40,Clouds
66205,50,1554346800,20,20,40,Clouds
66206,51,1554346800,40,0,40,Clouds
66207,52,1554346800,31,1,32,Clouds
66208,53,1554346800,40,0,40,Clouds
66209,54,1554346800,33,0,33,Clouds
66210,55,1554346800,36,0,36,Clouds
66211,56,1554346800,16,24,40,Clouds
66212,57,1554346800,19,4,23,Clouds
66213,58,1554346800,39,1,40,Clouds
66214,59,1554346800,18,2,20,Clouds
66215,60,1554346800,0,30,30,Clouds
66216,61,1554346800,4,21,25,Clouds
66217,62,1554346800,40,0,40,Clouds
66218,63,1554346800,35,0,35,Clouds
66219,64,1554346800,40,0,40,Clouds
66220,65,1554346800,22,18,40,Clouds
66221,66,1554346800,30,10,40,Clouds
66222,67,1554346800,17,23,40,Clouds
66223,68,1554346800,33,7,40,Clouds
66224,69,1554346800,32,8,40,Clouds
66225,70,1554346800,19,9,28,Clouds
66226,71,1554346800,40,0,40,Clouds
66227,72,1554346800,19,12,31,Clouds
66228,73,1554346800,9,21,30,Clouds
66229,74,1554346800,25,5,30,Clouds
66230,75,1554346800,11,29,40,Clouds
66231,76,1554346800,12,26,38,Clouds
66232,77,1554346800,15,14,29,Clouds
66233,78,1554346800,29,11,40,Clouds
66234,79,1554346800,23,4,27,Clouds
66235,80,1554346800,36,4,40,Clouds
66236,81,1554346800,13,27,40,Clouds
66237,82,1554346800,14,8,22,Clouds
66238,83,1554346800,13,27,40,Clouds
66239,84,1554346800,13,17,30,Clouds
66240,85,1554346800,19,16,35,Clouds
66241,86,1554346800,17,21,38,Clouds
66242,87,1554346800,26,12,38,Clouds
66243,88,1554346800,16,14,30,Clouds
66244,89,1554346800,25,15,40,Clouds
66245,90,1554346800,39,1,40,Clouds
66246,91,1554346800,0,30,30,Clouds
66247,92,1554346800,6,34,40,Clouds
66248,93,1554346800,0,40,40,Clouds
66249,94,1554346800,17,23,40,Clouds
66250,95,1554346800,19,21,40,Clouds
66251,96,1554346800,12,18,30,Clouds
66252,97,1554346800,22,18,40,Clouds
66253,98,1554346800,39,1,40,Clouds
66254,99,1554346800,8,22,30,Clouds
66255,100,1554346800,2,23,25,Clouds
66256,101,1554346800,14,16,30,Clouds
66257,102,1554346800,29,11,40,Clouds
66258,103,1554346800,29,11,40,Clouds
66259,104,1554346800,22,18,40,Clouds
66260,105,1554346800,34,2,36,Clouds
66261,106,1554346800,30,10,40,Clouds
66262,107,1554346800,19,21,40,Clouds
66263,108,1554346800,27,13,40,Clouds
66264,109,1554346800,19,10,29,Clouds
66265,110,1554346800,23,17,40,Clouds
66266,111,1554346800,15,25,40,Clouds
66267,112,1554346800,5,25,30,Clouds
66268,113,1554346800,24,16,40,Clouds
66269,114,1554346800,39,1,40,Clouds
66270,115,1554346800,4,26,30,Clouds
66271,2,1554350400,10,10,20,Clouds
66272,3,1554350400,17,3,20,Clouds
66273,4,1554350400,14,6,20,Clouds
66274,5,1554350400,21,19,40,Clouds
66275,6,1554350400,20,0,20,Clouds
66276,7,1554350400,14,15,29,Clouds
66277,8,1554350400,27,3,30,Clouds
66278,9,1554350400,24,0,24,Clouds
66279,10,1554350400,16,0,16,Clouds
66280,11,1554350400,30,0,30,Clouds
66281,12,1554350400,8,12,20,Clouds
66282,13,1554350400,23,7,30,Clouds
66283,14,1554350400,30,0,30,Clouds
66284,15,1554350400,10,6,16,Clouds
66285,16,1554350400,17,3,20,Clouds
66286,17,1554350400,20,0,20,Clouds
66287,18,1554350400,27,3,30,Clouds
66288,19,1554350400,27,3,30,Clouds
66289,21,1554350400,23,7,30,Clouds
66290,22,1554350400,14,6,20,Clouds
66291,23,1554350400,27,3,30,Clouds
66292,24,1554350400,11,9,20,Clouds
66293,25,1554350400,29,1,30,Clouds
66294,26,1554350400,8,12,20,Clouds
66295,27,1554350400,20,0,20,Clouds
66296,28,1554350400,6,24,30,Clouds
66297,29,1554350400,29,0,29,Clouds
66298,30,1554350400,18,2,20,Clouds
66299,31,1554350400,13,7,20,Clouds
66300,32,1554350400,27,3,30,Clouds
66301,33,1554350400,11,12,23,Clouds
66302,34,1554350400,3,27,30,Clouds
66303,35,1554350400,21,9,30,Clouds
66304,36,1554350400,39,1,40,Clouds
66305,37,1554350400,30,0,30,Clouds
66306,38,1554350400,7,33,40,Clouds
66307,39,1554350400,17,3,20,Clouds
66308,40,1554350400,19,2,21,Clouds
66309,41,1554350400,19,1,20,Clouds
66310,42,1554350400,1,29,30,Clouds
66311,43,1554350400,23,7,30,Clouds
66312,44,1554350400,0,30,30,Clouds
66313,45,1554350400,7,23,30,Clouds
66314,46,1554350400,20,0,20,Clouds
66315,47,1554350400,39,1,40,Clouds
66316,48,1554350400,13,27,40,Clouds
66317,49,1554350400,24,16,40,Clouds
66318,50,1554350400,20,20,40,Clouds
66319,51,1554350400,40,0,40,Clouds
66320,52,1554350400,31,1,32,Clouds
66321,53,1554350400,40,0,40,Clouds
66322,54,1554350400,33,0,33,Clouds
66323,55,1554350400,36,0,36,Clouds
66324,56,1554350400,16,24,40,Clouds
66325,57,1554350400,19,4,23,Clouds
66326,58,1554350400,39,1,40,Clouds
66327,59,1554350400,18,2,20,Clouds
66328,60,1554350400,0,30,30,Clouds
66329,61,1554350400,4,21,25,Clouds
66330,62,1554350400,40,0,40,Clouds
66331,63,1554350400,35,0,35,Clouds
66332,64,1554350400,40,0,40,Clouds
66333,65,1554350400,22,18,40,Clouds
66334,66,1554350400,30,10,40,Clouds
66335,67,1554350400,17,23,40,Clouds
66336,68,1554350400,33,7,40,Clouds
66337,69,1554350400,32,8,40,Clouds
66338,70,1554350400,19,9,28,Clouds
66339,71,1554350400,40,0,40,Clouds
66340,72,1554350400,19,12,31,Clouds
66341,73,1554350400,9,21,30,Clouds
66342,74,1554350400,25,5,30,Clouds
66343,75,1554350400,11,29,40,Clouds
66344,76,1554350400,12,26,38,Clouds
66345,77,1554350400,15,14,29,Clouds
66346,78,1554350400,29,11,40,Clouds
66347,79,1554350400,23,4,27,Clouds
66348,80,1554350400,36,4,40,Clouds
66349,81,1554350400,13,27,40,Clouds
66350,82,1554350400,14,8,22,Clouds
66351,83,1554350400,13,27,40,Clouds
66352,84,1554350400,13,17,30,Clouds
66353,85,1554350400,19,16,35,Clouds
66354,86,1554350400,17,21,38,Clouds
66355,87,1554350400,26,12,38,Clouds
66356,88,1554350400,16,14,30,Clouds
66357,89,1554350400,25,15,40,Clouds
66358,90,1554350400,39,1,40,Clouds
66359,91,1554350400,0,30,30,Clouds
66360,92,1554350400,6,34,40,Clouds
66361,93,1554350400,0,40,40,Clouds
66362,94,1554350400,17,23,40,Clouds
66363,95,1554350400,19,21,40,Clouds
66364,96,1554350400,12,18,30,Clouds
66365,97,1554350400,22,18,40,Clouds
66366,98,1554350400,39,1,40,Clouds
66367,99,1554350400,8,22,30,Clouds
66368,100,1554350400,2,23,25,Clouds
66369,101,1554350400,14,16,30,Clouds
66370,102,1554350400,29,11,40,Clouds
66371,103,1554350400,29,11,40,Clouds
66372,104,1554350400,22,18,40,Clouds
66373,105,1554350400,34,2,36,Clouds
66374,106,1554350400,30,10,40,Clouds
66375,107,1554350400,19,21,40,Clouds
66376,108,1554350400,27,13,40,Clouds
66377,109,1554350400,19,10,29,Clouds
66378,110,1554350400,23,17,40,Clouds
66379,111,1554350400,15,25,40,Clouds
66380,112,1554350400,5,25,30,Clouds
66381,113,1554350400,24,16,40,Clouds
66382,114,1554350400,39,1,40,Clouds
66383,115,1554350400,4,26,30,Clouds
66384,2,1554354000,10,10,20,Clouds
66385,3,1554354000,17,3,20,Clouds
66386,4,1554354000,14,6,20,Clouds
66387,5,1554354000,21,19,40,Clouds
66388,6,1554354000,20,0,20,Clouds
66389,7,1554354000,14,15,29,Clouds
66390,8,1554354000,27,3,30,Clouds
66391,9,1554354000,24,0,24,Clouds
66392,10,1554354000,16,0,16,Clouds
66393,11,1554354000,30,0,30,Clouds
66394,12,1554354000,8,12,20,Clouds
66395,13,1554354000,23,7,30,Clouds
66396,14,1554354000,30,0,30,Clouds
66397,15,1554354000,10,6,16,Clouds
66398,16,1554354000,17,3,20,Clouds
66399,17,1554354000,20,0,20,Clouds
66400,18,1554354000,27,3,30,Clouds
66401,19,1554354000,27,3,30,Clouds
66402,21,1554354000,23,7,30,Clouds
66403,22,1554354000,14,6,20,Clouds
66404,23,1554354000,27,3,30,Clouds
66405,24,1554354000,11,9,20,Clouds
66406,25,1554354000,29,1,30,Clouds
66407,26,1554354000,8,12,20,Clouds
66408,27,1554354000,20,0,20,Clouds
66409,28,1554354000,6,24,30,Clouds
66410,29,1554354000,29,0,29,Clouds
66411,30,1554354000,18,2,20,Clouds
66412,31,1554354000,13,7,20,Clouds
66413,32,1554354000,27,3,30,Clouds
66414,33,1554354000,12,11,23,Clouds
66415,34,1554354000,3,27,30,Clouds
66416,35,1554354000,21,9,30,Clouds
66417,36,1554354000,39,1,40,Clouds
66418,37,1554354000,30,0,30,Clouds
66419,38,1554354000,7,33,40,Clouds
66420,39,1554354000,17,3,20,Clouds
66421,40,1554354000,19,2,21,Clouds
66422,41,1554354000,19,1,20,Clouds
66423,42,1554354000,1,29,30,Clouds
66424,43,1554354000,23,7,30,Clouds
66425,44,1554354000,0,30,30,Clouds
66426,45,1554354000,7,23,30,Clouds
66427,46,1554354000,20,0,20,Clouds
66428,47,1554354000,39,1,40,Clouds
66429,48,1554354000,13,27,40,Clouds
66430,49,1554354000,25,15,40,Clouds
66431,50,1554354000,20,20,40,Clouds
66432,51,1554354000,40,0,40,Clouds
66433,52,1554354000,31,1,32,Clouds
66434,53,1554354000,40,0,40,Clouds
66435,54,1554354000,33,0,33,Clouds
66436,55,1554354000,36,0,36,Clouds
66437,56,1554354000,16,24,40,Clouds
66438,57,1554354000,19,4,23,Clouds
66439,58,1554354000,39,1,40,Clouds
66440,59,1554354000,18,2,20,Clouds
66441,60,1554354000,1,29,30,Clouds
66442,61,1554354000,4,21,25,Clouds
66443,62,1554354000,40,0,40,Clouds
66444,63,1554354000,35,0,35,Clouds
66445,64,1554354000,40,0,40,Clouds
66446,65,1554354000,22,18,40,Clouds
66447,66,1554354000,30,10,40,Clouds
66448,67,1554354000,17,23,40,Clouds
66449,68,1554354000,33,7,40,Clouds
66450,69,1554354000,32,8,40,Clouds
66451,70,1554354000,19,9,28,Clouds
66452,71,1554354000,40,0,40,Clouds
66453,72,1554354000,19,12,31,Clouds
66454,73,1554354000,9,21,30,Clouds
66455,74,1554354000,25,5,30,Clouds
66456,75,1554354000,11,29,40,Clouds
66457,76,1554354000,12,26,38,Clouds
66458,77,1554354000,15,14,29,Clouds
66459,78,1554354000,29,11,40,Clouds
66460,79,1554354000,23,4,27,Clouds
66461,80,1554354000,37,3,40,Clouds
66462,81,1554354000,13,27,40,Clouds
66463,82,1554354000,14,8,22,Clouds
66464,83,1554354000,13,27,40,Clouds
66465,84,1554354000,13,17,30,Clouds
66466,85,1554354000,19,16,35,Clouds
66467,86,1554354000,17,21,38,Clouds
66468,87,1554354000,26,12,38,Clouds
66469,88,1554354000,16,14,30,Clouds
66470,89,1554354000,25,15,40,Clouds
66471,90,1554354000,39,1,40,Clouds
66472,91,1554354000,0,30,30,Clouds
66473,92,1554354000,6,34,40,Clouds
66474,93,1554354000,0,40,40,Clouds
66475,94,1554354000,17,23,40,Clouds
66476,95,1554354000,19,21,40,Clouds
66477,96,1554354000,12,18,30,Clouds
66478,97,1554354000,22,18,40,Clouds
66479,98,1554354000,39,1,40,Clouds
66480,99,1554354000,8,22,30,Clouds
66481,100,1554354000,2,23,25,Clouds
66482,101,1554354000,14,16,30,Clouds
66483,102,1554354000,29,11,40,Clouds
66484,103,1554354000,29,11,40,Clouds
66485,104,1554354000,22,18,40,Clouds
66486,105,1554354000,34,2,36,Clouds
66487,106,1554354000,30,10,40,Clouds
66488,107,1554354000,19,21,40,Clouds
66489,108,1554354000,27,13,40,Clouds
66490,109,1554354000,19,10,29,Clouds
66491,110,1554354000,23,17,40,Clouds
66492,111,1554354000,15,25,40,Clouds
66493,112,1554354000,5,25,30,Clouds
66494,113,1554354000,24,16,40,Clouds
66495,114,1554354000,39,1,40,Clouds
66496,115,1554354000,4,26,30,Clouds
66497,2,1554357600,10,10,20,Clouds
66498,3,1554357600,18,2,20,Clouds
66499,4,1554357600,15,5,20,Clouds
66500,5,1554357600,21,19,40,Clouds
66501,6,1554357600,20,0,20,Clouds
66502,7,1554357600,15,14,29,Clouds
66503,8,1554357600,22,8,30,Clouds
66504,9,1554357600,20,4,24,Clouds
66505,10,1554357600,15,1,16,Clouds
66506,11,1554357600,29,1,30,Clouds
66507,12,1554357600,9,11,20,Clouds
66508,13,1554357600,24,6,30,Clouds
66509,14,1554357600,23,7,30,Clouds
66510,15,1554357600,12,4,16,Clouds
66511,16,1554357600,17,3,20,Clouds
66512,17,1554357600,19,1,20,Clouds
66513,18,1554357600,27,3,30,Clouds
66514,19,1554357600,27,3,30,Clouds
66515,21,1554357600,22,8,30,Clouds
66516,22,1554357600,13,7,20,Clouds
66517,23,1554357600,26,4,30,Clouds
66518,24,1554357600,11,9,20,Clouds
66519,25,1554357600,26,4,30,Clouds
66520,26,1554357600,8,12,20,Clouds
66521,27,1554357600,20,0,20,Clouds
66522,28,1554357600,7,23,30,Clouds
66523,29,1554357600,27,2,29,Clouds
66524,30,1554357600,18,2,20,Clouds
66525,31,1554357600,17,3,20,Clouds
66526,32,1554357600,25,5,30,Clouds
66527,33,1554357600,2,21,23,Clouds
66528,34,1554357600,7,23,30,Clouds
66529,35,1554357600,23,7,30,Clouds
66530,36,1554357600,35,5,40,Clouds
66531,37,1554357600,30,0,30,Clouds
66532,38,1554357600,9,31,40,Clouds
66533,39,1554357600,16,4,20,Clouds
66534,40,1554357600,19,2,21,Clouds
66535,41,1554357600,20,0,20,Clouds
66536,42,1554357600,3,27,30,Clouds
66537,43,1554357600,12,18,30,Clouds
66538,44,1554357600,8,22,30,Clouds
66539,45,1554357600,8,22,30,Clouds
66540,46,1554357600,20,0,20,Clouds
66541,47,1554357600,39,1,40,Clouds
66542,48,1554357600,32,8,40,Clouds
66543,49,1554357600,24,16,40,Clouds
66544,50,1554357600,21,19,40,Clouds
66545,51,1554357600,39,1,40,Clouds
66546,52,1554357600,26,6,32,Clouds
66547,53,1554357600,40,0,40,Clouds
66548,54,1554357600,33,0,33,Clouds
66549,55,1554357600,36,0,36,Clouds
66550,56,1554357600,35,5,40,Clouds
66551,57,1554357600,18,5,23,Clouds
66552,58,1554357600,38,2,40,Clouds
66553,59,1554357600,18,2,20,Clouds
66554,60,1554357600,4,26,30,Clouds
66555,61,1554357600,4,21,25,Clouds
66556,62,1554357600,38,2,40,Clouds
66557,63,1554357600,34,1,35,Clouds
66558,64,1554357600,40,0,40,Clouds
66559,65,1554357600,22,18,40,Clouds
66560,66,1554357600,29,11,40,Clouds
66561,67,1554357600,16,24,40,Clouds
66562,68,1554357600,29,11,40,Clouds
66563,69,1554357600,28,12,40,Clouds
66564,70,1554357600,16,12,28,Clouds
66565,71,1554357600,39,1,40,Clouds
66566,72,1554357600,20,11,31,Clouds
66567,73,1554357600,9,21,30,Clouds
66568,74,1554357600,26,4,30,Clouds
66569,75,1554357600,11,29,40,Clouds
66570,76,1554357600,15,23,38,Clouds
66571,77,1554357600,15,14,29,Clouds
66572,78,1554357600,30,10,40,Clouds
66573,79,1554357600,5,22,27,Clouds
66574,80,1554357600,38,2,40,Clouds
66575,81,1554357600,13,27,40,Clouds
66576,82,1554357600,15,7,22,Clouds
66577,83,1554357600,15,25,40,Clouds
66578,84,1554357600,15,15,30,Clouds
66579,85,1554357600,2,33,35,Clouds
66580,86,1554357600,19,19,38,Clouds
66581,87,1554357600,28,10,38,Clouds
66582,88,1554357600,16,14,30,Clouds
66583,89,1554357600,25,15,40,Clouds
66584,90,1554357600,38,2,40,Clouds
66585,91,1554357600,4,26,30,Clouds
66586,92,1554357600,7,33,40,Clouds
66587,93,1554357600,0,40,40,Clouds
66588,94,1554357600,17,23,40,Clouds
66589,95,1554357600,19,21,40,Clouds
66590,96,1554357600,12,18,30,Clouds
66591,97,1554357600,13,27,40,Clouds
66592,98,1554357600,39,1,40,Clouds
66593,99,1554357600,6,24,30,Clouds
66594,100,1554357600,2,23,25,Clouds
66595,101,1554357600,17,13,30,Clouds
66596,102,1554357600,29,11,40,Clouds
66597,103,1554357600,29,11,40,Clouds
66598,104,1554357600,22,18,40,Clouds
66599,105,1554357600,35,1,36,Clouds
66600,106,1554357600,30,10,40,Clouds
66601,107,1554357600,25,15,40,Clouds
66602,108,1554357600,28,12,40,Clouds
66603,109,1554357600,24,5,29,Clouds
66604,110,1554357600,22,18,40,Clouds
66605,111,1554357600,14,26,40,Clouds
66606,112,1554357600,6,24,30,Clouds
66607,113,1554357600,23,17,40,Clouds
66608,114,1554357600,39,1,40,Clouds
66609,115,1554357600,7,23,30,Clouds
66610,2,1554361200,20,0,20,Clouds
66611,3,1554361200,18,2,20,Clouds
66612,4,1554361200,16,4,20,Clouds
66613,5,1554361200,20,20,40,Clouds
66614,6,1554361200,19,1,20,Clouds
66615,7,1554361200,17,12,29,Clouds
66616,8,1554361200,18,12,30,Clouds
66617,9,1554361200,15,9,24,Clouds
66618,10,1554361200,15,1,16,Clouds
66619,11,1554361200,26,4,30,Clouds
66620,12,1554361200,19,1,20,Clouds
66621,13,1554361200,21,9,30,Clouds
66622,14,1554361200,19,11,30,Clouds
66623,15,1554361200,15,1,16,Clouds
66624,16,1554361200,17,3,20,Clouds
66625,17,1554361200,20,0,20,Clouds
66626,18,1554361200,21,9,30,Clouds
66627,19,1554361200,18,12,30,Clouds
66628,21,1554361200,21,9,30,Clouds
66629,22,1554361200,10,10,20,Clouds
66630,23,1554361200,29,1,30,Clouds
66631,24,1554361200,11,9,20,Clouds
66632,25,1554361200,21,9,30,Clouds
66633,26,1554361200,8,12,20,Clouds
66634,27,1554361200,13,7,20,Clouds
66635,28,1554361200,13,17,30,Clouds
66636,29,1554361200,25,4,29,Clouds
66637,30,1554361200,15,5,20,Clouds
66638,31,1554361200,12,8,20,Clouds
66639,32,1554361200,19,11,30,Clouds
66640,33,1554361200,0,23,23,Clouds
66641,34,1554361200,22,8,30,Clouds
66642,35,1554361200,28,2,30,Clouds
66643,36,1554361200,35,5,40,Clouds
66644,37,1554361200,30,0,30,Clouds
66645,38,1554361200,9,31,40,Clouds
66646,39,1554361200,16,4,20,Clouds
66647,40,1554361200,16,5,21,Clouds
66648,41,1554361200,20,0,20,Clouds
66649,42,1554361200,15,15,30,Clouds
66650,43,1554361200,13,17,30,Clouds
66651,44,1554361200,20,10,30,Clouds
66652,45,1554361200,11,19,30,Clouds
66653,46,1554361200,15,5,20,Clouds
66654,47,1554361200,39,1,40,Clouds
66655,48,1554361200,33,7,40,Clouds
66656,49,1554361200,21,19,40,Clouds
66657,50,1554361200,28,12,40,Clouds
66658,51,1554361200,37,3,40,Clouds
66659,52,1554361200,25,7,32,Clouds
66660,53,1554361200,37,3,40,Clouds
66661,54,1554361200,31,2,33,Clouds
66662,55,1554361200,32,4,36,Clouds
66663,56,1554361200,37,3,40,Clouds
66664,57,1554361200,17,6,23,Clouds
66665,58,1554361200,35,5,40,Clouds
66666,59,1554361200,18,2,20,Clouds
66667,60,1554361200,20,10,30,Clouds
66668,61,1554361200,9,16,25,Clouds
66669,62,1554361200,27,13,40,Clouds
66670,63,1554361200,32,3,35,Clouds
66671,64,1554361200,36,4,40,Clouds
66672,65,1554361200,20,20,40,Clouds
66673,66,1554361200,18,22,40,Clouds
66674,67,1554361200,13,27,40,Clouds
66675,68,1554361200,33,7,40,Clouds
66676,69,1554361200,37,3,40,Clouds
66677,70,1554361200,16,11,27,Clouds
66678,71,1554361200,37,3,40,Clouds
66679,72,1554361200,28,3,31,Clouds
66680,73,1554361200,13,17,30,Clouds
66681,74,1554361200,30,0,30,Clouds
66682,75,1554361200,12,28,40,Clouds
66683,76,1554361200,20,18,38,Clouds
66684,77,1554361200,18,11,29,Clouds
66685,78,1554361200,13,27,40,Clouds
66686,79,1554361200,4,23,27,Clouds
66687,80,1554361200,40,0,40,Clouds
66688,81,1554361200,13,27,40,Clouds
66689,82,1554361200,15,7,22,Clouds
66690,83,1554361200,19,21,40,Clouds
66691,84,1554361200,14,16,30,Clouds
66692,85,1554361200,9,26,35,Clouds
66693,86,1554361200,23,15,38,Clouds
66694,87,1554361200,31,7,38,Clouds
66695,88,1554361200,26,4,30,Clouds
66696,89,1554361200,22,18,40,Clouds
66697,90,1554361200,20,20,40,Clouds
66698,91,1554361200,16,14,30,Clouds
66699,92,1554361200,8,32,40,Clouds
66700,93,1554361200,0,40,40,Clouds
66701,94,1554361200,18,22,40,Clouds
66702,95,1554361200,25,15,40,Clouds
66703,96,1554361200,12,18,30,Clouds
66704,97,1554361200,15,25,40,Clouds
66705,98,1554361200,38,2,40,Clouds
66706,99,1554361200,23,7,30,Clouds
66707,100,1554361200,2,23,25,Clouds
66708,101,1554361200,23,7,30,Clouds
66709,102,1554361200,33,7,40,Clouds
66710,103,1554361200,28,12,40,Clouds
66711,104,1554361200,22,18,40,Clouds
66712,105,1554361200,35,1,36,Clouds
66713,106,1554361200,31,9,40,Clouds
66714,107,1554361200,26,14,40,Clouds
66715,108,1554361200,32,8,40,Clouds
66716,109,1554361200,29,0,29,Clouds
66717,110,1554361200,25,15,40,Clouds
66718,111,1554361200,22,18,40,Clouds
66719,112,1554361200,21,9,30,Clouds
66720,113,1554361200,31,9,40,Clouds
66721,114,1554361200,32,8,40,Clouds
66722,115,1554361200,14,16,30,Clouds
66723,2,1554364800,20,0,20,Clouds
66724,3,1554364800,19,1,20,Clouds
66725,4,1554364800,18,2,20,Clouds
66726,5,1554364800,39,1,40,Clouds
66727,6,1554364800,19,1,20,Clouds
66728,7,1554364800,29,0,29,Clouds
66729,8,1554364800,22,8,30,Clouds
66730,9,1554364800,7,17,24,Clouds
66731,10,1554364800,12,4,16,Clouds
66732,11,1554364800,19,11,30,Clouds
66733,12,1554364800,9,11,20,Clouds
66734,13,1554364800,25,4,29,Clouds
66735,14,1554364800,18,12,30,Clouds
66736,15,1554364800,16,0,16,Clouds
66737,16,1554364800,14,6,20,Clouds
66738,17,1554364800,16,4,20,Clouds
66739,18,1554364800,27,3,30,Clouds
66740,19,1554364800,18,12,30,Clouds
66741,21,1554364800,21,9,30,Clouds
66742,22,1554364800,6,14,20,Clouds
66743,23,1554364800,23,7,30,Clouds
66744,24,1554364800,15,5,20,Clouds
66745,25,1554364800,7,23,30,Clouds
66746,26,1554364800,8,12,20,Clouds
66747,27,1554364800,10,10,20,Clouds
66748,28,1554364800,24,6,30,Clouds
66749,29,1554364800,26,3,29,Clouds
66750,30,1554364800,12,8,20,Clouds
66751,31,1554364800,9,11,20,Clouds
66752,32,1554364800,12,18,30,Clouds
66753,33,1554364800,17,6,23,Clouds
66754,34,1554364800,30,0,30,Clouds
66755,35,1554364800,27,3,30,Clouds
66756,36,1554364800,23,17,40,Clouds
66757,37,1554364800,24,6,30,Clouds
66758,38,1554364800,13,27,40,Clouds
66759,39,1554364800,19,1,20,Clouds
66760,40,1554364800,4,17,21,Clouds
66761,41,1554364800,20,0,20,Clouds
66762,42,1554364800,29,1,30,Clouds
66763,43,1554364800,30,0,30,Clouds
66764,44,1554364800,30,0,30,Clouds
66765,45,1554364800,13,17,30,Clouds
66766,46,1554364800,14,6,20,Clouds
66767,47,1554364800,31,8,39,Clouds
66768,48,1554364800,29,10,39,Clouds
66769,49,1554364800,30,9,39,Clouds
66770,50,1554364800,40,0,40,Clouds
66771,51,1554364800,30,10,40,Clouds
66772,52,1554364800,14,17,31,Clouds
66773,53,1554364800,35,5,40,Clouds
66774,54,1554364800,26,7,33,Clouds
66775,55,1554364800,28,8,36,Clouds
66776,56,1554364800,27,13,40,Clouds
66777,57,1554364800,14,9,23,Clouds
66778,58,1554364800,19,20,39,Clouds
66779,59,1554364800,17,3,20,Clouds
66780,60,1554364800,30,0,30,Clouds
66781,61,1554364800,14,11,25,Clouds
66782,62,1554364800,21,18,39,Clouds
66783,63,1554364800,23,12,35,Clouds
66784,64,1554364800,28,12,40,Clouds
66785,65,1554364800,17,23,40,Clouds
66786,66,1554364800,0,39,39,Clouds
66787,67,1554364800,12,28,40,Clouds
66788,68,1554364800,26,14,40,Clouds
66789,69,1554364800,25,15,40,Clouds
66790,70,1554364800,9,18,27,Clouds
66791,71,1554364800,37,3,40,Clouds
66792,72,1554364800,30,1,31,Clouds
66793,73,1554364800,30,0,30,Clouds
66794,74,1554364800,28,2,30,Clouds
66795,75,1554364800,25,15,40,Clouds
66796,76,1554364800,24,14,38,Clouds
66797,77,1554364800,24,5,29,Clouds
66798,78,1554364800,19,21,40,Clouds
66799,79,1554364800,6,21,27,Clouds
66800,80,1554364800,40,0,40,Clouds
66801,81,1554364800,13,27,40,Clouds
66802,82,1554364800,21,1,22,Clouds
66803,83,1554364800,29,11,40,Clouds
66804,84,1554364800,25,5,30,Clouds
66805,85,1554364800,25,10,35,Clouds
66806,86,1554364800,34,4,38,Clouds
66807,87,1554364800,38,0,38,Clouds
66808,88,1554364800,28,2,30,Clouds
66809,89,1554364800,33,7,40,Clouds
66810,90,1554364800,0,39,39,Clouds
66811,91,1554364800,18,12,30,Clouds
66812,92,1554364800,10,30,40,Clouds
66813,93,1554364800,21,19,40,Clouds
66814,94,1554364800,24,16,40,Clouds
66815,95,1554364800,33,7,40,Clouds
66816,96,1554364800,14,16,30,Clouds
66817,97,1554364800,40,0,40,Clouds
66818,98,1554364800,35,4,39,Clouds
66819,99,1554364800,19,11,30,Clouds
66820,100,1554364800,20,5,25,Clouds
66821,101,1554364800,30,0,30,Clouds
66822,102,1554364800,40,0,40,Clouds
66823,103,1554364800,27,13,40,Clouds
66824,104,1554364800,21,19,40,Clouds
66825,105,1554364800,33,3,36,Clouds
66826,106,1554364800,33,7,40,Clouds
66827,107,1554364800,40,0,40,Clouds
66828,108,1554364800,38,2,40,Clouds
66829,109,1554364800,29,0,29,Clouds
66830,110,1554364800,29,11,40,Clouds
66831,111,1554364800,38,2,40,Clouds
66832,112,1554364800,29,1,30,Clouds
66833,113,1554364800,25,15,40,Clouds
66834,114,1554364800,31,9,40,Clouds
66835,115,1554364800,30,0,30,Clouds
66836,2,1554368400,20,0,20,Clouds
66837,3,1554368400,13,7,20,Clouds
66838,4,1554368400,18,2,20,Clouds
66839,5,1554368400,40,0,40,Clouds
66840,6,1554368400,18,2,20,Clouds
66841,7,1554368400,29,0,29,Clouds
66842,8,1554368400,21,9,30,Clouds
66843,9,1554368400,13,11,24,Clouds
66844,10,1554368400,12,4,16,Clouds
66845,11,1554368400,10,20,30,Clouds
66846,12,1554368400,20,0,20,Clouds
66847,13,1554368400,14,14,28,Clouds
66848,14,1554368400,28,2,30,Clouds
66849,15,1554368400,15,1,16,Clouds
66850,16,1554368400,8,12,20,Clouds
66851,17,1554368400,19,1,20,Clouds
66852,18,1554368400,30,0,30,Clouds
66853,19,1554368400,6,24,30,Clouds
66854,21,1554368400,12,17,29,Clouds
66855,22,1554368400,10,10,20,Clouds
66856,23,1554368400,25,4,29,Clouds
66857,24,1554368400,18,2,20,Clouds
66858,25,1554368400,1,29,30,Clouds
66859,26,1554368400,12,8,20,Clouds
66860,27,1554368400,7,12,19,Clouds
66861,28,1554368400,30,0,30,Clouds
66862,29,1554368400,24,5,29,Clouds
66863,30,1554368400,20,0,20,Clouds
66864,31,1554368400,12,8,20,Clouds
66865,32,1554368400,11,19,30,Clouds
66866,33,1554368400,8,15,23,Clouds
66867,34,1554368400,30,0,30,Clouds
66868,35,1554368400,28,2,30,Clouds
66869,36,1554368400,0,40,40,Clouds
66870,37,1554368400,23,6,29,Clouds
66871,38,1554368400,34,6,40,Clouds
66872,39,1554368400,20,0,20,Clouds
66873,40,1554368400,11,10,21,Clouds
66874,41,1554368400,13,7,20,Clouds
66875,42,1554368400,30,0,30,Clouds
66876,43,1554368400,30,0,30,Clouds
66877,44,1554368400,30,0,30,Clouds
66878,45,1554368400,30,0,30,Clouds
66879,46,1554368400,20,0,20,Clouds
66880,47,1554368400,0,38,38,Clouds
66881,48,1554368400,27,12,39,Clouds
66882,49,1554368400,11,27,38,Clouds
66883,50,1554368400,38,2,40,Clouds
66884,51,1554368400,36,4,40,Clouds
66885,52,1554368400,16,15,31,Clouds
66886,53,1554368400,25,14,39,Clouds
66887,54,1554368400,26,7,33,Clouds
66888,55,1554368400,21,15,36,Clouds
66889,56,1554368400,15,25,40,Clouds
66890,57,1554368400,8,14,22,Clouds
66891,58,1554368400,4,34,38,Clouds
66892,59,1554368400,20,0,20,Clouds
66893,60,1554368400,30,0,30,Clouds
66894,61,1554368400,24,0,24,Clouds
66895,62,1554368400,0,39,39,Clouds
66896,63,1554368400,13,22,35,Clouds
66897,64,1554368400,9,31,40,Clouds
66898,65,1554368400,1,38,39,Clouds
66899,66,1554368400,2,37,39,Clouds
66900,67,1554368400,1,38,39,Clouds
66901,68,1554368400,4,36,40,Clouds
66902,69,1554368400,0,40,40,Clouds
66903,70,1554368400,8,20,28,Clouds
66904,71,1554368400,40,0,40,Clouds
66905,72,1554368400,30,1,31,Clouds
66906,73,1554368400,30,0,30,Clouds
66907,74,1554368400,30,0,30,Clouds
66908,75,1554368400,40,0,40,Clouds
66909,76,1554368400,37,0,37,Clouds
66910,77,1554368400,29,0,29,Clouds
66911,78,1554368400,40,0,40,Clouds
66912,79,1554368400,25,2,27,Clouds
66913,80,1554368400,39,1,40,Clouds
66914,81,1554368400,40,0,40,Clouds
66915,82,1554368400,22,0,22,Clouds
66916,83,1554368400,40,0,40,Clouds
66917,84,1554368400,30,0,30,Clouds
66918,85,1554368400,35,0,35,Clouds
66919,86,1554368400,38,0,38,Clouds
66920,87,1554368400,38,0,38,Clouds
66921,88,1554368400,30,0,30,Clouds
66922,89,1554368400,31,9,40,Clouds
66923,90,1554368400,0,39,39,Clouds
66924,91,1554368400,26,3,29,Clouds
66925,92,1554368400,39,1,40,Clouds
66926,93,1554368400,40,0,40,Clouds
66927,94,1554368400,39,1,40,Clouds
66928,95,1554368400,40,0,40,Clouds
66929,96,1554368400,30,0,30,Clouds
66930,97,1554368400,40,0,40,Clouds
66931,98,1554368400,36,3,39,Clouds
66932,99,1554368400,1,28,29,Clouds
66933,100,1554368400,25,0,25,Clouds
66934,101,1554368400,29,1,30,Clouds
66935,102,1554368400,40,0,40,Clouds
66936,103,1554368400,32,8,40,Clouds
66937,104,1554368400,30,10,40,Clouds
66938,105,1554368400,36,0,36,Clouds
66939,106,1554368400,40,0,40,Clouds
66940,107,1554368400,40,0,40,Clouds
66941,108,1554368400,40,0,40,Clouds
66942,109,1554368400,29,0,29,Clouds
66943,110,1554368400,40,0,40,Clouds
66944,111,1554368400,40,0,40,Clouds
66945,112,1554368400,30,0,30,Clouds
66946,113,1554368400,18,22,40,Clouds
66947,114,1554368400,7,33,40,Clouds
66948,115,1554368400,28,2,30,Clouds
66949,2,1554372000,20,0,20,Clouds
66950,3,1554372000,20,0,20,Clouds
66951,4,1554372000,11,8,19,Clouds
66952,5,1554372000,40,0,40,Clouds
66953,6,1554372000,19,1,20,Clouds
66954,7,1554372000,29,0,29,Clouds
66955,8,1554372000,18,12,30,Clouds
66956,9,1554372000,14,10,24,Clouds
66957,10,1554372000,11,5,16,Clouds
66958,11,1554372000,3,27,30,Clouds
66959,12,1554372000,19,1,20,Clouds
66960,13,1554372000,17,12,29,Clouds
66961,14,1554372000,29,1,30,Clouds
66962,15,1554372000,16,0,16,Clouds
66963,16,1554372000,9,11,20,Clouds
66964,17,1554372000,20,0,20,Clouds
66965,18,1554372000,26,4,30,Clouds
66966,19,1554372000,3,27,30,Clouds
66967,21,1554372000,2,26,28,Clouds
66968,22,1554372000,7,13,20,Clouds
66969,23,1554372000,29,0,29,Clouds
66970,24,1554372000,18,2,20,Clouds
66971,25,1554372000,0,30,30,Clouds
66972,26,1554372000,10,10,20,Clouds
66973,27,1554372000,5,14,19,Clouds
66974,28,1554372000,13,17,30,Clouds
66975,29,1554372000,27,2,29,Clouds
66976,30,1554372000,20,0,20,Clouds
66977,31,1554372000,14,5,19,Clouds
66978,32,1554372000,0,30,30,Clouds
66979,33,1554372000,3,20,23,Clouds
66980,34,1554372000,30,0,30,Clouds
66981,35,1554372000,25,5,30,Clouds
66982,36,1554372000,0,40,40,Clouds
66983,37,1554372000,22,7,29,Clouds
66984,38,1554372000,31,9,40,Clouds
66985,39,1554372000,15,5,20,Clouds
66986,40,1554372000,16,5,21,Clouds
66987,41,1554372000,12,8,20,Clouds
66988,42,1554372000,30,0,30,Clouds
66989,43,1554372000,29,1,30,Clouds
66990,44,1554372000,28,2,30,Clouds
66991,45,1554372000,29,1,30,Clouds
66992,46,1554372000,18,2,20,Clouds
66993,47,1554372000,1,37,38,Clouds
66994,48,1554372000,0,39,39,Clouds
66995,49,1554372000,0,38,38,Clouds
66996,50,1554372000,39,1,40,Clouds
66997,51,1554372000,36,4,40,Clouds
66998,52,1554372000,11,20,31,Clouds
66999,53,1554372000,19,20,39,Clouds
67000,54,1554372000,19,13,32,Clouds
67001,55,1554372000,30,6,36,Clouds
67002,56,1554372000,0,40,40,Clouds
67003,57,1554372000,0,22,22,Clouds
67004,58,1554372000,1,37,38,Clouds
67005,59,1554372000,20,0,20,Clouds
67006,60,1554372000,28,2,30,Clouds
67007,61,1554372000,25,0,25,Clouds
67008,62,1554372000,3,36,39,Clouds
67009,63,1554372000,0,35,35,Clouds
67010,64,1554372000,0,40,40,Clouds
67011,65,1554372000,0,39,39,Clouds
67012,66,1554372000,10,29,39,Clouds
67013,67,1554372000,0,39,39,Clouds
67014,68,1554372000,9,31,40,Clouds
67015,69,1554372000,0,40,40,Clouds
67016,70,1554372000,0,28,28,Clouds
67017,71,1554372000,39,1,40,Clouds
67018,72,1554372000,31,0,31,Clouds
67019,73,1554372000,30,0,30,Clouds
67020,74,1554372000,30,0,30,Clouds
67021,75,1554372000,40,0,40,Clouds
67022,76,1554372000,36,2,38,Clouds
67023,77,1554372000,29,0,29,Clouds
67024,78,1554372000,40,0,40,Clouds
67025,79,1554372000,27,0,27,Clouds
67026,80,1554372000,39,1,40,Clouds
67027,81,1554372000,40,0,40,Clouds
67028,82,1554372000,21,1,22,Clouds
67029,83,1554372000,40,0,40,Clouds
67030,84,1554372000,30,0,30,Clouds
67031,85,1554372000,35,0,35,Clouds
67032,86,1554372000,38,0,38,Clouds
67033,87,1554372000,38,0,38,Clouds
67034,88,1554372000,30,0,30,Clouds
67035,89,1554372000,26,14,40,Clouds
67036,90,1554372000,0,39,39,Clouds
67037,91,1554372000,13,16,29,Clouds
67038,92,1554372000,39,1,40,Clouds
67039,93,1554372000,40,0,40,Clouds
67040,94,1554372000,40,0,40,Clouds
67041,95,1554372000,40,0,40,Clouds
67042,96,1554372000,30,0,30,Clouds
67043,97,1554372000,40,0,40,Clouds
67044,98,1554372000,31,8,39,Clouds
67045,99,1554372000,0,29,29,Clouds
67046,100,1554372000,25,0,25,Clouds
67047,101,1554372000,30,0,30,Clouds
67048,102,1554372000,40,0,40,Clouds
67049,103,1554372000,36,4,40,Clouds
67050,104,1554372000,36,4,40,Clouds
67051,105,1554372000,36,0,36,Clouds
67052,106,1554372000,40,0,40,Clouds
67053,107,1554372000,40,0,40,Clouds
67054,108,1554372000,39,1,40,Clouds
67055,109,1554372000,26,3,29,Clouds
67056,110,1554372000,40,0,40,Clouds
67057,111,1554372000,40,0,40,Clouds
67058,112,1554372000,30,0,30,Clouds
67059,113,1554372000,0,40,40,Clouds
67060,114,1554372000,0,40,40,Clouds
67061,115,1554372000,30,0,30,Clouds
67062,2,1554375600,20,0,20,Rain
67063,3,1554375600,15,5,20,Rain
67064,4,1554375600,20,0,20,Rain
67065,5,1554375600,28,12,40,Rain
67066,6,1554375600,20,0,20,Rain
67067,7,1554375600,28,1,29,Rain
67068,8,1554375600,17,13,30,Rain
67069,9,1554375600,12,12,24,Rain
67070,10,1554375600,14,2,16,Rain
67071,11,1554375600,6,24,30,Rain
67072,12,1554375600,20,0,20,Rain
67073,13,1554375600,15,14,29,Rain
67074,14,1554375600,19,11,30,Rain
67075,15,1554375600,16,0,16,Rain
67076,16,1554375600,9,11,20,Rain
67077,17,1554375600,17,3,20,Rain
67078,18,1554375600,29,1,30,Rain
67079,19,1554375600,2,28,30,Rain
67080,21,1554375600,0,28,28,Rain
67081,22,1554375600,8,12,20,Rain
67082,23,1554375600,26,3,29,Rain
67083,24,1554375600,19,1,20,Rain
67084,25,1554375600,0,30,30,Rain
67085,26,1554375600,10,10,20,Rain
67086,27,1554375600,6,13,19,Rain
67087,28,1554375600,17,13,30,Rain
67088,29,1554375600,28,1,29,Rain
67089,30,1554375600,20,0,20,Rain
67090,31,1554375600,10,9,19,Rain
67091,32,1554375600,7,23,30,Rain
67092,33,1554375600,6,17,23,Rain
67093,34,1554375600,30,0,30,Rain
67094,35,1554375600,29,1,30,Rain
67095,36,1554375600,21,19,40,Rain
67096,37,1554375600,22,7,29,Rain
67097,38,1554375600,23,17,40,Rain
67098,39,1554375600,17,3,20,Rain
67099,40,1554375600,13,8,21,Rain
67100,41,1554375600,17,3,20,Rain
67101,42,1554375600,29,1,30,Rain
67102,43,1554375600,13,17,30,Rain
67103,44,1554375600,29,1,30,Rain
67104,45,1554375600,29,1,30,Rain
67105,46,1554375600,19,1,20,Rain
67106,47,1554375600,1,37,38,Rain
67107,48,1554375600,2,38,40,Rain
67108,49,1554375600,12,28,40,Rain
67109,50,1554375600,40,0,40,Rain
67110,51,1554375600,36,4,40,Rain
67111,52,1554375600,10,21,31,Rain
67112,53,1554375600,18,21,39,Rain
67113,54,1554375600,18,14,32,Rain
67114,55,1554375600,31,5,36,Rain
67115,56,1554375600,17,23,40,Rain
67116,57,1554375600,1,21,22,Rain
67117,58,1554375600,4,34,38,Rain
67118,59,1554375600,20,0,20,Rain
67119,60,1554375600,17,13,30,Rain
67120,61,1554375600,16,9,25,Rain
67121,62,1554375600,2,38,40,Rain
67122,63,1554375600,0,35,35,Rain
67123,64,1554375600,5,35,40,Rain
67124,65,1554375600,5,35,40,Rain
67125,66,1554375600,8,32,40,Rain
67126,67,1554375600,2,38,40,Rain
67127,68,1554375600,0,40,40,Rain
67128,69,1554375600,1,39,40,Rain
67129,70,1554375600,4,24,28,Rain
67130,71,1554375600,40,0,40,Rain
67131,72,1554375600,31,0,31,Rain
67132,73,1554375600,30,0,30,Rain
67133,74,1554375600,30,0,30,Rain
67134,75,1554375600,39,1,40,Rain
67135,76,1554375600,36,2,38,Rain
67136,77,1554375600,28,1,29,Rain
67137,78,1554375600,40,0,40,Rain
67138,79,1554375600,27,0,27,Rain
67139,80,1554375600,40,0,40,Rain
67140,81,1554375600,39,1,40,Rain
67141,82,1554375600,22,0,22,Rain
67142,83,1554375600,40,0,40,Rain
67143,84,1554375600,30,0,30,Rain
67144,85,1554375600,35,0,35,Rain
67145,86,1554375600,38,0,38,Rain
67146,87,1554375600,38,0,38,Rain
67147,88,1554375600,26,4,30,Rain
67148,89,1554375600,20,20,40,Rain
67149,90,1554375600,0,39,39,Rain
67150,91,1554375600,9,20,29,Rain
67151,92,1554375600,40,0,40,Rain
67152,93,1554375600,40,0,40,Rain
67153,94,1554375600,40,0,40,Rain
67154,95,1554375600,40,0,40,Rain
67155,96,1554375600,30,0,30,Rain
67156,97,1554375600,40,0,40,Rain
67157,98,1554375600,24,15,39,Rain
67158,99,1554375600,1,29,30,Rain
67159,100,1554375600,25,0,25,Rain
67160,101,1554375600,30,0,30,Rain
67161,102,1554375600,40,0,40,Rain
67162,103,1554375600,38,2,40,Rain
67163,104,1554375600,36,4,40,Rain
67164,105,1554375600,36,0,36,Rain
67165,106,1554375600,40,0,40,Rain
67166,107,1554375600,40,0,40,Rain
67167,108,1554375600,39,1,40,Rain
67168,109,1554375600,27,2,29,Rain
67169,110,1554375600,40,0,40,Rain
67170,111,1554375600,39,1,40,Rain
67171,112,1554375600,30,0,30,Rain
67172,113,1554375600,0,40,40,Rain
67173,114,1554375600,0,40,40,Rain
67174,115,1554375600,22,8,30,Rain
67175,2,1554379200,20,0,20,Rain
67176,3,1554379200,18,2,20,Rain
67177,4,1554379200,20,0,20,Rain
67178,5,1554379200,31,9,40,Rain
67179,6,1554379200,18,2,20,Rain
67180,7,1554379200,29,0,29,Rain
67181,8,1554379200,17,13,30,Rain
67182,9,1554379200,11,13,24,Rain
67183,10,1554379200,11,5,16,Rain
67184,11,1554379200,4,26,30,Rain
67185,12,1554379200,20,0,20,Rain
67186,13,1554379200,17,12,29,Rain
67187,14,1554379200,14,16,30,Rain
67188,15,1554379200,16,0,16,Rain
67189,16,1554379200,9,11,20,Rain
67190,17,1554379200,17,3,20,Rain
67191,18,1554379200,26,4,30,Rain
67192,19,1554379200,0,30,30,Rain
67193,21,1554379200,3,25,28,Rain
67194,22,1554379200,6,14,20,Rain
67195,23,1554379200,25,4,29,Rain
67196,24,1554379200,18,2,20,Rain
67197,25,1554379200,1,29,30,Rain
67198,26,1554379200,6,14,20,Rain
67199,27,1554379200,8,11,19,Rain
67200,28,1554379200,25,5,30,Rain
67201,29,1554379200,25,4,29,Rain
67202,30,1554379200,19,1,20,Rain
67203,31,1554379200,17,2,19,Rain
67204,32,1554379200,6,24,30,Rain
67205,33,1554379200,0,23,23,Rain
67206,34,1554379200,30,0,30,Rain
67207,35,1554379200,27,3,30,Rain
67208,36,1554379200,19,21,40,Rain
67209,37,1554379200,29,0,29,Rain
67210,38,1554379200,27,13,40,Rain
67211,39,1554379200,14,6,20,Rain
67212,40,1554379200,13,8,21,Rain
67213,41,1554379200,17,3,20,Rain
67214,42,1554379200,30,0,30,Rain
67215,43,1554379200,19,11,30,Rain
67216,44,1554379200,30,0,30,Rain
67217,45,1554379200,30,0,30,Rain
67218,46,1554379200,16,4,20,Rain
67219,47,1554379200,2,38,40,Rain
67220,48,1554379200,1,39,40,Rain
67221,49,1554379200,13,27,40,Rain
67222,50,1554379200,40,0,40,Rain
67223,51,1554379200,36,4,40,Rain
67224,52,1554379200,13,18,31,Rain
67225,53,1554379200,17,22,39,Rain
67226,54,1554379200,18,14,32,Rain
67227,55,1554379200,34,2,36,Rain
67228,56,1554379200,17,23,40,Rain
67229,57,1554379200,3,20,23,Rain
67230,58,1554379200,4,35,39,Rain
67231,59,1554379200,20,0,20,Rain
67232,60,1554379200,23,7,30,Rain
67233,61,1554379200,17,8,25,Rain
67234,62,1554379200,2,38,40,Rain
67235,63,1554379200,0,35,35,Rain
67236,64,1554379200,1,39,40,Rain
67237,65,1554379200,3,37,40,Rain
67238,66,1554379200,13,27,40,Rain
67239,67,1554379200,3,37,40,Rain
67240,68,1554379200,1,39,40,Rain
67241,69,1554379200,4,36,40,Rain
67242,70,1554379200,2,26,28,Rain
67243,71,1554379200,37,3,40,Rain
67244,72,1554379200,31,0,31,Rain
67245,73,1554379200,30,0,30,Rain
67246,74,1554379200,30,0,30,Rain
67247,75,1554379200,40,0,40,Rain
67248,76,1554379200,38,0,38,Rain
67249,77,1554379200,29,0,29,Rain
67250,78,1554379200,38,2,40,Rain
67251,79,1554379200,27,0,27,Rain
67252,80,1554379200,39,1,40,Rain
67253,81,1554379200,40,0,40,Rain
67254,82,1554379200,22,0,22,Rain
67255,83,1554379200,38,2,40,Rain
67256,84,1554379200,30,0,30,Rain
67257,85,1554379200,34,1,35,Rain
67258,86,1554379200,38,0,38,Rain
67259,87,1554379200,38,0,38,Rain
67260,88,1554379200,26,4,30,Rain
67261,89,1554379200,20,20,40,Rain
67262,90,1554379200,2,38,40,Rain
67263,91,1554379200,10,20,30,Rain
67264,92,1554379200,40,0,40,Rain
67265,93,1554379200,40,0,40,Rain
67266,94,1554379200,40,0,40,Rain
67267,95,1554379200,40,0,40,Rain
67268,96,1554379200,30,0,30,Rain
67269,97,1554379200,40,0,40,Rain
67270,98,1554379200,22,17,39,Rain
67271,99,1554379200,0,30,30,Rain
67272,100,1554379200,25,0,25,Rain
67273,101,1554379200,30,0,30,Rain
67274,102,1554379200,40,0,40,Rain
67275,103,1554379200,40,0,40,Rain
67276,104,1554379200,39,1,40,Rain
67277,105,1554379200,36,0,36,Rain
67278,106,1554379200,40,0,40,Rain
67279,107,1554379200,40,0,40,Rain
67280,108,1554379200,39,1,40,Rain
67281,109,1554379200,28,1,29,Rain
67282,110,1554379200,40,0,40,Rain
67283,111,1554379200,40,0,40,Rain
67284,112,1554379200,28,2,30,Rain
67285,113,1554379200,0,40,40,Rain
67286,114,1554379200,0,40,40,Rain
67287,115,1554379200,21,9,30,Rain
67288,2,1554382800,19,1,20,Clouds
67289,3,1554382800,20,0,20,Clouds
67290,4,1554382800,20,0,20,Clouds
67291,5,1554382800,33,7,40,Clouds
67292,6,1554382800,20,0,20,Clouds
67293,7,1554382800,29,0,29,Clouds
67294,8,1554382800,18,12,30,Clouds
67295,9,1554382800,12,12,24,Clouds
67296,10,1554382800,7,9,16,Clouds
67297,11,1554382800,15,15,30,Clouds
67298,12,1554382800,20,0,20,Clouds
67299,13,1554382800,19,11,30,Clouds
67300,14,1554382800,6,24,30,Clouds
67301,15,1554382800,15,1,16,Clouds
67302,16,1554382800,7,13,20,Clouds
67303,17,1554382800,18,2,20,Clouds
67304,18,1554382800,24,6,30,Clouds
67305,19,1554382800,0,30,30,Clouds
67306,21,1554382800,6,22,28,Clouds
67307,22,1554382800,5,15,20,Clouds
67308,23,1554382800,26,3,29,Clouds
67309,24,1554382800,20,0,20,Clouds
67310,25,1554382800,4,26,30,Clouds
67311,26,1554382800,2,18,20,Clouds
67312,27,1554382800,0,19,19,Clouds
67313,28,1554382800,29,1,30,Clouds
67314,29,1554382800,28,1,29,Clouds
67315,30,1554382800,19,1,20,Clouds
67316,31,1554382800,20,0,20,Clouds
67317,32,1554382800,9,21,30,Clouds
67318,33,1554382800,11,11,22,Clouds
67319,34,1554382800,27,3,30,Clouds
67320,35,1554382800,24,6,30,Clouds
67321,36,1554382800,21,19,40,Clouds
67322,37,1554382800,25,4,29,Clouds
67323,38,1554382800,26,14,40,Clouds
67324,39,1554382800,14,6,20,Clouds
67325,40,1554382800,21,0,21,Clouds
67326,41,1554382800,18,2,20,Clouds
67327,42,1554382800,28,2,30,Clouds
67328,43,1554382800,22,8,30,Clouds
67329,44,1554382800,30,0,30,Clouds
67330,45,1554382800,28,2,30,Clouds
67331,46,1554382800,15,5,20,Clouds
67332,47,1554382800,5,35,40,Clouds
67333,48,1554382800,1,38,39,Clouds
67334,49,1554382800,12,28,40,Clouds
67335,50,1554382800,39,1,40,Clouds
67336,51,1554382800,36,4,40,Clouds
67337,52,1554382800,5,26,31,Clouds
67338,53,1554382800,17,22,39,Clouds
67339,54,1554382800,20,12,32,Clouds
67340,55,1554382800,35,1,36,Clouds
67341,56,1554382800,25,15,40,Clouds
67342,57,1554382800,5,18,23,Clouds
67343,58,1554382800,11,28,39,Clouds
67344,59,1554382800,19,1,20,Clouds
67345,60,1554382800,30,0,30,Clouds
67346,61,1554382800,25,0,25,Clouds
67347,62,1554382800,3,37,40,Clouds
67348,63,1554382800,11,24,35,Clouds
67349,64,1554382800,8,32,40,Clouds
67350,65,1554382800,11,29,40,Clouds
67351,66,1554382800,13,27,40,Clouds
67352,67,1554382800,1,39,40,Clouds
67353,68,1554382800,7,33,40,Clouds
67354,69,1554382800,1,39,40,Clouds
67355,70,1554382800,5,23,28,Clouds
67356,71,1554382800,37,3,40,Clouds
67357,72,1554382800,31,0,31,Clouds
67358,73,1554382800,28,2,30,Clouds
67359,74,1554382800,21,9,30,Clouds
67360,75,1554382800,36,4,40,Clouds
67361,76,1554382800,35,3,38,Clouds
67362,77,1554382800,29,0,29,Clouds
67363,78,1554382800,40,0,40,Clouds
67364,79,1554382800,26,1,27,Clouds
67365,80,1554382800,22,18,40,Clouds
67366,81,1554382800,40,0,40,Clouds
67367,82,1554382800,21,1,22,Clouds
67368,83,1554382800,40,0,40,Clouds
67369,84,1554382800,29,1,30,Clouds
67370,85,1554382800,35,0,35,Clouds
67371,86,1554382800,38,0,38,Clouds
67372,87,1554382800,36,2,38,Clouds
67373,88,1554382800,30,0,30,Clouds
67374,89,1554382800,24,16,40,Clouds
67375,90,1554382800,11,29,40,Clouds
67376,91,1554382800,15,15,30,Clouds
67377,92,1554382800,40,0,40,Clouds
67378,93,1554382800,40,0,40,Clouds
67379,94,1554382800,40,0,40,Clouds
67380,95,1554382800,40,0,40,Clouds
67381,96,1554382800,29,1,30,Clouds
67382,97,1554382800,37,3,40,Clouds
67383,98,1554382800,10,29,39,Clouds
67384,99,1554382800,1,29,30,Clouds
67385,100,1554382800,23,2,25,Clouds
67386,101,1554382800,30,0,30,Clouds
67387,102,1554382800,40,0,40,Clouds
67388,103,1554382800,40,0,40,Clouds
67389,104,1554382800,39,1,40,Clouds
67390,105,1554382800,36,0,36,Clouds
67391,106,1554382800,40,0,40,Clouds
67392,107,1554382800,31,9,40,Clouds
67393,108,1554382800,33,7,40,Clouds
67394,109,1554382800,29,0,29,Clouds
67395,110,1554382800,39,1,40,Clouds
67396,111,1554382800,39,1,40,Clouds
67397,112,1554382800,26,4,30,Clouds
67398,113,1554382800,4,36,40,Clouds
67399,114,1554382800,2,38,40,Clouds
67400,115,1554382800,28,2,30,Clouds
67401,2,1554386400,20,0,20,Rain
67402,3,1554386400,15,5,20,Rain
67403,4,1554386400,18,2,20,Rain
67404,5,1554386400,25,15,40,Rain
67405,6,1554386400,20,0,20,Rain
67406,7,1554386400,29,0,29,Rain
67407,8,1554386400,9,21,30,Rain
67408,9,1554386400,1,23,24,Rain
67409,10,1554386400,6,10,16,Rain
67410,11,1554386400,23,7,30,Rain
67411,12,1554386400,20,0,20,Rain
67412,13,1554386400,18,12,30,Rain
67413,14,1554386400,13,17,30,Rain
67414,15,1554386400,16,0,16,Rain
67415,16,1554386400,9,11,20,Rain
67416,17,1554386400,17,3,20,Rain
67417,18,1554386400,23,7,30,Rain
67418,19,1554386400,1,29,30,Rain
67419,21,1554386400,15,13,28,Rain
67420,22,1554386400,18,2,20,Rain
67421,23,1554386400,23,6,29,Rain
67422,24,1554386400,20,0,20,Rain
67423,25,1554386400,1,29,30,Rain
67424,26,1554386400,1,19,20,Rain
67425,27,1554386400,7,12,19,Rain
67426,28,1554386400,29,1,30,Rain
67427,29,1554386400,26,3,29,Rain
67428,30,1554386400,11,9,20,Rain
67429,31,1554386400,18,2,20,Rain
67430,32,1554386400,14,16,30,Rain
67431,33,1554386400,12,10,22,Rain
67432,34,1554386400,17,13,30,Rain
67433,35,1554386400,24,6,30,Rain
67434,36,1554386400,16,24,40,Rain
67435,37,1554386400,26,3,29,Rain
67436,38,1554386400,29,11,40,Rain
67437,39,1554386400,18,2,20,Rain
67438,40,1554386400,21,0,21,Rain
67439,41,1554386400,20,0,20,Rain
67440,42,1554386400,27,3,30,Rain
67441,43,1554386400,28,2,30,Rain
67442,44,1554386400,30,0,30,Rain
67443,45,1554386400,29,1,30,Rain
67444,46,1554386400,12,8,20,Rain
67445,47,1554386400,1,39,40,Rain
67446,48,1554386400,1,38,39,Rain
67447,49,1554386400,3,37,40,Rain
67448,50,1554386400,36,4,40,Rain
67449,51,1554386400,38,2,40,Rain
67450,52,1554386400,25,6,31,Rain
67451,53,1554386400,17,22,39,Rain
67452,54,1554386400,18,14,32,Rain
67453,55,1554386400,29,7,36,Rain
67454,56,1554386400,14,26,40,Rain
67455,57,1554386400,8,15,23,Rain
67456,58,1554386400,11,28,39,Rain
67457,59,1554386400,19,1,20,Rain
67458,60,1554386400,22,8,30,Rain
67459,61,1554386400,23,2,25,Rain
67460,62,1554386400,1,39,40,Rain
67461,63,1554386400,6,29,35,Rain
67462,64,1554386400,11,29,40,Rain
67463,65,1554386400,5,35,40,Rain
67464,66,1554386400,11,29,40,Rain
67465,67,1554386400,3,37,40,Rain
67466,68,1554386400,7,33,40,Rain
67467,69,1554386400,0,39,39,Rain
67468,70,1554386400,5,23,28,Rain
67469,71,1554386400,36,4,40,Rain
67470,72,1554386400,31,0,31,Rain
67471,73,1554386400,29,1,30,Rain
67472,74,1554386400,24,6,30,Rain
67473,75,1554386400,38,2,40,Rain
67474,76,1554386400,37,1,38,Rain
67475,77,1554386400,29,0,29,Rain
67476,78,1554386400,39,1,40,Rain
67477,79,1554386400,25,2,27,Rain
67478,80,1554386400,25,15,40,Rain
67479,81,1554386400,39,1,40,Rain
67480,82,1554386400,22,0,22,Rain
67481,83,1554386400,40,0,40,Rain
67482,84,1554386400,30,0,30,Rain
67483,85,1554386400,35,0,35,Rain
67484,86,1554386400,33,5,38,Rain
67485,87,1554386400,37,1,38,Rain
67486,88,1554386400,28,2,30,Rain
67487,89,1554386400,26,14,40,Rain
67488,90,1554386400,5,35,40,Rain
67489,91,1554386400,14,16,30,Rain
67490,92,1554386400,40,0,40,Rain
67491,93,1554386400,40,0,40,Rain
67492,94,1554386400,40,0,40,Rain
67493,95,1554386400,38,2,40,Rain
67494,96,1554386400,30,0,30,Rain
67495,97,1554386400,37,3,40,Rain
67496,98,1554386400,10,29,39,Rain
67497,99,1554386400,4,26,30,Rain
67498,100,1554386400,23,2,25,Rain
67499,101,1554386400,27,3,30,Rain
67500,102,1554386400,40,0,40,Rain
67501,103,1554386400,39,1,40,Rain
67502,104,1554386400,40,0,40,Rain
67503,105,1554386400,36,0,36,Rain
67504,106,1554386400,39,1,40,Rain
67505,107,1554386400,35,5,40,Rain
67506,108,1554386400,36,4,40,Rain
67507,109,1554386400,29,0,29,Rain
67508,110,1554386400,40,0,40,Rain
67509,111,1554386400,40,0,40,Rain
67510,112,1554386400,24,6,30,Rain
67511,113,1554386400,5,35,40,Rain
67512,114,1554386400,2,38,40,Rain
67513,115,1554386400,28,2,30,Rain
67514,2,1554390000,20,0,20,Rain
67515,3,1554390000,20,0,20,Rain
67516,4,1554390000,17,3,20,Rain
67517,5,1554390000,35,5,40,Rain
67518,6,1554390000,18,2,20,Rain
67519,7,1554390000,29,0,29,Rain
67520,8,1554390000,0,30,30,Rain
67521,9,1554390000,4,20,24,Rain
67522,10,1554390000,4,12,16,Rain
67523,11,1554390000,24,6,30,Rain
67524,12,1554390000,14,6,20,Rain
67525,13,1554390000,1,29,30,Rain
67526,14,1554390000,18,12,30,Rain
67527,15,1554390000,15,1,16,Rain
67528,16,1554390000,6,14,20,Rain
67529,17,1554390000,16,4,20,Rain
67530,18,1554390000,23,7,30,Rain
67531,19,1554390000,5,25,30,Rain
67532,21,1554390000,15,13,28,Rain
67533,22,1554390000,19,1,20,Rain
67534,23,1554390000,21,8,29,Rain
67535,24,1554390000,13,7,20,Rain
67536,25,1554390000,1,29,30,Rain
67537,26,1554390000,1,19,20,Rain
67538,27,1554390000,12,7,19,Rain
67539,28,1554390000,30,0,30,Rain
67540,29,1554390000,28,1,29,Rain
67541,30,1554390000,12,8,20,Rain
67542,31,1554390000,20,0,20,Rain
67543,32,1554390000,6,24,30,Rain
67544,33,1554390000,13,9,22,Rain
67545,34,1554390000,23,7,30,Rain
67546,35,1554390000,29,1,30,Rain
67547,36,1554390000,15,25,40,Rain
67548,37,1554390000,28,1,29,Rain
67549,38,1554390000,30,10,40,Rain
67550,39,1554390000,15,5,20,Rain
67551,40,1554390000,17,4,21,Rain
67552,41,1554390000,14,6,20,Rain
67553,42,1554390000,27,3,30,Rain
67554,43,1554390000,23,7,30,Rain
67555,44,1554390000,30,0,30,Rain
67556,45,1554390000,27,3,30,Rain
67557,46,1554390000,13,7,20,Rain
67558,47,1554390000,1,39,40,Rain
67559,48,1554390000,1,39,40,Rain
67560,49,1554390000,0,40,40,Rain
67561,50,1554390000,40,0,40,Rain
67562,51,1554390000,37,3,40,Rain
67563,52,1554390000,27,4,31,Rain
67564,53,1554390000,18,21,39,Rain
67565,54,1554390000,20,13,33,Rain
67566,55,1554390000,29,7,36,Rain
67567,56,1554390000,14,26,40,Rain
67568,57,1554390000,8,15,23,Rain
67569,58,1554390000,12,27,39,Rain
67570,59,1554390000,20,0,20,Rain
67571,60,1554390000,28,2,30,Rain
67572,61,1554390000,24,1,25,Rain
67573,62,1554390000,1,39,40,Rain
67574,63,1554390000,2,33,35,Rain
67575,64,1554390000,9,31,40,Rain
67576,65,1554390000,0,40,40,Rain
67577,66,1554390000,10,30,40,Rain
67578,67,1554390000,8,32,40,Rain
67579,68,1554390000,0,40,40,Rain
67580,69,1554390000,1,39,40,Rain
67581,70,1554390000,5,23,28,Rain
67582,71,1554390000,35,5,40,Rain
67583,72,1554390000,28,3,31,Rain
67584,73,1554390000,25,5,30,Rain
67585,74,1554390000,23,7,30,Rain
67586,75,1554390000,39,1,40,Rain
67587,76,1554390000,36,2,38,Rain
67588,77,1554390000,27,2,29,Rain
67589,78,1554390000,39,1,40,Rain
67590,79,1554390000,25,2,27,Rain
67591,80,1554390000,29,11,40,Rain
67592,81,1554390000,39,1,40,Rain
67593,82,1554390000,22,0,22,Rain
67594,83,1554390000,38,2,40,Rain
67595,84,1554390000,30,0,30,Rain
67596,85,1554390000,35,0,35,Rain
67597,86,1554390000,30,8,38,Rain
67598,87,1554390000,36,2,38,Rain
67599,88,1554390000,28,2,30,Rain
67600,89,1554390000,23,17,40,Rain
67601,90,1554390000,6,34,40,Rain
67602,91,1554390000,8,22,30,Rain
67603,92,1554390000,40,0,40,Rain
67604,93,1554390000,40,0,40,Rain
67605,94,1554390000,40,0,40,Rain
67606,95,1554390000,36,4,40,Rain
67607,96,1554390000,29,1,30,Rain
67608,97,1554390000,36,4,40,Rain
67609,98,1554390000,14,25,39,Rain
67610,99,1554390000,5,25,30,Rain
67611,100,1554390000,16,9,25,Rain
67612,101,1554390000,29,1,30,Rain
67613,102,1554390000,24,16,40,Rain
67614,103,1554390000,39,1,40,Rain
67615,104,1554390000,40,0,40,Rain
67616,105,1554390000,36,0,36,Rain
67617,106,1554390000,40,0,40,Rain
67618,107,1554390000,35,5,40,Rain
67619,108,1554390000,37,3,40,Rain
67620,109,1554390000,26,3,29,Rain
67621,110,1554390000,40,0,40,Rain
67622,111,1554390000,40,0,40,Rain
67623,112,1554390000,30,0,30,Rain
67624,113,1554390000,2,38,40,Rain
67625,114,1554390000,3,37,40,Rain
67626,115,1554390000,29,1,30,Rain
67627,2,1554393600,19,1,20,Rain
67628,3,1554393600,20,0,20,Rain
67629,4,1554393600,20,0,20,Rain
67630,5,1554393600,27,13,40,Rain
67631,6,1554393600,17,3,20,Rain
67632,7,1554393600,29,0,29,Rain
67633,8,1554393600,0,30,30,Rain
67634,9,1554393600,11,13,24,Rain
67635,10,1554393600,1,15,16,Rain
67636,11,1554393600,25,5,30,Rain
67637,12,1554393600,15,5,20,Rain
67638,13,1554393600,1,29,30,Rain
67639,14,1554393600,19,11,30,Rain
67640,15,1554393600,15,1,16,Rain
67641,16,1554393600,8,12,20,Rain
67642,17,1554393600,20,0,20,Rain
67643,18,1554393600,22,8,30,Rain
67644,19,1554393600,7,23,30,Rain
67645,21,1554393600,15,15,30,Rain
67646,22,1554393600,13,7,20,Rain
67647,23,1554393600,16,14,30,Rain
67648,24,1554393600,16,4,20,Rain
67649,25,1554393600,3,27,30,Rain
67650,26,1554393600,3,17,20,Rain
67651,27,1554393600,16,4,20,Rain
67652,28,1554393600,29,1,30,Rain
67653,29,1554393600,27,2,29,Rain
67654,30,1554393600,15,5,20,Rain
67655,31,1554393600,20,0,20,Rain
67656,32,1554393600,18,12,30,Rain
67657,33,1554393600,7,15,22,Rain
67658,34,1554393600,26,4,30,Rain
67659,35,1554393600,27,3,30,Rain
67660,36,1554393600,13,27,40,Rain
67661,37,1554393600,27,3,30,Rain
67662,38,1554393600,32,8,40,Rain
67663,39,1554393600,15,5,20,Rain
67664,40,1554393600,18,3,21,Rain
67665,41,1554393600,10,10,20,Rain
67666,42,1554393600,28,2,30,Rain
67667,43,1554393600,22,8,30,Rain
67668,44,1554393600,27,3,30,Rain
67669,45,1554393600,19,11,30,Rain
67670,46,1554393600,12,8,20,Rain
67671,47,1554393600,2,38,40,Rain
67672,48,1554393600,1,39,40,Rain
67673,49,1554393600,1,39,40,Rain
67674,50,1554393600,40,0,40,Rain
67675,51,1554393600,36,4,40,Rain
67676,52,1554393600,28,4,32,Rain
67677,53,1554393600,21,19,40,Rain
67678,54,1554393600,21,12,33,Rain
67679,55,1554393600,32,4,36,Rain
67680,56,1554393600,3,37,40,Rain
67681,57,1554393600,8,15,23,Rain
67682,58,1554393600,15,24,39,Rain
67683,59,1554393600,20,0,20,Rain
67684,60,1554393600,27,3,30,Rain
67685,61,1554393600,8,17,25,Rain
67686,62,1554393600,4,36,40,Rain
67687,63,1554393600,4,31,35,Rain
67688,64,1554393600,9,31,40,Rain
67689,65,1554393600,0,40,40,Rain
67690,66,1554393600,9,31,40,Rain
67691,67,1554393600,4,36,40,Rain
67692,68,1554393600,3,37,40,Rain
67693,69,1554393600,2,38,40,Rain
67694,70,1554393600,6,22,28,Rain
67695,71,1554393600,36,4,40,Rain
67696,72,1554393600,28,3,31,Rain
67697,73,1554393600,26,4,30,Rain
67698,74,1554393600,22,8,30,Rain
67699,75,1554393600,40,0,40,Rain
67700,76,1554393600,35,3,38,Rain
67701,77,1554393600,27,2,29,Rain
67702,78,1554393600,39,1,40,Rain
67703,79,1554393600,27,0,27,Rain
67704,80,1554393600,21,19,40,Rain
67705,81,1554393600,40,0,40,Rain
67706,82,1554393600,22,0,22,Rain
67707,83,1554393600,38,2,40,Rain
67708,84,1554393600,29,1,30,Rain
67709,85,1554393600,33,2,35,Rain
67710,86,1554393600,38,0,38,Rain
67711,87,1554393600,33,5,38,Rain
67712,88,1554393600,28,2,30,Rain
67713,89,1554393600,4,36,40,Rain
67714,90,1554393600,13,27,40,Rain
67715,91,1554393600,9,21,30,Rain
67716,92,1554393600,40,0,40,Rain
67717,93,1554393600,40,0,40,Rain
67718,94,1554393600,39,1,40,Rain
67719,95,1554393600,37,3,40,Rain
67720,96,1554393600,27,3,30,Rain
67721,97,1554393600,34,6,40,Rain
67722,98,1554393600,18,22,40,Rain
67723,99,1554393600,6,24,30,Rain
67724,100,1554393600,14,11,25,Rain
67725,101,1554393600,30,0,30,Rain
67726,102,1554393600,25,15,40,Rain
67727,103,1554393600,38,2,40,Rain
67728,104,1554393600,40,0,40,Rain
67729,105,1554393600,36,0,36,Rain
67730,106,1554393600,40,0,40,Rain
67731,107,1554393600,34,6,40,Rain
67732,108,1554393600,37,3,40,Rain
67733,109,1554393600,25,4,29,Rain
67734,110,1554393600,40,0,40,Rain
67735,111,1554393600,40,0,40,Rain
67736,112,1554393600,30,0,30,Rain
67737,113,1554393600,2,38,40,Rain
67738,114,1554393600,9,31,40,Rain
67739,115,1554393600,29,1,30,Rain
67740,2,1554397200,18,2,20,Rain
67741,3,1554397200,19,1,20,Rain
67742,4,1554397200,20,0,20,Rain
67743,5,1554397200,33,7,40,Rain
67744,6,1554397200,16,4,20,Rain
67745,7,1554397200,28,1,29,Rain
67746,8,1554397200,1,29,30,Rain
67747,9,1554397200,13,11,24,Rain
67748,10,1554397200,6,10,16,Rain
67749,11,1554397200,30,0,30,Rain
67750,12,1554397200,15,5,20,Rain
67751,13,1554397200,5,25,30,Rain
67752,14,1554397200,21,9,30,Rain
67753,15,1554397200,16,0,16,Rain
67754,16,1554397200,2,18,20,Rain
67755,17,1554397200,20,0,20,Rain
67756,18,1554397200,28,2,30,Rain
67757,19,1554397200,14,16,30,Rain
67758,21,1554397200,9,21,30,Rain
67759,22,1554397200,14,6,20,Rain
67760,23,1554397200,5,25,30,Rain
67761,24,1554397200,10,9,19,Rain
67762,25,1554397200,8,22,30,Rain
67763,26,1554397200,6,14,20,Rain
67764,27,1554397200,16,4,20,Rain
67765,28,1554397200,28,2,30,Rain
67766,29,1554397200,29,0,29,Rain
67767,30,1554397200,20,0,20,Rain
67768,31,1554397200,20,0,20,Rain
67769,32,1554397200,6,24,30,Rain
67770,33,1554397200,8,14,22,Rain
67771,34,1554397200,18,12,30,Rain
67772,35,1554397200,26,4,30,Rain
67773,36,1554397200,26,14,40,Rain
67774,37,1554397200,30,0,30,Rain
67775,38,1554397200,28,12,40,Rain
67776,39,1554397200,14,6,20,Rain
67777,40,1554397200,21,0,21,Rain
67778,41,1554397200,12,8,20,Rain
67779,42,1554397200,27,3,30,Rain
67780,43,1554397200,21,9,30,Rain
67781,44,1554397200,28,2,30,Rain
67782,45,1554397200,18,12,30,Rain
67783,46,1554397200,17,3,20,Rain
67784,47,1554397200,8,32,40,Rain
67785,48,1554397200,18,22,40,Rain
67786,49,1554397200,1,39,40,Rain
67787,50,1554397200,39,1,40,Rain
67788,51,1554397200,38,2,40,Rain
67789,52,1554397200,28,4,32,Rain
67790,53,1554397200,28,12,40,Rain
67791,54,1554397200,33,0,33,Rain
67792,55,1554397200,36,0,36,Rain
67793,56,1554397200,16,24,40,Rain
67794,57,1554397200,13,10,23,Rain
67795,58,1554397200,24,15,39,Rain
67796,59,1554397200,20,0,20,Rain
67797,60,1554397200,23,7,30,Rain
67798,61,1554397200,12,13,25,Rain
67799,62,1554397200,10,30,40,Rain
67800,63,1554397200,2,33,35,Rain
67801,64,1554397200,7,33,40,Rain
67802,65,1554397200,5,35,40,Rain
67803,66,1554397200,18,22,40,Rain
67804,67,1554397200,0,40,40,Rain
67805,68,1554397200,5,35,40,Rain
67806,69,1554397200,7,33,40,Rain
67807,70,1554397200,0,28,28,Rain
67808,71,1554397200,39,1,40,Rain
67809,72,1554397200,27,4,31,Rain
67810,73,1554397200,28,2,30,Rain
67811,74,1554397200,25,5,30,Rain
67812,75,1554397200,37,3,40,Rain
67813,76,1554397200,18,20,38,Rain
67814,77,1554397200,29,0,29,Rain
67815,78,1554397200,39,1,40,Rain
67816,79,1554397200,27,0,27,Rain
67817,80,1554397200,15,25,40,Rain
67818,81,1554397200,40,0,40,Rain
67819,82,1554397200,21,1,22,Rain
67820,83,1554397200,36,4,40,Rain
67821,84,1554397200,28,2,30,Rain
67822,85,1554397200,33,2,35,Rain
67823,86,1554397200,23,15,38,Rain
67824,87,1554397200,33,5,38,Rain
67825,88,1554397200,27,3,30,Rain
67826,89,1554397200,12,28,40,Rain
67827,90,1554397200,9,31,40,Rain
67828,91,1554397200,8,22,30,Rain
67829,92,1554397200,32,8,40,Rain
67830,93,1554397200,31,9,40,Rain
67831,94,1554397200,39,1,40,Rain
67832,95,1554397200,35,5,40,Rain
67833,96,1554397200,27,3,30,Rain
67834,97,1554397200,37,3,40,Rain
67835,98,1554397200,17,23,40,Rain
67836,99,1554397200,5,25,30,Rain
67837,100,1554397200,0,25,25,Rain
67838,101,1554397200,28,2,30,Rain
67839,102,1554397200,22,18,40,Rain
67840,103,1554397200,40,0,40,Rain
67841,104,1554397200,40,0,40,Rain
67842,105,1554397200,36,0,36,Rain
67843,106,1554397200,40,0,40,Rain
67844,107,1554397200,34,6,40,Rain
67845,108,1554397200,36,4,40,Rain
67846,109,1554397200,28,1,29,Rain
67847,110,1554397200,38,2,40,Rain
67848,111,1554397200,35,5,40,Rain
67849,112,1554397200,28,2,30,Rain
67850,113,1554397200,5,35,40,Rain
67851,114,1554397200,23,17,40,Rain
67852,115,1554397200,29,1,30,Rain
67853,2,1554400800,20,0,20,Rain
67854,3,1554400800,19,1,20,Rain
67855,4,1554400800,20,0,20,Rain
67856,5,1554400800,40,0,40,Rain
67857,6,1554400800,19,1,20,Rain
67858,7,1554400800,12,17,29,Rain
67859,8,1554400800,1,29,30,Rain
67860,9,1554400800,17,7,24,Rain
67861,10,1554400800,11,5,16,Rain
67862,11,1554400800,30,0,30,Rain
67863,12,1554400800,12,8,20,Rain
67864,13,1554400800,13,17,30,Rain
67865,14,1554400800,17,13,30,Rain
67866,15,1554400800,16,0,16,Rain
67867,16,1554400800,12,8,20,Rain
67868,17,1554400800,16,4,20,Rain
67869,18,1554400800,28,2,30,Rain
67870,19,1554400800,27,3,30,Rain
67871,21,1554400800,9,21,30,Rain
67872,22,1554400800,10,10,20,Rain
67873,23,1554400800,13,17,30,Rain
67874,24,1554400800,18,2,20,Rain
67875,25,1554400800,8,22,30,Rain
67876,26,1554400800,10,10,20,Rain
67877,27,1554400800,19,1,20,Rain
67878,28,1554400800,27,3,30,Rain
67879,29,1554400800,26,3,29,Rain
67880,30,1554400800,20,0,20,Rain
67881,31,1554400800,20,0,20,Rain
67882,32,1554400800,5,25,30,Rain
67883,33,1554400800,11,12,23,Rain
67884,34,1554400800,7,23,30,Rain
67885,35,1554400800,28,2,30,Rain
67886,36,1554400800,36,4,40,Rain
67887,37,1554400800,28,2,30,Rain
67888,38,1554400800,20,20,40,Rain
67889,39,1554400800,16,4,20,Rain
67890,40,1554400800,18,3,21,Rain
67891,41,1554400800,18,2,20,Rain
67892,42,1554400800,29,1,30,Rain
67893,43,1554400800,10,20,30,Rain
67894,44,1554400800,26,4,30,Rain
67895,45,1554400800,15,15,30,Rain
67896,46,1554400800,17,3,20,Rain
67897,47,1554400800,14,26,40,Rain
67898,48,1554400800,13,27,40,Rain
67899,49,1554400800,1,39,40,Rain
67900,50,1554400800,39,1,40,Rain
67901,51,1554400800,34,6,40,Rain
67902,52,1554400800,28,4,32,Rain
67903,53,1554400800,38,2,40,Rain
67904,54,1554400800,33,0,33,Rain
67905,55,1554400800,36,0,36,Rain
67906,56,1554400800,27,13,40,Rain
67907,57,1554400800,18,5,23,Rain
67908,58,1554400800,28,11,39,Rain
67909,59,1554400800,20,0,20,Rain
67910,60,1554400800,12,18,30,Rain
67911,61,1554400800,14,11,25,Rain
67912,62,1554400800,18,22,40,Rain
67913,63,1554400800,2,33,35,Rain
67914,64,1554400800,0,40,40,Rain
67915,65,1554400800,12,28,40,Rain
67916,66,1554400800,32,8,40,Rain
67917,67,1554400800,3,37,40,Rain
67918,68,1554400800,3,37,40,Rain
67919,69,1554400800,5,35,40,Rain
67920,70,1554400800,7,21,28,Rain
67921,71,1554400800,37,3,40,Rain
67922,72,1554400800,31,0,31,Rain
67923,73,1554400800,30,0,30,Rain
67924,74,1554400800,30,0,30,Rain
67925,75,1554400800,33,7,40,Rain
67926,76,1554400800,17,21,38,Rain
67927,77,1554400800,28,1,29,Rain
67928,78,1554400800,37,3,40,Rain
67929,80,1554400800,14,26,40,Rain
67930,81,1554400800,40,0,40,Rain
67931,82,1554400800,18,4,22,Rain
67932,83,1554400800,36,4,40,Rain
67933,84,1554400800,26,4,30,Rain
67934,85,1554400800,29,6,35,Rain
67935,86,1554400800,16,22,38,Rain
67936,87,1554400800,32,6,38,Rain
67937,88,1554400800,27,3,30,Rain
67938,89,1554400800,23,17,40,Rain
67939,90,1554400800,23,17,40,Rain
67940,91,1554400800,1,29,30,Rain
67941,92,1554400800,16,24,40,Rain
67942,93,1554400800,6,34,40,Rain
67943,94,1554400800,37,3,40,Rain
67944,95,1554400800,36,4,40,Rain
67945,96,1554400800,27,3,30,Rain
67946,97,1554400800,31,9,40,Rain
67947,98,1554400800,18,22,40,Rain
67948,99,1554400800,4,26,30,Rain
67949,100,1554400800,0,25,25,Rain
67950,101,1554400800,25,5,30,Rain
67951,102,1554400800,21,19,40,Rain
67952,103,1554400800,39,1,40,Rain
67953,104,1554400800,40,0,40,Rain
67954,105,1554400800,36,0,36,Rain
67955,106,1554400800,39,1,40,Rain
67956,107,1554400800,31,9,40,Rain
67957,108,1554400800,36,4,40,Rain
67958,109,1554400800,28,1,29,Rain
67959,110,1554400800,39,1,40,Rain
67960,111,1554400800,31,9,40,Rain
67961,112,1554400800,24,6,30,Rain
67962,113,1554400800,6,34,40,Rain
67963,114,1554400800,40,0,40,Rain
67964,115,1554400800,23,7,30,Rain
67965,2,1554404400,18,2,20,Rain
67966,3,1554404400,20,0,20,Rain
67967,4,1554404400,18,2,20,Rain
67968,5,1554404400,33,7,40,Rain
67969,6,1554404400,16,4,20,Rain
67970,7,1554404400,16,13,29,Rain
67971,8,1554404400,0,30,30,Rain
67972,9,1554404400,19,5,24,Rain
67973,10,1554404400,13,3,16,Rain
67974,11,1554404400,30,0,30,Rain
67975,12,1554404400,9,11,20,Rain
67976,13,1554404400,14,16,30,Rain
67977,14,1554404400,21,9,30,Rain
67978,15,1554404400,14,2,16,Rain
67979,16,1554404400,16,4,20,Rain
67980,17,1554404400,13,7,20,Rain
67981,18,1554404400,28,2,30,Rain
67982,19,1554404400,30,0,30,Rain
67983,21,1554404400,9,21,30,Rain
67984,22,1554404400,11,9,20,Rain
67985,23,1554404400,3,27,30,Rain
67986,24,1554404400,20,0,20,Rain
67987,25,1554404400,9,21,30,Rain
67988,26,1554404400,14,6,20,Rain
67989,27,1554404400,20,0,20,Rain
67990,28,1554404400,28,2,30,Rain
67991,29,1554404400,29,0,29,Rain
67992,30,1554404400,18,2,20,Rain
67993,31,1554404400,16,4,20,Rain
67994,32,1554404400,5,25,30,Rain
67995,33,1554404400,12,11,23,Rain
67996,34,1554404400,0,30,30,Rain
67997,35,1554404400,25,5,30,Rain
67998,36,1554404400,40,0,40,Rain
67999,37,1554404400,30,0,30,Rain
68000,38,1554404400,23,17,40,Rain
68001,39,1554404400,19,1,20,Rain
68002,40,1554404400,20,1,21,Rain
68003,41,1554404400,19,1,20,Rain
68004,42,1554404400,27,3,30,Rain
68005,43,1554404400,0,30,30,Rain
68006,44,1554404400,22,8,30,Rain
68007,45,1554404400,8,22,30,Rain
68008,46,1554404400,19,1,20,Rain
68009,47,1554404400,32,8,40,Rain
68010,48,1554404400,19,21,40,Rain
68011,49,1554404400,21,19,40,Rain
68012,50,1554404400,39,1,40,Rain
68013,51,1554404400,35,5,40,Rain
68014,52,1554404400,32,0,32,Rain
68015,53,1554404400,39,1,40,Rain
68016,54,1554404400,32,1,33,Rain
68017,55,1554404400,35,1,36,Rain
68018,56,1554404400,27,13,40,Rain
68019,57,1554404400,20,3,23,Rain
68020,58,1554404400,38,1,39,Rain
68021,59,1554404400,19,1,20,Rain
68022,60,1554404400,7,23,30,Rain
68023,61,1554404400,13,12,25,Rain
68024,62,1554404400,24,16,40,Rain
68025,63,1554404400,9,26,35,Rain
68026,64,1554404400,4,36,40,Rain
68027,65,1554404400,18,22,40,Rain
68028,66,1554404400,36,4,40,Rain
68029,67,1554404400,7,33,40,Rain
68030,68,1554404400,5,35,40,Rain
68031,69,1554404400,8,32,40,Rain
68032,70,1554404400,0,28,28,Rain
68033,71,1554404400,37,3,40,Rain
68034,72,1554404400,24,7,31,Rain
68035,73,1554404400,30,0,30,Rain
68036,74,1554404400,8,22,30,Rain
68037,75,1554404400,28,12,40,Rain
68038,76,1554404400,14,24,38,Rain
68039,77,1554404400,28,1,29,Rain
68040,78,1554404400,35,5,40,Rain
68041,80,1554404400,16,24,40,Rain
68042,81,1554404400,40,0,40,Rain
68043,82,1554404400,14,8,22,Rain
68044,83,1554404400,29,11,40,Rain
68045,84,1554404400,28,2,30,Rain
68046,85,1554404400,23,12,35,Rain
68047,86,1554404400,11,27,38,Rain
68048,87,1554404400,28,10,38,Rain
68049,88,1554404400,20,10,30,Rain
68050,89,1554404400,30,10,40,Rain
68051,90,1554404400,36,4,40,Rain
68052,91,1554404400,0,30,30,Rain
68053,92,1554404400,13,27,40,Rain
68054,93,1554404400,6,34,40,Rain
68055,94,1554404400,35,5,40,Rain
68056,95,1554404400,34,6,40,Rain
68057,96,1554404400,27,3,30,Rain
68058,97,1554404400,28,12,40,Rain
68059,98,1554404400,31,9,40,Rain
68060,99,1554404400,10,20,30,Rain
68061,100,1554404400,14,11,25,Rain
68062,101,1554404400,19,11,30,Rain
68063,102,1554404400,22,18,40,Rain
68064,103,1554404400,40,0,40,Rain
68065,104,1554404400,40,0,40,Rain
68066,105,1554404400,36,0,36,Rain
68067,106,1554404400,40,0,40,Rain
68068,107,1554404400,32,8,40,Rain
68069,108,1554404400,35,5,40,Rain
68070,109,1554404400,24,5,29,Rain
68071,110,1554404400,39,1,40,Rain
68072,111,1554404400,30,10,40,Rain
68073,112,1554404400,16,14,30,Rain
68074,113,1554404400,14,26,40,Rain
68075,114,1554404400,39,1,40,Rain
68076,115,1554404400,19,11,30,Rain
68077,2,1554408000,15,5,20,Rain
68078,3,1554408000,18,2,20,Rain
68079,4,1554408000,18,2,20,Rain
68080,5,1554408000,29,11,40,Rain
68081,6,1554408000,18,2,20,Rain
68082,7,1554408000,12,17,29,Rain
68083,8,1554408000,12,18,30,Rain
68084,9,1554408000,24,0,24,Rain
68085,10,1554408000,13,3,16,Rain
68086,11,1554408000,28,2,30,Rain
68087,12,1554408000,9,11,20,Rain
68088,13,1554408000,14,16,30,Rain
68089,14,1554408000,24,6,30,Rain
68090,15,1554408000,14,2,16,Rain
68091,16,1554408000,17,3,20,Rain
68092,17,1554408000,16,4,20,Rain
68093,18,1554408000,29,1,30,Rain
68094,19,1554408000,30,0,30,Rain
68095,21,1554408000,13,17,30,Rain
68096,22,1554408000,10,10,20,Rain
68097,23,1554408000,7,23,30,Rain
68098,24,1554408000,20,0,20,Rain
68099,25,1554408000,13,17,30,Rain
68100,26,1554408000,14,6,20,Rain
68101,27,1554408000,20,0,20,Rain
68102,28,1554408000,29,1,30,Rain
68103,29,1554408000,24,5,29,Rain
68104,30,1554408000,19,1,20,Rain
68105,31,1554408000,20,0,20,Rain
68106,32,1554408000,5,25,30,Rain
68107,33,1554408000,9,14,23,Rain
68108,34,1554408000,17,13,30,Rain
68109,35,1554408000,24,6,30,Rain
68110,36,1554408000,39,1,40,Rain
68111,37,1554408000,29,1,30,Rain
68112,38,1554408000,13,27,40,Rain
68113,39,1554408000,15,5,20,Rain
68114,40,1554408000,14,7,21,Rain
68115,41,1554408000,18,2,20,Rain
68116,42,1554408000,26,4,30,Rain
68117,43,1554408000,3,27,30,Rain
68118,44,1554408000,22,8,30,Rain
68119,45,1554408000,8,22,30,Rain
68120,46,1554408000,18,2,20,Rain
68121,47,1554408000,39,1,40,Rain
68122,48,1554408000,14,26,40,Rain
68123,49,1554408000,15,25,40,Rain
68124,50,1554408000,38,2,40,Rain
68125,51,1554408000,36,4,40,Rain
68126,52,1554408000,27,5,32,Rain
68127,53,1554408000,38,2,40,Rain
68128,54,1554408000,33,0,33,Rain
68129,55,1554408000,36,0,36,Rain
68130,56,1554408000,40,0,40,Rain
68131,57,1554408000,20,3,23,Rain
68132,58,1554408000,25,14,39,Rain
68133,59,1554408000,19,1,20,Rain
68134,60,1554408000,3,27,30,Rain
68135,61,1554408000,6,19,25,Rain
68136,62,1554408000,34,6,40,Rain
68137,63,1554408000,7,28,35,Rain
68138,64,1554408000,18,22,40,Rain
68139,65,1554408000,22,18,40,Rain
68140,66,1554408000,25,15,40,Rain
68141,67,1554408000,0,39,39,Rain
68142,68,1554408000,6,34,40,Rain
68143,69,1554408000,16,24,40,Rain
68144,70,1554408000,3,25,28,Rain
68145,71,1554408000,39,1,40,Rain
68146,72,1554408000,25,6,31,Rain
68147,73,1554408000,23,7,30,Rain
68148,74,1554408000,7,23,30,Rain
68149,75,1554408000,14,26,40,Rain
68150,76,1554408000,14,24,38,Rain
68151,77,1554408000,28,1,29,Rain
68152,78,1554408000,34,6,40,Rain
68153,80,1554408000,18,22,40,Rain
68154,81,1554408000,40,0,40,Rain
68155,82,1554408000,13,9,22,Rain
68156,83,1554408000,25,15,40,Rain
68157,84,1554408000,23,7,30,Rain
68158,85,1554408000,23,12,35,Rain
68159,86,1554408000,10,28,38,Rain
68160,87,1554408000,24,14,38,Rain
68161,88,1554408000,19,11,30,Rain
68162,89,1554408000,33,7,40,Rain
68163,90,1554408000,39,1,40,Rain
68164,91,1554408000,0,30,30,Rain
68165,92,1554408000,10,30,40,Rain
68166,93,1554408000,6,34,40,Rain
68167,94,1554408000,35,5,40,Rain
68168,95,1554408000,37,3,40,Rain
68169,96,1554408000,26,4,30,Rain
68170,97,1554408000,26,14,40,Rain
68171,98,1554408000,38,2,40,Rain
68172,99,1554408000,13,17,30,Rain
68173,100,1554408000,8,17,25,Rain
68174,101,1554408000,16,14,30,Rain
68175,102,1554408000,24,16,40,Rain
68176,103,1554408000,40,0,40,Rain
68177,104,1554408000,40,0,40,Rain
68178,105,1554408000,36,0,36,Rain
68179,106,1554408000,39,1,40,Rain
68180,107,1554408000,33,7,40,Rain
68181,108,1554408000,33,7,40,Rain
68182,109,1554408000,21,8,29,Rain
68183,110,1554408000,39,1,40,Rain
68184,111,1554408000,26,14,40,Rain
68185,112,1554408000,13,17,30,Rain
68186,113,1554408000,17,23,40,Rain
68187,114,1554408000,39,1,40,Rain
68188,115,1554408000,10,20,30,Rain
68189,2,1554411600,11,9,20,Rain
68190,3,1554411600,20,0,20,Rain
68191,4,1554411600,17,3,20,Rain
68192,5,1554411600,26,14,40,Rain
68193,6,1554411600,20,0,20,Rain
68194,7,1554411600,12,17,29,Rain
68195,8,1554411600,11,19,30,Rain
68196,9,1554411600,24,0,24,Rain
68197,10,1554411600,15,1,16,Rain
68198,11,1554411600,30,0,30,Rain
68199,12,1554411600,7,13,20,Rain
68200,13,1554411600,14,16,30,Rain
68201,14,1554411600,15,15,30,Rain
68202,15,1554411600,13,3,16,Rain
68203,16,1554411600,18,2,20,Rain
68204,17,1554411600,15,5,20,Rain
68205,18,1554411600,24,6,30,Rain
68206,19,1554411600,29,1,30,Rain
68207,21,1554411600,16,14,30,Rain
68208,22,1554411600,11,9,20,Rain
68209,23,1554411600,3,27,30,Rain
68210,24,1554411600,20,0,20,Rain
68211,25,1554411600,14,16,30,Rain
68212,26,1554411600,15,5,20,Rain
68213,27,1554411600,20,0,20,Rain
68214,28,1554411600,12,18,30,Rain
68215,29,1554411600,21,8,29,Rain
68216,30,1554411600,19,1,20,Rain
68217,31,1554411600,20,0,20,Rain
68218,32,1554411600,9,21,30,Rain
68219,33,1554411600,10,13,23,Rain
68220,34,1554411600,12,18,30,Rain
68221,35,1554411600,21,9,30,Rain
68222,36,1554411600,40,0,40,Rain
68223,37,1554411600,28,2,30,Rain
68224,38,1554411600,14,26,40,Rain
68225,39,1554411600,13,7,20,Rain
68226,40,1554411600,17,4,21,Rain
68227,41,1554411600,20,0,20,Rain
68228,42,1554411600,24,6,30,Rain
68229,43,1554411600,3,27,30,Rain
68230,44,1554411600,20,10,30,Rain
68231,45,1554411600,6,24,30,Rain
68232,46,1554411600,18,2,20,Rain
68233,47,1554411600,40,0,40,Rain
68234,48,1554411600,18,22,40,Rain
68235,49,1554411600,11,29,40,Rain
68236,50,1554411600,37,3,40,Rain
68237,51,1554411600,39,1,40,Rain
68238,52,1554411600,26,6,32,Rain
68239,53,1554411600,39,1,40,Rain
68240,54,1554411600,33,0,33,Rain
68241,55,1554411600,36,0,36,Rain
68242,56,1554411600,37,3,40,Rain
68243,57,1554411600,18,5,23,Rain
68244,58,1554411600,28,11,39,Rain
68245,59,1554411600,19,1,20,Rain
68246,60,1554411600,1,29,30,Rain
68247,61,1554411600,8,17,25,Rain
68248,62,1554411600,34,6,40,Rain
68249,63,1554411600,8,27,35,Rain
68250,64,1554411600,18,22,40,Rain
68251,65,1554411600,23,17,40,Rain
68252,66,1554411600,18,22,40,Rain
68253,67,1554411600,0,40,40,Rain
68254,68,1554411600,11,29,40,Rain
68255,69,1554411600,11,29,40,Rain
68256,70,1554411600,8,20,28,Rain
68257,71,1554411600,37,3,40,Rain
68258,72,1554411600,26,5,31,Rain
68259,73,1554411600,22,8,30,Rain
68260,74,1554411600,5,25,30,Rain
68261,75,1554411600,14,26,40,Rain
68262,76,1554411600,13,25,38,Rain
68263,77,1554411600,24,5,29,Rain
68264,78,1554411600,32,8,40,Rain
68265,80,1554411600,18,22,40,Rain
68266,81,1554411600,40,0,40,Rain
68267,82,1554411600,12,10,22,Rain
68268,83,1554411600,25,15,40,Rain
68269,84,1554411600,20,10,30,Rain
68270,85,1554411600,23,12,35,Rain
68271,86,1554411600,13,25,38,Rain
68272,87,1554411600,23,15,38,Rain
68273,88,1554411600,19,11,30,Rain
68274,89,1554411600,33,7,40,Rain
68275,90,1554411600,40,0,40,Rain
68276,91,1554411600,3,27,30,Rain
68277,92,1554411600,10,30,40,Rain
68278,93,1554411600,7,33,40,Rain
68279,94,1554411600,35,5,40,Rain
68280,95,1554411600,38,2,40,Rain
68281,96,1554411600,26,4,30,Rain
68282,97,1554411600,27,13,40,Rain
68283,98,1554411600,40,0,40,Rain
68284,99,1554411600,13,17,30,Rain
68285,100,1554411600,9,16,25,Rain
68286,101,1554411600,13,17,30,Rain
68287,102,1554411600,24,16,40,Rain
68288,103,1554411600,24,16,40,Rain
68289,104,1554411600,40,0,40,Rain
68290,105,1554411600,34,2,36,Rain
68291,106,1554411600,37,3,40,Rain
68292,107,1554411600,36,4,40,Rain
68293,108,1554411600,31,9,40,Rain
68294,109,1554411600,21,8,29,Rain
68295,110,1554411600,35,5,40,Rain
68296,111,1554411600,27,13,40,Rain
68297,112,1554411600,10,20,30,Rain
68298,113,1554411600,17,23,40,Rain
68299,114,1554411600,37,3,40,Rain
68300,115,1554411600,7,23,30,Rain
68301,2,1554415200,9,11,20,Rain
68302,3,1554415200,17,2,19,Rain
68303,4,1554415200,17,3,20,Rain
68304,5,1554415200,24,16,40,Rain
68305,6,1554415200,20,0,20,Rain
68306,7,1554415200,11,18,29,Rain
68307,8,1554415200,18,12,30,Rain
68308,9,1554415200,23,1,24,Rain
68309,10,1554415200,16,0,16,Rain
68310,11,1554415200,30,0,30,Rain
68311,12,1554415200,7,13,20,Rain
68312,13,1554415200,14,16,30,Rain
68313,14,1554415200,16,14,30,Rain
68314,15,1554415200,11,5,16,Rain
68315,16,1554415200,18,1,19,Rain
68316,17,1554415200,15,5,20,Rain
68317,18,1554415200,27,3,30,Rain
68318,19,1554415200,29,1,30,Rain
68319,21,1554415200,19,11,30,Rain
68320,22,1554415200,14,6,20,Rain
68321,23,1554415200,2,28,30,Rain
68322,24,1554415200,16,4,20,Rain
68323,25,1554415200,14,16,30,Rain
68324,26,1554415200,16,4,20,Rain
68325,27,1554415200,20,0,20,Rain
68326,28,1554415200,8,22,30,Rain
68327,29,1554415200,23,6,29,Rain
68328,30,1554415200,17,3,20,Rain
68329,31,1554415200,17,3,20,Rain
68330,32,1554415200,15,15,30,Rain
68331,33,1554415200,19,4,23,Rain
68332,34,1554415200,16,14,30,Rain
68333,35,1554415200,17,13,30,Rain
68334,36,1554415200,40,0,40,Rain
68335,37,1554415200,27,3,30,Rain
68336,38,1554415200,17,23,40,Rain
68337,39,1554415200,13,7,20,Rain
68338,40,1554415200,20,1,21,Rain
68339,41,1554415200,20,0,20,Rain
68340,42,1554415200,21,9,30,Rain
68341,43,1554415200,4,26,30,Rain
68342,44,1554415200,20,10,30,Rain
68343,45,1554415200,4,26,30,Rain
68344,46,1554415200,19,1,20,Rain
68345,47,1554415200,40,0,40,Rain
68346,48,1554415200,21,19,40,Rain
68347,49,1554415200,29,11,40,Rain
68348,50,1554415200,29,11,40,Rain
68349,51,1554415200,40,0,40,Rain
68350,52,1554415200,30,2,32,Rain
68351,53,1554415200,40,0,40,Rain
68352,54,1554415200,33,0,33,Rain
68353,55,1554415200,36,0,36,Rain
68354,56,1554415200,39,1,40,Rain
68355,57,1554415200,18,5,23,Rain
68356,58,1554415200,26,13,39,Rain
68357,59,1554415200,20,0,20,Rain
68358,60,1554415200,0,30,30,Rain
68359,61,1554415200,7,18,25,Rain
68360,62,1554415200,34,6,40,Rain
68361,63,1554415200,11,24,35,Rain
68362,64,1554415200,21,19,40,Rain
68363,65,1554415200,23,17,40,Rain
68364,66,1554415200,16,24,40,Rain
68365,67,1554415200,23,17,40,Rain
68366,68,1554415200,11,29,40,Rain
68367,69,1554415200,11,29,40,Rain
68368,70,1554415200,2,26,28,Rain
68369,71,1554415200,39,1,40,Rain
68370,72,1554415200,26,5,31,Rain
68371,73,1554415200,20,10,30,Rain
68372,74,1554415200,5,25,30,Rain
68373,75,1554415200,14,26,40,Rain
68374,76,1554415200,10,28,38,Rain
68375,77,1554415200,20,9,29,Rain
68376,78,1554415200,30,10,40,Rain
68377,80,1554415200,18,22,40,Rain
68378,81,1554415200,39,1,40,Rain
68379,82,1554415200,11,11,22,Rain
68380,83,1554415200,25,15,40,Rain
68381,84,1554415200,18,12,30,Rain
68382,85,1554415200,21,14,35,Rain
68383,86,1554415200,13,25,38,Rain
68384,87,1554415200,22,16,38,Rain
68385,88,1554415200,19,11,30,Rain
68386,89,1554415200,34,6,40,Rain
68387,90,1554415200,39,1,40,Rain
68388,91,1554415200,0,30,30,Rain
68389,92,1554415200,9,31,40,Rain
68390,93,1554415200,7,33,40,Rain
68391,94,1554415200,36,4,40,Rain
68392,95,1554415200,39,1,40,Rain
68393,96,1554415200,26,4,30,Rain
68394,97,1554415200,27,13,40,Rain
68395,98,1554415200,40,0,40,Rain
68396,99,1554415200,13,17,30,Rain
68397,100,1554415200,10,15,25,Rain
68398,101,1554415200,14,16,30,Rain
68399,102,1554415200,23,17,40,Rain
68400,103,1554415200,24,16,40,Rain
68401,104,1554415200,40,0,40,Rain
68402,105,1554415200,34,2,36,Rain
68403,106,1554415200,35,5,40,Rain
68404,107,1554415200,35,5,40,Rain
68405,108,1554415200,31,9,40,Rain
68406,109,1554415200,19,10,29,Rain
68407,110,1554415200,17,23,40,Rain
68408,111,1554415200,22,18,40,Rain
68409,112,1554415200,3,27,30,Rain
68410,113,1554415200,18,22,40,Rain
68411,114,1554415200,38,2,40,Rain
68412,115,1554415200,8,22,30,Rain
68413,2,1554418800,7,13,20,Clouds
68414,3,1554418800,15,4,19,Clouds
68415,4,1554418800,15,5,20,Clouds
68416,5,1554418800,28,12,40,Clouds
68417,6,1554418800,19,1,20,Clouds
68418,7,1554418800,12,17,29,Clouds
68419,8,1554418800,22,8,30,Clouds
68420,9,1554418800,17,7,24,Clouds
68421,10,1554418800,12,4,16,Clouds
68422,11,1554418800,29,1,30,Clouds
68423,12,1554418800,8,12,20,Clouds
68424,13,1554418800,16,14,30,Clouds
68425,14,1554418800,21,9,30,Clouds
68426,15,1554418800,11,5,16,Clouds
68427,16,1554418800,18,2,20,Clouds
68428,17,1554418800,18,2,20,Clouds
68429,18,1554418800,30,0,30,Clouds
68430,19,1554418800,30,0,30,Clouds
68431,21,1554418800,25,5,30,Clouds
68432,22,1554418800,20,0,20,Clouds
68433,23,1554418800,1,29,30,Clouds
68434,24,1554418800,20,0,20,Clouds
68435,25,1554418800,15,15,30,Clouds
68436,26,1554418800,17,3,20,Clouds
68437,27,1554418800,20,0,20,Clouds
68438,28,1554418800,6,24,30,Clouds
68439,29,1554418800,26,3,29,Clouds
68440,30,1554418800,18,2,20,Clouds
68441,31,1554418800,17,3,20,Clouds
68442,32,1554418800,14,16,30,Clouds
68443,33,1554418800,20,3,23,Clouds
68444,34,1554418800,11,19,30,Clouds
68445,35,1554418800,18,12,30,Clouds
68446,36,1554418800,40,0,40,Clouds
68447,37,1554418800,29,1,30,Clouds
68448,38,1554418800,20,20,40,Clouds
68449,39,1554418800,13,7,20,Clouds
68450,40,1554418800,21,0,21,Clouds
68451,41,1554418800,20,0,20,Clouds
68452,42,1554418800,23,7,30,Clouds
68453,43,1554418800,3,27,30,Clouds
68454,44,1554418800,18,12,30,Clouds
68455,45,1554418800,4,26,30,Clouds
68456,46,1554418800,20,0,20,Clouds
68457,47,1554418800,38,2,40,Clouds
68458,48,1554418800,20,20,40,Clouds
68459,49,1554418800,28,12,40,Clouds
68460,50,1554418800,26,14,40,Clouds
68461,51,1554418800,40,0,40,Clouds
68462,52,1554418800,32,0,32,Clouds
68463,53,1554418800,40,0,40,Clouds
68464,54,1554418800,33,0,33,Clouds
68465,55,1554418800,36,0,36,Clouds
68466,56,1554418800,35,5,40,Clouds
68467,57,1554418800,17,6,23,Clouds
68468,58,1554418800,31,8,39,Clouds
68469,59,1554418800,14,6,20,Clouds
68470,60,1554418800,1,29,30,Clouds
68471,61,1554418800,8,17,25,Clouds
68472,62,1554418800,34,6,40,Clouds
68473,63,1554418800,13,22,35,Clouds
68474,64,1554418800,28,12,40,Clouds
68475,65,1554418800,22,18,40,Clouds
68476,66,1554418800,15,25,40,Clouds
68477,67,1554418800,26,14,40,Clouds
68478,68,1554418800,31,9,40,Clouds
68479,69,1554418800,12,28,40,Clouds
68480,70,1554418800,1,27,28,Clouds
68481,71,1554418800,39,1,40,Clouds
68482,72,1554418800,24,7,31,Clouds
68483,73,1554418800,17,13,30,Clouds
68484,74,1554418800,7,23,30,Clouds
68485,75,1554418800,12,28,40,Clouds
68486,76,1554418800,6,32,38,Clouds
68487,77,1554418800,22,7,29,Clouds
68488,78,1554418800,20,20,40,Clouds
68489,80,1554418800,18,22,40,Clouds
68490,81,1554418800,35,5,40,Clouds
68491,82,1554418800,11,11,22,Clouds
68492,83,1554418800,19,21,40,Clouds
68493,84,1554418800,18,12,30,Clouds
68494,85,1554418800,21,14,35,Clouds
68495,86,1554418800,15,23,38,Clouds
68496,87,1554418800,22,16,38,Clouds
68497,88,1554418800,18,12,30,Clouds
68498,89,1554418800,34,6,40,Clouds
68499,90,1554418800,39,1,40,Clouds
68500,91,1554418800,3,27,30,Clouds
68501,92,1554418800,8,32,40,Clouds
68502,93,1554418800,7,33,40,Clouds
68503,94,1554418800,27,13,40,Clouds
68504,95,1554418800,39,1,40,Clouds
68505,96,1554418800,26,4,30,Clouds
68506,97,1554418800,29,11,40,Clouds
68507,98,1554418800,40,0,40,Clouds
68508,99,1554418800,13,17,30,Clouds
68509,100,1554418800,9,16,25,Clouds
68510,101,1554418800,12,17,29,Clouds
68511,102,1554418800,23,17,40,Clouds
68512,103,1554418800,24,16,40,Clouds
68513,104,1554418800,40,0,40,Clouds
68514,105,1554418800,34,2,36,Clouds
68515,106,1554418800,35,5,40,Clouds
68516,107,1554418800,34,6,40,Clouds
68517,108,1554418800,30,10,40,Clouds
68518,109,1554418800,18,11,29,Clouds
68519,110,1554418800,17,23,40,Clouds
68520,111,1554418800,17,23,40,Clouds
68521,112,1554418800,3,27,30,Clouds
68522,113,1554418800,19,21,40,Clouds
68523,114,1554418800,37,3,40,Clouds
68524,115,1554418800,4,26,30,Clouds
68525,2,1554422400,5,15,20,Rain
68526,3,1554422400,14,5,19,Rain
68527,4,1554422400,16,4,20,Rain
68528,5,1554422400,27,13,40,Rain
68529,6,1554422400,20,0,20,Rain
68530,7,1554422400,16,13,29,Rain
68531,8,1554422400,20,10,30,Rain
68532,9,1554422400,24,0,24,Rain
68533,10,1554422400,16,0,16,Rain
68534,11,1554422400,29,1,30,Rain
68535,12,1554422400,9,11,20,Rain
68536,13,1554422400,17,13,30,Rain
68537,14,1554422400,27,3,30,Rain
68538,15,1554422400,8,8,16,Rain
68539,16,1554422400,20,0,20,Rain
68540,17,1554422400,17,3,20,Rain
68541,18,1554422400,28,2,30,Rain
68542,19,1554422400,30,0,30,Rain
68543,21,1554422400,30,0,30,Rain
68544,22,1554422400,20,0,20,Rain
68545,23,1554422400,2,28,30,Rain
68546,24,1554422400,13,7,20,Rain
68547,25,1554422400,15,15,30,Rain
68548,26,1554422400,18,2,20,Rain
68549,27,1554422400,20,0,20,Rain
68550,28,1554422400,4,26,30,Rain
68551,29,1554422400,29,0,29,Rain
68552,30,1554422400,17,3,20,Rain
68553,31,1554422400,17,3,20,Rain
68554,32,1554422400,14,16,30,Rain
68555,33,1554422400,21,2,23,Rain
68556,34,1554422400,5,25,30,Rain
68557,35,1554422400,21,9,30,Rain
68558,36,1554422400,31,9,40,Rain
68559,37,1554422400,30,0,30,Rain
68560,38,1554422400,22,18,40,Rain
68561,39,1554422400,14,6,20,Rain
68562,40,1554422400,21,0,21,Rain
68563,41,1554422400,18,2,20,Rain
68564,42,1554422400,19,11,30,Rain
68565,43,1554422400,2,28,30,Rain
68566,44,1554422400,18,12,30,Rain
68567,45,1554422400,5,25,30,Rain
68568,46,1554422400,20,0,20,Rain
68569,47,1554422400,38,2,40,Rain
68570,48,1554422400,24,16,40,Rain
68571,49,1554422400,28,12,40,Rain
68572,50,1554422400,25,15,40,Rain
68573,51,1554422400,40,0,40,Rain
68574,52,1554422400,32,0,32,Rain
68575,53,1554422400,40,0,40,Rain
68576,54,1554422400,32,1,33,Rain
68577,55,1554422400,36,0,36,Rain
68578,56,1554422400,33,7,40,Rain
68579,57,1554422400,17,6,23,Rain
68580,58,1554422400,31,8,39,Rain
68581,59,1554422400,14,6,20,Rain
68582,60,1554422400,0,30,30,Rain
68583,61,1554422400,8,17,25,Rain
68584,62,1554422400,37,3,40,Rain
68585,63,1554422400,34,1,35,Rain
68586,64,1554422400,30,10,40,Rain
68587,65,1554422400,23,17,40,Rain
68588,66,1554422400,28,12,40,Rain
68589,67,1554422400,25,15,40,Rain
68590,68,1554422400,33,7,40,Rain
68591,69,1554422400,7,33,40,Rain
68592,70,1554422400,1,27,28,Rain
68593,71,1554422400,40,0,40,Rain
68594,72,1554422400,24,7,31,Rain
68595,73,1554422400,14,16,30,Rain
68596,74,1554422400,9,21,30,Rain
68597,75,1554422400,9,31,40,Rain
68598,76,1554422400,9,29,38,Rain
68599,77,1554422400,23,6,29,Rain
68600,78,1554422400,18,22,40,Rain
68601,80,1554422400,17,23,40,Rain
68602,81,1554422400,35,5,40,Rain
68603,82,1554422400,10,12,22,Rain
68604,83,1554422400,17,23,40,Rain
68605,84,1554422400,15,15,30,Rain
68606,85,1554422400,22,13,35,Rain
68607,86,1554422400,16,22,38,Rain
68608,87,1554422400,23,15,38,Rain
68609,88,1554422400,14,16,30,Rain
68610,89,1554422400,35,5,40,Rain
68611,90,1554422400,37,3,40,Rain
68612,91,1554422400,2,28,30,Rain
68613,92,1554422400,9,31,40,Rain
68614,93,1554422400,7,33,40,Rain
68615,94,1554422400,27,13,40,Rain
68616,95,1554422400,38,2,40,Rain
68617,96,1554422400,26,4,30,Rain
68618,97,1554422400,25,15,40,Rain
68619,98,1554422400,40,0,40,Rain
68620,99,1554422400,13,17,30,Rain
68621,100,1554422400,9,16,25,Rain
68622,101,1554422400,14,15,29,Rain
68623,102,1554422400,21,19,40,Rain
68624,103,1554422400,24,16,40,Rain
68625,104,1554422400,40,0,40,Rain
68626,105,1554422400,34,2,36,Rain
68627,106,1554422400,34,6,40,Rain
68628,107,1554422400,32,8,40,Rain
68629,108,1554422400,30,10,40,Rain
68630,109,1554422400,18,11,29,Rain
68631,110,1554422400,18,22,40,Rain
68632,111,1554422400,9,31,40,Rain
68633,112,1554422400,0,30,30,Rain
68634,113,1554422400,19,21,40,Rain
68635,114,1554422400,40,0,40,Rain
68636,115,1554422400,4,26,30,Rain
68637,2,1554426000,5,15,20,Clouds
68638,3,1554426000,15,4,19,Clouds
68639,4,1554426000,16,4,20,Clouds
68640,5,1554426000,28,12,40,Clouds
68641,6,1554426000,20,0,20,Clouds
68642,7,1554426000,17,12,29,Clouds
68643,8,1554426000,22,8,30,Clouds
68644,9,1554426000,24,0,24,Clouds
68645,10,1554426000,15,1,16,Clouds
68646,11,1554426000,29,1,30,Clouds
68647,12,1554426000,9,11,20,Clouds
68648,13,1554426000,17,13,30,Clouds
68649,14,1554426000,30,0,30,Clouds
68650,15,1554426000,8,8,16,Clouds
68651,16,1554426000,20,0,20,Clouds
68652,17,1554426000,18,2,20,Clouds
68653,18,1554426000,26,4,30,Clouds
68654,19,1554426000,30,0,30,Clouds
68655,21,1554426000,30,0,30,Clouds
68656,22,1554426000,19,1,20,Clouds
68657,23,1554426000,2,28,30,Clouds
68658,24,1554426000,13,7,20,Clouds
68659,25,1554426000,15,15,30,Clouds
68660,26,1554426000,20,0,20,Clouds
68661,27,1554426000,20,0,20,Clouds
68662,28,1554426000,5,25,30,Clouds
68663,29,1554426000,29,0,29,Clouds
68664,30,1554426000,18,2,20,Clouds
68665,31,1554426000,17,3,20,Clouds
68666,32,1554426000,15,15,30,Clouds
68667,33,1554426000,20,3,23,Clouds
68668,34,1554426000,5,25,30,Clouds
68669,35,1554426000,22,8,30,Clouds
68670,36,1554426000,33,7,40,Clouds
68671,37,1554426000,30,0,30,Clouds
68672,38,1554426000,23,17,40,Clouds
68673,39,1554426000,18,2,20,Clouds
68674,40,1554426000,21,0,21,Clouds
68675,41,1554426000,18,2,20,Clouds
68676,42,1554426000,20,10,30,Clouds
68677,43,1554426000,2,28,30,Clouds
68678,44,1554426000,12,18,30,Clouds
68679,45,1554426000,5,25,30,Clouds
68680,46,1554426000,20,0,20,Clouds
68681,47,1554426000,38,2,40,Clouds
68682,48,1554426000,24,16,40,Clouds
68683,49,1554426000,28,12,40,Clouds
68684,50,1554426000,23,17,40,Clouds
68685,51,1554426000,40,0,40,Clouds
68686,52,1554426000,32,0,32,Clouds
68687,53,1554426000,40,0,40,Clouds
68688,54,1554426000,32,1,33,Clouds
68689,55,1554426000,36,0,36,Clouds
68690,56,1554426000,36,4,40,Clouds
68691,57,1554426000,17,6,23,Clouds
68692,58,1554426000,31,8,39,Clouds
68693,59,1554426000,15,5,20,Clouds
68694,60,1554426000,0,30,30,Clouds
68695,61,1554426000,8,17,25,Clouds
68696,62,1554426000,36,4,40,Clouds
68697,63,1554426000,35,0,35,Clouds
68698,64,1554426000,30,10,40,Clouds
68699,65,1554426000,23,17,40,Clouds
68700,66,1554426000,27,13,40,Clouds
68701,67,1554426000,25,15,40,Clouds
68702,68,1554426000,33,7,40,Clouds
68703,69,1554426000,2,38,40,Clouds
68704,70,1554426000,1,27,28,Clouds
68705,71,1554426000,38,2,40,Clouds
68706,72,1554426000,25,6,31,Clouds
68707,73,1554426000,13,17,30,Clouds
68708,74,1554426000,9,21,30,Clouds
68709,75,1554426000,9,31,40,Clouds
68710,76,1554426000,7,31,38,Clouds
68711,77,1554426000,25,4,29,Clouds
68712,78,1554426000,17,23,40,Clouds
68713,80,1554426000,16,24,40,Clouds
68714,81,1554426000,35,5,40,Clouds
68715,82,1554426000,9,13,22,Clouds
68716,83,1554426000,17,23,40,Clouds
68717,84,1554426000,15,15,30,Clouds
68718,85,1554426000,20,15,35,Clouds
68719,86,1554426000,16,22,38,Clouds
68720,87,1554426000,23,15,38,Clouds
68721,88,1554426000,13,17,30,Clouds
68722,89,1554426000,35,5,40,Clouds
68723,90,1554426000,37,3,40,Clouds
68724,91,1554426000,2,28,30,Clouds
68725,92,1554426000,9,31,40,Clouds
68726,93,1554426000,7,33,40,Clouds
68727,94,1554426000,27,13,40,Clouds
68728,95,1554426000,38,2,40,Clouds
68729,96,1554426000,26,4,30,Clouds
68730,97,1554426000,25,15,40,Clouds
68731,98,1554426000,40,0,40,Clouds
68732,99,1554426000,13,17,30,Clouds
68733,100,1554426000,9,16,25,Clouds
68734,101,1554426000,14,15,29,Clouds
68735,102,1554426000,20,20,40,Clouds
68736,103,1554426000,24,16,40,Clouds
68737,104,1554426000,40,0,40,Clouds
68738,105,1554426000,33,3,36,Clouds
68739,106,1554426000,35,5,40,Clouds
68740,107,1554426000,32,8,40,Clouds
68741,108,1554426000,30,10,40,Clouds
68742,109,1554426000,18,11,29,Clouds
68743,110,1554426000,17,23,40,Clouds
68744,111,1554426000,5,35,40,Clouds
68745,112,1554426000,0,30,30,Clouds
68746,113,1554426000,20,20,40,Clouds
68747,114,1554426000,40,0,40,Clouds
68748,115,1554426000,2,28,30,Clouds
68749,2,1554429600,5,15,20,Rain
68750,3,1554429600,15,4,19,Rain
68751,4,1554429600,16,4,20,Rain
68752,5,1554429600,28,12,40,Rain
68753,6,1554429600,20,0,20,Rain
68754,7,1554429600,17,12,29,Rain
68755,8,1554429600,22,8,30,Rain
68756,9,1554429600,24,0,24,Rain
68757,10,1554429600,15,1,16,Rain
68758,11,1554429600,29,1,30,Rain
68759,12,1554429600,8,12,20,Rain
68760,13,1554429600,17,13,30,Rain
68761,14,1554429600,30,0,30,Rain
68762,15,1554429600,8,8,16,Rain
68763,16,1554429600,20,0,20,Rain
68764,17,1554429600,18,2,20,Rain
68765,18,1554429600,26,4,30,Rain
68766,19,1554429600,30,0,30,Rain
68767,21,1554429600,30,0,30,Rain
68768,22,1554429600,19,1,20,Rain
68769,23,1554429600,2,28,30,Rain
68770,24,1554429600,13,7,20,Rain
68771,25,1554429600,15,15,30,Rain
68772,26,1554429600,20,0,20,Rain
68773,27,1554429600,20,0,20,Rain
68774,28,1554429600,5,25,30,Rain
68775,29,1554429600,29,0,29,Rain
68776,30,1554429600,18,2,20,Rain
68777,31,1554429600,17,3,20,Rain
68778,32,1554429600,15,15,30,Rain
68779,33,1554429600,20,3,23,Rain
68780,34,1554429600,5,25,30,Rain
68781,35,1554429600,22,8,30,Rain
68782,36,1554429600,33,7,40,Rain
68783,37,1554429600,30,0,30,Rain
68784,38,1554429600,23,17,40,Rain
68785,39,1554429600,18,2,20,Rain
68786,40,1554429600,21,0,21,Rain
68787,41,1554429600,18,2,20,Rain
68788,42,1554429600,20,10,30,Rain
68789,43,1554429600,2,28,30,Rain
68790,44,1554429600,12,18,30,Rain
68791,45,1554429600,5,25,30,Rain
68792,46,1554429600,20,0,20,Rain
68793,47,1554429600,38,2,40,Rain
68794,48,1554429600,24,16,40,Rain
68795,49,1554429600,28,12,40,Rain
68796,50,1554429600,23,17,40,Rain
68797,51,1554429600,40,0,40,Rain
68798,52,1554429600,32,0,32,Rain
68799,53,1554429600,40,0,40,Rain
68800,54,1554429600,32,1,33,Rain
68801,55,1554429600,36,0,36,Rain
68802,56,1554429600,36,4,40,Rain
68803,57,1554429600,17,6,23,Rain
68804,58,1554429600,31,8,39,Rain
68805,59,1554429600,15,5,20,Rain
68806,60,1554429600,0,30,30,Rain
68807,61,1554429600,8,17,25,Rain
68808,62,1554429600,36,4,40,Rain
68809,63,1554429600,35,0,35,Rain
68810,64,1554429600,30,10,40,Rain
68811,65,1554429600,23,17,40,Rain
68812,66,1554429600,27,13,40,Rain
68813,67,1554429600,25,15,40,Rain
68814,68,1554429600,33,7,40,Rain
68815,69,1554429600,2,38,40,Rain
68816,70,1554429600,1,27,28,Rain
68817,71,1554429600,38,2,40,Rain
68818,72,1554429600,25,6,31,Rain
68819,73,1554429600,13,17,30,Rain
68820,74,1554429600,9,21,30,Rain
68821,75,1554429600,9,31,40,Rain
68822,76,1554429600,7,31,38,Rain
68823,77,1554429600,25,4,29,Rain
68824,78,1554429600,17,23,40,Rain
68825,80,1554429600,16,24,40,Rain
68826,81,1554429600,35,5,40,Rain
68827,82,1554429600,9,13,22,Rain
68828,83,1554429600,17,23,40,Rain
68829,84,1554429600,15,15,30,Rain
68830,85,1554429600,20,15,35,Rain
68831,86,1554429600,16,22,38,Rain
68832,87,1554429600,23,15,38,Rain
68833,88,1554429600,13,17,30,Rain
68834,89,1554429600,35,5,40,Rain
68835,90,1554429600,37,3,40,Rain
68836,91,1554429600,2,28,30,Rain
68837,92,1554429600,9,31,40,Rain
68838,93,1554429600,7,33,40,Rain
68839,94,1554429600,27,13,40,Rain
68840,95,1554429600,38,2,40,Rain
68841,96,1554429600,26,4,30,Rain
68842,97,1554429600,25,15,40,Rain
68843,98,1554429600,40,0,40,Rain
68844,99,1554429600,13,17,30,Rain
68845,100,1554429600,9,16,25,Rain
68846,101,1554429600,14,15,29,Rain
68847,102,1554429600,20,20,40,Rain
68848,103,1554429600,24,16,40,Rain
68849,104,1554429600,40,0,40,Rain
68850,105,1554429600,33,3,36,Rain
68851,106,1554429600,35,5,40,Rain
68852,107,1554429600,31,9,40,Rain
68853,108,1554429600,30,10,40,Rain
68854,109,1554429600,18,11,29,Rain
68855,110,1554429600,17,23,40,Rain
68856,111,1554429600,5,35,40,Rain
68857,112,1554429600,0,30,30,Rain
68858,113,1554429600,20,20,40,Rain
68859,114,1554429600,40,0,40,Rain
68860,115,1554429600,2,28,30,Rain
68861,2,1554433200,5,15,20,Clouds
68862,3,1554433200,15,4,19,Clouds
68863,4,1554433200,16,4,20,Clouds
68864,5,1554433200,28,12,40,Clouds
68865,6,1554433200,20,0,20,Clouds
68866,7,1554433200,17,12,29,Clouds
68867,8,1554433200,22,8,30,Clouds
68868,9,1554433200,24,0,24,Clouds
68869,10,1554433200,15,1,16,Clouds
68870,11,1554433200,29,1,30,Clouds
68871,12,1554433200,8,12,20,Clouds
68872,13,1554433200,17,13,30,Clouds
68873,14,1554433200,30,0,30,Clouds
68874,15,1554433200,8,8,16,Clouds
68875,16,1554433200,20,0,20,Clouds
68876,17,1554433200,18,2,20,Clouds
68877,18,1554433200,26,4,30,Clouds
68878,19,1554433200,30,0,30,Clouds
68879,21,1554433200,30,0,30,Clouds
68880,22,1554433200,19,1,20,Clouds
68881,23,1554433200,2,28,30,Clouds
68882,24,1554433200,13,7,20,Clouds
68883,25,1554433200,15,15,30,Clouds
68884,26,1554433200,20,0,20,Clouds
68885,27,1554433200,20,0,20,Clouds
68886,28,1554433200,5,25,30,Clouds
68887,29,1554433200,29,0,29,Clouds
68888,30,1554433200,18,2,20,Clouds
68889,31,1554433200,17,3,20,Clouds
68890,32,1554433200,15,15,30,Clouds
68891,33,1554433200,20,3,23,Clouds
68892,34,1554433200,5,25,30,Clouds
68893,35,1554433200,22,8,30,Clouds
68894,36,1554433200,33,7,40,Clouds
68895,37,1554433200,30,0,30,Clouds
68896,38,1554433200,23,17,40,Clouds
68897,39,1554433200,18,2,20,Clouds
68898,40,1554433200,21,0,21,Clouds
68899,41,1554433200,18,2,20,Clouds
68900,42,1554433200,20,10,30,Clouds
68901,43,1554433200,2,28,30,Clouds
68902,44,1554433200,12,18,30,Clouds
68903,45,1554433200,5,25,30,Clouds
68904,46,1554433200,20,0,20,Clouds
68905,47,1554433200,38,2,40,Clouds
68906,48,1554433200,24,16,40,Clouds
68907,49,1554433200,28,12,40,Clouds
68908,50,1554433200,23,17,40,Clouds
68909,51,1554433200,40,0,40,Clouds
68910,52,1554433200,32,0,32,Clouds
68911,53,1554433200,40,0,40,Clouds
68912,54,1554433200,32,1,33,Clouds
68913,55,1554433200,36,0,36,Clouds
68914,56,1554433200,36,4,40,Clouds
68915,57,1554433200,17,6,23,Clouds
68916,58,1554433200,31,8,39,Clouds
68917,59,1554433200,15,5,20,Clouds
68918,60,1554433200,0,30,30,Clouds
68919,61,1554433200,8,17,25,Clouds
68920,62,1554433200,36,4,40,Clouds
68921,63,1554433200,35,0,35,Clouds
68922,64,1554433200,30,10,40,Clouds
68923,65,1554433200,23,17,40,Clouds
68924,66,1554433200,27,13,40,Clouds
68925,67,1554433200,25,15,40,Clouds
68926,68,1554433200,33,7,40,Clouds
68927,69,1554433200,2,38,40,Clouds
68928,70,1554433200,1,27,28,Clouds
68929,71,1554433200,38,2,40,Clouds
68930,72,1554433200,25,6,31,Clouds
68931,73,1554433200,13,17,30,Clouds
68932,74,1554433200,9,21,30,Clouds
68933,75,1554433200,9,31,40,Clouds
68934,76,1554433200,7,31,38,Clouds
68935,77,1554433200,25,4,29,Clouds
68936,78,1554433200,17,23,40,Clouds
68937,80,1554433200,16,24,40,Clouds
68938,81,1554433200,35,5,40,Clouds
68939,82,1554433200,9,13,22,Clouds
68940,83,1554433200,17,23,40,Clouds
68941,84,1554433200,15,15,30,Clouds
68942,85,1554433200,20,15,35,Clouds
68943,86,1554433200,16,22,38,Clouds
68944,87,1554433200,23,15,38,Clouds
68945,88,1554433200,13,17,30,Clouds
68946,89,1554433200,35,5,40,Clouds
68947,90,1554433200,37,3,40,Clouds
68948,91,1554433200,2,28,30,Clouds
68949,92,1554433200,9,31,40,Clouds
68950,93,1554433200,7,33,40,Clouds
68951,94,1554433200,27,13,40,Clouds
68952,95,1554433200,38,2,40,Clouds
68953,96,1554433200,26,4,30,Clouds
68954,97,1554433200,25,15,40,Clouds
68955,98,1554433200,40,0,40,Clouds
68956,99,1554433200,13,17,30,Clouds
68957,100,1554433200,9,16,25,Clouds
68958,101,1554433200,14,15,29,Clouds
68959,102,1554433200,20,20,40,Clouds
68960,103,1554433200,24,16,40,Clouds
68961,104,1554433200,40,0,40,Clouds
68962,105,1554433200,33,3,36,Clouds
68963,106,1554433200,35,5,40,Clouds
68964,107,1554433200,31,9,40,Clouds
68965,108,1554433200,30,10,40,Clouds
68966,109,1554433200,18,11,29,Clouds
68967,110,1554433200,17,23,40,Clouds
68968,111,1554433200,5,35,40,Clouds
68969,112,1554433200,0,30,30,Clouds
68970,113,1554433200,20,20,40,Clouds
68971,114,1554433200,40,0,40,Clouds
68972,115,1554433200,2,28,30,Clouds
68973,2,1554436800,5,15,20,Clouds
68974,3,1554436800,15,4,19,Clouds
68975,4,1554436800,16,4,20,Clouds
68976,5,1554436800,28,12,40,Clouds
68977,6,1554436800,20,0,20,Clouds
68978,7,1554436800,17,12,29,Clouds
68979,8,1554436800,21,9,30,Clouds
68980,9,1554436800,24,0,24,Clouds
68981,10,1554436800,15,1,16,Clouds
68982,11,1554436800,29,1,30,Clouds
68983,12,1554436800,8,12,20,Clouds
68984,13,1554436800,17,13,30,Clouds
68985,14,1554436800,30,0,30,Clouds
68986,15,1554436800,8,8,16,Clouds
68987,16,1554436800,20,0,20,Clouds
68988,17,1554436800,18,2,20,Clouds
68989,18,1554436800,26,4,30,Clouds
68990,19,1554436800,30,0,30,Clouds
68991,21,1554436800,30,0,30,Clouds
68992,22,1554436800,19,1,20,Clouds
68993,23,1554436800,2,28,30,Clouds
68994,24,1554436800,13,7,20,Clouds
68995,25,1554436800,15,15,30,Clouds
68996,26,1554436800,20,0,20,Clouds
68997,27,1554436800,20,0,20,Clouds
68998,28,1554436800,5,25,30,Clouds
68999,29,1554436800,29,0,29,Clouds
69000,30,1554436800,18,2,20,Clouds
69001,31,1554436800,17,3,20,Clouds
69002,32,1554436800,15,15,30,Clouds
69003,33,1554436800,20,3,23,Clouds
69004,34,1554436800,5,25,30,Clouds
69005,35,1554436800,22,8,30,Clouds
69006,36,1554436800,33,7,40,Clouds
69007,37,1554436800,30,0,30,Clouds
69008,38,1554436800,23,17,40,Clouds
69009,39,1554436800,18,2,20,Clouds
69010,40,1554436800,21,0,21,Clouds
69011,41,1554436800,18,2,20,Clouds
69012,42,1554436800,20,10,30,Clouds
69013,43,1554436800,2,28,30,Clouds
69014,44,1554436800,12,18,30,Clouds
69015,45,1554436800,5,25,30,Clouds
69016,46,1554436800,20,0,20,Clouds
69017,47,1554436800,38,2,40,Clouds
69018,48,1554436800,24,16,40,Clouds
69019,49,1554436800,28,12,40,Clouds
69020,50,1554436800,23,17,40,Clouds
69021,51,1554436800,40,0,40,Clouds
69022,52,1554436800,32,0,32,Clouds
69023,53,1554436800,40,0,40,Clouds
69024,54,1554436800,32,1,33,Clouds
69025,55,1554436800,36,0,36,Clouds
69026,56,1554436800,36,4,40,Clouds
69027,57,1554436800,17,6,23,Clouds
69028,58,1554436800,31,8,39,Clouds
69029,59,1554436800,15,5,20,Clouds
69030,60,1554436800,0,30,30,Clouds
69031,61,1554436800,8,17,25,Clouds
69032,62,1554436800,36,4,40,Clouds
69033,63,1554436800,35,0,35,Clouds
69034,64,1554436800,30,10,40,Clouds
69035,65,1554436800,23,17,40,Clouds
69036,66,1554436800,27,13,40,Clouds
69037,67,1554436800,25,15,40,Clouds
69038,68,1554436800,33,7,40,Clouds
69039,69,1554436800,2,38,40,Clouds
69040,70,1554436800,1,27,28,Clouds
69041,71,1554436800,38,2,40,Clouds
69042,72,1554436800,25,6,31,Clouds
69043,73,1554436800,13,17,30,Clouds
69044,74,1554436800,9,21,30,Clouds
69045,75,1554436800,9,31,40,Clouds
69046,76,1554436800,7,31,38,Clouds
69047,77,1554436800,25,4,29,Clouds
69048,78,1554436800,17,23,40,Clouds
69049,80,1554436800,16,24,40,Clouds
69050,81,1554436800,35,5,40,Clouds
69051,82,1554436800,9,13,22,Clouds
69052,83,1554436800,17,23,40,Clouds
69053,84,1554436800,15,15,30,Clouds
69054,85,1554436800,20,15,35,Clouds
69055,86,1554436800,16,22,38,Clouds
69056,87,1554436800,23,15,38,Clouds
69057,88,1554436800,13,17,30,Clouds
69058,89,1554436800,35,5,40,Clouds
69059,90,1554436800,37,3,40,Clouds
69060,91,1554436800,2,28,30,Clouds
69061,92,1554436800,9,31,40,Clouds
69062,93,1554436800,7,33,40,Clouds
69063,94,1554436800,27,13,40,Clouds
69064,95,1554436800,38,2,40,Clouds
69065,96,1554436800,26,4,30,Clouds
69066,97,1554436800,25,15,40,Clouds
69067,98,1554436800,40,0,40,Clouds
69068,99,1554436800,13,17,30,Clouds
69069,100,1554436800,9,16,25,Clouds
69070,101,1554436800,14,15,29,Clouds
69071,102,1554436800,20,20,40,Clouds
69072,103,1554436800,24,16,40,Clouds
69073,104,1554436800,40,0,40,Clouds
69074,105,1554436800,33,3,36,Clouds
69075,106,1554436800,35,5,40,Clouds
69076,107,1554436800,31,9,40,Clouds
69077,108,1554436800,30,10,40,Clouds
69078,109,1554436800,18,11,29,Clouds
69079,110,1554436800,17,23,40,Clouds
69080,111,1554436800,5,35,40,Clouds
69081,112,1554436800,0,30,30,Clouds
69082,113,1554436800,20,20,40,Clouds
69083,114,1554436800,40,0,40,Clouds
69084,115,1554436800,2,28,30,Clouds
69085,2,1554440400,5,15,20,Clouds
69086,3,1554440400,15,4,19,Clouds
69087,4,1554440400,16,4,20,Clouds
69088,5,1554440400,28,12,40,Clouds
69089,6,1554440400,20,0,20,Clouds
69090,7,1554440400,17,12,29,Clouds
69091,8,1554440400,21,9,30,Clouds
69092,9,1554440400,24,0,24,Clouds
69093,10,1554440400,15,1,16,Clouds
69094,11,1554440400,29,1,30,Clouds
69095,12,1554440400,8,12,20,Clouds
69096,13,1554440400,17,13,30,Clouds
69097,14,1554440400,30,0,30,Clouds
69098,15,1554440400,8,8,16,Clouds
69099,16,1554440400,20,0,20,Clouds
69100,17,1554440400,18,2,20,Clouds
69101,18,1554440400,26,4,30,Clouds
69102,19,1554440400,30,0,30,Clouds
69103,21,1554440400,30,0,30,Clouds
69104,22,1554440400,19,1,20,Clouds
69105,23,1554440400,2,28,30,Clouds
69106,24,1554440400,13,7,20,Clouds
69107,25,1554440400,15,15,30,Clouds
69108,26,1554440400,20,0,20,Clouds
69109,27,1554440400,20,0,20,Clouds
69110,28,1554440400,5,25,30,Clouds
69111,29,1554440400,29,0,29,Clouds
69112,30,1554440400,18,2,20,Clouds
69113,31,1554440400,17,3,20,Clouds
69114,32,1554440400,15,15,30,Clouds
69115,33,1554440400,20,3,23,Clouds
69116,34,1554440400,5,25,30,Clouds
69117,35,1554440400,22,8,30,Clouds
69118,36,1554440400,33,7,40,Clouds
69119,37,1554440400,30,0,30,Clouds
69120,38,1554440400,23,17,40,Clouds
69121,39,1554440400,18,2,20,Clouds
69122,40,1554440400,21,0,21,Clouds
69123,41,1554440400,18,2,20,Clouds
69124,42,1554440400,20,10,30,Clouds
69125,43,1554440400,2,28,30,Clouds
69126,44,1554440400,12,18,30,Clouds
69127,45,1554440400,5,25,30,Clouds
69128,46,1554440400,20,0,20,Clouds
69129,47,1554440400,38,2,40,Clouds
69130,48,1554440400,24,16,40,Clouds
69131,49,1554440400,28,12,40,Clouds
69132,50,1554440400,23,17,40,Clouds
69133,51,1554440400,40,0,40,Clouds
69134,52,1554440400,32,0,32,Clouds
69135,53,1554440400,40,0,40,Clouds
69136,54,1554440400,32,1,33,Clouds
69137,55,1554440400,36,0,36,Clouds
69138,56,1554440400,36,4,40,Clouds
69139,57,1554440400,17,6,23,Clouds
69140,58,1554440400,31,8,39,Clouds
69141,59,1554440400,15,5,20,Clouds
69142,60,1554440400,1,29,30,Clouds
69143,61,1554440400,8,17,25,Clouds
69144,62,1554440400,36,4,40,Clouds
69145,63,1554440400,35,0,35,Clouds
69146,64,1554440400,30,10,40,Clouds
69147,65,1554440400,23,17,40,Clouds
69148,66,1554440400,27,13,40,Clouds
69149,67,1554440400,25,15,40,Clouds
69150,68,1554440400,33,7,40,Clouds
69151,69,1554440400,2,38,40,Clouds
69152,70,1554440400,1,27,28,Clouds
69153,71,1554440400,38,2,40,Clouds
69154,72,1554440400,25,6,31,Clouds
69155,73,1554440400,13,17,30,Clouds
69156,74,1554440400,9,21,30,Clouds
69157,75,1554440400,9,31,40,Clouds
69158,76,1554440400,7,31,38,Clouds
69159,77,1554440400,25,4,29,Clouds
69160,78,1554440400,17,23,40,Clouds
69161,80,1554440400,18,22,40,Clouds
69162,81,1554440400,35,5,40,Clouds
69163,82,1554440400,9,13,22,Clouds
69164,83,1554440400,17,23,40,Clouds
69165,84,1554440400,15,15,30,Clouds
69166,85,1554440400,20,15,35,Clouds
69167,86,1554440400,16,22,38,Clouds
69168,87,1554440400,23,15,38,Clouds
69169,88,1554440400,13,17,30,Clouds
69170,89,1554440400,35,5,40,Clouds
69171,90,1554440400,37,3,40,Clouds
69172,91,1554440400,2,28,30,Clouds
69173,92,1554440400,9,31,40,Clouds
69174,93,1554440400,7,33,40,Clouds
69175,94,1554440400,27,13,40,Clouds
69176,95,1554440400,38,2,40,Clouds
69177,96,1554440400,26,4,30,Clouds
69178,97,1554440400,25,15,40,Clouds
69179,98,1554440400,40,0,40,Clouds
69180,99,1554440400,13,17,30,Clouds
69181,100,1554440400,9,16,25,Clouds
69182,101,1554440400,14,15,29,Clouds
69183,102,1554440400,20,20,40,Clouds
69184,103,1554440400,24,16,40,Clouds
69185,104,1554440400,40,0,40,Clouds
69186,105,1554440400,33,3,36,Clouds
69187,106,1554440400,35,5,40,Clouds
69188,107,1554440400,31,9,40,Clouds
69189,108,1554440400,30,10,40,Clouds
69190,109,1554440400,18,11,29,Clouds
69191,110,1554440400,17,23,40,Clouds
69192,111,1554440400,5,35,40,Clouds
69193,112,1554440400,0,30,30,Clouds
69194,113,1554440400,20,20,40,Clouds
69195,114,1554440400,40,0,40,Clouds
69196,115,1554440400,2,28,30,Clouds
69197,2,1554444000,6,14,20,Clouds
69198,3,1554444000,17,3,20,Clouds
69199,4,1554444000,17,3,20,Clouds
69200,5,1554444000,10,30,40,Clouds
69201,6,1554444000,19,1,20,Clouds
69202,7,1554444000,18,11,29,Clouds
69203,8,1554444000,20,10,30,Clouds
69204,9,1554444000,23,1,24,Clouds
69205,10,1554444000,14,2,16,Clouds
69206,11,1554444000,29,1,30,Clouds
69207,12,1554444000,10,10,20,Clouds
69208,13,1554444000,18,12,30,Clouds
69209,14,1554444000,23,7,30,Clouds
69210,15,1554444000,11,5,16,Clouds
69211,16,1554444000,20,0,20,Clouds
69212,17,1554444000,20,0,20,Clouds
69213,18,1554444000,10,20,30,Clouds
69214,19,1554444000,28,2,30,Clouds
69215,21,1554444000,29,1,30,Clouds
69216,22,1554444000,17,3,20,Clouds
69217,23,1554444000,2,27,29,Clouds
69218,24,1554444000,9,11,20,Clouds
69219,25,1554444000,26,4,30,Clouds
69220,26,1554444000,20,0,20,Clouds
69221,27,1554444000,20,0,20,Clouds
69222,28,1554444000,8,22,30,Clouds
69223,29,1554444000,29,0,29,Clouds
69224,30,1554444000,17,3,20,Clouds
69225,31,1554444000,19,1,20,Clouds
69226,32,1554444000,11,19,30,Clouds
69227,33,1554444000,17,6,23,Clouds
69228,34,1554444000,6,24,30,Clouds
69229,35,1554444000,25,5,30,Clouds
69230,36,1554444000,31,9,40,Clouds
69231,37,1554444000,30,0,30,Clouds
69232,38,1554444000,21,19,40,Clouds
69233,39,1554444000,18,2,20,Clouds
69234,40,1554444000,19,2,21,Clouds
69235,41,1554444000,18,2,20,Clouds
69236,42,1554444000,21,9,30,Clouds
69237,43,1554444000,8,22,30,Clouds
69238,44,1554444000,18,12,30,Clouds
69239,45,1554444000,5,25,30,Clouds
69240,46,1554444000,18,2,20,Clouds
69241,47,1554444000,38,2,40,Clouds
69242,48,1554444000,20,20,40,Clouds
69243,49,1554444000,29,11,40,Clouds
69244,50,1554444000,24,16,40,Clouds
69245,51,1554444000,39,1,40,Clouds
69246,52,1554444000,28,4,32,Clouds
69247,53,1554444000,40,0,40,Clouds
69248,54,1554444000,32,1,33,Clouds
69249,55,1554444000,36,0,36,Clouds
69250,56,1554444000,40,0,40,Clouds
69251,57,1554444000,17,6,23,Clouds
69252,58,1554444000,30,9,39,Clouds
69253,59,1554444000,15,5,20,Clouds
69254,60,1554444000,6,24,30,Clouds
69255,61,1554444000,9,16,25,Clouds
69256,62,1554444000,35,5,40,Clouds
69257,63,1554444000,35,0,35,Clouds
69258,64,1554444000,28,12,40,Clouds
69259,65,1554444000,23,17,40,Clouds
69260,66,1554444000,26,14,40,Clouds
69261,67,1554444000,26,14,40,Clouds
69262,68,1554444000,30,10,40,Clouds
69263,69,1554444000,19,21,40,Clouds
69264,70,1554444000,15,13,28,Clouds
69265,71,1554444000,36,4,40,Clouds
69266,72,1554444000,25,6,31,Clouds
69267,73,1554444000,15,15,30,Clouds
69268,74,1554444000,9,21,30,Clouds
69269,75,1554444000,9,31,40,Clouds
69270,76,1554444000,9,29,38,Clouds
69271,77,1554444000,24,5,29,Clouds
69272,78,1554444000,18,22,40,Clouds
69273,80,1554444000,18,22,40,Clouds
69274,81,1554444000,35,5,40,Clouds
69275,82,1554444000,10,12,22,Clouds
69276,83,1554444000,17,23,40,Clouds
69277,84,1554444000,15,15,30,Clouds
69278,85,1554444000,21,14,35,Clouds
69279,86,1554444000,17,21,38,Clouds
69280,87,1554444000,23,15,38,Clouds
69281,88,1554444000,13,17,30,Clouds
69282,89,1554444000,35,5,40,Clouds
69283,90,1554444000,36,4,40,Clouds
69284,91,1554444000,1,29,30,Clouds
69285,92,1554444000,11,29,40,Clouds
69286,93,1554444000,7,33,40,Clouds
69287,94,1554444000,19,21,40,Clouds
69288,95,1554444000,38,2,40,Clouds
69289,96,1554444000,26,4,30,Clouds
69290,97,1554444000,29,11,40,Clouds
69291,98,1554444000,40,0,40,Clouds
69292,99,1554444000,11,19,30,Clouds
69293,100,1554444000,7,18,25,Clouds
69294,101,1554444000,18,11,29,Clouds
69295,102,1554444000,22,18,40,Clouds
69296,103,1554444000,24,16,40,Clouds
69297,104,1554444000,40,0,40,Clouds
69298,105,1554444000,34,2,36,Clouds
69299,106,1554444000,13,27,40,Clouds
69300,107,1554444000,17,23,40,Clouds
69301,108,1554444000,33,7,40,Clouds
69302,109,1554444000,24,5,29,Clouds
69303,110,1554444000,17,23,40,Clouds
69304,111,1554444000,6,34,40,Clouds
69305,112,1554444000,3,27,30,Clouds
69306,113,1554444000,36,4,40,Clouds
69307,114,1554444000,40,0,40,Clouds
69308,115,1554444000,5,25,30,Clouds
69309,2,1554447600,16,4,20,Clouds
69310,3,1554447600,18,2,20,Clouds
69311,4,1554447600,18,2,20,Clouds
69312,5,1554447600,22,18,40,Clouds
69313,6,1554447600,20,0,20,Clouds
69314,7,1554447600,22,7,29,Clouds
69315,8,1554447600,17,13,30,Clouds
69316,9,1554447600,13,11,24,Clouds
69317,10,1554447600,13,3,16,Clouds
69318,11,1554447600,23,7,30,Clouds
69319,12,1554447600,20,0,20,Clouds
69320,13,1554447600,25,5,30,Clouds
69321,14,1554447600,20,10,30,Clouds
69322,15,1554447600,13,3,16,Clouds
69323,16,1554447600,18,2,20,Clouds
69324,17,1554447600,20,0,20,Clouds
69325,18,1554447600,7,23,30,Clouds
69326,19,1554447600,28,2,30,Clouds
69327,21,1554447600,23,7,30,Clouds
69328,22,1554447600,16,4,20,Clouds
69329,23,1554447600,0,29,29,Clouds
69330,24,1554447600,10,10,20,Clouds
69331,25,1554447600,24,6,30,Clouds
69332,26,1554447600,15,5,20,Clouds
69333,27,1554447600,19,1,20,Clouds
69334,28,1554447600,14,16,30,Clouds
69335,29,1554447600,28,1,29,Clouds
69336,30,1554447600,15,5,20,Clouds
69337,31,1554447600,18,2,20,Clouds
69338,32,1554447600,9,21,30,Clouds
69339,33,1554447600,6,17,23,Clouds
69340,34,1554447600,18,12,30,Clouds
69341,35,1554447600,28,2,30,Clouds
69342,36,1554447600,28,12,40,Clouds
69343,37,1554447600,30,0,30,Clouds
69344,38,1554447600,20,20,40,Clouds
69345,39,1554447600,18,2,20,Clouds
69346,40,1554447600,15,6,21,Clouds
69347,41,1554447600,19,1,20,Clouds
69348,42,1554447600,30,0,30,Clouds
69349,43,1554447600,12,18,30,Clouds
69350,44,1554447600,30,0,30,Clouds
69351,45,1554447600,10,20,30,Clouds
69352,46,1554447600,13,7,20,Clouds
69353,47,1554447600,37,3,40,Clouds
69354,48,1554447600,25,15,40,Clouds
69355,49,1554447600,30,10,40,Clouds
69356,50,1554447600,28,12,40,Clouds
69357,51,1554447600,36,4,40,Clouds
69358,52,1554447600,16,16,32,Clouds
69359,53,1554447600,36,4,40,Clouds
69360,54,1554447600,30,3,33,Clouds
69361,55,1554447600,33,3,36,Clouds
69362,56,1554447600,40,0,40,Clouds
69363,57,1554447600,20,3,23,Clouds
69364,58,1554447600,19,20,39,Clouds
69365,59,1554447600,14,6,20,Clouds
69366,60,1554447600,15,15,30,Clouds
69367,61,1554447600,11,14,25,Clouds
69368,62,1554447600,30,10,40,Clouds
69369,63,1554447600,33,2,35,Clouds
69370,64,1554447600,27,13,40,Clouds
69371,65,1554447600,18,22,40,Clouds
69372,66,1554447600,31,9,40,Clouds
69373,67,1554447600,22,18,40,Clouds
69374,68,1554447600,19,21,40,Clouds
69375,69,1554447600,25,15,40,Clouds
69376,70,1554447600,6,22,28,Clouds
69377,71,1554447600,35,5,40,Clouds
69378,72,1554447600,28,3,31,Clouds
69379,73,1554447600,17,13,30,Clouds
69380,74,1554447600,12,18,30,Clouds
69381,75,1554447600,11,29,40,Clouds
69382,76,1554447600,14,24,38,Clouds
69383,77,1554447600,29,0,29,Clouds
69384,78,1554447600,21,19,40,Clouds
69385,80,1554447600,21,19,40,Clouds
69386,81,1554447600,34,6,40,Clouds
69387,82,1554447600,10,12,22,Clouds
69388,83,1554447600,20,20,40,Clouds
69389,84,1554447600,16,14,30,Clouds
69390,85,1554447600,26,9,35,Clouds
69391,86,1554447600,21,17,38,Clouds
69392,87,1554447600,24,14,38,Clouds
69393,88,1554447600,20,10,30,Clouds
69394,89,1554447600,38,2,40,Clouds
69395,90,1554447600,26,14,40,Clouds
69396,91,1554447600,16,14,30,Clouds
69397,92,1554447600,10,30,40,Clouds
69398,93,1554447600,11,29,40,Clouds
69399,94,1554447600,1,39,40,Clouds
69400,95,1554447600,40,0,40,Clouds
69401,96,1554447600,28,2,30,Clouds
69402,97,1554447600,34,6,40,Clouds
69403,98,1554447600,40,0,40,Clouds
69404,99,1554447600,8,22,30,Clouds
69405,100,1554447600,6,19,25,Clouds
69406,101,1554447600,27,3,30,Clouds
69407,102,1554447600,27,13,40,Clouds
69408,103,1554447600,23,17,40,Clouds
69409,104,1554447600,40,0,40,Clouds
69410,105,1554447600,33,3,36,Clouds
69411,106,1554447600,15,25,40,Clouds
69412,107,1554447600,22,18,40,Clouds
69413,108,1554447600,40,0,40,Clouds
69414,109,1554447600,6,23,29,Clouds
69415,110,1554447600,21,19,40,Clouds
69416,111,1554447600,13,27,40,Clouds
69417,112,1554447600,13,17,30,Clouds
69418,113,1554447600,34,6,40,Clouds
69419,114,1554447600,34,6,40,Clouds
69420,115,1554447600,8,22,30,Clouds
69421,2,1554451200,19,1,20,Clouds
69422,3,1554451200,17,2,19,Clouds
69423,4,1554451200,17,3,20,Clouds
69424,5,1554451200,40,0,40,Clouds
69425,6,1554451200,20,0,20,Clouds
69426,7,1554451200,29,0,29,Clouds
69427,8,1554451200,11,19,30,Clouds
69428,9,1554451200,0,24,24,Clouds
69429,10,1554451200,12,4,16,Clouds
69430,11,1554451200,14,16,30,Clouds
69431,12,1554451200,20,0,20,Clouds
69432,13,1554451200,19,9,28,Clouds
69433,14,1554451200,11,19,30,Clouds
69434,15,1554451200,16,0,16,Clouds
69435,16,1554451200,13,7,20,Clouds
69436,17,1554451200,16,4,20,Clouds
69437,18,1554451200,14,16,30,Clouds
69438,19,1554451200,20,10,30,Clouds
69439,21,1554451200,23,7,30,Clouds
69440,22,1554451200,18,2,20,Clouds
69441,23,1554451200,3,26,29,Clouds
69442,24,1554451200,16,4,20,Clouds
69443,25,1554451200,19,11,30,Clouds
69444,26,1554451200,14,6,20,Clouds
69445,27,1554451200,3,17,20,Clouds
69446,28,1554451200,23,7,30,Clouds
69447,29,1554451200,29,0,29,Clouds
69448,30,1554451200,16,4,20,Clouds
69449,31,1554451200,18,2,20,Clouds
69450,32,1554451200,4,25,29,Clouds
69451,33,1554451200,9,14,23,Clouds
69452,34,1554451200,24,6,30,Clouds
69453,35,1554451200,30,0,30,Clouds
69454,36,1554451200,22,18,40,Clouds
69455,37,1554451200,29,1,30,Clouds
69456,38,1554451200,23,17,40,Clouds
69457,39,1554451200,19,1,20,Clouds
69458,40,1554451200,12,9,21,Clouds
69459,41,1554451200,19,1,20,Clouds
69460,42,1554451200,30,0,30,Clouds
69461,43,1554451200,30,0,30,Clouds
69462,44,1554451200,19,11,30,Clouds
69463,45,1554451200,11,19,30,Clouds
69464,46,1554451200,17,3,20,Clouds
69465,47,1554451200,27,13,40,Clouds
69466,48,1554451200,24,16,40,Clouds
69467,49,1554451200,26,14,40,Clouds
69468,50,1554451200,40,0,40,Clouds
69469,51,1554451200,34,6,40,Clouds
69470,52,1554451200,25,7,32,Clouds
69471,53,1554451200,33,7,40,Clouds
69472,54,1554451200,29,4,33,Clouds
69473,55,1554451200,24,12,36,Clouds
69474,56,1554451200,30,10,40,Clouds
69475,57,1554451200,16,7,23,Clouds
69476,58,1554451200,21,18,39,Clouds
69477,59,1554451200,14,6,20,Clouds
69478,60,1554451200,14,16,30,Clouds
69479,61,1554451200,15,10,25,Clouds
69480,62,1554451200,24,16,40,Clouds
69481,63,1554451200,30,5,35,Clouds
69482,64,1554451200,27,13,40,Clouds
69483,65,1554451200,17,21,38,Clouds
69484,66,1554451200,20,20,40,Clouds
69485,67,1554451200,14,26,40,Clouds
69486,68,1554451200,18,22,40,Clouds
69487,69,1554451200,19,21,40,Clouds
69488,70,1554451200,3,25,28,Clouds
69489,71,1554451200,37,3,40,Clouds
69490,72,1554451200,31,0,31,Clouds
69491,73,1554451200,29,1,30,Clouds
69492,74,1554451200,26,4,30,Clouds
69493,75,1554451200,21,19,40,Clouds
69494,76,1554451200,21,17,38,Clouds
69495,77,1554451200,28,1,29,Clouds
69496,78,1554451200,21,19,40,Clouds
69497,80,1554451200,33,7,40,Clouds
69498,81,1554451200,32,8,40,Clouds
69499,82,1554451200,14,8,22,Clouds
69500,83,1554451200,40,0,40,Clouds
69501,84,1554451200,25,5,30,Clouds
69502,85,1554451200,35,0,35,Clouds
69503,86,1554451200,37,1,38,Clouds
69504,87,1554451200,32,6,38,Clouds
69505,88,1554451200,26,4,30,Clouds
69506,89,1554451200,36,4,40,Clouds
69507,90,1554451200,0,39,39,Clouds
69508,91,1554451200,13,17,30,Clouds
69509,92,1554451200,36,4,40,Clouds
69510,93,1554451200,28,12,40,Clouds
69511,94,1554451200,9,31,40,Clouds
69512,95,1554451200,40,0,40,Clouds
69513,96,1554451200,30,0,30,Clouds
69514,97,1554451200,40,0,40,Clouds
69515,98,1554451200,37,3,40,Clouds
69516,99,1554451200,11,19,30,Clouds
69517,100,1554451200,19,6,25,Clouds
69518,101,1554451200,29,1,30,Clouds
69519,102,1554451200,34,6,40,Clouds
69520,103,1554451200,23,17,40,Clouds
69521,104,1554451200,40,0,40,Clouds
69522,105,1554451200,33,3,36,Clouds
69523,106,1554451200,19,21,40,Clouds
69524,107,1554451200,36,4,40,Clouds
69525,108,1554451200,40,0,40,Clouds
69526,109,1554451200,12,17,29,Clouds
69527,110,1554451200,27,13,40,Clouds
69528,111,1554451200,22,18,40,Clouds
69529,112,1554451200,30,0,30,Clouds
69530,113,1554451200,30,10,40,Clouds
69531,114,1554451200,17,23,40,Clouds
69532,115,1554451200,18,12,30,Clouds
69533,2,1554454800,20,0,20,Rain
69534,3,1554454800,17,3,20,Rain
69535,4,1554454800,20,0,20,Rain
69536,5,1554454800,39,1,40,Rain
69537,6,1554454800,14,6,20,Rain
69538,7,1554454800,29,0,29,Rain
69539,8,1554454800,10,20,30,Rain
69540,9,1554454800,22,2,24,Rain
69541,10,1554454800,14,2,16,Rain
69542,11,1554454800,7,23,30,Rain
69543,12,1554454800,19,1,20,Rain
69544,13,1554454800,6,22,28,Rain
69545,14,1554454800,19,11,30,Rain
69546,15,1554454800,16,0,16,Rain
69547,16,1554454800,6,14,20,Rain
69548,17,1554454800,19,1,20,Rain
69549,18,1554454800,30,0,30,Rain
69550,19,1554454800,10,20,30,Rain
69551,21,1554454800,17,13,30,Rain
69552,22,1554454800,13,7,20,Rain
69553,23,1554454800,6,23,29,Rain
69554,24,1554454800,15,5,20,Rain
69555,25,1554454800,11,19,30,Rain
69556,26,1554454800,3,17,20,Rain
69557,27,1554454800,7,13,20,Rain
69558,28,1554454800,21,9,30,Rain
69559,29,1554454800,29,0,29,Rain
69560,30,1554454800,18,2,20,Rain
69561,31,1554454800,17,3,20,Rain
69562,32,1554454800,12,17,29,Rain
69563,33,1554454800,6,17,23,Rain
69564,34,1554454800,30,0,30,Rain
69565,35,1554454800,30,0,30,Rain
69566,36,1554454800,0,40,40,Rain
69567,37,1554454800,30,0,30,Rain
69568,38,1554454800,26,14,40,Rain
69569,39,1554454800,19,1,20,Rain
69570,40,1554454800,21,0,21,Rain
69571,41,1554454800,13,7,20,Rain
69572,42,1554454800,29,1,30,Rain
69573,43,1554454800,30,0,30,Rain
69574,44,1554454800,30,0,30,Rain
69575,45,1554454800,19,11,30,Rain
69576,46,1554454800,18,2,20,Rain
69577,47,1554454800,9,31,40,Rain
69578,48,1554454800,6,34,40,Rain
69579,49,1554454800,13,27,40,Rain
69580,50,1554454800,40,0,40,Rain
69581,51,1554454800,39,1,40,Rain
69582,52,1554454800,16,16,32,Rain
69583,53,1554454800,20,20,40,Rain
69584,54,1554454800,22,11,33,Rain
69585,55,1554454800,10,26,36,Rain
69586,56,1554454800,12,28,40,Rain
69587,57,1554454800,2,21,23,Rain
69588,58,1554454800,3,36,39,Rain
69589,59,1554454800,20,0,20,Rain
69590,60,1554454800,29,1,30,Rain
69591,61,1554454800,25,0,25,Rain
69592,62,1554454800,0,40,40,Rain
69593,63,1554454800,18,17,35,Rain
69594,64,1554454800,15,25,40,Rain
69595,65,1554454800,24,14,38,Rain
69596,66,1554454800,5,35,40,Rain
69597,67,1554454800,21,19,40,Rain
69598,68,1554454800,0,40,40,Rain
69599,69,1554454800,0,40,40,Rain
69600,70,1554454800,6,22,28,Rain
69601,71,1554454800,38,2,40,Rain
69602,72,1554454800,31,0,31,Rain
69603,73,1554454800,29,1,30,Rain
69604,74,1554454800,30,0,30,Rain
69605,75,1554454800,39,1,40,Rain
69606,76,1554454800,36,2,38,Rain
69607,77,1554454800,29,0,29,Rain
69608,78,1554454800,40,0,40,Rain
69609,80,1554454800,40,0,40,Rain
69610,81,1554454800,40,0,40,Rain
69611,82,1554454800,22,0,22,Rain
69612,83,1554454800,40,0,40,Rain
69613,84,1554454800,30,0,30,Rain
69614,85,1554454800,35,0,35,Rain
69615,86,1554454800,38,0,38,Rain
69616,87,1554454800,37,1,38,Rain
69617,88,1554454800,30,0,30,Rain
69618,89,1554454800,33,7,40,Rain
69619,90,1554454800,0,39,39,Rain
69620,91,1554454800,18,12,30,Rain
69621,92,1554454800,40,0,40,Rain
69622,93,1554454800,40,0,40,Rain
69623,94,1554454800,38,2,40,Rain
69624,95,1554454800,39,1,40,Rain
69625,96,1554454800,30,0,30,Rain
69626,97,1554454800,40,0,40,Rain
69627,98,1554454800,36,4,40,Rain
69628,99,1554454800,0,30,30,Rain
69629,100,1554454800,16,9,25,Rain
69630,101,1554454800,30,0,30,Rain
69631,102,1554454800,40,0,40,Rain
69632,103,1554454800,29,11,40,Rain
69633,104,1554454800,40,0,40,Rain
69634,105,1554454800,36,0,36,Rain
69635,106,1554454800,40,0,40,Rain
69636,107,1554454800,40,0,40,Rain
69637,108,1554454800,40,0,40,Rain
69638,109,1554454800,23,6,29,Rain
69639,110,1554454800,35,5,40,Rain
69640,111,1554454800,38,2,40,Rain
69641,112,1554454800,30,0,30,Rain
69642,113,1554454800,30,10,40,Rain
69643,114,1554454800,28,12,40,Rain
69644,115,1554454800,30,0,30,Rain
69645,2,1554458400,20,0,20,Rain
69646,3,1554458400,20,0,20,Rain
69647,4,1554458400,17,3,20,Rain
69648,5,1554458400,40,0,40,Rain
69649,6,1554458400,20,0,20,Rain
69650,7,1554458400,29,0,29,Rain
69651,8,1554458400,1,29,30,Rain
69652,9,1554458400,18,6,24,Rain
69653,10,1554458400,14,2,16,Rain
69654,11,1554458400,0,30,30,Rain
69655,12,1554458400,20,0,20,Rain
69656,13,1554458400,4,26,30,Rain
69657,14,1554458400,14,15,29,Rain
69658,15,1554458400,16,0,16,Rain
69659,16,1554458400,0,20,20,Rain
69660,17,1554458400,18,2,20,Rain
69661,18,1554458400,28,2,30,Rain
69662,19,1554458400,16,14,30,Rain
69663,21,1554458400,12,18,30,Rain
69664,22,1554458400,15,5,20,Rain
69665,23,1554458400,0,29,29,Rain
69666,24,1554458400,18,2,20,Rain
69667,25,1554458400,6,24,30,Rain
69668,26,1554458400,0,20,20,Rain
69669,27,1554458400,3,17,20,Rain
69670,28,1554458400,29,1,30,Rain
69671,29,1554458400,29,0,29,Rain
69672,30,1554458400,19,1,20,Rain
69673,31,1554458400,19,1,20,Rain
69674,32,1554458400,1,29,30,Rain
69675,33,1554458400,4,19,23,Rain
69676,34,1554458400,23,7,30,Rain
69677,35,1554458400,30,0,30,Rain
69678,36,1554458400,11,29,40,Rain
69679,37,1554458400,26,4,30,Rain
69680,38,1554458400,15,25,40,Rain
69681,39,1554458400,19,1,20,Rain
69682,40,1554458400,18,3,21,Rain
69683,41,1554458400,14,6,20,Rain
69684,42,1554458400,30,0,30,Rain
69685,43,1554458400,30,0,30,Rain
69686,44,1554458400,30,0,30,Rain
69687,45,1554458400,23,7,30,Rain
69688,46,1554458400,15,4,19,Rain
69689,47,1554458400,6,34,40,Rain
69690,48,1554458400,0,40,40,Rain
69691,49,1554458400,0,40,40,Rain
69692,50,1554458400,39,1,40,Rain
69693,51,1554458400,38,2,40,Rain
69694,52,1554458400,18,14,32,Rain
69695,53,1554458400,2,38,40,Rain
69696,54,1554458400,17,16,33,Rain
69697,55,1554458400,11,25,36,Rain
69698,56,1554458400,15,25,40,Rain
69699,57,1554458400,0,23,23,Rain
69700,58,1554458400,4,36,40,Rain
69701,59,1554458400,20,0,20,Rain
69702,60,1554458400,27,3,30,Rain
69703,61,1554458400,25,0,25,Rain
69704,62,1554458400,0,40,40,Rain
69705,63,1554458400,12,23,35,Rain
69706,64,1554458400,0,40,40,Rain
69707,65,1554458400,0,38,38,Rain
69708,66,1554458400,1,39,40,Rain
69709,67,1554458400,14,26,40,Rain
69710,68,1554458400,10,30,40,Rain
69711,69,1554458400,0,40,40,Rain
69712,70,1554458400,1,27,28,Rain
69713,71,1554458400,39,1,40,Rain
69714,72,1554458400,31,0,31,Rain
69715,73,1554458400,30,0,30,Rain
69716,74,1554458400,29,1,30,Rain
69717,75,1554458400,39,1,40,Rain
69718,76,1554458400,38,0,38,Rain
69719,77,1554458400,27,2,29,Rain
69720,78,1554458400,40,0,40,Rain
69721,80,1554458400,39,1,40,Rain
69722,81,1554458400,39,1,40,Rain
69723,82,1554458400,22,0,22,Rain
69724,83,1554458400,40,0,40,Rain
69725,84,1554458400,30,0,30,Rain
69726,85,1554458400,35,0,35,Rain
69727,86,1554458400,36,2,38,Rain
69728,87,1554458400,38,0,38,Rain
69729,88,1554458400,30,0,30,Rain
69730,89,1554458400,26,14,40,Rain
69731,90,1554458400,1,38,39,Rain
69732,91,1554458400,18,12,30,Rain
69733,92,1554458400,40,0,40,Rain
69734,93,1554458400,40,0,40,Rain
69735,94,1554458400,38,2,40,Rain
69736,95,1554458400,40,0,40,Rain
69737,96,1554458400,30,0,30,Rain
69738,97,1554458400,40,0,40,Rain
69739,98,1554458400,33,7,40,Rain
69740,99,1554458400,0,30,30,Rain
69741,100,1554458400,7,18,25,Rain
69742,101,1554458400,30,0,30,Rain
69743,102,1554458400,40,0,40,Rain
69744,103,1554458400,32,8,40,Rain
69745,104,1554458400,40,0,40,Rain
69746,105,1554458400,36,0,36,Rain
69747,106,1554458400,40,0,40,Rain
69748,107,1554458400,40,0,40,Rain
69749,108,1554458400,40,0,40,Rain
69750,109,1554458400,28,1,29,Rain
69751,110,1554458400,40,0,40,Rain
69752,111,1554458400,40,0,40,Rain
69753,112,1554458400,9,21,30,Rain
69754,113,1554458400,19,21,40,Rain
69755,114,1554458400,30,10,40,Rain
69756,115,1554458400,30,0,30,Rain
69757,2,1554462000,20,0,20,Clouds
69758,3,1554462000,19,1,20,Clouds
69759,4,1554462000,20,0,20,Clouds
69760,5,1554462000,38,2,40,Clouds
69761,6,1554462000,18,2,20,Clouds
69762,7,1554462000,28,1,29,Clouds
69763,8,1554462000,0,30,30,Clouds
69764,9,1554462000,12,12,24,Clouds
69765,10,1554462000,10,6,16,Clouds
69766,11,1554462000,0,30,30,Clouds
69767,12,1554462000,20,0,20,Clouds
69768,13,1554462000,2,28,30,Clouds
69769,14,1554462000,10,19,29,Clouds
69770,15,1554462000,15,1,16,Clouds
69771,16,1554462000,1,19,20,Clouds
69772,17,1554462000,18,2,20,Clouds
69773,18,1554462000,28,2,30,Clouds
69774,19,1554462000,17,13,30,Clouds
69775,21,1554462000,6,24,30,Clouds
69776,22,1554462000,11,9,20,Clouds
69777,23,1554462000,1,28,29,Clouds
69778,24,1554462000,20,0,20,Clouds
69779,25,1554462000,6,24,30,Clouds
69780,26,1554462000,0,20,20,Clouds
69781,27,1554462000,0,20,20,Clouds
69782,28,1554462000,24,6,30,Clouds
69783,29,1554462000,26,3,29,Clouds
69784,30,1554462000,20,0,20,Clouds
69785,31,1554462000,20,0,20,Clouds
69786,32,1554462000,2,28,30,Clouds
69787,33,1554462000,4,19,23,Clouds
69788,34,1554462000,28,2,30,Clouds
69789,35,1554462000,28,2,30,Clouds
69790,36,1554462000,13,27,40,Clouds
69791,37,1554462000,26,4,30,Clouds
69792,38,1554462000,21,19,40,Clouds
69793,39,1554462000,20,0,20,Clouds
69794,40,1554462000,20,1,21,Clouds
69795,41,1554462000,18,2,20,Clouds
69796,42,1554462000,29,1,30,Clouds
69797,43,1554462000,30,0,30,Clouds
69798,44,1554462000,28,2,30,Clouds
69799,45,1554462000,22,8,30,Clouds
69800,46,1554462000,11,9,20,Clouds
69801,47,1554462000,7,33,40,Clouds
69802,48,1554462000,0,40,40,Clouds
69803,49,1554462000,0,40,40,Clouds
69804,50,1554462000,39,1,40,Clouds
69805,51,1554462000,37,3,40,Clouds
69806,52,1554462000,19,13,32,Clouds
69807,53,1554462000,2,38,40,Clouds
69808,54,1554462000,21,12,33,Clouds
69809,55,1554462000,11,25,36,Clouds
69810,56,1554462000,20,20,40,Clouds
69811,57,1554462000,0,23,23,Clouds
69812,58,1554462000,1,39,40,Clouds
69813,59,1554462000,18,2,20,Clouds
69814,60,1554462000,30,0,30,Clouds
69815,61,1554462000,14,11,25,Clouds
69816,62,1554462000,7,33,40,Clouds
69817,63,1554462000,9,26,35,Clouds
69818,64,1554462000,6,34,40,Clouds
69819,65,1554462000,0,38,38,Clouds
69820,66,1554462000,12,28,40,Clouds
69821,67,1554462000,18,22,40,Clouds
69822,68,1554462000,1,39,40,Clouds
69823,69,1554462000,0,40,40,Clouds
69824,70,1554462000,1,27,28,Clouds
69825,71,1554462000,39,1,40,Clouds
69826,72,1554462000,31,0,31,Clouds
69827,73,1554462000,30,0,30,Clouds
69828,74,1554462000,30,0,30,Clouds
69829,75,1554462000,35,4,39,Clouds
69830,76,1554462000,37,1,38,Clouds
69831,77,1554462000,28,1,29,Clouds
69832,78,1554462000,39,1,40,Clouds
69833,79,1554462000,27,0,27,Clouds
69834,80,1554462000,38,2,40,Clouds
69835,81,1554462000,39,1,40,Clouds
69836,82,1554462000,22,0,22,Clouds
69837,83,1554462000,32,8,40,Clouds
69838,84,1554462000,30,0,30,Clouds
69839,85,1554462000,29,6,35,Clouds
69840,86,1554462000,38,0,38,Clouds
69841,87,1554462000,38,0,38,Clouds
69842,88,1554462000,30,0,30,Clouds
69843,89,1554462000,26,14,40,Clouds
69844,90,1554462000,0,39,39,Clouds
69845,91,1554462000,19,11,30,Clouds
69846,92,1554462000,40,0,40,Clouds
69847,93,1554462000,40,0,40,Clouds
69848,94,1554462000,39,1,40,Clouds
69849,95,1554462000,40,0,40,Clouds
69850,96,1554462000,30,0,30,Clouds
69851,97,1554462000,40,0,40,Clouds
69852,98,1554462000,31,9,40,Clouds
69853,99,1554462000,0,30,30,Clouds
69854,100,1554462000,15,10,25,Clouds
69855,101,1554462000,28,2,30,Clouds
69856,102,1554462000,40,0,40,Clouds
69857,103,1554462000,34,6,40,Clouds
69858,104,1554462000,39,1,40,Clouds
69859,105,1554462000,36,0,36,Clouds
69860,106,1554462000,40,0,40,Clouds
69861,107,1554462000,40,0,40,Clouds
69862,108,1554462000,39,1,40,Clouds
69863,109,1554462000,29,0,29,Clouds
69864,110,1554462000,39,1,40,Clouds
69865,111,1554462000,40,0,40,Clouds
69866,112,1554462000,20,10,30,Clouds
69867,113,1554462000,17,23,40,Clouds
69868,114,1554462000,32,8,40,Clouds
69869,115,1554462000,30,0,30,Clouds
69870,2,1554465600,20,0,20,Clouds
69871,3,1554465600,15,5,20,Clouds
69872,4,1554465600,19,1,20,Clouds
69873,5,1554465600,40,0,40,Clouds
69874,6,1554465600,18,2,20,Clouds
69875,7,1554465600,29,0,29,Clouds
69876,8,1554465600,3,27,30,Clouds
69877,9,1554465600,8,16,24,Clouds
69878,10,1554465600,8,8,16,Clouds
69879,11,1554465600,3,27,30,Clouds
69880,12,1554465600,20,0,20,Clouds
69881,13,1554465600,4,26,30,Clouds
69882,14,1554465600,5,24,29,Clouds
69883,15,1554465600,14,2,16,Clouds
69884,16,1554465600,5,15,20,Clouds
69885,17,1554465600,15,5,20,Clouds
69886,18,1554465600,27,3,30,Clouds
69887,19,1554465600,22,8,30,Clouds
69888,21,1554465600,2,28,30,Clouds
69889,22,1554465600,8,12,20,Clouds
69890,23,1554465600,0,29,29,Clouds
69891,24,1554465600,19,1,20,Clouds
69892,25,1554465600,3,27,30,Clouds
69893,26,1554465600,0,20,20,Clouds
69894,27,1554465600,4,16,20,Clouds
69895,28,1554465600,30,0,30,Clouds
69896,29,1554465600,22,7,29,Clouds
69897,30,1554465600,19,1,20,Clouds
69898,31,1554465600,20,0,20,Clouds
69899,32,1554465600,2,28,30,Clouds
69900,33,1554465600,3,20,23,Clouds
69901,34,1554465600,30,0,30,Clouds
69902,35,1554465600,30,0,30,Clouds
69903,36,1554465600,6,34,40,Clouds
69904,37,1554465600,29,1,30,Clouds
69905,38,1554465600,23,17,40,Clouds
69906,39,1554465600,15,5,20,Clouds
69907,40,1554465600,18,3,21,Clouds
69908,41,1554465600,19,1,20,Clouds
69909,42,1554465600,29,1,30,Clouds
69910,43,1554465600,28,2,30,Clouds
69911,44,1554465600,30,0,30,Clouds
69912,45,1554465600,23,7,30,Clouds
69913,46,1554465600,15,5,20,Clouds
69914,47,1554465600,7,33,40,Clouds
69915,48,1554465600,6,34,40,Clouds
69916,49,1554465600,9,31,40,Clouds
69917,50,1554465600,40,0,40,Clouds
69918,51,1554465600,38,2,40,Clouds
69919,52,1554465600,18,14,32,Clouds
69920,53,1554465600,1,39,40,Clouds
69921,54,1554465600,25,8,33,Clouds
69922,55,1554465600,15,21,36,Clouds
69923,56,1554465600,17,23,40,Clouds
69924,57,1554465600,1,22,23,Clouds
69925,58,1554465600,3,37,40,Clouds
69926,59,1554465600,20,0,20,Clouds
69927,60,1554465600,28,2,30,Clouds
69928,61,1554465600,21,4,25,Clouds
69929,62,1554465600,10,30,40,Clouds
69930,63,1554465600,6,29,35,Clouds
69931,64,1554465600,5,35,40,Clouds
69932,65,1554465600,4,34,38,Clouds
69933,66,1554465600,10,30,40,Clouds
69934,67,1554465600,14,26,40,Clouds
69935,68,1554465600,0,40,40,Clouds
69936,69,1554465600,0,40,40,Clouds
69937,70,1554465600,7,21,28,Clouds
69938,71,1554465600,39,1,40,Clouds
69939,72,1554465600,31,0,31,Clouds
69940,73,1554465600,30,0,30,Clouds
69941,74,1554465600,29,1,30,Clouds
69942,75,1554465600,36,3,39,Clouds
69943,76,1554465600,38,0,38,Clouds
69944,77,1554465600,29,0,29,Clouds
69945,78,1554465600,40,0,40,Clouds
69946,79,1554465600,2,25,27,Clouds
69947,80,1554465600,40,0,40,Clouds
69948,81,1554465600,40,0,40,Clouds
69949,82,1554465600,22,0,22,Clouds
69950,83,1554465600,36,4,40,Clouds
69951,84,1554465600,30,0,30,Clouds
69952,85,1554465600,31,4,35,Clouds
69953,86,1554465600,38,0,38,Clouds
69954,87,1554465600,38,0,38,Clouds
69955,88,1554465600,30,0,30,Clouds
69956,89,1554465600,24,16,40,Clouds
69957,90,1554465600,3,36,39,Clouds
69958,91,1554465600,19,11,30,Clouds
69959,92,1554465600,40,0,40,Clouds
69960,93,1554465600,40,0,40,Clouds
69961,94,1554465600,40,0,40,Clouds
69962,95,1554465600,39,1,40,Clouds
69963,96,1554465600,30,0,30,Clouds
69964,97,1554465600,40,0,40,Clouds
69965,98,1554465600,29,11,40,Clouds
69966,99,1554465600,2,28,30,Clouds
69967,100,1554465600,17,8,25,Clouds
69968,101,1554465600,29,1,30,Clouds
69969,102,1554465600,40,0,40,Clouds
69970,103,1554465600,39,1,40,Clouds
69971,104,1554465600,40,0,40,Clouds
69972,105,1554465600,35,1,36,Clouds
69973,106,1554465600,40,0,40,Clouds
69974,107,1554465600,39,1,40,Clouds
69975,108,1554465600,40,0,40,Clouds
69976,109,1554465600,29,0,29,Clouds
69977,110,1554465600,38,2,40,Clouds
69978,111,1554465600,40,0,40,Clouds
69979,112,1554465600,21,9,30,Clouds
69980,113,1554465600,16,24,40,Clouds
69981,114,1554465600,29,11,40,Clouds
69982,115,1554465600,29,1,30,Clouds
69983,2,1554469200,19,1,20,Clouds
69984,3,1554469200,19,1,20,Clouds
69985,4,1554469200,20,0,20,Clouds
69986,5,1554469200,40,0,40,Clouds
69987,6,1554469200,19,1,20,Clouds
69988,7,1554469200,29,0,29,Clouds
69989,8,1554469200,1,29,30,Clouds
69990,9,1554469200,2,22,24,Clouds
69991,10,1554469200,5,11,16,Clouds
69992,11,1554469200,11,19,30,Clouds
69993,12,1554469200,20,0,20,Clouds
69994,13,1554469200,4,26,30,Clouds
69995,14,1554469200,4,26,30,Clouds
69996,15,1554469200,16,0,16,Clouds
69997,16,1554469200,7,13,20,Clouds
69998,17,1554469200,18,2,20,Clouds
69999,18,1554469200,24,6,30,Clouds
70000,19,1554469200,17,13,30,Clouds
70001,21,1554469200,0,30,30,Clouds
70002,22,1554469200,7,13,20,Clouds
70003,23,1554469200,10,19,29,Clouds
70004,24,1554469200,19,1,20,Clouds
70005,25,1554469200,11,19,30,Clouds
70006,26,1554469200,0,20,20,Clouds
70007,27,1554469200,1,19,20,Clouds
70008,28,1554469200,28,2,30,Clouds
70009,29,1554469200,29,0,29,Clouds
70010,30,1554469200,20,0,20,Clouds
70011,31,1554469200,18,2,20,Clouds
70012,32,1554469200,25,5,30,Clouds
70013,33,1554469200,4,19,23,Clouds
70014,34,1554469200,30,0,30,Clouds
70015,35,1554469200,30,0,30,Clouds
70016,36,1554469200,11,29,40,Clouds
70017,37,1554469200,24,6,30,Clouds
70018,38,1554469200,22,18,40,Clouds
70019,39,1554469200,18,2,20,Clouds
70020,40,1554469200,20,0,20,Clouds
70021,41,1554469200,18,2,20,Clouds
70022,42,1554469200,29,1,30,Clouds
70023,43,1554469200,25,5,30,Clouds
70024,44,1554469200,30,0,30,Clouds
70025,45,1554469200,29,1,30,Clouds
70026,46,1554469200,16,4,20,Clouds
70027,47,1554469200,8,32,40,Clouds
70028,48,1554469200,10,30,40,Clouds
70029,49,1554469200,10,30,40,Clouds
70030,50,1554469200,38,2,40,Clouds
70031,51,1554469200,38,2,40,Clouds
70032,52,1554469200,14,18,32,Clouds
70033,53,1554469200,1,39,40,Clouds
70034,54,1554469200,25,8,33,Clouds
70035,55,1554469200,19,17,36,Clouds
70036,56,1554469200,19,21,40,Clouds
70037,57,1554469200,0,23,23,Clouds
70038,58,1554469200,10,30,40,Clouds
70039,59,1554469200,20,0,20,Clouds
70040,60,1554469200,27,3,30,Clouds
70041,61,1554469200,24,1,25,Clouds
70042,62,1554469200,11,29,40,Clouds
70043,63,1554469200,7,28,35,Clouds
70044,64,1554469200,1,39,40,Clouds
70045,65,1554469200,16,24,40,Clouds
70046,66,1554469200,13,27,40,Clouds
70047,67,1554469200,13,27,40,Clouds
70048,68,1554469200,0,40,40,Clouds
70049,69,1554469200,2,38,40,Clouds
70050,70,1554469200,4,24,28,Clouds
70051,71,1554469200,39,1,40,Clouds
70052,72,1554469200,20,11,31,Clouds
70053,73,1554469200,29,1,30,Clouds
70054,74,1554469200,21,9,30,Clouds
70055,75,1554469200,38,1,39,Clouds
70056,76,1554469200,35,3,38,Clouds
70057,77,1554469200,29,0,29,Clouds
70058,78,1554469200,40,0,40,Clouds
70059,79,1554469200,6,21,27,Clouds
70060,80,1554469200,26,14,40,Clouds
70061,81,1554469200,40,0,40,Clouds
70062,82,1554469200,22,0,22,Clouds
70063,83,1554469200,37,3,40,Clouds
70064,84,1554469200,30,0,30,Clouds
70065,85,1554469200,33,2,35,Clouds
70066,86,1554469200,37,1,38,Clouds
70067,87,1554469200,38,0,38,Clouds
70068,88,1554469200,29,1,30,Clouds
70069,89,1554469200,24,16,40,Clouds
70070,90,1554469200,7,32,39,Clouds
70071,91,1554469200,17,13,30,Clouds
70072,92,1554469200,40,0,40,Clouds
70073,93,1554469200,40,0,40,Clouds
70074,94,1554469200,40,0,40,Clouds
70075,95,1554469200,40,0,40,Clouds
70076,96,1554469200,30,0,30,Clouds
70077,97,1554469200,36,4,40,Clouds
70078,98,1554469200,26,14,40,Clouds
70079,99,1554469200,1,29,30,Clouds
70080,100,1554469200,12,13,25,Clouds
70081,101,1554469200,29,1,30,Clouds
70082,102,1554469200,39,1,40,Clouds
70083,103,1554469200,40,0,40,Clouds
70084,104,1554469200,40,0,40,Clouds
70085,105,1554469200,35,1,36,Clouds
70086,106,1554469200,40,0,40,Clouds
70087,107,1554469200,29,11,40,Clouds
70088,108,1554469200,33,7,40,Clouds
70089,109,1554469200,28,1,29,Clouds
70090,110,1554469200,36,4,40,Clouds
70091,111,1554469200,38,2,40,Clouds
70092,112,1554469200,21,9,30,Clouds
70093,113,1554469200,16,24,40,Clouds
70094,114,1554469200,40,0,40,Clouds
70095,115,1554469200,27,3,30,Clouds
70096,2,1554472800,20,0,20,Clouds
70097,3,1554472800,17,3,20,Clouds
70098,4,1554472800,20,0,20,Clouds
70099,5,1554472800,35,5,40,Clouds
70100,6,1554472800,17,3,20,Clouds
70101,7,1554472800,27,2,29,Clouds
70102,8,1554472800,8,22,30,Clouds
70103,9,1554472800,7,17,24,Clouds
70104,10,1554472800,7,9,16,Clouds
70105,11,1554472800,18,12,30,Clouds
70106,12,1554472800,17,3,20,Clouds
70107,13,1554472800,1,29,30,Clouds
70108,14,1554472800,0,30,30,Clouds
70109,15,1554472800,14,2,16,Clouds
70110,16,1554472800,5,15,20,Clouds
70111,17,1554472800,18,2,20,Clouds
70112,18,1554472800,29,1,30,Clouds
70113,19,1554472800,15,15,30,Clouds
70114,21,1554472800,0,30,30,Clouds
70115,22,1554472800,8,12,20,Clouds
70116,23,1554472800,11,18,29,Clouds
70117,24,1554472800,17,3,20,Clouds
70118,25,1554472800,6,24,30,Clouds
70119,26,1554472800,5,15,20,Clouds
70120,27,1554472800,6,14,20,Clouds
70121,28,1554472800,26,4,30,Clouds
70122,29,1554472800,28,1,29,Clouds
70123,30,1554472800,20,0,20,Clouds
70124,31,1554472800,14,6,20,Clouds
70125,32,1554472800,14,16,30,Clouds
70126,33,1554472800,4,19,23,Clouds
70127,34,1554472800,28,2,30,Clouds
70128,35,1554472800,26,4,30,Clouds
70129,36,1554472800,8,32,40,Clouds
70130,37,1554472800,17,13,30,Clouds
70131,38,1554472800,15,25,40,Clouds
70132,39,1554472800,18,2,20,Clouds
70133,40,1554472800,20,1,21,Clouds
70134,41,1554472800,17,3,20,Clouds
70135,42,1554472800,29,1,30,Clouds
70136,43,1554472800,26,4,30,Clouds
70137,44,1554472800,29,1,30,Clouds
70138,45,1554472800,27,3,30,Clouds
70139,46,1554472800,17,3,20,Clouds
70140,47,1554472800,9,31,40,Clouds
70141,48,1554472800,8,32,40,Clouds
70142,49,1554472800,6,34,40,Clouds
70143,50,1554472800,39,1,40,Clouds
70144,51,1554472800,40,0,40,Clouds
70145,52,1554472800,14,18,32,Clouds
70146,53,1554472800,4,36,40,Clouds
70147,54,1554472800,21,12,33,Clouds
70148,55,1554472800,22,14,36,Clouds
70149,56,1554472800,25,15,40,Clouds
70150,57,1554472800,1,22,23,Clouds
70151,58,1554472800,11,29,40,Clouds
70152,59,1554472800,19,1,20,Clouds
70153,60,1554472800,28,2,30,Clouds
70154,61,1554472800,25,0,25,Clouds
70155,62,1554472800,15,25,40,Clouds
70156,63,1554472800,3,32,35,Clouds
70157,64,1554472800,2,38,40,Clouds
70158,65,1554472800,6,34,40,Clouds
70159,66,1554472800,15,25,40,Clouds
70160,67,1554472800,13,27,40,Clouds
70161,68,1554472800,4,36,40,Clouds
70162,69,1554472800,7,33,40,Clouds
70163,70,1554472800,3,25,28,Clouds
70164,71,1554472800,40,0,40,Clouds
70165,72,1554472800,26,5,31,Clouds
70166,73,1554472800,27,3,30,Clouds
70167,74,1554472800,23,7,30,Clouds
70168,75,1554472800,38,2,40,Clouds
70169,76,1554472800,37,1,38,Clouds
70170,77,1554472800,25,4,29,Clouds
70171,78,1554472800,40,0,40,Clouds
70172,79,1554472800,6,21,27,Clouds
70173,80,1554472800,26,14,40,Clouds
70174,81,1554472800,39,1,40,Clouds
70175,82,1554472800,22,0,22,Clouds
70176,83,1554472800,40,0,40,Clouds
70177,84,1554472800,27,3,30,Clouds
70178,85,1554472800,34,1,35,Clouds
70179,86,1554472800,37,1,38,Clouds
70180,87,1554472800,37,1,38,Clouds
70181,88,1554472800,29,1,30,Clouds
70182,89,1554472800,26,14,40,Clouds
70183,90,1554472800,10,29,39,Clouds
70184,91,1554472800,7,23,30,Clouds
70185,92,1554472800,39,1,40,Clouds
70186,93,1554472800,40,0,40,Clouds
70187,94,1554472800,40,0,40,Clouds
70188,95,1554472800,38,2,40,Clouds
70189,96,1554472800,29,1,30,Clouds
70190,97,1554472800,38,2,40,Clouds
70191,98,1554472800,28,12,40,Clouds
70192,99,1554472800,3,27,30,Clouds
70193,100,1554472800,7,18,25,Clouds
70194,101,1554472800,29,1,30,Clouds
70195,102,1554472800,39,1,40,Clouds
70196,103,1554472800,40,0,40,Clouds
70197,104,1554472800,40,0,40,Clouds
70198,105,1554472800,36,0,36,Clouds
70199,106,1554472800,40,0,40,Clouds
70200,107,1554472800,28,12,40,Clouds
70201,108,1554472800,36,4,40,Clouds
70202,109,1554472800,29,0,29,Clouds
70203,110,1554472800,39,1,40,Clouds
70204,111,1554472800,40,0,40,Clouds
70205,112,1554472800,21,9,30,Clouds
70206,113,1554472800,13,27,40,Clouds
70207,114,1554472800,33,7,40,Clouds
70208,115,1554472800,28,2,30,Clouds
70209,2,1554476400,20,0,20,Clouds
70210,3,1554476400,18,2,20,Clouds
70211,4,1554476400,18,2,20,Clouds
70212,5,1554476400,28,12,40,Clouds
70213,6,1554476400,16,4,20,Clouds
70214,7,1554476400,27,2,29,Clouds
70215,8,1554476400,7,23,30,Clouds
70216,9,1554476400,8,16,24,Clouds
70217,10,1554476400,12,4,16,Clouds
70218,11,1554476400,18,12,30,Clouds
70219,12,1554476400,19,1,20,Clouds
70220,13,1554476400,1,29,30,Clouds
70221,14,1554476400,1,29,30,Clouds
70222,15,1554476400,13,3,16,Clouds
70223,16,1554476400,1,19,20,Clouds
70224,17,1554476400,20,0,20,Clouds
70225,18,1554476400,26,4,30,Clouds
70226,19,1554476400,25,5,30,Clouds
70227,21,1554476400,0,30,30,Clouds
70228,22,1554476400,13,7,20,Clouds
70229,23,1554476400,5,25,30,Clouds
70230,24,1554476400,15,5,20,Clouds
70231,25,1554476400,10,20,30,Clouds
70232,26,1554476400,0,20,20,Clouds
70233,27,1554476400,10,10,20,Clouds
70234,28,1554476400,27,3,30,Clouds
70235,29,1554476400,29,0,29,Clouds
70236,30,1554476400,18,2,20,Clouds
70237,31,1554476400,18,2,20,Clouds
70238,32,1554476400,8,22,30,Clouds
70239,33,1554476400,1,22,23,Clouds
70240,34,1554476400,28,2,30,Clouds
70241,35,1554476400,27,3,30,Clouds
70242,36,1554476400,3,37,40,Clouds
70243,37,1554476400,17,13,30,Clouds
70244,38,1554476400,24,16,40,Clouds
70245,39,1554476400,19,1,20,Clouds
70246,40,1554476400,18,3,21,Clouds
70247,41,1554476400,14,6,20,Clouds
70248,42,1554476400,28,2,30,Clouds
70249,43,1554476400,29,1,30,Clouds
70250,44,1554476400,30,0,30,Clouds
70251,45,1554476400,28,2,30,Clouds
70252,46,1554476400,15,5,20,Clouds
70253,47,1554476400,10,30,40,Clouds
70254,48,1554476400,5,35,40,Clouds
70255,49,1554476400,1,39,40,Clouds
70256,50,1554476400,40,0,40,Clouds
70257,51,1554476400,37,3,40,Clouds
70258,52,1554476400,12,20,32,Clouds
70259,53,1554476400,22,18,40,Clouds
70260,54,1554476400,24,9,33,Clouds
70261,55,1554476400,26,10,36,Clouds
70262,56,1554476400,8,32,40,Clouds
70263,57,1554476400,2,21,23,Clouds
70264,58,1554476400,11,29,40,Clouds
70265,59,1554476400,19,1,20,Clouds
70266,60,1554476400,26,4,30,Clouds
70267,61,1554476400,25,0,25,Clouds
70268,62,1554476400,13,27,40,Clouds
70269,63,1554476400,2,33,35,Clouds
70270,64,1554476400,3,37,40,Clouds
70271,65,1554476400,1,39,40,Clouds
70272,66,1554476400,15,25,40,Clouds
70273,67,1554476400,5,35,40,Clouds
70274,68,1554476400,1,39,40,Clouds
70275,69,1554476400,9,31,40,Clouds
70276,70,1554476400,11,17,28,Clouds
70277,71,1554476400,38,2,40,Clouds
70278,72,1554476400,24,7,31,Clouds
70279,73,1554476400,30,0,30,Clouds
70280,74,1554476400,21,9,30,Clouds
70281,75,1554476400,35,5,40,Clouds
70282,76,1554476400,37,1,38,Clouds
70283,77,1554476400,24,5,29,Clouds
70284,78,1554476400,40,0,40,Clouds
70285,79,1554476400,8,19,27,Clouds
70286,80,1554476400,29,11,40,Clouds
70287,81,1554476400,39,1,40,Clouds
70288,82,1554476400,21,1,22,Clouds
70289,83,1554476400,39,1,40,Clouds
70290,84,1554476400,27,3,30,Clouds
70291,85,1554476400,35,0,35,Clouds
70292,86,1554476400,36,2,38,Clouds
70293,87,1554476400,36,2,38,Clouds
70294,88,1554476400,28,2,30,Clouds
70295,89,1554476400,22,18,40,Clouds
70296,90,1554476400,12,28,40,Clouds
70297,91,1554476400,7,23,30,Clouds
70298,92,1554476400,40,0,40,Clouds
70299,93,1554476400,40,0,40,Clouds
70300,94,1554476400,40,0,40,Clouds
70301,95,1554476400,40,0,40,Clouds
70302,96,1554476400,29,1,30,Clouds
70303,97,1554476400,39,1,40,Clouds
70304,98,1554476400,30,10,40,Clouds
70305,99,1554476400,6,24,30,Clouds
70306,100,1554476400,17,8,25,Clouds
70307,101,1554476400,29,1,30,Clouds
70308,102,1554476400,38,2,40,Clouds
70309,103,1554476400,39,1,40,Clouds
70310,104,1554476400,39,1,40,Clouds
70311,105,1554476400,36,0,36,Clouds
70312,106,1554476400,23,17,40,Clouds
70313,107,1554476400,28,12,40,Clouds
70314,108,1554476400,37,3,40,Clouds
70315,109,1554476400,29,0,29,Clouds
70316,110,1554476400,38,2,40,Clouds
70317,111,1554476400,39,1,40,Clouds
70318,112,1554476400,21,9,30,Clouds
70319,113,1554476400,14,26,40,Clouds
70320,114,1554476400,40,0,40,Clouds
70321,115,1554476400,27,3,30,Clouds
70322,2,1554480000,20,0,20,Clouds
70323,3,1554480000,19,1,20,Clouds
70324,4,1554480000,20,0,20,Clouds
70325,5,1554480000,36,4,40,Clouds
70326,6,1554480000,19,1,20,Clouds
70327,7,1554480000,8,21,29,Clouds
70328,8,1554480000,4,26,30,Clouds
70329,9,1554480000,21,3,24,Clouds
70330,10,1554480000,6,10,16,Clouds
70331,11,1554480000,21,9,30,Clouds
70332,12,1554480000,20,0,20,Clouds
70333,13,1554480000,4,26,30,Clouds
70334,14,1554480000,12,18,30,Clouds
70335,15,1554480000,15,1,16,Clouds
70336,16,1554480000,0,20,20,Clouds
70337,17,1554480000,19,1,20,Clouds
70338,18,1554480000,26,4,30,Clouds
70339,19,1554480000,13,17,30,Clouds
70340,21,1554480000,10,19,29,Clouds
70341,22,1554480000,10,10,20,Clouds
70342,23,1554480000,0,30,30,Clouds
70343,24,1554480000,10,10,20,Clouds
70344,25,1554480000,11,19,30,Clouds
70345,26,1554480000,0,20,20,Clouds
70346,27,1554480000,8,12,20,Clouds
70347,28,1554480000,30,0,30,Clouds
70348,29,1554480000,25,4,29,Clouds
70349,30,1554480000,20,0,20,Clouds
70350,31,1554480000,20,0,20,Clouds
70351,32,1554480000,1,29,30,Clouds
70352,33,1554480000,2,21,23,Clouds
70353,34,1554480000,26,4,30,Clouds
70354,35,1554480000,30,0,30,Clouds
70355,36,1554480000,6,34,40,Clouds
70356,37,1554480000,24,6,30,Clouds
70357,38,1554480000,26,14,40,Clouds
70358,39,1554480000,10,10,20,Clouds
70359,40,1554480000,16,5,21,Clouds
70360,41,1554480000,16,4,20,Clouds
70361,42,1554480000,25,5,30,Clouds
70362,43,1554480000,26,4,30,Clouds
70363,44,1554480000,29,1,30,Clouds
70364,45,1554480000,27,3,30,Clouds
70365,46,1554480000,10,10,20,Clouds
70366,47,1554480000,13,27,40,Clouds
70367,48,1554480000,1,39,40,Clouds
70368,49,1554480000,1,39,40,Clouds
70369,50,1554480000,38,2,40,Clouds
70370,51,1554480000,40,0,40,Clouds
70371,52,1554480000,7,25,32,Clouds
70372,53,1554480000,26,14,40,Clouds
70373,54,1554480000,28,5,33,Clouds
70374,55,1554480000,29,7,36,Clouds
70375,56,1554480000,11,29,40,Clouds
70376,57,1554480000,3,20,23,Clouds
70377,58,1554480000,15,25,40,Clouds
70378,59,1554480000,20,0,20,Clouds
70379,60,1554480000,30,0,30,Clouds
70380,61,1554480000,24,1,25,Clouds
70381,62,1554480000,16,24,40,Clouds
70382,63,1554480000,3,32,35,Clouds
70383,64,1554480000,3,37,40,Clouds
70384,65,1554480000,0,40,40,Clouds
70385,66,1554480000,22,18,40,Clouds
70386,67,1554480000,1,39,40,Clouds
70387,68,1554480000,5,35,40,Clouds
70388,69,1554480000,9,31,40,Clouds
70389,70,1554480000,22,6,28,Clouds
70390,71,1554480000,39,1,40,Clouds
70391,72,1554480000,29,2,31,Clouds
70392,73,1554480000,25,5,30,Clouds
70393,74,1554480000,18,12,30,Clouds
70394,75,1554480000,35,5,40,Clouds
70395,76,1554480000,28,10,38,Clouds
70396,77,1554480000,28,1,29,Clouds
70397,78,1554480000,40,0,40,Clouds
70398,79,1554480000,17,10,27,Clouds
70399,80,1554480000,34,6,40,Clouds
70400,81,1554480000,40,0,40,Clouds
70401,82,1554480000,22,0,22,Clouds
70402,83,1554480000,39,1,40,Clouds
70403,84,1554480000,29,1,30,Clouds
70404,85,1554480000,35,0,35,Clouds
70405,86,1554480000,33,5,38,Clouds
70406,87,1554480000,35,3,38,Clouds
70407,88,1554480000,24,6,30,Clouds
70408,89,1554480000,24,16,40,Clouds
70409,90,1554480000,17,23,40,Clouds
70410,91,1554480000,15,15,30,Clouds
70411,92,1554480000,35,5,40,Clouds
70412,93,1554480000,38,2,40,Clouds
70413,94,1554480000,40,0,40,Clouds
70414,95,1554480000,37,3,40,Clouds
70415,96,1554480000,30,0,30,Clouds
70416,97,1554480000,35,5,40,Clouds
70417,98,1554480000,30,10,40,Clouds
70418,99,1554480000,9,21,30,Clouds
70419,100,1554480000,4,21,25,Clouds
70420,101,1554480000,30,0,30,Clouds
70421,102,1554480000,39,1,40,Clouds
70422,103,1554480000,40,0,40,Clouds
70423,104,1554480000,40,0,40,Clouds
70424,105,1554480000,36,0,36,Clouds
70425,106,1554480000,23,17,40,Clouds
70426,107,1554480000,28,12,40,Clouds
70427,108,1554480000,37,3,40,Clouds
70428,109,1554480000,26,3,29,Clouds
70429,110,1554480000,38,2,40,Clouds
70430,111,1554480000,38,2,40,Clouds
70431,112,1554480000,22,8,30,Clouds
70432,113,1554480000,18,22,40,Clouds
70433,114,1554480000,39,1,40,Clouds
70434,115,1554480000,29,1,30,Clouds
70435,2,1554483600,14,6,20,Clouds
70436,3,1554483600,18,2,20,Clouds
70437,4,1554483600,19,1,20,Clouds
70438,5,1554483600,25,15,40,Clouds
70439,6,1554483600,18,2,20,Clouds
70440,7,1554483600,12,17,29,Clouds
70441,8,1554483600,4,26,30,Clouds
70442,9,1554483600,23,1,24,Clouds
70443,10,1554483600,16,0,16,Clouds
70444,11,1554483600,30,0,30,Clouds
70445,12,1554483600,18,2,20,Clouds
70446,13,1554483600,11,19,30,Clouds
70447,14,1554483600,15,15,30,Clouds
70448,15,1554483600,16,0,16,Clouds
70449,16,1554483600,0,20,20,Clouds
70450,17,1554483600,18,2,20,Clouds
70451,18,1554483600,30,0,30,Clouds
70452,19,1554483600,14,16,30,Clouds
70453,21,1554483600,3,27,30,Clouds
70454,22,1554483600,0,20,20,Clouds
70455,23,1554483600,0,30,30,Clouds
70456,24,1554483600,18,2,20,Clouds
70457,25,1554483600,12,18,30,Clouds
70458,26,1554483600,1,19,20,Clouds
70459,27,1554483600,10,10,20,Clouds
70460,28,1554483600,29,1,30,Clouds
70461,29,1554483600,28,1,29,Clouds
70462,30,1554483600,19,1,20,Clouds
70463,31,1554483600,16,4,20,Clouds
70464,32,1554483600,16,14,30,Clouds
70465,33,1554483600,0,23,23,Clouds
70466,34,1554483600,13,17,30,Clouds
70467,35,1554483600,23,7,30,Clouds
70468,36,1554483600,23,17,40,Clouds
70469,37,1554483600,30,0,30,Clouds
70470,38,1554483600,9,31,40,Clouds
70471,39,1554483600,20,0,20,Clouds
70472,40,1554483600,17,4,21,Clouds
70473,41,1554483600,20,0,20,Clouds
70474,42,1554483600,20,10,30,Clouds
70475,43,1554483600,24,6,30,Clouds
70476,44,1554483600,25,5,30,Clouds
70477,45,1554483600,29,1,30,Clouds
70478,46,1554483600,13,7,20,Clouds
70479,47,1554483600,27,13,40,Clouds
70480,48,1554483600,2,38,40,Clouds
70481,49,1554483600,2,38,40,Clouds
70482,50,1554483600,37,3,40,Clouds
70483,51,1554483600,39,1,40,Clouds
70484,52,1554483600,17,15,32,Clouds
70485,53,1554483600,40,0,40,Clouds
70486,54,1554483600,33,0,33,Clouds
70487,55,1554483600,36,0,36,Clouds
70488,56,1554483600,28,12,40,Clouds
70489,57,1554483600,12,11,23,Clouds
70490,58,1554483600,21,19,40,Clouds
70491,59,1554483600,20,0,20,Clouds
70492,60,1554483600,28,2,30,Clouds
70493,61,1554483600,25,0,25,Clouds
70494,62,1554483600,28,12,40,Clouds
70495,63,1554483600,3,32,35,Clouds
70496,64,1554483600,7,33,40,Clouds
70497,65,1554483600,15,25,40,Clouds
70498,66,1554483600,40,0,40,Clouds
70499,67,1554483600,4,36,40,Clouds
70500,68,1554483600,10,30,40,Clouds
70501,69,1554483600,10,30,40,Clouds
70502,70,1554483600,23,5,28,Clouds
70503,71,1554483600,40,0,40,Clouds
70504,72,1554483600,28,3,31,Clouds
70505,73,1554483600,30,0,30,Clouds
70506,74,1554483600,10,20,30,Clouds
70507,75,1554483600,33,7,40,Clouds
70508,76,1554483600,16,22,38,Clouds
70509,77,1554483600,27,2,29,Clouds
70510,78,1554483600,37,3,40,Clouds
70511,79,1554483600,27,0,27,Clouds
70512,80,1554483600,38,2,40,Clouds
70513,81,1554483600,23,17,40,Clouds
70514,82,1554483600,18,4,22,Clouds
70515,83,1554483600,39,1,40,Clouds
70516,84,1554483600,26,4,30,Clouds
70517,85,1554483600,34,1,35,Clouds
70518,86,1554483600,26,12,38,Clouds
70519,87,1554483600,37,1,38,Clouds
70520,88,1554483600,25,5,30,Clouds
70521,89,1554483600,29,11,40,Clouds
70522,90,1554483600,35,5,40,Clouds
70523,91,1554483600,16,14,30,Clouds
70524,92,1554483600,18,22,40,Clouds
70525,93,1554483600,7,33,40,Clouds
70526,94,1554483600,39,1,40,Clouds
70527,95,1554483600,30,10,40,Clouds
70528,96,1554483600,28,2,30,Clouds
70529,97,1554483600,35,5,40,Clouds
70530,98,1554483600,30,10,40,Clouds
70531,99,1554483600,3,27,30,Clouds
70532,100,1554483600,0,25,25,Clouds
70533,101,1554483600,28,2,30,Clouds
70534,102,1554483600,39,1,40,Clouds
70535,103,1554483600,40,0,40,Clouds
70536,104,1554483600,40,0,40,Clouds
70537,105,1554483600,36,0,36,Clouds
70538,106,1554483600,24,16,40,Clouds
70539,107,1554483600,25,15,40,Clouds
70540,108,1554483600,35,5,40,Clouds
70541,109,1554483600,22,7,29,Clouds
70542,110,1554483600,39,1,40,Clouds
70543,111,1554483600,37,3,40,Clouds
70544,112,1554483600,15,15,30,Clouds
70545,113,1554483600,20,20,40,Clouds
70546,114,1554483600,40,0,40,Clouds
70547,115,1554483600,28,2,30,Clouds
70548,2,1554487200,9,11,20,Rain
70549,3,1554487200,19,1,20,Rain
70550,4,1554487200,20,0,20,Rain
70551,5,1554487200,37,3,40,Rain
70552,6,1554487200,17,3,20,Rain
70553,7,1554487200,16,13,29,Rain
70554,8,1554487200,7,23,30,Rain
70555,9,1554487200,18,6,24,Rain
70556,10,1554487200,5,11,16,Rain
70557,11,1554487200,30,0,30,Rain
70558,12,1554487200,18,2,20,Rain
70559,13,1554487200,29,1,30,Rain
70560,14,1554487200,5,25,30,Rain
70561,15,1554487200,15,1,16,Rain
70562,16,1554487200,2,18,20,Rain
70563,17,1554487200,20,0,20,Rain
70564,18,1554487200,28,2,30,Rain
70565,19,1554487200,28,2,30,Rain
70566,21,1554487200,0,30,30,Rain
70567,22,1554487200,0,20,20,Rain
70568,23,1554487200,4,26,30,Rain
70569,24,1554487200,20,0,20,Rain
70570,25,1554487200,22,8,30,Rain
70571,26,1554487200,1,19,20,Rain
70572,27,1554487200,18,2,20,Rain
70573,28,1554487200,30,0,30,Rain
70574,29,1554487200,29,0,29,Rain
70575,30,1554487200,18,2,20,Rain
70576,31,1554487200,7,13,20,Rain
70577,32,1554487200,5,25,30,Rain
70578,33,1554487200,1,22,23,Rain
70579,34,1554487200,7,23,30,Rain
70580,35,1554487200,28,2,30,Rain
70581,36,1554487200,40,0,40,Rain
70582,37,1554487200,30,0,30,Rain
70583,38,1554487200,11,29,40,Rain
70584,39,1554487200,18,2,20,Rain
70585,40,1554487200,21,0,21,Rain
70586,41,1554487200,20,0,20,Rain
70587,42,1554487200,12,18,30,Rain
70588,43,1554487200,8,22,30,Rain
70589,44,1554487200,11,19,30,Rain
70590,45,1554487200,28,2,30,Rain
70591,46,1554487200,10,10,20,Rain
70592,47,1554487200,40,0,40,Rain
70593,48,1554487200,10,30,40,Rain
70594,49,1554487200,0,40,40,Rain
70595,50,1554487200,23,17,40,Rain
70596,51,1554487200,37,3,40,Rain
70597,52,1554487200,32,0,32,Rain
70598,53,1554487200,40,0,40,Rain
70599,54,1554487200,33,0,33,Rain
70600,55,1554487200,36,0,36,Rain
70601,56,1554487200,34,6,40,Rain
70602,57,1554487200,16,7,23,Rain
70603,58,1554487200,39,1,40,Rain
70604,59,1554487200,20,0,20,Rain
70605,60,1554487200,15,15,30,Rain
70606,61,1554487200,23,2,25,Rain
70607,62,1554487200,40,0,40,Rain
70608,63,1554487200,1,34,35,Rain
70609,64,1554487200,6,34,40,Rain
70610,65,1554487200,35,5,40,Rain
70611,66,1554487200,40,0,40,Rain
70612,67,1554487200,16,24,40,Rain
70613,68,1554487200,40,0,40,Rain
70614,69,1554487200,38,2,40,Rain
70615,70,1554487200,25,3,28,Rain
70616,71,1554487200,40,0,40,Rain
70617,72,1554487200,9,22,31,Rain
70618,73,1554487200,27,3,30,Rain
70619,74,1554487200,18,12,30,Rain
70620,75,1554487200,24,16,40,Rain
70621,76,1554487200,13,25,38,Rain
70622,77,1554487200,25,4,29,Rain
70623,78,1554487200,36,4,40,Rain
70624,79,1554487200,26,1,27,Rain
70625,80,1554487200,32,8,40,Rain
70626,81,1554487200,26,14,40,Rain
70627,82,1554487200,20,2,22,Rain
70628,83,1554487200,32,8,40,Rain
70629,84,1554487200,26,4,30,Rain
70630,85,1554487200,30,5,35,Rain
70631,86,1554487200,2,36,38,Rain
70632,87,1554487200,33,5,38,Rain
70633,88,1554487200,28,2,30,Rain
70634,89,1554487200,40,0,40,Rain
70635,90,1554487200,37,3,40,Rain
70636,91,1554487200,16,14,30,Rain
70637,92,1554487200,14,26,40,Rain
70638,93,1554487200,0,40,40,Rain
70639,94,1554487200,12,28,40,Rain
70640,95,1554487200,23,17,40,Rain
70641,96,1554487200,22,8,30,Rain
70642,97,1554487200,31,9,40,Rain
70643,98,1554487200,35,5,40,Rain
70644,99,1554487200,7,23,30,Rain
70645,100,1554487200,0,25,25,Rain
70646,101,1554487200,27,3,30,Rain
70647,102,1554487200,40,0,40,Rain
70648,103,1554487200,40,0,40,Rain
70649,104,1554487200,40,0,40,Rain
70650,105,1554487200,36,0,36,Rain
70651,106,1554487200,24,16,40,Rain
70652,107,1554487200,14,26,40,Rain
70653,108,1554487200,34,6,40,Rain
70654,109,1554487200,19,10,29,Rain
70655,110,1554487200,36,4,40,Rain
70656,111,1554487200,40,0,40,Rain
70657,112,1554487200,6,24,30,Rain
70658,113,1554487200,31,9,40,Rain
70659,114,1554487200,40,0,40,Rain
70660,115,1554487200,22,8,30,Rain
70661,2,1554490800,4,16,20,Rain
70662,3,1554490800,18,2,20,Rain
70663,4,1554490800,19,1,20,Rain
70664,5,1554490800,30,10,40,Rain
70665,6,1554490800,16,4,20,Rain
70666,7,1554490800,13,16,29,Rain
70667,8,1554490800,18,12,30,Rain
70668,9,1554490800,17,7,24,Rain
70669,10,1554490800,1,15,16,Rain
70670,11,1554490800,14,16,30,Rain
70671,12,1554490800,12,8,20,Rain
70672,13,1554490800,30,0,30,Rain
70673,14,1554490800,3,27,30,Rain
70674,15,1554490800,14,2,16,Rain
70675,16,1554490800,5,15,20,Rain
70676,17,1554490800,16,4,20,Rain
70677,18,1554490800,21,9,30,Rain
70678,19,1554490800,29,1,30,Rain
70679,21,1554490800,8,22,30,Rain
70680,22,1554490800,1,19,20,Rain
70681,23,1554490800,0,30,30,Rain
70682,24,1554490800,14,6,20,Rain
70683,25,1554490800,29,1,30,Rain
70684,26,1554490800,7,13,20,Rain
70685,27,1554490800,17,3,20,Rain
70686,28,1554490800,27,3,30,Rain
70687,29,1554490800,29,0,29,Rain
70688,30,1554490800,20,0,20,Rain
70689,31,1554490800,15,5,20,Rain
70690,32,1554490800,1,29,30,Rain
70691,33,1554490800,2,21,23,Rain
70692,34,1554490800,24,6,30,Rain
70693,35,1554490800,23,7,30,Rain
70694,36,1554490800,40,0,40,Rain
70695,37,1554490800,28,2,30,Rain
70696,38,1554490800,13,27,40,Rain
70697,39,1554490800,19,1,20,Rain
70698,40,1554490800,17,4,21,Rain
70699,41,1554490800,20,0,20,Rain
70700,42,1554490800,12,18,30,Rain
70701,43,1554490800,10,20,30,Rain
70702,44,1554490800,5,25,30,Rain
70703,45,1554490800,29,1,30,Rain
70704,46,1554490800,7,13,20,Rain
70705,47,1554490800,40,0,40,Rain
70706,48,1554490800,15,25,40,Rain
70707,49,1554490800,16,24,40,Rain
70708,50,1554490800,21,19,40,Rain
70709,51,1554490800,38,2,40,Rain
70710,52,1554490800,29,3,32,Rain
70711,53,1554490800,39,1,40,Rain
70712,54,1554490800,32,1,33,Rain
70713,55,1554490800,35,1,36,Rain
70714,56,1554490800,39,1,40,Rain
70715,57,1554490800,21,2,23,Rain
70716,58,1554490800,37,3,40,Rain
70717,59,1554490800,17,3,20,Rain
70718,60,1554490800,13,17,30,Rain
70719,61,1554490800,25,0,25,Rain
70720,62,1554490800,40,0,40,Rain
70721,63,1554490800,3,32,35,Rain
70722,64,1554490800,8,32,40,Rain
70723,65,1554490800,40,0,40,Rain
70724,66,1554490800,39,1,40,Rain
70725,67,1554490800,18,22,40,Rain
70726,68,1554490800,40,0,40,Rain
70727,69,1554490800,38,2,40,Rain
70728,70,1554490800,25,3,28,Rain
70729,71,1554490800,36,4,40,Rain
70730,72,1554490800,5,26,31,Rain
70731,73,1554490800,20,10,30,Rain
70732,74,1554490800,20,10,30,Rain
70733,75,1554490800,14,26,40,Rain
70734,76,1554490800,16,22,38,Rain
70735,77,1554490800,28,1,29,Rain
70736,78,1554490800,31,9,40,Rain
70737,79,1554490800,24,3,27,Rain
70738,80,1554490800,14,26,40,Rain
70739,81,1554490800,27,13,40,Rain
70740,82,1554490800,16,6,22,Rain
70741,83,1554490800,27,13,40,Rain
70742,84,1554490800,27,3,30,Rain
70743,85,1554490800,28,7,35,Rain
70744,86,1554490800,1,37,38,Rain
70745,87,1554490800,30,8,38,Rain
70746,88,1554490800,23,7,30,Rain
70747,89,1554490800,40,0,40,Rain
70748,90,1554490800,40,0,40,Rain
70749,91,1554490800,16,14,30,Rain
70750,92,1554490800,0,40,40,Rain
70751,93,1554490800,15,25,40,Rain
70752,94,1554490800,9,31,40,Rain
70753,95,1554490800,20,20,40,Rain
70754,96,1554490800,20,10,30,Rain
70755,97,1554490800,24,16,40,Rain
70756,98,1554490800,40,0,40,Rain
70757,99,1554490800,15,15,30,Rain
70758,100,1554490800,0,25,25,Rain
70759,101,1554490800,23,7,30,Rain
70760,102,1554490800,37,3,40,Rain
70761,103,1554490800,40,0,40,Rain
70762,104,1554490800,40,0,40,Rain
70763,105,1554490800,35,1,36,Rain
70764,106,1554490800,22,18,40,Rain
70765,107,1554490800,17,23,40,Rain
70766,108,1554490800,34,6,40,Rain
70767,109,1554490800,18,11,29,Rain
70768,110,1554490800,35,5,40,Rain
70769,111,1554490800,33,7,40,Rain
70770,112,1554490800,1,29,30,Rain
70771,113,1554490800,40,0,40,Rain
70772,114,1554490800,40,0,40,Rain
70773,115,1554490800,20,10,30,Rain
70774,2,1554494400,0,20,20,Rain
70775,3,1554494400,18,2,20,Rain
70776,4,1554494400,20,0,20,Rain
70777,5,1554494400,32,8,40,Rain
70778,6,1554494400,15,5,20,Rain
70779,7,1554494400,13,16,29,Rain
70780,8,1554494400,22,8,30,Rain
70781,9,1554494400,5,19,24,Rain
70782,10,1554494400,1,15,16,Rain
70783,11,1554494400,15,15,30,Rain
70784,12,1554494400,11,9,20,Rain
70785,13,1554494400,30,0,30,Rain
70786,14,1554494400,1,29,30,Rain
70787,15,1554494400,16,0,16,Rain
70788,16,1554494400,4,16,20,Rain
70789,17,1554494400,17,3,20,Rain
70790,18,1554494400,23,7,30,Rain
70791,19,1554494400,29,1,30,Rain
70792,21,1554494400,3,27,30,Rain
70793,22,1554494400,0,20,20,Rain
70794,23,1554494400,1,29,30,Rain
70795,24,1554494400,6,14,20,Rain
70796,25,1554494400,29,1,30,Rain
70797,26,1554494400,13,7,20,Rain
70798,27,1554494400,16,4,20,Rain
70799,28,1554494400,27,3,30,Rain
70800,29,1554494400,17,12,29,Rain
70801,30,1554494400,19,1,20,Rain
70802,31,1554494400,15,5,20,Rain
70803,32,1554494400,9,21,30,Rain
70804,33,1554494400,0,23,23,Rain
70805,34,1554494400,20,10,30,Rain
70806,35,1554494400,18,12,30,Rain
70807,36,1554494400,38,2,40,Rain
70808,37,1554494400,26,4,30,Rain
70809,38,1554494400,13,27,40,Rain
70810,39,1554494400,20,0,20,Rain
70811,40,1554494400,17,4,21,Rain
70812,41,1554494400,18,2,20,Rain
70813,42,1554494400,8,22,30,Rain
70814,43,1554494400,4,26,30,Rain
70815,44,1554494400,4,26,30,Rain
70816,45,1554494400,24,6,30,Rain
70817,46,1554494400,12,8,20,Rain
70818,47,1554494400,40,0,40,Rain
70819,48,1554494400,19,21,40,Rain
70820,49,1554494400,16,24,40,Rain
70821,50,1554494400,25,15,40,Rain
70822,51,1554494400,37,3,40,Rain
70823,52,1554494400,31,1,32,Rain
70824,53,1554494400,38,2,40,Rain
70825,54,1554494400,33,0,33,Rain
70826,55,1554494400,35,1,36,Rain
70827,56,1554494400,36,4,40,Rain
70828,57,1554494400,23,0,23,Rain
70829,58,1554494400,39,1,40,Rain
70830,59,1554494400,17,3,20,Rain
70831,60,1554494400,9,21,30,Rain
70832,61,1554494400,25,0,25,Rain
70833,62,1554494400,39,1,40,Rain
70834,63,1554494400,5,30,35,Rain
70835,64,1554494400,9,31,40,Rain
70836,65,1554494400,40,0,40,Rain
70837,66,1554494400,37,3,40,Rain
70838,67,1554494400,14,26,40,Rain
70839,68,1554494400,34,6,40,Rain
70840,69,1554494400,40,0,40,Rain
70841,70,1554494400,28,0,28,Rain
70842,71,1554494400,40,0,40,Rain
70843,72,1554494400,6,25,31,Rain
70844,73,1554494400,23,7,30,Rain
70845,74,1554494400,18,12,30,Rain
70846,75,1554494400,14,26,40,Rain
70847,76,1554494400,17,21,38,Rain
70848,77,1554494400,27,2,29,Rain
70849,78,1554494400,33,7,40,Rain
70850,79,1554494400,24,3,27,Rain
70851,80,1554494400,14,26,40,Rain
70852,81,1554494400,27,13,40,Rain
70853,82,1554494400,14,8,22,Rain
70854,83,1554494400,21,19,40,Rain
70855,84,1554494400,23,7,30,Rain
70856,85,1554494400,22,13,35,Rain
70857,86,1554494400,0,38,38,Rain
70858,87,1554494400,23,15,38,Rain
70859,88,1554494400,19,11,30,Rain
70860,89,1554494400,40,0,40,Rain
70861,90,1554494400,37,3,40,Rain
70862,91,1554494400,18,12,30,Rain
70863,92,1554494400,0,40,40,Rain
70864,93,1554494400,13,27,40,Rain
70865,94,1554494400,9,31,40,Rain
70866,95,1554494400,15,25,40,Rain
70867,96,1554494400,17,13,30,Rain
70868,97,1554494400,28,12,40,Rain
70869,98,1554494400,39,1,40,Rain
70870,99,1554494400,23,7,30,Rain
70871,100,1554494400,0,25,25,Rain
70872,101,1554494400,21,9,30,Rain
70873,102,1554494400,36,4,40,Rain
70874,103,1554494400,40,0,40,Rain
70875,104,1554494400,40,0,40,Rain
70876,105,1554494400,36,0,36,Rain
70877,106,1554494400,22,18,40,Rain
70878,107,1554494400,16,24,40,Rain
70879,108,1554494400,32,8,40,Rain
70880,109,1554494400,17,12,29,Rain
70881,110,1554494400,33,7,40,Rain
70882,111,1554494400,36,4,40,Rain
70883,112,1554494400,0,30,30,Rain
70884,113,1554494400,40,0,40,Rain
70885,114,1554494400,39,1,40,Rain
70886,115,1554494400,13,17,30,Rain
70887,2,1554498000,1,19,20,Rain
70888,3,1554498000,18,2,20,Rain
70889,4,1554498000,19,1,20,Rain
70890,5,1554498000,29,11,40,Rain
70891,6,1554498000,14,6,20,Rain
70892,7,1554498000,14,15,29,Rain
70893,8,1554498000,26,4,30,Rain
70894,9,1554498000,8,16,24,Rain
70895,10,1554498000,0,16,16,Rain
70896,11,1554498000,13,17,30,Rain
70897,12,1554498000,11,9,20,Rain
70898,13,1554498000,29,1,30,Rain
70899,14,1554498000,0,30,30,Rain
70900,15,1554498000,16,0,16,Rain
70901,16,1554498000,4,16,20,Rain
70902,17,1554498000,18,2,20,Rain
70903,18,1554498000,17,13,30,Rain
70904,19,1554498000,30,0,30,Rain
70905,21,1554498000,6,24,30,Rain
70906,22,1554498000,5,15,20,Rain
70907,23,1554498000,2,28,30,Rain
70908,24,1554498000,8,12,20,Rain
70909,25,1554498000,30,0,30,Rain
70910,26,1554498000,14,6,20,Rain
70911,27,1554498000,18,2,20,Rain
70912,28,1554498000,26,4,30,Rain
70913,29,1554498000,13,16,29,Rain
70914,30,1554498000,19,1,20,Rain
70915,31,1554498000,19,1,20,Rain
70916,32,1554498000,12,18,30,Rain
70917,33,1554498000,2,21,23,Rain
70918,34,1554498000,19,11,30,Rain
70919,35,1554498000,13,17,30,Rain
70920,36,1554498000,38,2,40,Rain
70921,37,1554498000,28,2,30,Rain
70922,38,1554498000,10,30,40,Rain
70923,39,1554498000,20,0,20,Rain
70924,40,1554498000,19,2,21,Rain
70925,41,1554498000,20,0,20,Rain
70926,42,1554498000,3,27,30,Rain
70927,43,1554498000,5,25,30,Rain
70928,44,1554498000,4,26,30,Rain
70929,45,1554498000,22,8,30,Rain
70930,46,1554498000,7,13,20,Rain
70931,47,1554498000,40,0,40,Rain
70932,48,1554498000,29,11,40,Rain
70933,49,1554498000,20,20,40,Rain
70934,50,1554498000,23,17,40,Rain
70935,51,1554498000,38,2,40,Rain
70936,52,1554498000,32,0,32,Rain
70937,53,1554498000,38,2,40,Rain
70938,54,1554498000,33,0,33,Rain
70939,55,1554498000,35,1,36,Rain
70940,56,1554498000,38,2,40,Rain
70941,57,1554498000,23,0,23,Rain
70942,58,1554498000,40,0,40,Rain
70943,59,1554498000,19,1,20,Rain
70944,60,1554498000,3,27,30,Rain
70945,61,1554498000,25,0,25,Rain
70946,62,1554498000,39,1,40,Rain
70947,63,1554498000,9,26,35,Rain
70948,64,1554498000,10,30,40,Rain
70949,65,1554498000,39,1,40,Rain
70950,66,1554498000,37,3,40,Rain
70951,67,1554498000,13,27,40,Rain
70952,68,1554498000,36,4,40,Rain
70953,69,1554498000,40,0,40,Rain
70954,70,1554498000,28,0,28,Rain
70955,71,1554498000,39,1,40,Rain
70956,72,1554498000,5,26,31,Rain
70957,73,1554498000,20,10,30,Rain
70958,74,1554498000,19,11,30,Rain
70959,75,1554498000,18,22,40,Rain
70960,76,1554498000,17,21,38,Rain
70961,77,1554498000,24,5,29,Rain
70962,78,1554498000,31,9,40,Rain
70963,79,1554498000,23,4,27,Rain
70964,80,1554498000,14,26,40,Rain
70965,81,1554498000,27,13,40,Rain
70966,82,1554498000,15,7,22,Rain
70967,83,1554498000,18,22,40,Rain
70968,84,1554498000,23,7,30,Rain
70969,85,1554498000,20,15,35,Rain
70970,86,1554498000,0,38,38,Rain
70971,87,1554498000,22,16,38,Rain
70972,88,1554498000,19,11,30,Rain
70973,89,1554498000,39,1,40,Rain
70974,90,1554498000,38,2,40,Rain
70975,91,1554498000,15,15,30,Rain
70976,92,1554498000,0,40,40,Rain
70977,93,1554498000,12,28,40,Rain
70978,94,1554498000,9,31,40,Rain
70979,95,1554498000,14,26,40,Rain
70980,96,1554498000,18,12,30,Rain
70981,97,1554498000,28,12,40,Rain
70982,98,1554498000,38,2,40,Rain
70983,99,1554498000,24,6,30,Rain
70984,100,1554498000,0,25,25,Rain
70985,101,1554498000,18,12,30,Rain
70986,102,1554498000,32,8,40,Rain
70987,103,1554498000,40,0,40,Rain
70988,104,1554498000,34,6,40,Rain
70989,105,1554498000,36,0,36,Rain
70990,106,1554498000,24,16,40,Rain
70991,107,1554498000,17,23,40,Rain
70992,108,1554498000,32,8,40,Rain
70993,109,1554498000,14,15,29,Rain
70994,110,1554498000,25,15,40,Rain
70995,111,1554498000,33,7,40,Rain
70996,112,1554498000,0,30,30,Rain
70997,113,1554498000,39,1,40,Rain
70998,114,1554498000,40,0,40,Rain
70999,115,1554498000,11,19,30,Rain
71000,2,1554501600,0,20,20,Rain
71001,3,1554501600,20,0,20,Rain
71002,4,1554501600,20,0,20,Rain
71003,5,1554501600,29,11,40,Rain
71004,6,1554501600,17,3,20,Rain
71005,7,1554501600,14,15,29,Rain
71006,8,1554501600,27,3,30,Rain
71007,9,1554501600,3,21,24,Rain
71008,10,1554501600,1,15,16,Rain
71009,11,1554501600,15,15,30,Rain
71010,12,1554501600,10,10,20,Rain
71011,13,1554501600,28,2,30,Rain
71012,14,1554501600,14,16,30,Rain
71013,15,1554501600,16,0,16,Rain
71014,16,1554501600,14,6,20,Rain
71015,17,1554501600,16,4,20,Rain
71016,18,1554501600,15,15,30,Rain
71017,19,1554501600,30,0,30,Rain
71018,21,1554501600,11,19,30,Rain
71019,22,1554501600,9,11,20,Rain
71020,23,1554501600,3,27,30,Rain
71021,24,1554501600,7,13,20,Rain
71022,25,1554501600,30,0,30,Rain
71023,26,1554501600,17,3,20,Rain
71024,27,1554501600,20,0,20,Rain
71025,28,1554501600,23,7,30,Rain
71026,29,1554501600,14,15,29,Rain
71027,30,1554501600,20,0,20,Rain
71028,31,1554501600,18,2,20,Rain
71029,32,1554501600,17,13,30,Rain
71030,33,1554501600,1,22,23,Rain
71031,34,1554501600,21,9,30,Rain
71032,35,1554501600,10,20,30,Rain
71033,36,1554501600,40,0,40,Rain
71034,37,1554501600,28,2,30,Rain
71035,38,1554501600,16,24,40,Rain
71036,39,1554501600,19,1,20,Rain
71037,40,1554501600,19,2,21,Rain
71038,41,1554501600,19,1,20,Rain
71039,42,1554501600,0,30,30,Rain
71040,43,1554501600,2,28,30,Rain
71041,44,1554501600,0,30,30,Rain
71042,45,1554501600,27,3,30,Rain
71043,46,1554501600,8,12,20,Rain
71044,47,1554501600,39,1,40,Rain
71045,48,1554501600,29,11,40,Rain
71046,49,1554501600,22,18,40,Rain
71047,50,1554501600,19,21,40,Rain
71048,51,1554501600,40,0,40,Rain
71049,52,1554501600,31,1,32,Rain
71050,53,1554501600,37,3,40,Rain
71051,54,1554501600,32,1,33,Rain
71052,55,1554501600,36,0,36,Rain
71053,56,1554501600,39,1,40,Rain
71054,57,1554501600,21,2,23,Rain
71055,58,1554501600,40,0,40,Rain
71056,59,1554501600,19,1,20,Rain
71057,60,1554501600,3,27,30,Rain
71058,61,1554501600,16,9,25,Rain
71059,62,1554501600,40,0,40,Rain
71060,63,1554501600,13,22,35,Rain
71061,64,1554501600,12,28,40,Rain
71062,65,1554501600,40,0,40,Rain
71063,66,1554501600,34,6,40,Rain
71064,67,1554501600,12,28,40,Rain
71065,68,1554501600,39,1,40,Rain
71066,69,1554501600,40,0,40,Rain
71067,70,1554501600,28,0,28,Rain
71068,71,1554501600,35,5,40,Rain
71069,72,1554501600,3,28,31,Rain
71070,73,1554501600,20,10,30,Rain
71071,74,1554501600,21,9,30,Rain
71072,75,1554501600,18,22,40,Rain
71073,76,1554501600,15,23,38,Rain
71074,77,1554501600,23,6,29,Rain
71075,78,1554501600,22,18,40,Rain
71076,79,1554501600,18,9,27,Rain
71077,80,1554501600,14,26,40,Rain
71078,81,1554501600,10,30,40,Rain
71079,82,1554501600,15,7,22,Rain
71080,83,1554501600,18,22,40,Rain
71081,84,1554501600,20,10,30,Rain
71082,85,1554501600,19,16,35,Rain
71083,86,1554501600,0,38,38,Rain
71084,87,1554501600,19,19,38,Rain
71085,88,1554501600,16,14,30,Rain
71086,89,1554501600,38,2,40,Rain
71087,90,1554501600,40,0,40,Rain
71088,91,1554501600,16,14,30,Rain
71089,92,1554501600,10,30,40,Rain
71090,93,1554501600,11,29,40,Rain
71091,94,1554501600,9,31,40,Rain
71092,95,1554501600,19,21,40,Rain
71093,96,1554501600,18,12,30,Rain
71094,97,1554501600,28,12,40,Rain
71095,98,1554501600,38,2,40,Rain
71096,99,1554501600,24,6,30,Rain
71097,100,1554501600,7,18,25,Rain
71098,101,1554501600,19,11,30,Rain
71099,102,1554501600,32,8,40,Rain
71100,103,1554501600,39,1,40,Rain
71101,104,1554501600,36,4,40,Rain
71102,105,1554501600,36,0,36,Rain
71103,106,1554501600,21,19,40,Rain
71104,107,1554501600,15,25,40,Rain
71105,108,1554501600,33,7,40,Rain
71106,109,1554501600,12,17,29,Rain
71107,110,1554501600,26,14,40,Rain
71108,111,1554501600,30,10,40,Rain
71109,112,1554501600,0,30,30,Rain
71110,113,1554501600,39,1,40,Rain
71111,114,1554501600,39,1,40,Rain
71112,115,1554501600,10,20,30,Rain
71113,2,1554505200,1,19,20,Rain
71114,3,1554505200,16,4,20,Rain
71115,4,1554505200,19,1,20,Rain
71116,5,1554505200,30,10,40,Rain
71117,6,1554505200,18,2,20,Rain
71118,7,1554505200,18,11,29,Rain
71119,8,1554505200,27,3,30,Rain
71120,9,1554505200,7,17,24,Rain
71121,10,1554505200,6,10,16,Rain
71122,11,1554505200,14,16,30,Rain
71123,12,1554505200,9,11,20,Rain
71124,13,1554505200,28,2,30,Rain
71125,14,1554505200,12,18,30,Rain
71126,15,1554505200,16,0,16,Rain
71127,16,1554505200,14,6,20,Rain
71128,17,1554505200,15,5,20,Rain
71129,18,1554505200,12,18,30,Rain
71130,19,1554505200,27,3,30,Rain
71131,21,1554505200,15,15,30,Rain
71132,22,1554505200,9,11,20,Rain
71133,23,1554505200,16,14,30,Rain
71134,24,1554505200,8,12,20,Rain
71135,25,1554505200,30,0,30,Rain
71136,26,1554505200,19,1,20,Rain
71137,27,1554505200,20,0,20,Rain
71138,28,1554505200,14,16,30,Rain
71139,29,1554505200,12,17,29,Rain
71140,30,1554505200,20,0,20,Rain
71141,31,1554505200,19,1,20,Rain
71142,32,1554505200,17,13,30,Rain
71143,33,1554505200,0,23,23,Rain
71144,34,1554505200,22,8,30,Rain
71145,35,1554505200,8,22,30,Rain
71146,36,1554505200,40,0,40,Rain
71147,37,1554505200,28,2,30,Rain
71148,38,1554505200,14,26,40,Rain
71149,39,1554505200,19,1,20,Rain
71150,40,1554505200,16,5,21,Rain
71151,41,1554505200,20,0,20,Rain
71152,42,1554505200,1,29,30,Rain
71153,43,1554505200,1,29,30,Rain
71154,44,1554505200,4,26,30,Rain
71155,45,1554505200,26,4,30,Rain
71156,46,1554505200,7,13,20,Rain
71157,47,1554505200,39,1,40,Rain
71158,48,1554505200,27,13,40,Rain
71159,49,1554505200,26,14,40,Rain
71160,50,1554505200,19,21,40,Rain
71161,51,1554505200,39,1,40,Rain
71162,52,1554505200,30,2,32,Rain
71163,53,1554505200,35,5,40,Rain
71164,54,1554505200,30,3,33,Rain
71165,55,1554505200,36,0,36,Rain
71166,56,1554505200,39,1,40,Rain
71167,57,1554505200,22,1,23,Rain
71168,58,1554505200,37,3,40,Rain
71169,59,1554505200,18,2,20,Rain
71170,60,1554505200,3,27,30,Rain
71171,61,1554505200,18,7,25,Rain
71172,62,1554505200,39,1,40,Rain
71173,63,1554505200,12,23,35,Rain
71174,64,1554505200,13,27,40,Rain
71175,65,1554505200,39,1,40,Rain
71176,66,1554505200,31,9,40,Rain
71177,67,1554505200,13,27,40,Rain
71178,68,1554505200,38,2,40,Rain
71179,69,1554505200,40,0,40,Rain
71180,70,1554505200,24,4,28,Rain
71181,71,1554505200,29,11,40,Rain
71182,72,1554505200,1,30,31,Rain
71183,73,1554505200,19,11,30,Rain
71184,74,1554505200,21,9,30,Rain
71185,75,1554505200,18,22,40,Rain
71186,76,1554505200,14,24,38,Rain
71187,77,1554505200,22,7,29,Rain
71188,78,1554505200,20,20,40,Rain
71189,79,1554505200,18,9,27,Rain
71190,80,1554505200,15,25,40,Rain
71191,81,1554505200,10,30,40,Rain
71192,82,1554505200,15,7,22,Rain
71193,83,1554505200,20,20,40,Rain
71194,84,1554505200,19,11,30,Rain
71195,85,1554505200,17,18,35,Rain
71196,86,1554505200,1,37,38,Rain
71197,87,1554505200,19,19,38,Rain
71198,88,1554505200,16,14,30,Rain
71199,89,1554505200,38,2,40,Rain
71200,90,1554505200,40,0,40,Rain
71201,91,1554505200,19,11,30,Rain
71202,92,1554505200,10,30,40,Rain
71203,93,1554505200,11,29,40,Rain
71204,94,1554505200,9,31,40,Rain
71205,95,1554505200,17,23,40,Rain
71206,96,1554505200,19,11,30,Rain
71207,97,1554505200,27,13,40,Rain
71208,98,1554505200,40,0,40,Rain
71209,99,1554505200,24,6,30,Rain
71210,100,1554505200,7,18,25,Rain
71211,101,1554505200,17,13,30,Rain
71212,102,1554505200,31,9,40,Rain
71213,103,1554505200,39,1,40,Rain
71214,104,1554505200,37,3,40,Rain
71215,105,1554505200,36,0,36,Rain
71216,106,1554505200,21,19,40,Rain
71217,107,1554505200,16,24,40,Rain
71218,108,1554505200,33,7,40,Rain
71219,109,1554505200,10,19,29,Rain
71220,110,1554505200,27,13,40,Rain
71221,111,1554505200,25,15,40,Rain
71222,112,1554505200,1,29,30,Rain
71223,113,1554505200,39,1,40,Rain
71224,114,1554505200,40,0,40,Rain
71225,115,1554505200,7,23,30,Rain
71226,2,1554508800,2,18,20,Rain
71227,3,1554508800,16,4,20,Rain
71228,4,1554508800,19,1,20,Rain
71229,5,1554508800,33,7,40,Rain
71230,6,1554508800,20,0,20,Rain
71231,7,1554508800,17,12,29,Rain
71232,8,1554508800,29,1,30,Rain
71233,9,1554508800,22,2,24,Rain
71234,10,1554508800,10,6,16,Rain
71235,11,1554508800,14,16,30,Rain
71236,12,1554508800,9,11,20,Rain
71237,13,1554508800,28,2,30,Rain
71238,14,1554508800,15,15,30,Rain
71239,15,1554508800,15,1,16,Rain
71240,16,1554508800,14,6,20,Rain
71241,17,1554508800,15,5,20,Rain
71242,18,1554508800,16,14,30,Rain
71243,19,1554508800,28,2,30,Rain
71244,21,1554508800,20,10,30,Rain
71245,22,1554508800,13,7,20,Rain
71246,23,1554508800,15,15,30,Rain
71247,24,1554508800,12,8,20,Rain
71248,25,1554508800,30,0,30,Rain
71249,26,1554508800,20,0,20,Rain
71250,27,1554508800,17,3,20,Rain
71251,28,1554508800,12,18,30,Rain
71252,29,1554508800,14,15,29,Rain
71253,30,1554508800,19,1,20,Rain
71254,31,1554508800,17,3,20,Rain
71255,32,1554508800,15,15,30,Rain
71256,33,1554508800,1,22,23,Rain
71257,34,1554508800,17,13,30,Rain
71258,35,1554508800,7,23,30,Rain
71259,36,1554508800,40,0,40,Rain
71260,37,1554508800,29,1,30,Rain
71261,38,1554508800,15,25,40,Rain
71262,39,1554508800,19,1,20,Rain
71263,40,1554508800,18,3,21,Rain
71264,41,1554508800,20,0,20,Rain
71265,42,1554508800,0,30,30,Rain
71266,43,1554508800,0,30,30,Rain
71267,44,1554508800,0,30,30,Rain
71268,45,1554508800,28,2,30,Rain
71269,46,1554508800,8,12,20,Rain
71270,47,1554508800,39,1,40,Rain
71271,48,1554508800,28,12,40,Rain
71272,49,1554508800,23,17,40,Rain
71273,50,1554508800,17,23,40,Rain
71274,51,1554508800,40,0,40,Rain
71275,52,1554508800,30,2,32,Rain
71276,53,1554508800,36,4,40,Rain
71277,54,1554508800,31,2,33,Rain
71278,55,1554508800,36,0,36,Rain
71279,56,1554508800,38,2,40,Rain
71280,57,1554508800,22,1,23,Rain
71281,58,1554508800,38,2,40,Rain
71282,59,1554508800,16,4,20,Rain
71283,60,1554508800,3,27,30,Rain
71284,61,1554508800,20,5,25,Rain
71285,62,1554508800,39,1,40,Rain
71286,63,1554508800,13,22,35,Rain
71287,64,1554508800,12,28,40,Rain
71288,65,1554508800,39,1,40,Rain
71289,66,1554508800,26,14,40,Rain
71290,67,1554508800,15,25,40,Rain
71291,68,1554508800,40,0,40,Rain
71292,69,1554508800,39,1,40,Rain
71293,70,1554508800,23,5,28,Rain
71294,71,1554508800,30,10,40,Rain
71295,72,1554508800,3,28,31,Rain
71296,73,1554508800,16,14,30,Rain
71297,74,1554508800,23,7,30,Rain
71298,75,1554508800,16,24,40,Rain
71299,76,1554508800,15,23,38,Rain
71300,77,1554508800,21,8,29,Rain
71301,78,1554508800,21,19,40,Rain
71302,79,1554508800,18,9,27,Rain
71303,80,1554508800,11,28,39,Rain
71304,81,1554508800,10,30,40,Rain
71305,82,1554508800,13,9,22,Rain
71306,83,1554508800,21,19,40,Rain
71307,84,1554508800,18,12,30,Rain
71308,85,1554508800,17,18,35,Rain
71309,86,1554508800,4,34,38,Rain
71310,87,1554508800,18,20,38,Rain
71311,88,1554508800,11,19,30,Rain
71312,89,1554508800,38,2,40,Rain
71313,90,1554508800,40,0,40,Rain
71314,91,1554508800,17,13,30,Rain
71315,92,1554508800,9,31,40,Rain
71316,93,1554508800,11,29,40,Rain
71317,94,1554508800,9,31,40,Rain
71318,95,1554508800,18,22,40,Rain
71319,96,1554508800,22,8,30,Rain
71320,97,1554508800,24,16,40,Rain
71321,98,1554508800,40,0,40,Rain
71322,99,1554508800,23,7,30,Rain
71323,100,1554508800,6,19,25,Rain
71324,101,1554508800,14,15,29,Rain
71325,102,1554508800,29,11,40,Rain
71326,103,1554508800,39,1,40,Rain
71327,104,1554508800,37,3,40,Rain
71328,105,1554508800,36,0,36,Rain
71329,106,1554508800,20,20,40,Rain
71330,107,1554508800,16,24,40,Rain
71331,108,1554508800,32,8,40,Rain
71332,109,1554508800,6,23,29,Rain
71333,110,1554508800,28,12,40,Rain
71334,111,1554508800,22,18,40,Rain
71335,112,1554508800,0,30,30,Rain
71336,113,1554508800,39,1,40,Rain
71337,114,1554508800,40,0,40,Rain
71338,115,1554508800,1,29,30,Rain
71339,2,1554512400,2,18,20,Rain
71340,3,1554512400,16,4,20,Rain
71341,4,1554512400,19,1,20,Rain
71342,5,1554512400,34,6,40,Rain
71343,6,1554512400,20,0,20,Rain
71344,7,1554512400,19,10,29,Rain
71345,8,1554512400,30,0,30,Rain
71346,9,1554512400,24,0,24,Rain
71347,10,1554512400,10,6,16,Rain
71348,11,1554512400,14,16,30,Rain
71349,12,1554512400,7,13,20,Rain
71350,13,1554512400,29,1,30,Rain
71351,14,1554512400,18,12,30,Rain
71352,15,1554512400,15,1,16,Rain
71353,16,1554512400,14,6,20,Rain
71354,17,1554512400,15,5,20,Rain
71355,18,1554512400,19,11,30,Rain
71356,19,1554512400,30,0,30,Rain
71357,21,1554512400,22,8,30,Rain
71358,22,1554512400,15,5,20,Rain
71359,23,1554512400,14,16,30,Rain
71360,24,1554512400,12,8,20,Rain
71361,25,1554512400,30,0,30,Rain
71362,26,1554512400,20,0,20,Rain
71363,27,1554512400,19,1,20,Rain
71364,28,1554512400,10,20,30,Rain
71365,29,1554512400,15,14,29,Rain
71366,30,1554512400,19,1,20,Rain
71367,31,1554512400,14,6,20,Rain
71368,32,1554512400,14,16,30,Rain
71369,33,1554512400,3,20,23,Rain
71370,34,1554512400,18,12,30,Rain
71371,35,1554512400,7,23,30,Rain
71372,36,1554512400,40,0,40,Rain
71373,37,1554512400,29,1,30,Rain
71374,38,1554512400,19,21,40,Rain
71375,39,1554512400,19,1,20,Rain
71376,40,1554512400,20,1,21,Rain
71377,41,1554512400,20,0,20,Rain
71378,42,1554512400,0,30,30,Rain
71379,43,1554512400,2,28,30,Rain
71380,44,1554512400,0,30,30,Rain
71381,45,1554512400,26,4,30,Rain
71382,46,1554512400,8,12,20,Rain
71383,47,1554512400,38,2,40,Rain
71384,48,1554512400,29,11,40,Rain
71385,49,1554512400,23,17,40,Rain
71386,50,1554512400,17,23,40,Rain
71387,51,1554512400,40,0,40,Rain
71388,52,1554512400,30,2,32,Rain
71389,53,1554512400,36,4,40,Rain
71390,54,1554512400,32,1,33,Rain
71391,55,1554512400,36,0,36,Rain
71392,56,1554512400,35,5,40,Rain
71393,57,1554512400,22,1,23,Rain
71394,58,1554512400,38,2,40,Rain
71395,59,1554512400,17,3,20,Rain
71396,60,1554512400,0,30,30,Rain
71397,61,1554512400,20,5,25,Rain
71398,62,1554512400,39,1,40,Rain
71399,63,1554512400,14,21,35,Rain
71400,64,1554512400,13,27,40,Rain
71401,65,1554512400,39,1,40,Rain
71402,66,1554512400,25,15,40,Rain
71403,67,1554512400,13,27,40,Rain
71404,68,1554512400,40,0,40,Rain
71405,69,1554512400,38,2,40,Rain
71406,70,1554512400,24,4,28,Rain
71407,71,1554512400,30,10,40,Rain
71408,72,1554512400,1,30,31,Rain
71409,73,1554512400,15,15,30,Rain
71410,74,1554512400,23,7,30,Rain
71411,75,1554512400,16,24,40,Rain
71412,76,1554512400,15,23,38,Rain
71413,77,1554512400,21,8,29,Rain
71414,78,1554512400,20,20,40,Rain
71415,79,1554512400,18,9,27,Rain
71416,80,1554512400,11,28,39,Rain
71417,81,1554512400,10,30,40,Rain
71418,82,1554512400,14,8,22,Rain
71419,83,1554512400,18,22,40,Rain
71420,84,1554512400,16,14,30,Rain
71421,85,1554512400,16,19,35,Rain
71422,86,1554512400,4,34,38,Rain
71423,87,1554512400,18,20,38,Rain
71424,88,1554512400,10,20,30,Rain
71425,89,1554512400,38,2,40,Rain
71426,90,1554512400,40,0,40,Rain
71427,91,1554512400,16,14,30,Rain
71428,92,1554512400,8,32,40,Rain
71429,93,1554512400,11,29,40,Rain
71430,94,1554512400,9,31,40,Rain
71431,95,1554512400,14,26,40,Rain
71432,96,1554512400,22,8,30,Rain
71433,97,1554512400,24,16,40,Rain
71434,98,1554512400,40,0,40,Rain
71435,99,1554512400,23,7,30,Rain
71436,100,1554512400,6,19,25,Rain
71437,101,1554512400,14,16,30,Rain
71438,102,1554512400,29,11,40,Rain
71439,103,1554512400,39,1,40,Rain
71440,104,1554512400,37,3,40,Rain
71441,105,1554512400,35,1,36,Rain
71442,106,1554512400,20,20,40,Rain
71443,107,1554512400,15,25,40,Rain
71444,108,1554512400,32,8,40,Rain
71445,109,1554512400,2,27,29,Rain
71446,110,1554512400,26,14,40,Rain
71447,111,1554512400,20,20,40,Rain
71448,112,1554512400,0,30,30,Rain
71449,113,1554512400,40,0,40,Rain
71450,114,1554512400,39,1,40,Rain
71451,115,1554512400,1,29,30,Rain
71452,2,1554516000,2,18,20,Rain
71453,3,1554516000,16,4,20,Rain
71454,4,1554516000,19,1,20,Rain
71455,5,1554516000,34,6,40,Rain
71456,6,1554516000,20,0,20,Rain
71457,7,1554516000,19,10,29,Rain
71458,8,1554516000,30,0,30,Rain
71459,9,1554516000,24,0,24,Rain
71460,10,1554516000,10,6,16,Rain
71461,11,1554516000,14,16,30,Rain
71462,12,1554516000,7,13,20,Rain
71463,13,1554516000,29,1,30,Rain
71464,14,1554516000,18,12,30,Rain
71465,15,1554516000,15,1,16,Rain
71466,16,1554516000,14,6,20,Rain
71467,17,1554516000,15,5,20,Rain
71468,18,1554516000,19,11,30,Rain
71469,19,1554516000,30,0,30,Rain
71470,21,1554516000,22,8,30,Rain
71471,22,1554516000,15,5,20,Rain
71472,23,1554516000,14,16,30,Rain
71473,24,1554516000,12,8,20,Rain
71474,25,1554516000,30,0,30,Rain
71475,26,1554516000,20,0,20,Rain
71476,27,1554516000,19,1,20,Rain
71477,28,1554516000,10,20,30,Rain
71478,29,1554516000,15,14,29,Rain
71479,30,1554516000,19,1,20,Rain
71480,31,1554516000,14,6,20,Rain
71481,32,1554516000,14,16,30,Rain
71482,33,1554516000,3,20,23,Rain
71483,34,1554516000,18,12,30,Rain
71484,35,1554516000,7,23,30,Rain
71485,36,1554516000,40,0,40,Rain
71486,37,1554516000,29,1,30,Rain
71487,38,1554516000,19,21,40,Rain
71488,39,1554516000,19,1,20,Rain
71489,40,1554516000,20,1,21,Rain
71490,41,1554516000,20,0,20,Rain
71491,42,1554516000,0,30,30,Rain
71492,43,1554516000,2,28,30,Rain
71493,44,1554516000,0,30,30,Rain
71494,45,1554516000,26,4,30,Rain
71495,46,1554516000,8,12,20,Rain
71496,47,1554516000,38,2,40,Rain
71497,48,1554516000,29,11,40,Rain
71498,49,1554516000,23,17,40,Rain
71499,50,1554516000,17,23,40,Rain
71500,51,1554516000,40,0,40,Rain
71501,52,1554516000,30,2,32,Rain
71502,53,1554516000,36,4,40,Rain
71503,54,1554516000,31,2,33,Rain
71504,55,1554516000,36,0,36,Rain
71505,56,1554516000,35,5,40,Rain
71506,57,1554516000,22,1,23,Rain
71507,58,1554516000,38,2,40,Rain
71508,59,1554516000,16,4,20,Rain
71509,60,1554516000,0,30,30,Rain
71510,61,1554516000,20,5,25,Rain
71511,62,1554516000,39,1,40,Rain
71512,63,1554516000,14,21,35,Rain
71513,64,1554516000,12,28,40,Rain
71514,65,1554516000,39,1,40,Rain
71515,66,1554516000,25,15,40,Rain
71516,67,1554516000,13,27,40,Rain
71517,68,1554516000,40,0,40,Rain
71518,69,1554516000,38,2,40,Rain
71519,70,1554516000,24,4,28,Rain
71520,71,1554516000,30,10,40,Rain
71521,72,1554516000,1,30,31,Rain
71522,73,1554516000,15,15,30,Rain
71523,74,1554516000,23,7,30,Rain
71524,75,1554516000,16,24,40,Rain
71525,76,1554516000,15,23,38,Rain
71526,77,1554516000,21,8,29,Rain
71527,78,1554516000,20,20,40,Rain
71528,79,1554516000,18,9,27,Rain
71529,80,1554516000,11,28,39,Rain
71530,81,1554516000,10,30,40,Rain
71531,82,1554516000,14,8,22,Rain
71532,83,1554516000,18,22,40,Rain
71533,84,1554516000,15,15,30,Rain
71534,85,1554516000,16,19,35,Rain
71535,86,1554516000,4,34,38,Rain
71536,87,1554516000,18,20,38,Rain
71537,88,1554516000,10,20,30,Rain
71538,89,1554516000,38,2,40,Rain
71539,90,1554516000,40,0,40,Rain
71540,91,1554516000,16,14,30,Rain
71541,92,1554516000,8,32,40,Rain
71542,93,1554516000,11,29,40,Rain
71543,94,1554516000,9,31,40,Rain
71544,95,1554516000,14,26,40,Rain
71545,96,1554516000,22,8,30,Rain
71546,97,1554516000,24,16,40,Rain
71547,98,1554516000,40,0,40,Rain
71548,99,1554516000,23,7,30,Rain
71549,100,1554516000,6,19,25,Rain
71550,101,1554516000,14,16,30,Rain
71551,102,1554516000,29,11,40,Rain
71552,103,1554516000,39,1,40,Rain
71553,104,1554516000,37,3,40,Rain
71554,105,1554516000,35,1,36,Rain
71555,106,1554516000,20,20,40,Rain
71556,107,1554516000,15,25,40,Rain
71557,108,1554516000,32,8,40,Rain
71558,109,1554516000,2,27,29,Rain
71559,110,1554516000,26,14,40,Rain
71560,111,1554516000,20,20,40,Rain
71561,112,1554516000,0,30,30,Rain
71562,113,1554516000,40,0,40,Rain
71563,114,1554516000,39,1,40,Rain
71564,115,1554516000,1,29,30,Rain
71565,2,1554519600,2,18,20,Rain
71566,3,1554519600,16,4,20,Rain
71567,4,1554519600,19,1,20,Rain
71568,5,1554519600,34,6,40,Rain
71569,6,1554519600,20,0,20,Rain
71570,7,1554519600,19,10,29,Rain
71571,8,1554519600,30,0,30,Rain
71572,9,1554519600,24,0,24,Rain
71573,10,1554519600,10,6,16,Rain
71574,11,1554519600,14,16,30,Rain
71575,12,1554519600,7,13,20,Rain
71576,13,1554519600,29,1,30,Rain
71577,14,1554519600,18,12,30,Rain
71578,15,1554519600,15,1,16,Rain
71579,16,1554519600,14,6,20,Rain
71580,17,1554519600,15,5,20,Rain
71581,18,1554519600,19,11,30,Rain
71582,19,1554519600,30,0,30,Rain
71583,21,1554519600,22,8,30,Rain
71584,22,1554519600,15,5,20,Rain
71585,23,1554519600,14,16,30,Rain
71586,24,1554519600,12,8,20,Rain
71587,25,1554519600,30,0,30,Rain
71588,26,1554519600,20,0,20,Rain
71589,27,1554519600,19,1,20,Rain
71590,28,1554519600,9,21,30,Rain
71591,29,1554519600,15,14,29,Rain
71592,30,1554519600,19,1,20,Rain
71593,31,1554519600,14,6,20,Rain
71594,32,1554519600,14,16,30,Rain
71595,33,1554519600,3,20,23,Rain
71596,34,1554519600,18,12,30,Rain
71597,35,1554519600,7,23,30,Rain
71598,36,1554519600,40,0,40,Rain
71599,37,1554519600,29,1,30,Rain
71600,38,1554519600,19,21,40,Rain
71601,39,1554519600,19,1,20,Rain
71602,40,1554519600,20,1,21,Rain
71603,41,1554519600,20,0,20,Rain
71604,42,1554519600,0,30,30,Rain
71605,43,1554519600,2,28,30,Rain
71606,44,1554519600,0,30,30,Rain
71607,45,1554519600,26,4,30,Rain
71608,46,1554519600,8,12,20,Rain
71609,47,1554519600,38,2,40,Rain
71610,48,1554519600,29,11,40,Rain
71611,49,1554519600,23,17,40,Rain
71612,50,1554519600,17,23,40,Rain
71613,51,1554519600,40,0,40,Rain
71614,52,1554519600,30,2,32,Rain
71615,53,1554519600,36,4,40,Rain
71616,54,1554519600,31,2,33,Rain
71617,55,1554519600,36,0,36,Rain
71618,56,1554519600,35,5,40,Rain
71619,57,1554519600,22,1,23,Rain
71620,58,1554519600,38,2,40,Rain
71621,59,1554519600,16,4,20,Rain
71622,60,1554519600,0,30,30,Rain
71623,61,1554519600,20,5,25,Rain
71624,62,1554519600,39,1,40,Rain
71625,63,1554519600,14,21,35,Rain
71626,64,1554519600,12,28,40,Rain
71627,65,1554519600,39,1,40,Rain
71628,66,1554519600,25,15,40,Rain
71629,67,1554519600,13,27,40,Rain
71630,68,1554519600,40,0,40,Rain
71631,69,1554519600,38,2,40,Rain
71632,70,1554519600,24,4,28,Rain
71633,71,1554519600,30,10,40,Rain
71634,72,1554519600,1,30,31,Rain
71635,73,1554519600,15,15,30,Rain
71636,74,1554519600,23,7,30,Rain
71637,75,1554519600,16,24,40,Rain
71638,76,1554519600,15,23,38,Rain
71639,77,1554519600,21,8,29,Rain
71640,78,1554519600,20,20,40,Rain
71641,79,1554519600,18,9,27,Rain
71642,80,1554519600,11,28,39,Rain
71643,81,1554519600,10,30,40,Rain
71644,82,1554519600,14,8,22,Rain
71645,83,1554519600,18,22,40,Rain
71646,84,1554519600,15,15,30,Rain
71647,85,1554519600,16,19,35,Rain
71648,86,1554519600,4,34,38,Rain
71649,87,1554519600,18,20,38,Rain
71650,88,1554519600,9,21,30,Rain
71651,89,1554519600,38,2,40,Rain
71652,90,1554519600,40,0,40,Rain
71653,91,1554519600,16,14,30,Rain
71654,92,1554519600,8,32,40,Rain
71655,93,1554519600,11,29,40,Rain
71656,94,1554519600,9,31,40,Rain
71657,95,1554519600,14,26,40,Rain
71658,96,1554519600,22,8,30,Rain
71659,97,1554519600,24,16,40,Rain
71660,98,1554519600,40,0,40,Rain
71661,99,1554519600,23,7,30,Rain
71662,100,1554519600,6,19,25,Rain
71663,101,1554519600,14,16,30,Rain
71664,102,1554519600,29,11,40,Rain
71665,103,1554519600,39,1,40,Rain
71666,104,1554519600,37,3,40,Rain
71667,105,1554519600,35,1,36,Rain
71668,106,1554519600,20,20,40,Rain
71669,107,1554519600,15,25,40,Rain
71670,108,1554519600,32,8,40,Rain
71671,109,1554519600,2,27,29,Rain
71672,110,1554519600,26,14,40,Rain
71673,111,1554519600,20,20,40,Rain
71674,112,1554519600,0,30,30,Rain
71675,113,1554519600,40,0,40,Rain
71676,114,1554519600,39,1,40,Rain
71677,115,1554519600,1,29,30,Rain
71678,2,1554526800,2,18,20,Rain
71679,3,1554526800,16,4,20,Rain
71680,4,1554526800,19,1,20,Rain
71681,5,1554526800,34,6,40,Rain
71682,6,1554526800,20,0,20,Rain
71683,7,1554526800,19,10,29,Rain
71684,8,1554526800,30,0,30,Rain
71685,9,1554526800,24,0,24,Rain
71686,10,1554526800,10,6,16,Rain
71687,11,1554526800,14,16,30,Rain
71688,12,1554526800,7,13,20,Rain
71689,13,1554526800,29,1,30,Rain
71690,14,1554526800,18,12,30,Rain
71691,15,1554526800,15,1,16,Rain
71692,16,1554526800,14,6,20,Rain
71693,17,1554526800,15,5,20,Rain
71694,18,1554526800,19,11,30,Rain
71695,19,1554526800,30,0,30,Rain
71696,21,1554526800,22,8,30,Rain
71697,22,1554526800,15,5,20,Rain
71698,23,1554526800,14,16,30,Rain
71699,24,1554526800,12,8,20,Rain
71700,25,1554526800,30,0,30,Rain
71701,26,1554526800,20,0,20,Rain
71702,27,1554526800,19,1,20,Rain
71703,28,1554526800,9,21,30,Rain
71704,29,1554526800,15,14,29,Rain
71705,30,1554526800,19,1,20,Rain
71706,31,1554526800,14,6,20,Rain
71707,32,1554526800,14,16,30,Rain
71708,33,1554526800,3,20,23,Rain
71709,34,1554526800,18,12,30,Rain
71710,35,1554526800,7,23,30,Rain
71711,36,1554526800,40,0,40,Rain
71712,37,1554526800,29,1,30,Rain
71713,38,1554526800,18,22,40,Rain
71714,39,1554526800,19,1,20,Rain
71715,40,1554526800,20,1,21,Rain
71716,41,1554526800,20,0,20,Rain
71717,42,1554526800,0,30,30,Rain
71718,43,1554526800,2,28,30,Rain
71719,44,1554526800,0,30,30,Rain
71720,45,1554526800,26,4,30,Rain
71721,46,1554526800,8,12,20,Rain
71722,47,1554526800,38,2,40,Rain
71723,48,1554526800,29,11,40,Rain
71724,49,1554526800,23,17,40,Rain
71725,50,1554526800,17,23,40,Rain
71726,51,1554526800,40,0,40,Rain
71727,52,1554526800,30,2,32,Rain
71728,53,1554526800,36,4,40,Rain
71729,54,1554526800,31,2,33,Rain
71730,55,1554526800,36,0,36,Rain
71731,56,1554526800,35,5,40,Rain
71732,57,1554526800,22,1,23,Rain
71733,58,1554526800,38,2,40,Rain
71734,59,1554526800,16,4,20,Rain
71735,60,1554526800,0,30,30,Rain
71736,61,1554526800,20,5,25,Rain
71737,62,1554526800,39,1,40,Rain
71738,63,1554526800,14,21,35,Rain
71739,64,1554526800,12,28,40,Rain
71740,65,1554526800,39,1,40,Rain
71741,66,1554526800,25,15,40,Rain
71742,67,1554526800,13,27,40,Rain
71743,68,1554526800,40,0,40,Rain
71744,69,1554526800,38,2,40,Rain
71745,70,1554526800,24,4,28,Rain
71746,71,1554526800,30,10,40,Rain
71747,72,1554526800,1,30,31,Rain
71748,73,1554526800,15,15,30,Rain
71749,74,1554526800,23,7,30,Rain
71750,75,1554526800,16,24,40,Rain
71751,76,1554526800,15,23,38,Rain
71752,77,1554526800,21,8,29,Rain
71753,78,1554526800,20,20,40,Rain
71754,79,1554526800,18,9,27,Rain
71755,80,1554526800,11,28,39,Rain
71756,81,1554526800,10,30,40,Rain
71757,82,1554526800,14,8,22,Rain
71758,83,1554526800,18,22,40,Rain
71759,84,1554526800,15,15,30,Rain
71760,85,1554526800,16,19,35,Rain
71761,86,1554526800,4,34,38,Rain
71762,87,1554526800,18,20,38,Rain
71763,88,1554526800,9,21,30,Rain
71764,89,1554526800,38,2,40,Rain
71765,90,1554526800,40,0,40,Rain
71766,91,1554526800,16,14,30,Rain
71767,92,1554526800,8,32,40,Rain
71768,93,1554526800,11,29,40,Rain
71769,94,1554526800,9,31,40,Rain
71770,95,1554526800,14,26,40,Rain
71771,96,1554526800,22,8,30,Rain
71772,97,1554526800,24,16,40,Rain
71773,98,1554526800,40,0,40,Rain
71774,99,1554526800,23,7,30,Rain
71775,100,1554526800,6,19,25,Rain
71776,101,1554526800,14,16,30,Rain
71777,102,1554526800,29,11,40,Rain
71778,103,1554526800,39,1,40,Rain
71779,104,1554526800,37,3,40,Rain
71780,105,1554526800,35,1,36,Rain
71781,106,1554526800,20,20,40,Rain
71782,107,1554526800,15,25,40,Rain
71783,108,1554526800,32,8,40,Rain
71784,109,1554526800,2,27,29,Rain
71785,110,1554526800,26,14,40,Rain
71786,111,1554526800,20,20,40,Rain
71787,112,1554526800,0,30,30,Rain
71788,113,1554526800,40,0,40,Rain
71789,114,1554526800,39,1,40,Rain
71790,115,1554526800,1,29,30,Rain
71791,2,1554530400,4,16,20,Clouds
71792,3,1554530400,17,3,20,Clouds
71793,4,1554530400,20,0,20,Clouds
71794,5,1554530400,34,6,40,Clouds
71795,6,1554530400,20,0,20,Clouds
71796,7,1554530400,20,9,29,Clouds
71797,8,1554530400,30,0,30,Clouds
71798,9,1554530400,24,0,24,Clouds
71799,10,1554530400,11,5,16,Clouds
71800,11,1554530400,15,15,30,Clouds
71801,12,1554530400,9,11,20,Clouds
71802,13,1554530400,29,1,30,Clouds
71803,14,1554530400,17,13,30,Clouds
71804,15,1554530400,14,2,16,Clouds
71805,16,1554530400,14,6,20,Clouds
71806,17,1554530400,16,4,20,Clouds
71807,18,1554530400,18,12,30,Clouds
71808,19,1554530400,30,0,30,Clouds
71809,21,1554530400,22,8,30,Clouds
71810,22,1554530400,14,6,20,Clouds
71811,23,1554530400,14,16,30,Clouds
71812,24,1554530400,10,10,20,Clouds
71813,25,1554530400,30,0,30,Clouds
71814,26,1554530400,20,0,20,Clouds
71815,27,1554530400,19,1,20,Clouds
71816,28,1554530400,9,21,30,Clouds
71817,29,1554530400,14,15,29,Clouds
71818,30,1554530400,19,1,20,Clouds
71819,31,1554530400,14,6,20,Clouds
71820,32,1554530400,16,14,30,Clouds
71821,33,1554530400,0,23,23,Clouds
71822,34,1554530400,20,10,30,Clouds
71823,35,1554530400,8,22,30,Clouds
71824,36,1554530400,40,0,40,Clouds
71825,37,1554530400,29,1,30,Clouds
71826,38,1554530400,18,22,40,Clouds
71827,39,1554530400,18,2,20,Clouds
71828,40,1554530400,19,2,21,Clouds
71829,41,1554530400,20,0,20,Clouds
71830,42,1554530400,1,29,30,Clouds
71831,43,1554530400,2,28,30,Clouds
71832,44,1554530400,1,29,30,Clouds
71833,45,1554530400,25,5,30,Clouds
71834,46,1554530400,8,12,20,Clouds
71835,47,1554530400,38,2,40,Clouds
71836,48,1554530400,28,12,40,Clouds
71837,49,1554530400,22,18,40,Clouds
71838,50,1554530400,18,22,40,Clouds
71839,51,1554530400,40,0,40,Clouds
71840,52,1554530400,28,4,32,Clouds
71841,53,1554530400,37,3,40,Clouds
71842,54,1554530400,31,2,33,Clouds
71843,55,1554530400,36,0,36,Clouds
71844,56,1554530400,36,4,40,Clouds
71845,57,1554530400,21,2,23,Clouds
71846,58,1554530400,37,3,40,Clouds
71847,59,1554530400,16,4,20,Clouds
71848,60,1554530400,1,29,30,Clouds
71849,61,1554530400,20,5,25,Clouds
71850,62,1554530400,39,1,40,Clouds
71851,63,1554530400,14,21,35,Clouds
71852,64,1554530400,12,28,40,Clouds
71853,65,1554530400,39,1,40,Clouds
71854,66,1554530400,25,15,40,Clouds
71855,67,1554530400,12,28,40,Clouds
71856,68,1554530400,40,0,40,Clouds
71857,69,1554530400,39,1,40,Clouds
71858,70,1554530400,22,6,28,Clouds
71859,71,1554530400,33,7,40,Clouds
71860,72,1554530400,0,31,31,Clouds
71861,73,1554530400,14,16,30,Clouds
71862,74,1554530400,23,7,30,Clouds
71863,75,1554530400,16,24,40,Clouds
71864,76,1554530400,18,20,38,Clouds
71865,77,1554530400,20,9,29,Clouds
71866,78,1554530400,21,19,40,Clouds
71867,79,1554530400,18,9,27,Clouds
71868,80,1554530400,12,27,39,Clouds
71869,81,1554530400,10,30,40,Clouds
71870,82,1554530400,15,7,22,Clouds
71871,83,1554530400,18,22,40,Clouds
71872,84,1554530400,13,17,30,Clouds
71873,85,1554530400,16,19,35,Clouds
71874,86,1554530400,4,34,38,Clouds
71875,87,1554530400,18,20,38,Clouds
71876,88,1554530400,7,23,30,Clouds
71877,89,1554530400,38,2,40,Clouds
71878,90,1554530400,40,0,40,Clouds
71879,91,1554530400,15,15,30,Clouds
71880,92,1554530400,8,32,40,Clouds
71881,93,1554530400,11,29,40,Clouds
71882,94,1554530400,9,31,40,Clouds
71883,95,1554530400,14,26,40,Clouds
71884,96,1554530400,22,8,30,Clouds
71885,97,1554530400,25,15,40,Clouds
71886,98,1554530400,40,0,40,Clouds
71887,99,1554530400,23,7,30,Clouds
71888,100,1554530400,6,19,25,Clouds
71889,101,1554530400,14,16,30,Clouds
71890,102,1554530400,28,12,40,Clouds
71891,103,1554530400,39,1,40,Clouds
71892,104,1554530400,37,3,40,Clouds
71893,105,1554530400,35,1,36,Clouds
71894,106,1554530400,20,20,40,Clouds
71895,107,1554530400,17,23,40,Clouds
71896,108,1554530400,33,7,40,Clouds
71897,109,1554530400,4,25,29,Clouds
71898,110,1554530400,26,14,40,Clouds
71899,111,1554530400,22,18,40,Clouds
71900,112,1554530400,2,28,30,Clouds
71901,113,1554530400,40,0,40,Clouds
71902,114,1554530400,39,1,40,Clouds
71903,115,1554530400,1,29,30,Clouds
71904,2,1554534000,12,8,20,Mist
71905,3,1554534000,17,3,20,Mist
71906,4,1554534000,20,0,20,Mist
71907,5,1554534000,35,5,40,Mist
71908,6,1554534000,19,1,20,Mist
71909,7,1554534000,20,9,29,Mist
71910,8,1554534000,30,0,30,Mist
71911,9,1554534000,18,6,24,Mist
71912,10,1554534000,10,6,16,Mist
71913,11,1554534000,15,15,30,Mist
71914,12,1554534000,13,7,20,Mist
71915,13,1554534000,30,0,30,Mist
71916,14,1554534000,13,17,30,Mist
71917,15,1554534000,14,2,16,Mist
71918,16,1554534000,13,7,20,Mist
71919,17,1554534000,16,4,20,Mist
71920,18,1554534000,20,10,30,Mist
71921,19,1554534000,28,2,30,Mist
71922,21,1554534000,20,10,30,Mist
71923,22,1554534000,14,6,20,Mist
71924,23,1554534000,16,14,30,Mist
71925,24,1554534000,3,17,20,Mist
71926,25,1554534000,30,0,30,Mist
71927,26,1554534000,19,1,20,Mist
71928,27,1554534000,19,1,20,Mist
71929,28,1554534000,12,18,30,Mist
71930,29,1554534000,14,15,29,Mist
71931,30,1554534000,20,0,20,Mist
71932,31,1554534000,15,5,20,Mist
71933,32,1554534000,15,15,30,Mist
71934,33,1554534000,0,23,23,Mist
71935,34,1554534000,22,8,30,Mist
71936,35,1554534000,10,20,30,Mist
71937,36,1554534000,37,3,40,Mist
71938,37,1554534000,29,1,30,Mist
71939,38,1554534000,13,27,40,Mist
71940,39,1554534000,18,2,20,Mist
71941,40,1554534000,17,4,21,Mist
71942,41,1554534000,19,1,20,Mist
71943,42,1554534000,3,27,30,Mist
71944,43,1554534000,4,26,30,Mist
71945,44,1554534000,3,27,30,Mist
71946,45,1554534000,23,7,30,Mist
71947,46,1554534000,5,15,20,Mist
71948,47,1554534000,38,2,40,Mist
71949,48,1554534000,27,13,40,Mist
71950,49,1554534000,23,17,40,Mist
71951,50,1554534000,22,18,40,Mist
71952,51,1554534000,36,4,40,Mist
71953,52,1554534000,26,6,32,Mist
71954,53,1554534000,37,3,40,Mist
71955,54,1554534000,30,3,33,Mist
71956,55,1554534000,36,0,36,Mist
71957,56,1554534000,36,4,40,Mist
71958,57,1554534000,21,2,23,Mist
71959,58,1554534000,34,6,40,Mist
71960,59,1554534000,16,4,20,Mist
71961,60,1554534000,3,27,30,Mist
71962,61,1554534000,21,4,25,Mist
71963,62,1554534000,38,2,40,Mist
71964,63,1554534000,14,21,35,Mist
71965,64,1554534000,11,29,40,Mist
71966,65,1554534000,39,1,40,Mist
71967,66,1554534000,25,15,40,Mist
71968,67,1554534000,5,35,40,Mist
71969,68,1554534000,37,3,40,Mist
71970,69,1554534000,38,2,40,Mist
71971,70,1554534000,19,9,28,Mist
71972,71,1554534000,34,6,40,Mist
71973,72,1554534000,0,31,31,Mist
71974,73,1554534000,15,15,30,Mist
71975,74,1554534000,24,6,30,Mist
71976,75,1554534000,17,23,40,Mist
71977,76,1554534000,17,21,38,Mist
71978,77,1554534000,19,10,29,Mist
71979,78,1554534000,24,16,40,Mist
71980,79,1554534000,18,9,27,Mist
71981,80,1554534000,13,26,39,Mist
71982,81,1554534000,10,30,40,Mist
71983,82,1554534000,15,7,22,Mist
71984,83,1554534000,20,20,40,Mist
71985,84,1554534000,14,16,30,Mist
71986,85,1554534000,16,19,35,Mist
71987,86,1554534000,5,33,38,Mist
71988,87,1554534000,19,19,38,Mist
71989,88,1554534000,9,21,30,Mist
71990,89,1554534000,38,2,40,Mist
71991,90,1554534000,38,2,40,Mist
71992,91,1554534000,14,16,30,Mist
71993,92,1554534000,8,32,40,Mist
71994,93,1554534000,11,29,40,Mist
71995,94,1554534000,9,31,40,Mist
71996,95,1554534000,15,25,40,Mist
71997,96,1554534000,22,8,30,Mist
71998,97,1554534000,26,14,40,Mist
71999,98,1554534000,40,0,40,Mist
72000,99,1554534000,23,7,30,Mist
72001,100,1554534000,4,21,25,Mist
72002,101,1554534000,16,14,30,Mist
72003,102,1554534000,28,12,40,Mist
72004,103,1554534000,39,1,40,Mist
72005,104,1554534000,37,3,40,Mist
72006,105,1554534000,35,1,36,Mist
72007,106,1554534000,20,20,40,Mist
72008,107,1554534000,19,21,40,Mist
72009,108,1554534000,37,3,40,Mist
72010,109,1554534000,3,26,29,Mist
72011,110,1554534000,25,15,40,Mist
72012,111,1554534000,26,14,40,Mist
72013,112,1554534000,4,26,30,Mist
72014,113,1554534000,40,0,40,Mist
72015,114,1554534000,40,0,40,Mist
72016,115,1554534000,3,27,30,Mist
72017,2,1554537600,14,6,20,Mist
72018,3,1554537600,18,2,20,Mist
72019,4,1554537600,19,1,20,Mist
72020,5,1554537600,38,2,40,Mist
72021,6,1554537600,19,1,20,Mist
72022,7,1554537600,19,10,29,Mist
72023,8,1554537600,28,2,30,Mist
72024,9,1554537600,13,11,24,Mist
72025,10,1554537600,7,9,16,Mist
72026,11,1554537600,14,16,30,Mist
72027,12,1554537600,16,4,20,Mist
72028,13,1554537600,30,0,30,Mist
72029,14,1554537600,11,19,30,Mist
72030,15,1554537600,15,1,16,Mist
72031,16,1554537600,12,8,20,Mist
72032,17,1554537600,18,2,20,Mist
72033,18,1554537600,20,10,30,Mist
72034,19,1554537600,25,5,30,Mist
72035,21,1554537600,19,11,30,Mist
72036,22,1554537600,12,8,20,Mist
72037,23,1554537600,18,12,30,Mist
72038,24,1554537600,6,14,20,Mist
72039,25,1554537600,28,2,30,Mist
72040,26,1554537600,14,6,20,Mist
72041,27,1554537600,12,8,20,Mist
72042,28,1554537600,14,16,30,Mist
72043,29,1554537600,11,18,29,Mist
72044,30,1554537600,20,0,20,Mist
72045,31,1554537600,13,7,20,Mist
72046,32,1554537600,16,14,30,Mist
72047,33,1554537600,2,21,23,Mist
72048,34,1554537600,30,0,30,Mist
72049,35,1554537600,13,17,30,Mist
72050,36,1554537600,37,3,40,Mist
72051,37,1554537600,28,2,30,Mist
72052,38,1554537600,15,25,40,Mist
72053,39,1554537600,16,4,20,Mist
72054,40,1554537600,16,5,21,Mist
72055,41,1554537600,20,0,20,Mist
72056,42,1554537600,7,23,30,Mist
72057,43,1554537600,7,23,30,Mist
72058,44,1554537600,3,27,30,Mist
72059,45,1554537600,25,5,30,Mist
72060,46,1554537600,6,14,20,Mist
72061,47,1554537600,38,2,40,Mist
72062,48,1554537600,28,12,40,Mist
72063,49,1554537600,23,17,40,Mist
72064,50,1554537600,29,11,40,Mist
72065,51,1554537600,35,5,40,Mist
72066,52,1554537600,22,10,32,Mist
72067,53,1554537600,37,3,40,Mist
72068,54,1554537600,30,3,33,Mist
72069,55,1554537600,36,0,36,Mist
72070,56,1554537600,35,5,40,Mist
72071,57,1554537600,22,1,23,Mist
72072,58,1554537600,29,11,40,Mist
72073,59,1554537600,16,4,20,Mist
72074,60,1554537600,7,23,30,Mist
72075,61,1554537600,23,2,25,Mist
72076,62,1554537600,37,3,40,Mist
72077,63,1554537600,13,22,35,Mist
72078,64,1554537600,11,29,40,Mist
72079,65,1554537600,38,2,40,Mist
72080,66,1554537600,22,18,40,Mist
72081,67,1554537600,3,37,40,Mist
72082,68,1554537600,28,12,40,Mist
72083,69,1554537600,35,5,40,Mist
72084,70,1554537600,13,15,28,Mist
72085,71,1554537600,37,3,40,Mist
72086,72,1554537600,1,30,31,Mist
72087,73,1554537600,16,14,30,Mist
72088,74,1554537600,25,5,30,Mist
72089,75,1554537600,13,27,40,Mist
72090,76,1554537600,19,19,38,Mist
72091,77,1554537600,20,9,29,Mist
72092,78,1554537600,25,15,40,Mist
72093,79,1554537600,19,8,27,Mist
72094,80,1554537600,13,26,39,Mist
72095,81,1554537600,8,32,40,Mist
72096,82,1554537600,16,6,22,Mist
72097,83,1554537600,22,18,40,Mist
72098,84,1554537600,15,15,30,Mist
72099,85,1554537600,18,17,35,Mist
72100,86,1554537600,3,35,38,Mist
72101,87,1554537600,17,21,38,Mist
72102,88,1554537600,9,21,30,Mist
72103,89,1554537600,38,2,40,Mist
72104,90,1554537600,36,4,40,Mist
72105,91,1554537600,13,17,30,Mist
72106,92,1554537600,9,31,40,Mist
72107,93,1554537600,11,29,40,Mist
72108,94,1554537600,9,31,40,Mist
72109,95,1554537600,17,23,40,Mist
72110,96,1554537600,22,8,30,Mist
72111,97,1554537600,27,13,40,Mist
72112,98,1554537600,39,1,40,Mist
72113,99,1554537600,23,7,30,Mist
72114,100,1554537600,5,20,25,Mist
72115,101,1554537600,18,12,30,Mist
72116,102,1554537600,29,11,40,Mist
72117,103,1554537600,39,1,40,Mist
72118,104,1554537600,37,3,40,Mist
72119,105,1554537600,34,2,36,Mist
72120,106,1554537600,20,20,40,Mist
72121,107,1554537600,22,18,40,Mist
72122,108,1554537600,38,2,40,Mist
72123,109,1554537600,5,24,29,Mist
72124,110,1554537600,28,12,40,Mist
72125,111,1554537600,26,14,40,Mist
72126,112,1554537600,8,22,30,Mist
72127,113,1554537600,39,1,40,Mist
72128,114,1554537600,40,0,40,Mist
72129,115,1554537600,7,23,30,Mist
72130,2,1554541200,19,1,20,Mist
72131,3,1554541200,17,3,20,Mist
72132,4,1554541200,20,0,20,Mist
72133,5,1554541200,37,3,40,Mist
72134,6,1554541200,17,3,20,Mist
72135,7,1554541200,21,8,29,Mist
72136,8,1554541200,24,6,30,Mist
72137,9,1554541200,12,12,24,Mist
72138,10,1554541200,4,12,16,Mist
72139,11,1554541200,13,17,30,Mist
72140,12,1554541200,18,2,20,Mist
72141,13,1554541200,29,1,30,Mist
72142,14,1554541200,16,14,30,Mist
72143,15,1554541200,16,0,16,Mist
72144,16,1554541200,13,7,20,Mist
72145,17,1554541200,18,2,20,Mist
72146,18,1554541200,21,9,30,Mist
72147,19,1554541200,29,1,30,Mist
72148,21,1554541200,14,16,30,Mist
72149,22,1554541200,11,9,20,Mist
72150,23,1554541200,16,14,30,Mist
72151,24,1554541200,5,15,20,Mist
72152,25,1554541200,28,2,30,Mist
72153,26,1554541200,14,6,20,Mist
72154,27,1554541200,6,14,20,Mist
72155,28,1554541200,19,11,30,Mist
72156,29,1554541200,8,21,29,Mist
72157,30,1554541200,18,2,20,Mist
72158,31,1554541200,12,8,20,Mist
72159,32,1554541200,15,15,30,Mist
72160,33,1554541200,0,23,23,Mist
72161,34,1554541200,30,0,30,Mist
72162,35,1554541200,16,14,30,Mist
72163,36,1554541200,36,4,40,Mist
72164,37,1554541200,26,4,30,Mist
72165,38,1554541200,15,25,40,Mist
72166,39,1554541200,14,6,20,Mist
72167,40,1554541200,11,10,21,Mist
72168,41,1554541200,19,1,20,Mist
72169,42,1554541200,9,21,30,Mist
72170,43,1554541200,8,22,30,Mist
72171,44,1554541200,6,24,30,Mist
72172,45,1554541200,27,3,30,Mist
72173,46,1554541200,7,13,20,Mist
72174,47,1554541200,38,2,40,Mist
72175,48,1554541200,20,20,40,Mist
72176,49,1554541200,23,17,40,Mist
72177,50,1554541200,31,9,40,Mist
72178,51,1554541200,29,11,40,Mist
72179,52,1554541200,18,14,32,Mist
72180,53,1554541200,37,3,40,Mist
72181,54,1554541200,26,7,33,Mist
72182,55,1554541200,36,0,36,Mist
72183,56,1554541200,37,3,40,Mist
72184,57,1554541200,21,2,23,Mist
72185,58,1554541200,28,12,40,Mist
72186,59,1554541200,16,4,20,Mist
72187,60,1554541200,13,17,30,Mist
72188,61,1554541200,25,0,25,Mist
72189,62,1554541200,39,1,40,Mist
72190,63,1554541200,14,21,35,Mist
72191,64,1554541200,6,34,40,Mist
72192,65,1554541200,39,1,40,Mist
72193,66,1554541200,18,22,40,Mist
72194,67,1554541200,25,15,40,Mist
72195,68,1554541200,23,17,40,Mist
72196,69,1554541200,37,3,40,Mist
72197,70,1554541200,17,11,28,Mist
72198,71,1554541200,33,7,40,Mist
72199,72,1554541200,4,27,31,Mist
72200,73,1554541200,24,6,30,Mist
72201,74,1554541200,26,4,30,Mist
72202,75,1554541200,14,26,40,Mist
72203,76,1554541200,19,19,38,Mist
72204,77,1554541200,18,11,29,Mist
72205,78,1554541200,24,16,40,Mist
72206,79,1554541200,20,7,27,Mist
72207,80,1554541200,14,26,40,Mist
72208,81,1554541200,8,32,40,Mist
72209,82,1554541200,16,6,22,Mist
72210,83,1554541200,7,33,40,Mist
72211,84,1554541200,18,12,30,Mist
72212,85,1554541200,24,11,35,Mist
72213,86,1554541200,6,32,38,Mist
72214,87,1554541200,19,19,38,Mist
72215,88,1554541200,11,19,30,Mist
72216,89,1554541200,38,2,40,Mist
72217,90,1554541200,33,7,40,Mist
72218,91,1554541200,9,21,30,Mist
72219,92,1554541200,9,31,40,Mist
72220,93,1554541200,13,27,40,Mist
72221,94,1554541200,9,31,40,Mist
72222,95,1554541200,21,19,40,Mist
72223,96,1554541200,22,8,30,Mist
72224,97,1554541200,27,13,40,Mist
72225,98,1554541200,36,4,40,Mist
72226,99,1554541200,21,9,30,Mist
72227,100,1554541200,9,16,25,Mist
72228,101,1554541200,19,11,30,Mist
72229,102,1554541200,30,10,40,Mist
72230,103,1554541200,39,1,40,Mist
72231,104,1554541200,37,3,40,Mist
72232,105,1554541200,34,2,36,Mist
72233,106,1554541200,22,18,40,Mist
72234,107,1554541200,22,18,40,Mist
72235,108,1554541200,40,0,40,Mist
72236,109,1554541200,5,24,29,Mist
72237,110,1554541200,31,9,40,Mist
72238,111,1554541200,29,11,40,Mist
72239,112,1554541200,16,14,30,Mist
72240,113,1554541200,39,1,40,Mist
72241,114,1554541200,39,1,40,Mist
72242,115,1554541200,13,17,30,Mist
72243,2,1554544800,19,1,20,Mist
72244,3,1554544800,19,1,20,Mist
72245,4,1554544800,19,1,20,Mist
72246,5,1554544800,38,2,40,Mist
72247,6,1554544800,13,7,20,Mist
72248,7,1554544800,25,4,29,Mist
72249,8,1554544800,24,6,30,Mist
72250,9,1554544800,0,24,24,Mist
72251,10,1554544800,0,16,16,Mist
72252,11,1554544800,27,3,30,Mist
72253,12,1554544800,18,2,20,Mist
72254,13,1554544800,30,0,30,Mist
72255,14,1554544800,15,15,30,Mist
72256,15,1554544800,16,0,16,Mist
72257,16,1554544800,11,9,20,Mist
72258,17,1554544800,16,4,20,Mist
72259,18,1554544800,19,11,30,Mist
72260,19,1554544800,29,1,30,Mist
72261,21,1554544800,4,26,30,Mist
72262,22,1554544800,8,12,20,Mist
72263,23,1554544800,17,13,30,Mist
72264,24,1554544800,2,18,20,Mist
72265,25,1554544800,24,6,30,Mist
72266,26,1554544800,14,6,20,Mist
72267,27,1554544800,0,20,20,Mist
72268,28,1554544800,21,9,30,Mist
72269,29,1554544800,3,26,29,Mist
72270,30,1554544800,18,2,20,Mist
72271,31,1554544800,8,12,20,Mist
72272,32,1554544800,16,14,30,Mist
72273,33,1554544800,1,22,23,Mist
72274,34,1554544800,20,10,30,Mist
72275,35,1554544800,10,20,30,Mist
72276,36,1554544800,34,6,40,Mist
72277,37,1554544800,25,5,30,Mist
72278,38,1554544800,19,21,40,Mist
72279,39,1554544800,20,0,20,Mist
72280,40,1554544800,8,13,21,Mist
72281,41,1554544800,19,1,20,Mist
72282,42,1554544800,12,18,30,Mist
72283,43,1554544800,16,14,30,Mist
72284,44,1554544800,9,21,30,Mist
72285,45,1554544800,28,2,30,Mist
72286,46,1554544800,5,15,20,Mist
72287,47,1554544800,40,0,40,Mist
72288,48,1554544800,16,24,40,Mist
72289,49,1554544800,27,13,40,Mist
72290,50,1554544800,36,4,40,Mist
72291,51,1554544800,20,20,40,Mist
72292,52,1554544800,15,17,32,Mist
72293,53,1554544800,36,4,40,Mist
72294,54,1554544800,23,10,33,Mist
72295,55,1554544800,36,0,36,Mist
72296,56,1554544800,37,3,40,Mist
72297,57,1554544800,21,2,23,Mist
72298,58,1554544800,31,9,40,Mist
72299,59,1554544800,16,4,20,Mist
72300,60,1554544800,20,10,30,Mist
72301,61,1554544800,24,1,25,Mist
72302,62,1554544800,36,4,40,Mist
72303,63,1554544800,15,20,35,Mist
72304,64,1554544800,2,38,40,Mist
72305,65,1554544800,39,1,40,Mist
72306,66,1554544800,21,19,40,Mist
72307,67,1554544800,27,13,40,Mist
72308,68,1554544800,20,20,40,Mist
72309,69,1554544800,39,1,40,Mist
72310,70,1554544800,21,7,28,Mist
72311,71,1554544800,28,12,40,Mist
72312,72,1554544800,9,22,31,Mist
72313,73,1554544800,30,0,30,Mist
72314,74,1554544800,27,3,30,Mist
72315,75,1554544800,15,25,40,Mist
72316,76,1554544800,20,18,38,Mist
72317,77,1554544800,16,13,29,Mist
72318,78,1554544800,24,16,40,Mist
72319,79,1554544800,22,5,27,Mist
72320,80,1554544800,12,28,40,Mist
72321,81,1554544800,8,32,40,Mist
72322,82,1554544800,18,4,22,Mist
72323,83,1554544800,9,31,40,Mist
72324,84,1554544800,22,8,30,Mist
72325,85,1554544800,29,6,35,Mist
72326,86,1554544800,1,37,38,Mist
72327,87,1554544800,22,16,38,Mist
72328,88,1554544800,9,21,30,Mist
72329,89,1554544800,38,2,40,Mist
72330,90,1554544800,27,13,40,Mist
72331,91,1554544800,5,25,30,Mist
72332,92,1554544800,9,31,40,Mist
72333,93,1554544800,13,27,40,Mist
72334,94,1554544800,9,31,40,Mist
72335,95,1554544800,25,15,40,Mist
72336,96,1554544800,22,8,30,Mist
72337,97,1554544800,34,6,40,Mist
72338,98,1554544800,33,7,40,Mist
72339,99,1554544800,21,9,30,Mist
72340,100,1554544800,7,18,25,Mist
72341,101,1554544800,24,6,30,Mist
72342,102,1554544800,38,2,40,Mist
72343,103,1554544800,38,2,40,Mist
72344,104,1554544800,37,3,40,Mist
72345,105,1554544800,34,2,36,Mist
72346,106,1554544800,21,19,40,Mist
72347,107,1554544800,24,16,40,Mist
72348,108,1554544800,39,1,40,Mist
72349,109,1554544800,7,22,29,Mist
72350,110,1554544800,32,8,40,Mist
72351,111,1554544800,30,10,40,Mist
72352,112,1554544800,25,5,30,Mist
72353,113,1554544800,39,1,40,Mist
72354,114,1554544800,39,1,40,Mist
72355,115,1554544800,15,15,30,Mist
72356,2,1554548400,20,0,20,Clouds
72357,3,1554548400,19,1,20,Clouds
72358,4,1554548400,18,2,20,Clouds
72359,5,1554548400,23,17,40,Clouds
72360,6,1554548400,8,12,20,Clouds
72361,7,1554548400,27,2,29,Clouds
72362,8,1554548400,15,15,30,Clouds
72363,9,1554548400,0,24,24,Clouds
72364,10,1554548400,0,16,16,Clouds
72365,11,1554548400,27,3,30,Clouds
72366,12,1554548400,20,0,20,Clouds
72367,13,1554548400,30,0,30,Clouds
72368,14,1554548400,5,25,30,Clouds
72369,15,1554548400,16,0,16,Clouds
72370,16,1554548400,8,12,20,Clouds
72371,17,1554548400,10,10,20,Clouds
72372,18,1554548400,18,12,30,Clouds
72373,19,1554548400,29,1,30,Clouds
72374,21,1554548400,1,29,30,Clouds
72375,22,1554548400,2,18,20,Clouds
72376,23,1554548400,16,14,30,Clouds
72377,24,1554548400,5,15,20,Clouds
72378,25,1554548400,24,6,30,Clouds
72379,26,1554548400,13,7,20,Clouds
72380,27,1554548400,1,19,20,Clouds
72381,28,1554548400,23,7,30,Clouds
72382,29,1554548400,0,29,29,Clouds
72383,30,1554548400,16,4,20,Clouds
72384,31,1554548400,6,14,20,Clouds
72385,32,1554548400,16,14,30,Clouds
72386,33,1554548400,0,23,23,Clouds
72387,34,1554548400,21,9,30,Clouds
72388,35,1554548400,10,20,30,Clouds
72389,36,1554548400,35,5,40,Clouds
72390,37,1554548400,25,5,30,Clouds
72391,38,1554548400,19,21,40,Clouds
72392,39,1554548400,20,0,20,Clouds
72393,40,1554548400,0,21,21,Clouds
72394,41,1554548400,19,1,20,Clouds
72395,42,1554548400,17,13,30,Clouds
72396,43,1554548400,19,11,30,Clouds
72397,44,1554548400,18,12,30,Clouds
72398,45,1554548400,27,3,30,Clouds
72399,46,1554548400,3,17,20,Clouds
72400,47,1554548400,40,0,40,Clouds
72401,48,1554548400,17,23,40,Clouds
72402,49,1554548400,22,18,40,Clouds
72403,50,1554548400,40,0,40,Clouds
72404,51,1554548400,17,23,40,Clouds
72405,52,1554548400,14,18,32,Clouds
72406,53,1554548400,35,5,40,Clouds
72407,54,1554548400,23,10,33,Clouds
72408,55,1554548400,36,0,36,Clouds
72409,56,1554548400,38,2,40,Clouds
72410,57,1554548400,22,1,23,Clouds
72411,58,1554548400,36,4,40,Clouds
72412,59,1554548400,17,3,20,Clouds
72413,60,1554548400,23,7,30,Clouds
72414,61,1554548400,6,19,25,Clouds
72415,62,1554548400,37,3,40,Clouds
72416,63,1554548400,17,18,35,Clouds
72417,64,1554548400,22,18,40,Clouds
72418,65,1554548400,38,2,40,Clouds
72419,66,1554548400,28,12,40,Clouds
72420,67,1554548400,28,12,40,Clouds
72421,68,1554548400,23,17,40,Clouds
72422,69,1554548400,39,1,40,Clouds
72423,70,1554548400,20,8,28,Clouds
72424,71,1554548400,30,10,40,Clouds
72425,72,1554548400,12,19,31,Clouds
72426,73,1554548400,30,0,30,Clouds
72427,74,1554548400,28,2,30,Clouds
72428,75,1554548400,17,23,40,Clouds
72429,76,1554548400,21,17,38,Clouds
72430,77,1554548400,13,16,29,Clouds
72431,78,1554548400,23,17,40,Clouds
72432,79,1554548400,22,5,27,Clouds
72433,80,1554548400,12,28,40,Clouds
72434,81,1554548400,8,32,40,Clouds
72435,82,1554548400,19,3,22,Clouds
72436,83,1554548400,13,27,40,Clouds
72437,84,1554548400,23,7,30,Clouds
72438,85,1554548400,30,5,35,Clouds
72439,86,1554548400,6,32,38,Clouds
72440,87,1554548400,21,17,38,Clouds
72441,88,1554548400,13,17,30,Clouds
72442,89,1554548400,38,2,40,Clouds
72443,90,1554548400,32,8,40,Clouds
72444,91,1554548400,11,19,30,Clouds
72445,92,1554548400,12,28,40,Clouds
72446,93,1554548400,13,27,40,Clouds
72447,94,1554548400,9,31,40,Clouds
72448,95,1554548400,27,13,40,Clouds
72449,96,1554548400,21,9,30,Clouds
72450,97,1554548400,39,1,40,Clouds
72451,98,1554548400,25,15,40,Clouds
72452,99,1554548400,20,10,30,Clouds
72453,100,1554548400,8,17,25,Clouds
72454,101,1554548400,26,4,30,Clouds
72455,102,1554548400,40,0,40,Clouds
72456,103,1554548400,38,2,40,Clouds
72457,104,1554548400,37,3,40,Clouds
72458,105,1554548400,34,2,36,Clouds
72459,106,1554548400,22,18,40,Clouds
72460,107,1554548400,24,16,40,Clouds
72461,108,1554548400,39,1,40,Clouds
72462,109,1554548400,7,22,29,Clouds
72463,110,1554548400,32,8,40,Clouds
72464,111,1554548400,40,0,40,Clouds
72465,112,1554548400,30,0,30,Clouds
72466,113,1554548400,39,1,40,Clouds
72467,114,1554548400,40,0,40,Clouds
72468,115,1554548400,20,10,30,Clouds
72469,2,1554552000,20,0,20,Clouds
72470,3,1554552000,18,2,20,Clouds
72471,4,1554552000,16,4,20,Clouds
72472,5,1554552000,24,16,40,Clouds
72473,6,1554552000,5,15,20,Clouds
72474,7,1554552000,25,4,29,Clouds
72475,8,1554552000,11,19,30,Clouds
72476,9,1554552000,3,21,24,Clouds
72477,10,1554552000,0,16,16,Clouds
72478,11,1554552000,27,3,30,Clouds
72479,12,1554552000,20,0,20,Clouds
72480,13,1554552000,28,2,30,Clouds
72481,14,1554552000,0,30,30,Clouds
72482,15,1554552000,16,0,16,Clouds
72483,16,1554552000,5,15,20,Clouds
72484,17,1554552000,4,16,20,Clouds
72485,18,1554552000,14,16,30,Clouds
72486,19,1554552000,27,3,30,Clouds
72487,21,1554552000,15,15,30,Clouds
72488,22,1554552000,0,20,20,Clouds
72489,23,1554552000,4,26,30,Clouds
72490,24,1554552000,2,18,20,Clouds
72491,25,1554552000,25,5,30,Clouds
72492,26,1554552000,15,5,20,Clouds
72493,27,1554552000,0,20,20,Clouds
72494,28,1554552000,29,1,30,Clouds
72495,29,1554552000,2,27,29,Clouds
72496,30,1554552000,18,2,20,Clouds
72497,31,1554552000,2,18,20,Clouds
72498,32,1554552000,11,19,30,Clouds
72499,33,1554552000,0,23,23,Clouds
72500,34,1554552000,30,0,30,Clouds
72501,35,1554552000,14,16,30,Clouds
72502,36,1554552000,35,5,40,Clouds
72503,37,1554552000,30,0,30,Clouds
72504,38,1554552000,20,20,40,Clouds
72505,39,1554552000,19,1,20,Clouds
72506,40,1554552000,2,19,21,Clouds
72507,41,1554552000,20,0,20,Clouds
72508,42,1554552000,19,11,30,Clouds
72509,43,1554552000,3,27,30,Clouds
72510,44,1554552000,25,5,30,Clouds
72511,45,1554552000,29,1,30,Clouds
72512,46,1554552000,1,19,20,Clouds
72513,47,1554552000,39,1,40,Clouds
72514,48,1554552000,18,22,40,Clouds
72515,49,1554552000,25,15,40,Clouds
72516,50,1554552000,39,1,40,Clouds
72517,51,1554552000,17,23,40,Clouds
72518,52,1554552000,9,23,32,Clouds
72519,53,1554552000,35,5,40,Clouds
72520,54,1554552000,23,10,33,Clouds
72521,55,1554552000,36,0,36,Clouds
72522,56,1554552000,40,0,40,Clouds
72523,57,1554552000,23,0,23,Clouds
72524,58,1554552000,36,4,40,Clouds
72525,59,1554552000,17,3,20,Clouds
72526,60,1554552000,24,6,30,Clouds
72527,61,1554552000,7,18,25,Clouds
72528,62,1554552000,38,2,40,Clouds
72529,63,1554552000,17,18,35,Clouds
72530,64,1554552000,26,14,40,Clouds
72531,65,1554552000,36,4,40,Clouds
72532,66,1554552000,30,10,40,Clouds
72533,67,1554552000,27,13,40,Clouds
72534,68,1554552000,29,11,40,Clouds
72535,69,1554552000,38,2,40,Clouds
72536,70,1554552000,16,12,28,Clouds
72537,71,1554552000,36,4,40,Clouds
72538,72,1554552000,18,13,31,Clouds
72539,73,1554552000,26,4,30,Clouds
72540,74,1554552000,25,5,30,Clouds
72541,75,1554552000,15,25,40,Clouds
72542,76,1554552000,17,21,38,Clouds
72543,77,1554552000,6,23,29,Clouds
72544,78,1554552000,38,2,40,Clouds
72545,79,1554552000,24,3,27,Clouds
72546,80,1554552000,14,26,40,Clouds
72547,81,1554552000,8,32,40,Clouds
72548,82,1554552000,20,2,22,Clouds
72549,83,1554552000,17,23,40,Clouds
72550,84,1554552000,25,5,30,Clouds
72551,85,1554552000,33,2,35,Clouds
72552,86,1554552000,8,30,38,Clouds
72553,87,1554552000,24,14,38,Clouds
72554,88,1554552000,16,14,30,Clouds
72555,89,1554552000,38,2,40,Clouds
72556,90,1554552000,32,8,40,Clouds
72557,91,1554552000,12,18,30,Clouds
72558,92,1554552000,9,31,40,Clouds
72559,93,1554552000,13,27,40,Clouds
72560,94,1554552000,9,31,40,Clouds
72561,95,1554552000,25,15,40,Clouds
72562,96,1554552000,27,3,30,Clouds
72563,97,1554552000,40,0,40,Clouds
72564,98,1554552000,22,18,40,Clouds
72565,99,1554552000,21,9,30,Clouds
72566,100,1554552000,5,20,25,Clouds
72567,101,1554552000,28,2,30,Clouds
72568,102,1554552000,40,0,40,Clouds
72569,103,1554552000,38,2,40,Clouds
72570,104,1554552000,37,3,40,Clouds
72571,105,1554552000,36,0,36,Clouds
72572,106,1554552000,22,18,40,Clouds
72573,107,1554552000,27,13,40,Clouds
72574,108,1554552000,39,1,40,Clouds
72575,109,1554552000,8,21,29,Clouds
72576,110,1554552000,36,4,40,Clouds
72577,111,1554552000,38,2,40,Clouds
72578,112,1554552000,30,0,30,Clouds
72579,113,1554552000,39,1,40,Clouds
72580,114,1554552000,40,0,40,Clouds
72581,115,1554552000,24,6,30,Clouds
72582,2,1554555600,20,0,20,Clouds
72583,3,1554555600,18,2,20,Clouds
72584,4,1554555600,16,4,20,Clouds
72585,5,1554555600,27,13,40,Clouds
72586,6,1554555600,1,19,20,Clouds
72587,7,1554555600,24,5,29,Clouds
72588,8,1554555600,8,22,30,Clouds
72589,9,1554555600,1,23,24,Clouds
72590,10,1554555600,0,16,16,Clouds
72591,11,1554555600,27,3,30,Clouds
72592,12,1554555600,20,0,20,Clouds
72593,13,1554555600,28,2,30,Clouds
72594,14,1554555600,0,30,30,Clouds
72595,15,1554555600,14,2,16,Clouds
72596,16,1554555600,3,17,20,Clouds
72597,17,1554555600,4,16,20,Clouds
72598,18,1554555600,20,10,30,Clouds
72599,19,1554555600,26,4,30,Clouds
72600,21,1554555600,12,18,30,Clouds
72601,22,1554555600,0,20,20,Clouds
72602,23,1554555600,0,30,30,Clouds
72603,24,1554555600,3,17,20,Clouds
72604,25,1554555600,25,5,30,Clouds
72605,26,1554555600,14,6,20,Clouds
72606,27,1554555600,0,20,20,Clouds
72607,28,1554555600,28,2,30,Clouds
72608,29,1554555600,9,20,29,Clouds
72609,30,1554555600,19,1,20,Clouds
72610,31,1554555600,0,20,20,Clouds
72611,32,1554555600,5,25,30,Clouds
72612,33,1554555600,1,22,23,Clouds
72613,34,1554555600,27,3,30,Clouds
72614,35,1554555600,11,19,30,Clouds
72615,36,1554555600,34,6,40,Clouds
72616,37,1554555600,30,0,30,Clouds
72617,38,1554555600,20,20,40,Clouds
72618,39,1554555600,17,3,20,Clouds
72619,40,1554555600,1,20,21,Clouds
72620,41,1554555600,20,0,20,Clouds
72621,42,1554555600,16,14,30,Clouds
72622,43,1554555600,6,24,30,Clouds
72623,44,1554555600,29,1,30,Clouds
72624,45,1554555600,30,0,30,Clouds
72625,46,1554555600,0,20,20,Clouds
72626,47,1554555600,39,1,40,Clouds
72627,48,1554555600,14,26,40,Clouds
72628,49,1554555600,27,13,40,Clouds
72629,50,1554555600,40,0,40,Clouds
72630,51,1554555600,17,23,40,Clouds
72631,52,1554555600,6,26,32,Clouds
72632,53,1554555600,37,3,40,Clouds
72633,54,1554555600,23,10,33,Clouds
72634,55,1554555600,36,0,36,Clouds
72635,56,1554555600,34,6,40,Clouds
72636,57,1554555600,23,0,23,Clouds
72637,58,1554555600,40,0,40,Clouds
72638,59,1554555600,17,3,20,Clouds
72639,60,1554555600,26,4,30,Clouds
72640,61,1554555600,10,15,25,Clouds
72641,62,1554555600,36,4,40,Clouds
72642,63,1554555600,13,22,35,Clouds
72643,64,1554555600,21,19,40,Clouds
72644,65,1554555600,38,2,40,Clouds
72645,66,1554555600,29,11,40,Clouds
72646,67,1554555600,32,8,40,Clouds
72647,68,1554555600,39,1,40,Clouds
72648,69,1554555600,37,3,40,Clouds
72649,70,1554555600,17,11,28,Clouds
72650,71,1554555600,36,4,40,Clouds
72651,72,1554555600,18,13,31,Clouds
72652,73,1554555600,22,8,30,Clouds
72653,74,1554555600,27,3,30,Clouds
72654,75,1554555600,13,27,40,Clouds
72655,76,1554555600,16,22,38,Clouds
72656,77,1554555600,4,25,29,Clouds
72657,78,1554555600,21,19,40,Clouds
72658,79,1554555600,24,3,27,Clouds
72659,80,1554555600,16,24,40,Clouds
72660,81,1554555600,8,32,40,Clouds
72661,82,1554555600,22,0,22,Clouds
72662,83,1554555600,22,18,40,Clouds
72663,84,1554555600,30,0,30,Clouds
72664,85,1554555600,35,0,35,Clouds
72665,86,1554555600,5,33,38,Clouds
72666,87,1554555600,23,15,38,Clouds
72667,88,1554555600,24,6,30,Clouds
72668,89,1554555600,40,0,40,Clouds
72669,90,1554555600,31,9,40,Clouds
72670,91,1554555600,14,16,30,Clouds
72671,92,1554555600,9,31,40,Clouds
72672,93,1554555600,13,27,40,Clouds
72673,94,1554555600,10,30,40,Clouds
72674,95,1554555600,27,13,40,Clouds
72675,96,1554555600,29,1,30,Clouds
72676,97,1554555600,40,0,40,Clouds
72677,98,1554555600,21,19,40,Clouds
72678,99,1554555600,21,9,30,Clouds
72679,100,1554555600,1,24,25,Clouds
72680,101,1554555600,30,0,30,Clouds
72681,102,1554555600,31,9,40,Clouds
72682,103,1554555600,39,1,40,Clouds
72683,104,1554555600,36,4,40,Clouds
72684,105,1554555600,36,0,36,Clouds
72685,106,1554555600,24,16,40,Clouds
72686,107,1554555600,30,10,40,Clouds
72687,108,1554555600,40,0,40,Clouds
72688,109,1554555600,13,16,29,Clouds
72689,110,1554555600,35,5,40,Clouds
72690,111,1554555600,36,4,40,Clouds
72691,112,1554555600,30,0,30,Clouds
72692,113,1554555600,40,0,40,Clouds
72693,114,1554555600,38,2,40,Clouds
72694,115,1554555600,27,3,30,Clouds
72695,2,1554559200,20,0,20,Clouds
72696,3,1554559200,15,5,20,Clouds
72697,4,1554559200,17,3,20,Clouds
72698,5,1554559200,38,2,40,Clouds
72699,6,1554559200,0,20,20,Clouds
72700,7,1554559200,29,0,29,Clouds
72701,8,1554559200,10,20,30,Clouds
72702,9,1554559200,0,24,24,Clouds
72703,10,1554559200,0,16,16,Clouds
72704,11,1554559200,30,0,30,Clouds
72705,12,1554559200,20,0,20,Clouds
72706,13,1554559200,30,0,30,Clouds
72707,14,1554559200,1,29,30,Clouds
72708,15,1554559200,15,1,16,Clouds
72709,16,1554559200,0,20,20,Clouds
72710,17,1554559200,0,20,20,Clouds
72711,18,1554559200,14,16,30,Clouds
72712,19,1554559200,29,1,30,Clouds
72713,21,1554559200,9,21,30,Clouds
72714,22,1554559200,1,19,20,Clouds
72715,23,1554559200,0,30,30,Clouds
72716,24,1554559200,5,15,20,Clouds
72717,25,1554559200,24,6,30,Clouds
72718,26,1554559200,11,9,20,Clouds
72719,27,1554559200,0,20,20,Clouds
72720,28,1554559200,29,1,30,Clouds
72721,29,1554559200,1,28,29,Clouds
72722,30,1554559200,15,4,19,Clouds
72723,31,1554559200,1,19,20,Clouds
72724,32,1554559200,2,28,30,Clouds
72725,33,1554559200,1,22,23,Clouds
72726,34,1554559200,25,5,30,Clouds
72727,35,1554559200,20,10,30,Clouds
72728,36,1554559200,28,12,40,Clouds
72729,37,1554559200,28,2,30,Clouds
72730,38,1554559200,23,17,40,Clouds
72731,39,1554559200,18,2,20,Clouds
72732,40,1554559200,0,21,21,Clouds
72733,41,1554559200,20,0,20,Clouds
72734,42,1554559200,17,13,30,Clouds
72735,43,1554559200,11,19,30,Clouds
72736,44,1554559200,29,1,30,Clouds
72737,45,1554559200,29,1,30,Clouds
72738,46,1554559200,0,20,20,Clouds
72739,47,1554559200,38,2,40,Clouds
72740,48,1554559200,14,26,40,Clouds
72741,49,1554559200,30,10,40,Clouds
72742,50,1554559200,37,3,40,Clouds
72743,51,1554559200,1,39,40,Clouds
72744,52,1554559200,2,30,32,Clouds
72745,53,1554559200,36,4,40,Clouds
72746,54,1554559200,23,10,33,Clouds
72747,55,1554559200,36,0,36,Clouds
72748,56,1554559200,36,4,40,Clouds
72749,57,1554559200,23,0,23,Clouds
72750,58,1554559200,36,4,40,Clouds
72751,59,1554559200,20,0,20,Clouds
72752,60,1554559200,26,4,30,Clouds
72753,61,1554559200,11,14,25,Clouds
72754,62,1554559200,35,5,40,Clouds
72755,63,1554559200,15,20,35,Clouds
72756,64,1554559200,21,19,40,Clouds
72757,65,1554559200,40,0,40,Clouds
72758,66,1554559200,30,10,40,Clouds
72759,67,1554559200,35,5,40,Clouds
72760,68,1554559200,38,2,40,Clouds
72761,69,1554559200,40,0,40,Clouds
72762,70,1554559200,16,12,28,Clouds
72763,71,1554559200,37,3,40,Clouds
72764,72,1554559200,10,21,31,Clouds
72765,73,1554559200,20,10,30,Clouds
72766,74,1554559200,30,0,30,Clouds
72767,75,1554559200,13,27,40,Clouds
72768,76,1554559200,21,17,38,Clouds
72769,77,1554559200,0,29,29,Clouds
72770,78,1554559200,22,18,40,Clouds
72771,79,1554559200,25,2,27,Clouds
72772,80,1554559200,18,22,40,Clouds
72773,81,1554559200,10,30,40,Clouds
72774,82,1554559200,20,2,22,Clouds
72775,83,1554559200,33,7,40,Clouds
72776,84,1554559200,30,0,30,Clouds
72777,85,1554559200,29,6,35,Clouds
72778,86,1554559200,12,26,38,Clouds
72779,87,1554559200,26,12,38,Clouds
72780,88,1554559200,29,1,30,Clouds
72781,89,1554559200,39,1,40,Clouds
72782,90,1554559200,30,10,40,Clouds
72783,91,1554559200,13,17,30,Clouds
72784,92,1554559200,13,27,40,Clouds
72785,93,1554559200,13,27,40,Clouds
72786,94,1554559200,10,30,40,Clouds
72787,95,1554559200,33,7,40,Clouds
72788,96,1554559200,30,0,30,Clouds
72789,97,1554559200,39,1,40,Clouds
72790,98,1554559200,14,26,40,Clouds
72791,99,1554559200,22,8,30,Clouds
72792,100,1554559200,4,21,25,Clouds
72793,101,1554559200,28,2,30,Clouds
72794,102,1554559200,23,17,40,Clouds
72795,103,1554559200,39,1,40,Clouds
72796,104,1554559200,36,4,40,Clouds
72797,105,1554559200,35,1,36,Clouds
72798,106,1554559200,27,13,40,Clouds
72799,107,1554559200,30,10,40,Clouds
72800,108,1554559200,39,1,40,Clouds
72801,109,1554559200,18,11,29,Clouds
72802,110,1554559200,39,1,40,Clouds
72803,111,1554559200,39,1,40,Clouds
72804,112,1554559200,30,0,30,Clouds
72805,113,1554559200,40,0,40,Clouds
72806,114,1554559200,37,3,40,Clouds
72807,115,1554559200,25,5,30,Clouds
72808,2,1554562800,19,1,20,Clouds
72809,3,1554562800,13,7,20,Clouds
72810,4,1554562800,5,15,20,Clouds
72811,5,1554562800,38,2,40,Clouds
72812,6,1554562800,1,19,20,Clouds
72813,7,1554562800,27,2,29,Clouds
72814,8,1554562800,9,21,30,Clouds
72815,9,1554562800,1,23,24,Clouds
72816,10,1554562800,0,16,16,Clouds
72817,11,1554562800,30,0,30,Clouds
72818,12,1554562800,18,2,20,Clouds
72819,13,1554562800,28,2,30,Clouds
72820,14,1554562800,0,30,30,Clouds
72821,15,1554562800,15,1,16,Clouds
72822,16,1554562800,0,20,20,Clouds
72823,17,1554562800,2,18,20,Clouds
72824,18,1554562800,14,16,30,Clouds
72825,19,1554562800,26,4,30,Clouds
72826,21,1554562800,5,25,30,Clouds
72827,22,1554562800,0,20,20,Clouds
72828,23,1554562800,0,30,30,Clouds
72829,24,1554562800,8,12,20,Clouds
72830,25,1554562800,25,5,30,Clouds
72831,26,1554562800,8,12,20,Clouds
72832,27,1554562800,1,19,20,Clouds
72833,28,1554562800,30,0,30,Clouds
72834,29,1554562800,0,29,29,Clouds
72835,30,1554562800,20,0,20,Clouds
72836,31,1554562800,1,19,20,Clouds
72837,32,1554562800,0,30,30,Clouds
72838,33,1554562800,3,20,23,Clouds
72839,34,1554562800,21,9,30,Clouds
72840,35,1554562800,20,10,30,Clouds
72841,36,1554562800,26,14,40,Clouds
72842,37,1554562800,26,4,30,Clouds
72843,38,1554562800,20,20,40,Clouds
72844,39,1554562800,17,3,20,Clouds
72845,40,1554562800,0,21,21,Clouds
72846,41,1554562800,20,0,20,Clouds
72847,42,1554562800,15,15,30,Clouds
72848,43,1554562800,16,14,30,Clouds
72849,44,1554562800,30,0,30,Clouds
72850,45,1554562800,24,6,30,Clouds
72851,46,1554562800,0,20,20,Clouds
72852,47,1554562800,39,1,40,Clouds
72853,48,1554562800,22,18,40,Clouds
72854,49,1554562800,33,7,40,Clouds
72855,50,1554562800,37,3,40,Clouds
72856,51,1554562800,2,38,40,Clouds
72857,52,1554562800,0,32,32,Clouds
72858,53,1554562800,38,2,40,Clouds
72859,54,1554562800,24,9,33,Clouds
72860,55,1554562800,35,1,36,Clouds
72861,56,1554562800,37,3,40,Clouds
72862,57,1554562800,21,2,23,Clouds
72863,58,1554562800,36,4,40,Clouds
72864,59,1554562800,20,0,20,Clouds
72865,60,1554562800,30,0,30,Clouds
72866,61,1554562800,16,9,25,Clouds
72867,62,1554562800,39,1,40,Clouds
72868,63,1554562800,13,22,35,Clouds
72869,64,1554562800,21,19,40,Clouds
72870,65,1554562800,38,2,40,Clouds
72871,66,1554562800,37,3,40,Clouds
72872,67,1554562800,35,5,40,Clouds
72873,68,1554562800,39,1,40,Clouds
72874,69,1554562800,39,1,40,Clouds
72875,70,1554562800,18,10,28,Clouds
72876,71,1554562800,34,6,40,Clouds
72877,72,1554562800,14,17,31,Clouds
72878,73,1554562800,24,6,30,Clouds
72879,74,1554562800,28,2,30,Clouds
72880,75,1554562800,13,27,40,Clouds
72881,76,1554562800,28,10,38,Clouds
72882,77,1554562800,2,27,29,Clouds
72883,78,1554562800,22,18,40,Clouds
72884,79,1554562800,26,1,27,Clouds
72885,80,1554562800,17,23,40,Clouds
72886,81,1554562800,10,30,40,Clouds
72887,82,1554562800,21,1,22,Clouds
72888,83,1554562800,35,5,40,Clouds
72889,84,1554562800,28,2,30,Clouds
72890,85,1554562800,31,4,35,Clouds
72891,86,1554562800,16,22,38,Clouds
72892,87,1554562800,27,11,38,Clouds
72893,88,1554562800,30,0,30,Clouds
72894,89,1554562800,39,1,40,Clouds
72895,90,1554562800,32,8,40,Clouds
72896,91,1554562800,9,21,30,Clouds
72897,92,1554562800,10,30,40,Clouds
72898,93,1554562800,12,28,40,Clouds
72899,94,1554562800,10,30,40,Clouds
72900,95,1554562800,40,0,40,Clouds
72901,96,1554562800,29,1,30,Clouds
72902,97,1554562800,37,3,40,Clouds
72903,98,1554562800,9,31,40,Clouds
72904,99,1554562800,20,10,30,Clouds
72905,100,1554562800,2,23,25,Clouds
72906,101,1554562800,27,3,30,Clouds
72907,102,1554562800,20,20,40,Clouds
72908,103,1554562800,40,0,40,Clouds
72909,104,1554562800,40,0,40,Clouds
72910,105,1554562800,36,0,36,Clouds
72911,106,1554562800,28,12,40,Clouds
72912,107,1554562800,34,6,40,Clouds
72913,108,1554562800,39,1,40,Clouds
72914,109,1554562800,15,14,29,Clouds
72915,110,1554562800,39,1,40,Clouds
72916,111,1554562800,39,1,40,Clouds
72917,112,1554562800,28,2,30,Clouds
72918,113,1554562800,40,0,40,Clouds
72919,114,1554562800,40,0,40,Clouds
72920,115,1554562800,29,1,30,Clouds
72921,2,1554566400,20,0,20,Clouds
72922,3,1554566400,10,10,20,Clouds
72923,4,1554566400,0,20,20,Clouds
72924,5,1554566400,20,20,40,Clouds
72925,6,1554566400,1,19,20,Clouds
72926,7,1554566400,26,3,29,Clouds
72927,8,1554566400,4,26,30,Clouds
72928,9,1554566400,0,24,24,Clouds
72929,10,1554566400,0,16,16,Clouds
72930,11,1554566400,30,0,30,Clouds
72931,12,1554566400,18,2,20,Clouds
72932,13,1554566400,27,3,30,Clouds
72933,14,1554566400,0,30,30,Clouds
72934,15,1554566400,16,0,16,Clouds
72935,16,1554566400,3,17,20,Clouds
72936,17,1554566400,0,20,20,Clouds
72937,18,1554566400,17,13,30,Clouds
72938,19,1554566400,28,2,30,Clouds
72939,21,1554566400,4,26,30,Clouds
72940,22,1554566400,0,20,20,Clouds
72941,23,1554566400,21,9,30,Clouds
72942,24,1554566400,8,12,20,Clouds
72943,25,1554566400,28,2,30,Clouds
72944,26,1554566400,12,8,20,Clouds
72945,27,1554566400,0,20,20,Clouds
72946,28,1554566400,30,0,30,Clouds
72947,29,1554566400,0,29,29,Clouds
72948,30,1554566400,19,1,20,Clouds
72949,31,1554566400,2,18,20,Clouds
72950,32,1554566400,1,29,30,Clouds
72951,33,1554566400,1,22,23,Clouds
72952,34,1554566400,29,1,30,Clouds
72953,35,1554566400,22,8,30,Clouds
72954,36,1554566400,17,23,40,Clouds
72955,37,1554566400,20,10,30,Clouds
72956,38,1554566400,16,24,40,Clouds
72957,39,1554566400,18,2,20,Clouds
72958,40,1554566400,0,21,21,Clouds
72959,41,1554566400,20,0,20,Clouds
72960,42,1554566400,23,7,30,Clouds
72961,43,1554566400,23,7,30,Clouds
72962,44,1554566400,28,2,30,Clouds
72963,45,1554566400,23,7,30,Clouds
72964,46,1554566400,1,19,20,Clouds
72965,47,1554566400,39,1,40,Clouds
72966,48,1554566400,23,17,40,Clouds
72967,49,1554566400,34,6,40,Clouds
72968,50,1554566400,40,0,40,Clouds
72969,51,1554566400,0,40,40,Clouds
72970,52,1554566400,0,32,32,Clouds
72971,53,1554566400,40,0,40,Clouds
72972,54,1554566400,25,8,33,Clouds
72973,55,1554566400,34,2,36,Clouds
72974,56,1554566400,38,2,40,Clouds
72975,57,1554566400,21,2,23,Clouds
72976,58,1554566400,38,2,40,Clouds
72977,59,1554566400,18,2,20,Clouds
72978,60,1554566400,27,3,30,Clouds
72979,61,1554566400,20,5,25,Clouds
72980,62,1554566400,39,1,40,Clouds
72981,63,1554566400,9,26,35,Clouds
72982,64,1554566400,21,19,40,Clouds
72983,65,1554566400,39,1,40,Clouds
72984,66,1554566400,38,2,40,Clouds
72985,67,1554566400,38,2,40,Clouds
72986,68,1554566400,36,4,40,Clouds
72987,69,1554566400,39,1,40,Clouds
72988,70,1554566400,20,8,28,Clouds
72989,71,1554566400,29,11,40,Clouds
72990,72,1554566400,15,16,31,Clouds
72991,73,1554566400,30,0,30,Clouds
72992,74,1554566400,27,3,30,Clouds
72993,75,1554566400,16,24,40,Clouds
72994,76,1554566400,27,11,38,Clouds
72995,77,1554566400,0,29,29,Clouds
72996,78,1554566400,22,18,40,Clouds
72997,79,1554566400,25,2,27,Clouds
72998,80,1554566400,19,21,40,Clouds
72999,81,1554566400,9,31,40,Clouds
73000,82,1554566400,21,1,22,Clouds
73001,83,1554566400,35,5,40,Clouds
73002,84,1554566400,30,0,30,Clouds
73003,85,1554566400,31,4,35,Clouds
73004,86,1554566400,12,26,38,Clouds
73005,87,1554566400,27,11,38,Clouds
73006,88,1554566400,29,1,30,Clouds
73007,89,1554566400,40,0,40,Clouds
73008,90,1554566400,35,5,40,Clouds
73009,91,1554566400,7,23,30,Clouds
73010,92,1554566400,8,32,40,Clouds
73011,93,1554566400,12,28,40,Clouds
73012,94,1554566400,10,30,40,Clouds
73013,95,1554566400,40,0,40,Clouds
73014,96,1554566400,29,1,30,Clouds
73015,97,1554566400,40,0,40,Clouds
73016,98,1554566400,0,40,40,Clouds
73017,99,1554566400,19,11,30,Clouds
73018,100,1554566400,1,24,25,Clouds
73019,101,1554566400,26,4,30,Clouds
73020,102,1554566400,22,18,40,Clouds
73021,103,1554566400,40,0,40,Clouds
73022,104,1554566400,40,0,40,Clouds
73023,105,1554566400,36,0,36,Clouds
73024,106,1554566400,28,12,40,Clouds
73025,107,1554566400,37,3,40,Clouds
73026,108,1554566400,40,0,40,Clouds
73027,109,1554566400,16,13,29,Clouds
73028,110,1554566400,40,0,40,Clouds
73029,111,1554566400,40,0,40,Clouds
73030,112,1554566400,23,7,30,Clouds
73031,113,1554566400,40,0,40,Clouds
73032,114,1554566400,39,1,40,Clouds
73033,115,1554566400,25,5,30,Clouds
73034,2,1554570000,20,0,20,Clouds
73035,3,1554570000,4,16,20,Clouds
73036,4,1554570000,2,18,20,Clouds
73037,5,1554570000,26,14,40,Clouds
73038,6,1554570000,1,19,20,Clouds
73039,7,1554570000,27,2,29,Clouds
73040,8,1554570000,1,29,30,Clouds
73041,9,1554570000,1,23,24,Clouds
73042,10,1554570000,0,16,16,Clouds
73043,11,1554570000,27,3,30,Clouds
73044,12,1554570000,17,3,20,Clouds
73045,13,1554570000,26,4,30,Clouds
73046,14,1554570000,2,28,30,Clouds
73047,15,1554570000,16,0,16,Clouds
73048,16,1554570000,3,17,20,Clouds
73049,17,1554570000,5,15,20,Clouds
73050,18,1554570000,25,5,30,Clouds
73051,19,1554570000,22,8,30,Clouds
73052,21,1554570000,17,13,30,Clouds
73053,22,1554570000,2,18,20,Clouds
73054,23,1554570000,17,13,30,Clouds
73055,24,1554570000,6,14,20,Clouds
73056,25,1554570000,30,0,30,Clouds
73057,26,1554570000,13,7,20,Clouds
73058,27,1554570000,2,18,20,Clouds
73059,28,1554570000,30,0,30,Clouds
73060,29,1554570000,2,27,29,Clouds
73061,30,1554570000,20,0,20,Clouds
73062,31,1554570000,6,14,20,Clouds
73063,32,1554570000,2,28,30,Clouds
73064,33,1554570000,0,23,23,Clouds
73065,34,1554570000,30,0,30,Clouds
73066,35,1554570000,17,13,30,Clouds
73067,36,1554570000,18,22,40,Clouds
73068,37,1554570000,7,23,30,Clouds
73069,38,1554570000,13,27,40,Clouds
73070,39,1554570000,15,5,20,Clouds
73071,40,1554570000,0,21,21,Clouds
73072,41,1554570000,20,0,20,Clouds
73073,42,1554570000,25,5,30,Clouds
73074,43,1554570000,30,0,30,Clouds
73075,44,1554570000,28,2,30,Clouds
73076,45,1554570000,24,6,30,Clouds
73077,46,1554570000,2,18,20,Clouds
73078,47,1554570000,40,0,40,Clouds
73079,48,1554570000,28,12,40,Clouds
73080,49,1554570000,37,3,40,Clouds
73081,50,1554570000,39,1,40,Clouds
73082,51,1554570000,1,39,40,Clouds
73083,52,1554570000,0,32,32,Clouds
73084,53,1554570000,40,0,40,Clouds
73085,54,1554570000,26,7,33,Clouds
73086,55,1554570000,36,0,36,Clouds
73087,56,1554570000,38,2,40,Clouds
73088,57,1554570000,23,0,23,Clouds
73089,58,1554570000,38,2,40,Clouds
73090,59,1554570000,19,1,20,Clouds
73091,60,1554570000,24,6,30,Clouds
73092,61,1554570000,24,1,25,Clouds
73093,62,1554570000,38,2,40,Clouds
73094,63,1554570000,8,27,35,Clouds
73095,64,1554570000,22,18,40,Clouds
73096,65,1554570000,40,0,40,Clouds
73097,66,1554570000,40,0,40,Clouds
73098,67,1554570000,40,0,40,Clouds
73099,68,1554570000,25,15,40,Clouds
73100,69,1554570000,38,2,40,Clouds
73101,70,1554570000,19,9,28,Clouds
73102,71,1554570000,33,7,40,Clouds
73103,72,1554570000,18,13,31,Clouds
73104,73,1554570000,26,4,30,Clouds
73105,74,1554570000,30,0,30,Clouds
73106,75,1554570000,23,17,40,Clouds
73107,76,1554570000,30,8,38,Clouds
73108,77,1554570000,3,26,29,Clouds
73109,78,1554570000,29,11,40,Clouds
73110,79,1554570000,24,3,27,Clouds
73111,80,1554570000,25,15,40,Clouds
73112,81,1554570000,11,29,40,Clouds
73113,82,1554570000,21,1,22,Clouds
73114,83,1554570000,36,4,40,Clouds
73115,84,1554570000,29,1,30,Clouds
73116,85,1554570000,29,6,35,Clouds
73117,86,1554570000,7,31,38,Clouds
73118,87,1554570000,30,8,38,Clouds
73119,88,1554570000,28,2,30,Clouds
73120,89,1554570000,39,1,40,Clouds
73121,90,1554570000,35,5,40,Clouds
73122,91,1554570000,6,24,30,Clouds
73123,92,1554570000,14,26,40,Clouds
73124,93,1554570000,13,27,40,Clouds
73125,94,1554570000,10,30,40,Clouds
73126,95,1554570000,40,0,40,Clouds
73127,96,1554570000,30,0,30,Clouds
73128,97,1554570000,36,4,40,Clouds
73129,98,1554570000,2,38,40,Clouds
73130,99,1554570000,19,11,30,Clouds
73131,100,1554570000,3,22,25,Clouds
73132,101,1554570000,28,2,30,Clouds
73133,102,1554570000,26,14,40,Clouds
73134,103,1554570000,39,1,40,Clouds
73135,104,1554570000,40,0,40,Clouds
73136,105,1554570000,36,0,36,Clouds
73137,106,1554570000,31,9,40,Clouds
73138,107,1554570000,38,2,40,Clouds
73139,108,1554570000,40,0,40,Clouds
73140,109,1554570000,15,14,29,Clouds
73141,110,1554570000,40,0,40,Clouds
73142,111,1554570000,40,0,40,Clouds
73143,112,1554570000,22,8,30,Clouds
73144,113,1554570000,40,0,40,Clouds
73145,114,1554570000,36,4,40,Clouds
73146,115,1554570000,22,8,30,Clouds
73147,2,1554573600,20,0,20,Clouds
73148,3,1554573600,10,10,20,Clouds
73149,4,1554573600,1,19,20,Clouds
73150,5,1554573600,27,13,40,Clouds
73151,6,1554573600,1,19,20,Clouds
73152,7,1554573600,23,6,29,Clouds
73153,8,1554573600,1,29,30,Clouds
73154,9,1554573600,5,19,24,Clouds
73155,10,1554573600,2,14,16,Clouds
73156,11,1554573600,27,3,30,Clouds
73157,12,1554573600,20,0,20,Clouds
73158,13,1554573600,27,3,30,Clouds
73159,14,1554573600,1,29,30,Clouds
73160,15,1554573600,15,1,16,Clouds
73161,16,1554573600,1,19,20,Clouds
73162,17,1554573600,3,17,20,Clouds
73163,18,1554573600,18,12,30,Clouds
73164,19,1554573600,27,3,30,Clouds
73165,21,1554573600,12,18,30,Clouds
73166,22,1554573600,1,19,20,Clouds
73167,23,1554573600,19,11,30,Clouds
73168,24,1554573600,14,6,20,Clouds
73169,25,1554573600,30,0,30,Clouds
73170,26,1554573600,13,7,20,Clouds
73171,27,1554573600,7,13,20,Clouds
73172,28,1554573600,30,0,30,Clouds
73173,29,1554573600,2,27,29,Clouds
73174,30,1554573600,20,0,20,Clouds
73175,31,1554573600,8,12,20,Clouds
73176,32,1554573600,1,29,30,Clouds
73177,33,1554573600,8,15,23,Clouds
73178,34,1554573600,17,13,30,Clouds
73179,35,1554573600,12,18,30,Clouds
73180,36,1554573600,14,26,40,Clouds
73181,37,1554573600,6,24,30,Clouds
73182,38,1554573600,12,28,40,Clouds
73183,39,1554573600,19,1,20,Clouds
73184,40,1554573600,3,18,21,Clouds
73185,41,1554573600,20,0,20,Clouds
73186,42,1554573600,18,12,30,Clouds
73187,43,1554573600,23,7,30,Clouds
73188,44,1554573600,30,0,30,Clouds
73189,45,1554573600,27,3,30,Clouds
73190,46,1554573600,1,19,20,Clouds
73191,47,1554573600,40,0,40,Clouds
73192,48,1554573600,28,12,40,Clouds
73193,49,1554573600,40,0,40,Clouds
73194,50,1554573600,36,4,40,Clouds
73195,51,1554573600,4,36,40,Clouds
73196,52,1554573600,8,24,32,Clouds
73197,53,1554573600,40,0,40,Clouds
73198,54,1554573600,24,9,33,Clouds
73199,55,1554573600,35,1,36,Clouds
73200,56,1554573600,39,1,40,Clouds
73201,57,1554573600,22,1,23,Clouds
73202,58,1554573600,34,6,40,Clouds
73203,59,1554573600,20,0,20,Clouds
73204,60,1554573600,21,9,30,Clouds
73205,61,1554573600,23,2,25,Clouds
73206,62,1554573600,37,3,40,Clouds
73207,63,1554573600,8,27,35,Clouds
73208,64,1554573600,18,22,40,Clouds
73209,65,1554573600,40,0,40,Clouds
73210,66,1554573600,36,4,40,Clouds
73211,67,1554573600,34,6,40,Clouds
73212,68,1554573600,23,17,40,Clouds
73213,69,1554573600,23,17,40,Clouds
73214,70,1554573600,19,9,28,Clouds
73215,71,1554573600,30,10,40,Clouds
73216,72,1554573600,19,12,31,Clouds
73217,73,1554573600,26,4,30,Clouds
73218,74,1554573600,29,1,30,Clouds
73219,75,1554573600,29,11,40,Clouds
73220,76,1554573600,32,6,38,Clouds
73221,77,1554573600,1,28,29,Clouds
73222,78,1554573600,26,14,40,Clouds
73223,79,1554573600,22,5,27,Clouds
73224,80,1554573600,26,14,40,Clouds
73225,81,1554573600,11,29,40,Clouds
73226,82,1554573600,22,0,22,Clouds
73227,83,1554573600,32,8,40,Clouds
73228,84,1554573600,25,5,30,Clouds
73229,85,1554573600,25,10,35,Clouds
73230,86,1554573600,10,28,38,Clouds
73231,87,1554573600,31,7,38,Clouds
73232,88,1554573600,27,3,30,Clouds
73233,89,1554573600,38,2,40,Clouds
73234,90,1554573600,40,0,40,Clouds
73235,91,1554573600,6,24,30,Clouds
73236,92,1554573600,20,20,40,Clouds
73237,93,1554573600,13,27,40,Clouds
73238,94,1554573600,10,30,40,Clouds
73239,95,1554573600,36,4,40,Clouds
73240,96,1554573600,29,1,30,Clouds
73241,97,1554573600,38,2,40,Clouds
73242,98,1554573600,2,38,40,Clouds
73243,99,1554573600,18,12,30,Clouds
73244,100,1554573600,1,24,25,Clouds
73245,101,1554573600,26,3,29,Clouds
73246,102,1554573600,27,13,40,Clouds
73247,103,1554573600,40,0,40,Clouds
73248,104,1554573600,40,0,40,Clouds
73249,105,1554573600,36,0,36,Clouds
73250,106,1554573600,29,11,40,Clouds
73251,107,1554573600,39,1,40,Clouds
73252,108,1554573600,39,1,40,Clouds
73253,109,1554573600,13,16,29,Clouds
73254,110,1554573600,39,1,40,Clouds
73255,111,1554573600,39,1,40,Clouds
73256,112,1554573600,19,11,30,Clouds
73257,113,1554573600,40,0,40,Clouds
73258,114,1554573600,36,4,40,Clouds
73259,115,1554573600,17,13,30,Clouds
73260,2,1554577200,18,1,19,Clear
73261,3,1554577200,12,8,20,Clear
73262,4,1554577200,1,19,20,Clear
73263,5,1554577200,32,8,40,Clear
73264,6,1554577200,4,16,20,Clear
73265,7,1554577200,23,6,29,Clear
73266,8,1554577200,3,27,30,Clear
73267,9,1554577200,2,22,24,Clear
73268,10,1554577200,1,15,16,Clear
73269,11,1554577200,29,1,30,Clear
73270,12,1554577200,19,1,20,Clear
73271,13,1554577200,27,3,30,Clear
73272,14,1554577200,3,27,30,Clear
73273,15,1554577200,14,2,16,Clear
73274,16,1554577200,0,20,20,Clear
73275,17,1554577200,5,15,20,Clear
73276,18,1554577200,16,14,30,Clear
73277,19,1554577200,27,3,30,Clear
73278,21,1554577200,12,18,30,Clear
73279,22,1554577200,1,19,20,Clear
73280,23,1554577200,17,13,30,Clear
73281,24,1554577200,12,8,20,Clear
73282,25,1554577200,29,1,30,Clear
73283,26,1554577200,15,5,20,Clear
73284,27,1554577200,20,0,20,Clear
73285,28,1554577200,29,1,30,Clear
73286,29,1554577200,2,27,29,Clear
73287,30,1554577200,20,0,20,Clear
73288,31,1554577200,13,7,20,Clear
73289,32,1554577200,9,21,30,Clear
73290,33,1554577200,4,19,23,Clear
73291,34,1554577200,14,16,30,Clear
73292,35,1554577200,11,19,30,Clear
73293,36,1554577200,13,27,40,Clear
73294,37,1554577200,7,23,30,Clear
73295,38,1554577200,0,40,40,Clear
73296,39,1554577200,13,7,20,Clear
73297,40,1554577200,10,11,21,Clear
73298,41,1554577200,20,0,20,Clear
73299,42,1554577200,8,22,30,Clear
73300,43,1554577200,22,8,30,Clear
73301,44,1554577200,26,4,30,Clear
73302,45,1554577200,26,4,30,Clear
73303,46,1554577200,6,14,20,Clear
73304,47,1554577200,40,0,40,Clear
73305,48,1554577200,22,18,40,Clear
73306,49,1554577200,38,2,40,Clear
73307,50,1554577200,32,8,40,Clear
73308,51,1554577200,8,32,40,Clear
73309,52,1554577200,14,18,32,Clear
73310,53,1554577200,40,0,40,Clear
73311,54,1554577200,24,9,33,Clear
73312,55,1554577200,35,1,36,Clear
73313,56,1554577200,40,0,40,Clear
73314,57,1554577200,20,3,23,Clear
73315,58,1554577200,28,12,40,Clear
73316,59,1554577200,15,5,20,Clear
73317,60,1554577200,28,2,30,Clear
73318,61,1554577200,22,3,25,Clear
73319,62,1554577200,35,5,40,Clear
73320,63,1554577200,4,31,35,Clear
73321,64,1554577200,19,21,40,Clear
73322,65,1554577200,40,0,40,Clear
73323,66,1554577200,34,6,40,Clear
73324,67,1554577200,35,5,40,Clear
73325,68,1554577200,20,20,40,Clear
73326,69,1554577200,24,16,40,Clear
73327,70,1554577200,11,17,28,Clear
73328,71,1554577200,33,7,40,Clear
73329,72,1554577200,16,15,31,Clear
73330,73,1554577200,29,1,30,Clear
73331,74,1554577200,30,0,30,Clear
73332,75,1554577200,30,10,40,Clear
73333,76,1554577200,29,9,38,Clear
73334,77,1554577200,3,26,29,Clear
73335,78,1554577200,33,7,40,Clear
73336,79,1554577200,24,3,27,Clear
73337,80,1554577200,32,8,40,Clear
73338,81,1554577200,12,28,40,Clear
73339,82,1554577200,21,1,22,Clear
73340,83,1554577200,30,10,40,Clear
73341,84,1554577200,22,8,30,Clear
73342,85,1554577200,26,9,35,Clear
73343,86,1554577200,10,28,38,Clear
73344,87,1554577200,30,8,38,Clear
73345,88,1554577200,20,10,30,Clear
73346,89,1554577200,38,2,40,Clear
73347,90,1554577200,38,2,40,Clear
73348,91,1554577200,0,30,30,Clear
73349,92,1554577200,17,23,40,Clear
73350,93,1554577200,13,27,40,Clear
73351,94,1554577200,10,30,40,Clear
73352,95,1554577200,37,3,40,Clear
73353,96,1554577200,28,2,30,Clear
73354,97,1554577200,36,4,40,Clear
73355,98,1554577200,4,36,40,Clear
73356,99,1554577200,16,14,30,Clear
73357,100,1554577200,3,22,25,Clear
73358,101,1554577200,25,5,30,Clear
73359,102,1554577200,29,11,40,Clear
73360,103,1554577200,40,0,40,Clear
73361,104,1554577200,40,0,40,Clear
73362,105,1554577200,35,1,36,Clear
73363,106,1554577200,33,7,40,Clear
73364,107,1554577200,36,4,40,Clear
73365,108,1554577200,37,3,40,Clear
73366,109,1554577200,13,16,29,Clear
73367,110,1554577200,39,1,40,Clear
73368,111,1554577200,38,2,40,Clear
73369,112,1554577200,18,12,30,Clear
73370,113,1554577200,39,1,40,Clear
73371,114,1554577200,38,2,40,Clear
73372,115,1554577200,13,17,30,Clear
73373,2,1554580800,14,5,19,Clear
73374,3,1554580800,10,10,20,Clear
73375,4,1554580800,3,17,20,Clear
73376,5,1554580800,29,11,40,Clear
73377,6,1554580800,4,16,20,Clear
73378,7,1554580800,27,2,29,Clear
73379,8,1554580800,7,23,30,Clear
73380,9,1554580800,4,20,24,Clear
73381,10,1554580800,0,16,16,Clear
73382,11,1554580800,29,1,30,Clear
73383,12,1554580800,17,3,20,Clear
73384,13,1554580800,27,3,30,Clear
73385,14,1554580800,0,30,30,Clear
73386,15,1554580800,14,2,16,Clear
73387,16,1554580800,2,18,20,Clear
73388,17,1554580800,7,13,20,Clear
73389,18,1554580800,16,14,30,Clear
73390,19,1554580800,19,11,30,Clear
73391,21,1554580800,17,13,30,Clear
73392,22,1554580800,0,20,20,Clear
73393,23,1554580800,10,20,30,Clear
73394,24,1554580800,13,7,20,Clear
73395,25,1554580800,29,1,30,Clear
73396,26,1554580800,17,3,20,Clear
73397,27,1554580800,20,0,20,Clear
73398,28,1554580800,29,1,30,Clear
73399,29,1554580800,4,25,29,Clear
73400,30,1554580800,19,1,20,Clear
73401,31,1554580800,18,2,20,Clear
73402,32,1554580800,10,20,30,Clear
73403,33,1554580800,7,16,23,Clear
73404,34,1554580800,5,25,30,Clear
73405,35,1554580800,13,17,30,Clear
73406,36,1554580800,14,26,40,Clear
73407,37,1554580800,6,24,30,Clear
73408,38,1554580800,3,37,40,Clear
73409,39,1554580800,18,2,20,Clear
73410,40,1554580800,13,8,21,Clear
73411,41,1554580800,20,0,20,Clear
73412,42,1554580800,5,25,30,Clear
73413,43,1554580800,27,3,30,Clear
73414,44,1554580800,24,6,30,Clear
73415,45,1554580800,24,6,30,Clear
73416,46,1554580800,7,13,20,Clear
73417,47,1554580800,40,0,40,Clear
73418,48,1554580800,18,22,40,Clear
73419,49,1554580800,31,9,40,Clear
73420,50,1554580800,28,12,40,Clear
73421,51,1554580800,4,36,40,Clear
73422,52,1554580800,13,19,32,Clear
73423,53,1554580800,38,2,40,Clear
73424,54,1554580800,25,8,33,Clear
73425,55,1554580800,34,2,36,Clear
73426,56,1554580800,38,2,40,Clear
73427,57,1554580800,22,1,23,Clear
73428,58,1554580800,29,11,40,Clear
73429,59,1554580800,14,6,20,Clear
73430,60,1554580800,21,9,30,Clear
73431,61,1554580800,25,0,25,Clear
73432,62,1554580800,36,4,40,Clear
73433,63,1554580800,3,32,35,Clear
73434,64,1554580800,20,20,40,Clear
73435,65,1554580800,40,0,40,Clear
73436,66,1554580800,34,6,40,Clear
73437,67,1554580800,30,10,40,Clear
73438,68,1554580800,24,16,40,Clear
73439,69,1554580800,18,22,40,Clear
73440,70,1554580800,0,28,28,Clear
73441,71,1554580800,30,10,40,Clear
73442,72,1554580800,15,16,31,Clear
73443,73,1554580800,30,0,30,Clear
73444,74,1554580800,30,0,30,Clear
73445,75,1554580800,28,12,40,Clear
73446,76,1554580800,26,12,38,Clear
73447,77,1554580800,5,24,29,Clear
73448,78,1554580800,33,7,40,Clear
73449,79,1554580800,24,3,27,Clear
73450,80,1554580800,31,9,40,Clear
73451,81,1554580800,12,28,40,Clear
73452,82,1554580800,20,2,22,Clear
73453,83,1554580800,33,7,40,Clear
73454,84,1554580800,20,10,30,Clear
73455,85,1554580800,27,8,35,Clear
73456,86,1554580800,15,23,38,Clear
73457,87,1554580800,31,7,38,Clear
73458,88,1554580800,19,11,30,Clear
73459,89,1554580800,35,5,40,Clear
73460,90,1554580800,40,0,40,Clear
73461,91,1554580800,0,30,30,Clear
73462,92,1554580800,19,21,40,Clear
73463,93,1554580800,13,27,40,Clear
73464,94,1554580800,10,30,40,Clear
73465,95,1554580800,35,5,40,Clear
73466,96,1554580800,30,0,30,Clear
73467,97,1554580800,38,2,40,Clear
73468,98,1554580800,8,32,40,Clear
73469,99,1554580800,17,13,30,Clear
73470,100,1554580800,5,20,25,Clear
73471,101,1554580800,26,4,30,Clear
73472,102,1554580800,30,10,40,Clear
73473,103,1554580800,40,0,40,Clear
73474,104,1554580800,40,0,40,Clear
73475,105,1554580800,33,3,36,Clear
73476,106,1554580800,36,4,40,Clear
73477,107,1554580800,39,1,40,Clear
73478,108,1554580800,37,3,40,Clear
73479,109,1554580800,10,19,29,Clear
73480,110,1554580800,40,0,40,Clear
73481,111,1554580800,37,3,40,Clear
73482,112,1554580800,17,13,30,Clear
73483,113,1554580800,40,0,40,Clear
73484,114,1554580800,40,0,40,Clear
73485,115,1554580800,14,16,30,Clear
73486,2,1554584400,11,8,19,Clear
73487,3,1554584400,1,19,20,Clear
73488,4,1554584400,4,16,20,Clear
73489,5,1554584400,31,9,40,Clear
73490,6,1554584400,5,15,20,Clear
73491,7,1554584400,28,1,29,Clear
73492,8,1554584400,9,21,30,Clear
73493,9,1554584400,0,24,24,Clear
73494,10,1554584400,0,16,16,Clear
73495,11,1554584400,29,1,30,Clear
73496,12,1554584400,17,3,20,Clear
73497,13,1554584400,25,5,30,Clear
73498,14,1554584400,1,29,30,Clear
73499,15,1554584400,15,1,16,Clear
73500,16,1554584400,0,20,20,Clear
73501,17,1554584400,3,17,20,Clear
73502,18,1554584400,5,25,30,Clear
73503,19,1554584400,17,13,30,Clear
73504,21,1554584400,16,14,30,Clear
73505,22,1554584400,0,20,20,Clear
73506,23,1554584400,12,18,30,Clear
73507,24,1554584400,19,1,20,Clear
73508,25,1554584400,27,3,30,Clear
73509,26,1554584400,17,3,20,Clear
73510,27,1554584400,12,8,20,Clear
73511,28,1554584400,30,0,30,Clear
73512,29,1554584400,0,29,29,Clear
73513,30,1554584400,20,0,20,Clear
73514,31,1554584400,18,2,20,Clear
73515,32,1554584400,16,14,30,Clear
73516,33,1554584400,12,11,23,Clear
73517,34,1554584400,2,28,30,Clear
73518,35,1554584400,12,18,30,Clear
73519,36,1554584400,14,26,40,Clear
73520,37,1554584400,7,23,30,Clear
73521,38,1554584400,9,31,40,Clear
73522,39,1554584400,19,1,20,Clear
73523,40,1554584400,13,8,21,Clear
73524,41,1554584400,20,0,20,Clear
73525,42,1554584400,4,26,30,Clear
73526,43,1554584400,23,7,30,Clear
73527,44,1554584400,23,7,30,Clear
73528,45,1554584400,25,5,30,Clear
73529,46,1554584400,2,18,20,Clear
73530,47,1554584400,40,0,40,Clear
73531,48,1554584400,20,20,40,Clear
73532,49,1554584400,33,7,40,Clear
73533,50,1554584400,28,12,40,Clear
73534,51,1554584400,3,37,40,Clear
73535,52,1554584400,5,27,32,Clear
73536,53,1554584400,38,2,40,Clear
73537,54,1554584400,25,8,33,Clear
73538,55,1554584400,33,3,36,Clear
73539,56,1554584400,38,2,40,Clear
73540,57,1554584400,23,0,23,Clear
73541,58,1554584400,37,3,40,Clear
73542,59,1554584400,15,5,20,Clear
73543,60,1554584400,20,10,30,Clear
73544,61,1554584400,25,0,25,Clear
73545,62,1554584400,37,3,40,Clear
73546,63,1554584400,3,32,35,Clear
73547,64,1554584400,20,20,40,Clear
73548,65,1554584400,40,0,40,Clear
73549,66,1554584400,30,10,40,Clear
73550,67,1554584400,33,7,40,Clear
73551,68,1554584400,25,15,40,Clear
73552,69,1554584400,12,28,40,Clear
73553,70,1554584400,5,23,28,Clear
73554,71,1554584400,29,11,40,Clear
73555,72,1554584400,20,11,31,Clear
73556,73,1554584400,30,0,30,Clear
73557,74,1554584400,27,3,30,Clear
73558,75,1554584400,30,10,40,Clear
73559,76,1554584400,27,11,38,Clear
73560,77,1554584400,4,25,29,Clear
73561,78,1554584400,34,6,40,Clear
73562,79,1554584400,24,3,27,Clear
73563,80,1554584400,30,10,40,Clear
73564,81,1554584400,13,27,40,Clear
73565,82,1554584400,20,2,22,Clear
73566,83,1554584400,31,9,40,Clear
73567,84,1554584400,25,5,30,Clear
73568,85,1554584400,30,5,35,Clear
73569,86,1554584400,16,22,38,Clear
73570,87,1554584400,31,7,38,Clear
73571,88,1554584400,22,8,30,Clear
73572,89,1554584400,35,5,40,Clear
73573,90,1554584400,40,0,40,Clear
73574,91,1554584400,0,30,30,Clear
73575,92,1554584400,21,19,40,Clear
73576,93,1554584400,13,27,40,Clear
73577,94,1554584400,10,30,40,Clear
73578,95,1554584400,36,4,40,Clear
73579,96,1554584400,30,0,30,Clear
73580,97,1554584400,38,2,40,Clear
73581,98,1554584400,9,31,40,Clear
73582,99,1554584400,18,12,30,Clear
73583,100,1554584400,7,18,25,Clear
73584,101,1554584400,24,6,30,Clear
73585,102,1554584400,31,9,40,Clear
73586,103,1554584400,40,0,40,Clear
73587,104,1554584400,40,0,40,Clear
73588,105,1554584400,34,2,36,Clear
73589,106,1554584400,33,7,40,Clear
73590,107,1554584400,40,0,40,Clear
73591,108,1554584400,37,3,40,Clear
73592,109,1554584400,7,22,29,Clear
73593,110,1554584400,37,3,40,Clear
73594,111,1554584400,38,2,40,Clear
73595,112,1554584400,22,8,30,Clear
73596,113,1554584400,40,0,40,Clear
73597,114,1554584400,37,3,40,Clear
73598,115,1554584400,16,14,30,Clear
73599,2,1554588000,9,10,19,Clouds
73600,3,1554588000,2,18,20,Clouds
73601,4,1554588000,4,16,20,Clouds
73602,5,1554588000,31,9,40,Clouds
73603,6,1554588000,0,20,20,Clouds
73604,7,1554588000,28,1,29,Clouds
73605,8,1554588000,11,19,30,Clouds
73606,9,1554588000,1,23,24,Clouds
73607,10,1554588000,0,16,16,Clouds
73608,11,1554588000,30,0,30,Clouds
73609,12,1554588000,17,3,20,Clouds
73610,13,1554588000,24,6,30,Clouds
73611,14,1554588000,3,27,30,Clouds
73612,15,1554588000,13,3,16,Clouds
73613,16,1554588000,0,20,20,Clouds
73614,17,1554588000,1,19,20,Clouds
73615,18,1554588000,4,26,30,Clouds
73616,19,1554588000,17,13,30,Clouds
73617,21,1554588000,18,12,30,Clouds
73618,22,1554588000,1,19,20,Clouds
73619,23,1554588000,11,19,30,Clouds
73620,24,1554588000,18,2,20,Clouds
73621,25,1554588000,29,1,30,Clouds
73622,26,1554588000,16,4,20,Clouds
73623,27,1554588000,13,7,20,Clouds
73624,28,1554588000,28,2,30,Clouds
73625,29,1554588000,1,28,29,Clouds
73626,30,1554588000,19,1,20,Clouds
73627,31,1554588000,19,1,20,Clouds
73628,32,1554588000,20,10,30,Clouds
73629,33,1554588000,15,8,23,Clouds
73630,34,1554588000,1,29,30,Clouds
73631,35,1554588000,15,15,30,Clouds
73632,36,1554588000,11,29,40,Clouds
73633,37,1554588000,6,24,30,Clouds
73634,38,1554588000,10,30,40,Clouds
73635,39,1554588000,20,0,20,Clouds
73636,40,1554588000,7,14,21,Clouds
73637,41,1554588000,20,0,20,Clouds
73638,42,1554588000,5,25,30,Clouds
73639,43,1554588000,22,8,30,Clouds
73640,44,1554588000,23,7,30,Clouds
73641,45,1554588000,27,3,30,Clouds
73642,46,1554588000,0,20,20,Clouds
73643,47,1554588000,38,2,40,Clouds
73644,48,1554588000,26,14,40,Clouds
73645,49,1554588000,36,4,40,Clouds
73646,50,1554588000,33,7,40,Clouds
73647,51,1554588000,3,37,40,Clouds
73648,52,1554588000,6,26,32,Clouds
73649,53,1554588000,38,2,40,Clouds
73650,54,1554588000,22,11,33,Clouds
73651,55,1554588000,33,3,36,Clouds
73652,56,1554588000,35,5,40,Clouds
73653,57,1554588000,23,0,23,Clouds
73654,58,1554588000,37,3,40,Clouds
73655,59,1554588000,18,2,20,Clouds
73656,60,1554588000,22,8,30,Clouds
73657,61,1554588000,25,0,25,Clouds
73658,62,1554588000,36,4,40,Clouds
73659,63,1554588000,4,31,35,Clouds
73660,64,1554588000,22,18,40,Clouds
73661,65,1554588000,37,3,40,Clouds
73662,66,1554588000,30,10,40,Clouds
73663,67,1554588000,34,6,40,Clouds
73664,68,1554588000,22,18,40,Clouds
73665,69,1554588000,7,33,40,Clouds
73666,70,1554588000,6,22,28,Clouds
73667,71,1554588000,27,13,40,Clouds
73668,72,1554588000,18,13,31,Clouds
73669,73,1554588000,28,2,30,Clouds
73670,74,1554588000,28,2,30,Clouds
73671,75,1554588000,26,14,40,Clouds
73672,76,1554588000,23,15,38,Clouds
73673,77,1554588000,6,23,29,Clouds
73674,78,1554588000,31,9,40,Clouds
73675,79,1554588000,25,2,27,Clouds
73676,80,1554588000,28,12,40,Clouds
73677,81,1554588000,13,27,40,Clouds
73678,82,1554588000,19,3,22,Clouds
73679,83,1554588000,29,11,40,Clouds
73680,84,1554588000,24,6,30,Clouds
73681,85,1554588000,29,6,35,Clouds
73682,86,1554588000,17,21,38,Clouds
73683,87,1554588000,32,6,38,Clouds
73684,88,1554588000,23,7,30,Clouds
73685,89,1554588000,37,3,40,Clouds
73686,90,1554588000,40,0,40,Clouds
73687,91,1554588000,1,29,30,Clouds
73688,92,1554588000,21,19,40,Clouds
73689,93,1554588000,13,27,40,Clouds
73690,94,1554588000,10,30,40,Clouds
73691,95,1554588000,37,3,40,Clouds
73692,96,1554588000,30,0,30,Clouds
73693,97,1554588000,40,0,40,Clouds
73694,98,1554588000,11,29,40,Clouds
73695,99,1554588000,18,12,30,Clouds
73696,100,1554588000,7,18,25,Clouds
73697,101,1554588000,25,5,30,Clouds
73698,102,1554588000,30,10,40,Clouds
73699,103,1554588000,40,0,40,Clouds
73700,104,1554588000,40,0,40,Clouds
73701,105,1554588000,34,2,36,Clouds
73702,106,1554588000,34,6,40,Clouds
73703,107,1554588000,39,1,40,Clouds
73704,108,1554588000,35,5,40,Clouds
73705,109,1554588000,7,22,29,Clouds
73706,110,1554588000,35,5,40,Clouds
73707,111,1554588000,40,0,40,Clouds
73708,112,1554588000,22,8,30,Clouds
73709,113,1554588000,39,1,40,Clouds
73710,114,1554588000,39,1,40,Clouds
73711,115,1554588000,16,14,30,Clouds
73712,2,1554591600,12,7,19,Clouds
73713,3,1554591600,5,15,20,Clouds
73714,4,1554591600,4,16,20,Clouds
73715,5,1554591600,31,9,40,Clouds
73716,6,1554591600,3,17,20,Clouds
73717,7,1554591600,27,2,29,Clouds
73718,8,1554591600,13,17,30,Clouds
73719,9,1554591600,0,24,24,Clouds
73720,10,1554591600,1,15,16,Clouds
73721,11,1554591600,30,0,30,Clouds
73722,12,1554591600,16,4,20,Clouds
73723,13,1554591600,25,5,30,Clouds
73724,14,1554591600,0,30,30,Clouds
73725,15,1554591600,14,2,16,Clouds
73726,16,1554591600,0,20,20,Clouds
73727,17,1554591600,1,19,20,Clouds
73728,18,1554591600,2,28,30,Clouds
73729,19,1554591600,17,13,30,Clouds
73730,21,1554591600,18,12,30,Clouds
73731,22,1554591600,1,19,20,Clouds
73732,23,1554591600,10,20,30,Clouds
73733,24,1554591600,20,0,20,Clouds
73734,25,1554591600,28,2,30,Clouds
73735,26,1554591600,14,6,20,Clouds
73736,27,1554591600,20,0,20,Clouds
73737,28,1554591600,30,0,30,Clouds
73738,29,1554591600,1,28,29,Clouds
73739,30,1554591600,17,3,20,Clouds
73740,31,1554591600,20,0,20,Clouds
73741,32,1554591600,17,13,30,Clouds
73742,33,1554591600,11,12,23,Clouds
73743,34,1554591600,3,27,30,Clouds
73744,35,1554591600,8,22,30,Clouds
73745,36,1554591600,10,30,40,Clouds
73746,37,1554591600,6,24,30,Clouds
73747,38,1554591600,16,24,40,Clouds
73748,39,1554591600,20,0,20,Clouds
73749,40,1554591600,0,21,21,Clouds
73750,41,1554591600,19,1,20,Clouds
73751,42,1554591600,6,24,30,Clouds
73752,43,1554591600,21,9,30,Clouds
73753,44,1554591600,24,6,30,Clouds
73754,45,1554591600,29,1,30,Clouds
73755,46,1554591600,0,20,20,Clouds
73756,47,1554591600,39,1,40,Clouds
73757,48,1554591600,23,17,40,Clouds
73758,49,1554591600,37,3,40,Clouds
73759,50,1554591600,30,10,40,Clouds
73760,51,1554591600,4,36,40,Clouds
73761,52,1554591600,8,24,32,Clouds
73762,53,1554591600,38,2,40,Clouds
73763,54,1554591600,16,17,33,Clouds
73764,55,1554591600,36,0,36,Clouds
73765,56,1554591600,38,2,40,Clouds
73766,57,1554591600,21,2,23,Clouds
73767,58,1554591600,37,3,40,Clouds
73768,59,1554591600,19,1,20,Clouds
73769,60,1554591600,22,8,30,Clouds
73770,61,1554591600,23,2,25,Clouds
73771,62,1554591600,36,4,40,Clouds
73772,63,1554591600,10,25,35,Clouds
73773,64,1554591600,23,17,40,Clouds
73774,65,1554591600,35,5,40,Clouds
73775,66,1554591600,30,10,40,Clouds
73776,67,1554591600,34,6,40,Clouds
73777,68,1554591600,26,14,40,Clouds
73778,69,1554591600,12,28,40,Clouds
73779,70,1554591600,5,23,28,Clouds
73780,71,1554591600,23,17,40,Clouds
73781,72,1554591600,17,14,31,Clouds
73782,73,1554591600,28,2,30,Clouds
73783,74,1554591600,28,2,30,Clouds
73784,75,1554591600,25,15,40,Clouds
73785,76,1554591600,26,12,38,Clouds
73786,77,1554591600,3,26,29,Clouds
73787,78,1554591600,33,7,40,Clouds
73788,79,1554591600,25,2,27,Clouds
73789,80,1554591600,28,12,40,Clouds
73790,81,1554591600,13,27,40,Clouds
73791,82,1554591600,19,3,22,Clouds
73792,83,1554591600,29,11,40,Clouds
73793,84,1554591600,24,6,30,Clouds
73794,85,1554591600,29,6,35,Clouds
73795,86,1554591600,15,23,38,Clouds
73796,87,1554591600,29,9,38,Clouds
73797,88,1554591600,22,8,30,Clouds
73798,89,1554591600,36,4,40,Clouds
73799,90,1554591600,40,0,40,Clouds
73800,91,1554591600,1,29,30,Clouds
73801,92,1554591600,18,22,40,Clouds
73802,93,1554591600,13,27,40,Clouds
73803,94,1554591600,10,30,40,Clouds
73804,95,1554591600,38,2,40,Clouds
73805,96,1554591600,30,0,30,Clouds
73806,97,1554591600,37,3,40,Clouds
73807,98,1554591600,12,28,40,Clouds
73808,99,1554591600,20,10,30,Clouds
73809,100,1554591600,7,18,25,Clouds
73810,101,1554591600,23,7,30,Clouds
73811,102,1554591600,31,9,40,Clouds
73812,103,1554591600,40,0,40,Clouds
73813,104,1554591600,40,0,40,Clouds
73814,105,1554591600,34,2,36,Clouds
73815,106,1554591600,34,6,40,Clouds
73816,107,1554591600,33,7,40,Clouds
73817,108,1554591600,36,4,40,Clouds
73818,109,1554591600,7,22,29,Clouds
73819,110,1554591600,36,4,40,Clouds
73820,111,1554591600,35,5,40,Clouds
73821,112,1554591600,20,10,30,Clouds
73822,113,1554591600,39,1,40,Clouds
73823,114,1554591600,38,2,40,Clouds
73824,115,1554591600,11,19,30,Clouds
73825,2,1554595200,8,11,19,Clouds
73826,3,1554595200,5,15,20,Clouds
73827,4,1554595200,4,16,20,Clouds
73828,5,1554595200,31,9,40,Clouds
73829,6,1554595200,9,11,20,Clouds
73830,7,1554595200,27,2,29,Clouds
73831,8,1554595200,12,18,30,Clouds
73832,9,1554595200,9,15,24,Clouds
73833,10,1554595200,8,8,16,Clouds
73834,11,1554595200,29,1,30,Clouds
73835,12,1554595200,17,3,20,Clouds
73836,13,1554595200,25,5,30,Clouds
73837,14,1554595200,5,25,30,Clouds
73838,15,1554595200,14,2,16,Clouds
73839,16,1554595200,1,19,20,Clouds
73840,17,1554595200,1,19,20,Clouds
73841,18,1554595200,8,22,30,Clouds
73842,19,1554595200,15,15,30,Clouds
73843,21,1554595200,20,10,30,Clouds
73844,22,1554595200,4,16,20,Clouds
73845,23,1554595200,11,19,30,Clouds
73846,24,1554595200,20,0,20,Clouds
73847,25,1554595200,28,2,30,Clouds
73848,26,1554595200,16,4,20,Clouds
73849,27,1554595200,20,0,20,Clouds
73850,28,1554595200,29,1,30,Clouds
73851,29,1554595200,2,27,29,Clouds
73852,30,1554595200,19,1,20,Clouds
73853,31,1554595200,19,1,20,Clouds
73854,32,1554595200,15,15,30,Clouds
73855,33,1554595200,10,13,23,Clouds
73856,34,1554595200,6,24,30,Clouds
73857,35,1554595200,7,23,30,Clouds
73858,36,1554595200,17,23,40,Clouds
73859,37,1554595200,8,22,30,Clouds
73860,38,1554595200,15,25,40,Clouds
73861,39,1554595200,20,0,20,Clouds
73862,40,1554595200,1,20,21,Clouds
73863,41,1554595200,19,1,20,Clouds
73864,42,1554595200,5,25,30,Clouds
73865,43,1554595200,18,12,30,Clouds
73866,44,1554595200,22,8,30,Clouds
73867,45,1554595200,29,1,30,Clouds
73868,46,1554595200,0,20,20,Clouds
73869,47,1554595200,38,2,40,Clouds
73870,48,1554595200,26,14,40,Clouds
73871,49,1554595200,36,4,40,Clouds
73872,50,1554595200,28,12,40,Clouds
73873,51,1554595200,8,32,40,Clouds
73874,52,1554595200,8,24,32,Clouds
73875,53,1554595200,37,3,40,Clouds
73876,54,1554595200,17,16,33,Clouds
73877,55,1554595200,36,0,36,Clouds
73878,56,1554595200,36,4,40,Clouds
73879,57,1554595200,17,6,23,Clouds
73880,58,1554595200,36,4,40,Clouds
73881,59,1554595200,19,1,20,Clouds
73882,60,1554595200,20,10,30,Clouds
73883,61,1554595200,23,2,25,Clouds
73884,62,1554595200,37,3,40,Clouds
73885,63,1554595200,12,23,35,Clouds
73886,64,1554595200,23,17,40,Clouds
73887,65,1554595200,34,6,40,Clouds
73888,66,1554595200,28,12,40,Clouds
73889,67,1554595200,40,0,40,Clouds
73890,68,1554595200,23,17,40,Clouds
73891,69,1554595200,12,28,40,Clouds
73892,70,1554595200,6,22,28,Clouds
73893,71,1554595200,21,19,40,Clouds
73894,72,1554595200,15,16,31,Clouds
73895,73,1554595200,24,6,30,Clouds
73896,74,1554595200,29,1,30,Clouds
73897,75,1554595200,23,17,40,Clouds
73898,76,1554595200,26,12,38,Clouds
73899,77,1554595200,0,29,29,Clouds
73900,78,1554595200,32,8,40,Clouds
73901,79,1554595200,25,2,27,Clouds
73902,80,1554595200,28,12,40,Clouds
73903,81,1554595200,13,27,40,Clouds
73904,82,1554595200,17,5,22,Clouds
73905,83,1554595200,29,11,40,Clouds
73906,84,1554595200,23,7,30,Clouds
73907,85,1554595200,27,8,35,Clouds
73908,86,1554595200,15,23,38,Clouds
73909,87,1554595200,29,9,38,Clouds
73910,88,1554595200,19,11,30,Clouds
73911,89,1554595200,37,3,40,Clouds
73912,90,1554595200,40,0,40,Clouds
73913,91,1554595200,3,27,30,Clouds
73914,92,1554595200,17,23,40,Clouds
73915,93,1554595200,13,27,40,Clouds
73916,94,1554595200,10,30,40,Clouds
73917,95,1554595200,37,3,40,Clouds
73918,96,1554595200,30,0,30,Clouds
73919,97,1554595200,35,5,40,Clouds
73920,98,1554595200,12,28,40,Clouds
73921,99,1554595200,19,11,30,Clouds
73922,100,1554595200,7,18,25,Clouds
73923,101,1554595200,20,10,30,Clouds
73924,102,1554595200,29,11,40,Clouds
73925,103,1554595200,40,0,40,Clouds
73926,104,1554595200,40,0,40,Clouds
73927,105,1554595200,34,2,36,Clouds
73928,106,1554595200,33,7,40,Clouds
73929,107,1554595200,33,7,40,Clouds
73930,108,1554595200,36,4,40,Clouds
73931,109,1554595200,3,26,29,Clouds
73932,110,1554595200,35,5,40,Clouds
73933,111,1554595200,30,10,40,Clouds
73934,112,1554595200,22,8,30,Clouds
73935,113,1554595200,39,1,40,Clouds
73936,114,1554595200,39,1,40,Clouds
73937,115,1554595200,9,21,30,Clouds
73938,2,1554598800,7,12,19,Clouds
73939,3,1554598800,8,12,20,Clouds
73940,4,1554598800,3,17,20,Clouds
73941,5,1554598800,32,8,40,Clouds
73942,6,1554598800,9,11,20,Clouds
73943,7,1554598800,26,3,29,Clouds
73944,8,1554598800,11,19,30,Clouds
73945,9,1554598800,12,12,24,Clouds
73946,10,1554598800,11,5,16,Clouds
73947,11,1554598800,29,1,30,Clouds
73948,12,1554598800,15,5,20,Clouds
73949,13,1554598800,26,4,30,Clouds
73950,14,1554598800,5,25,30,Clouds
73951,15,1554598800,13,3,16,Clouds
73952,16,1554598800,0,20,20,Clouds
73953,17,1554598800,1,19,20,Clouds
73954,18,1554598800,8,22,30,Clouds
73955,19,1554598800,15,15,30,Clouds
73956,21,1554598800,21,9,30,Clouds
73957,22,1554598800,4,16,20,Clouds
73958,23,1554598800,12,18,30,Clouds
73959,24,1554598800,18,2,20,Clouds
73960,25,1554598800,29,1,30,Clouds
73961,26,1554598800,18,2,20,Clouds
73962,27,1554598800,20,0,20,Clouds
73963,28,1554598800,29,1,30,Clouds
73964,29,1554598800,5,24,29,Clouds
73965,30,1554598800,18,2,20,Clouds
73966,31,1554598800,20,0,20,Clouds
73967,32,1554598800,16,14,30,Clouds
73968,33,1554598800,8,15,23,Clouds
73969,34,1554598800,6,24,30,Clouds
73970,35,1554598800,5,25,30,Clouds
73971,36,1554598800,19,21,40,Clouds
73972,37,1554598800,8,22,30,Clouds
73973,38,1554598800,18,22,40,Clouds
73974,39,1554598800,19,1,20,Clouds
73975,40,1554598800,2,19,21,Clouds
73976,41,1554598800,19,1,20,Clouds
73977,42,1554598800,3,27,30,Clouds
73978,43,1554598800,21,9,30,Clouds
73979,44,1554598800,22,8,30,Clouds
73980,45,1554598800,29,1,30,Clouds
73981,46,1554598800,3,17,20,Clouds
73982,47,1554598800,38,2,40,Clouds
73983,48,1554598800,25,15,40,Clouds
73984,49,1554598800,34,6,40,Clouds
73985,50,1554598800,27,13,40,Clouds
73986,51,1554598800,8,32,40,Clouds
73987,52,1554598800,9,23,32,Clouds
73988,53,1554598800,37,3,40,Clouds
73989,54,1554598800,18,15,33,Clouds
73990,55,1554598800,36,0,36,Clouds
73991,56,1554598800,40,0,40,Clouds
73992,57,1554598800,17,6,23,Clouds
73993,58,1554598800,35,5,40,Clouds
73994,59,1554598800,19,1,20,Clouds
73995,60,1554598800,20,10,30,Clouds
73996,61,1554598800,23,2,25,Clouds
73997,62,1554598800,37,3,40,Clouds
73998,63,1554598800,14,21,35,Clouds
73999,64,1554598800,23,17,40,Clouds
74000,65,1554598800,34,6,40,Clouds
74001,66,1554598800,27,13,40,Clouds
74002,67,1554598800,39,1,40,Clouds
74003,68,1554598800,27,13,40,Clouds
74004,69,1554598800,11,29,40,Clouds
74005,70,1554598800,2,26,28,Clouds
74006,71,1554598800,19,21,40,Clouds
74007,72,1554598800,16,15,31,Clouds
74008,73,1554598800,23,7,30,Clouds
74009,74,1554598800,28,2,30,Clouds
74010,75,1554598800,23,17,40,Clouds
74011,76,1554598800,26,12,38,Clouds
74012,77,1554598800,1,28,29,Clouds
74013,78,1554598800,31,9,40,Clouds
74014,79,1554598800,25,2,27,Clouds
74015,80,1554598800,28,12,40,Clouds
74016,81,1554598800,13,27,40,Clouds
74017,82,1554598800,17,5,22,Clouds
74018,83,1554598800,24,16,40,Clouds
74019,84,1554598800,22,8,30,Clouds
74020,85,1554598800,27,8,35,Clouds
74021,86,1554598800,17,21,38,Clouds
74022,87,1554598800,29,9,38,Clouds
74023,88,1554598800,17,13,30,Clouds
74024,89,1554598800,37,3,40,Clouds
74025,90,1554598800,40,0,40,Clouds
74026,91,1554598800,8,22,30,Clouds
74027,92,1554598800,13,27,40,Clouds
74028,93,1554598800,13,27,40,Clouds
74029,94,1554598800,10,30,40,Clouds
74030,95,1554598800,36,4,40,Clouds
74031,96,1554598800,30,0,30,Clouds
74032,97,1554598800,35,5,40,Clouds
74033,98,1554598800,14,26,40,Clouds
74034,99,1554598800,20,10,30,Clouds
74035,100,1554598800,8,17,25,Clouds
74036,101,1554598800,18,12,30,Clouds
74037,102,1554598800,30,10,40,Clouds
74038,103,1554598800,40,0,40,Clouds
74039,104,1554598800,40,0,40,Clouds
74040,105,1554598800,34,2,36,Clouds
74041,106,1554598800,31,9,40,Clouds
74042,107,1554598800,30,10,40,Clouds
74043,108,1554598800,33,7,40,Clouds
74044,109,1554598800,2,27,29,Clouds
74045,110,1554598800,35,5,40,Clouds
74046,111,1554598800,27,13,40,Clouds
74047,112,1554598800,20,10,30,Clouds
74048,113,1554598800,39,1,40,Clouds
74049,114,1554598800,40,0,40,Clouds
74050,115,1554598800,6,24,30,Clouds
74051,2,1554602400,7,12,19,Clouds
74052,3,1554602400,8,12,20,Clouds
74053,4,1554602400,3,17,20,Clouds
74054,5,1554602400,32,8,40,Clouds
74055,6,1554602400,7,13,20,Clouds
74056,7,1554602400,26,3,29,Clouds
74057,8,1554602400,11,19,30,Clouds
74058,9,1554602400,12,12,24,Clouds
74059,10,1554602400,11,5,16,Clouds
74060,11,1554602400,29,1,30,Clouds
74061,12,1554602400,15,5,20,Clouds
74062,13,1554602400,26,4,30,Clouds
74063,14,1554602400,4,26,30,Clouds
74064,15,1554602400,13,3,16,Clouds
74065,16,1554602400,0,20,20,Clouds
74066,17,1554602400,1,19,20,Clouds
74067,18,1554602400,7,23,30,Clouds
74068,19,1554602400,15,15,30,Clouds
74069,21,1554602400,21,9,30,Clouds
74070,22,1554602400,4,16,20,Clouds
74071,23,1554602400,12,18,30,Clouds
74072,24,1554602400,16,4,20,Clouds
74073,25,1554602400,29,1,30,Clouds
74074,26,1554602400,18,2,20,Clouds
74075,27,1554602400,20,0,20,Clouds
74076,28,1554602400,28,2,30,Clouds
74077,29,1554602400,5,24,29,Clouds
74078,30,1554602400,18,2,20,Clouds
74079,31,1554602400,20,0,20,Clouds
74080,32,1554602400,16,14,30,Clouds
74081,33,1554602400,8,15,23,Clouds
74082,34,1554602400,5,25,30,Clouds
74083,35,1554602400,5,25,30,Clouds
74084,36,1554602400,19,21,40,Clouds
74085,37,1554602400,8,22,30,Clouds
74086,38,1554602400,18,22,40,Clouds
74087,39,1554602400,19,1,20,Clouds
74088,40,1554602400,2,19,21,Clouds
74089,41,1554602400,19,1,20,Clouds
74090,42,1554602400,3,27,30,Clouds
74091,43,1554602400,21,9,30,Clouds
74092,44,1554602400,22,8,30,Clouds
74093,45,1554602400,29,1,30,Clouds
74094,46,1554602400,3,17,20,Clouds
74095,47,1554602400,38,2,40,Clouds
74096,48,1554602400,25,15,40,Clouds
74097,49,1554602400,34,6,40,Clouds
74098,50,1554602400,27,13,40,Clouds
74099,51,1554602400,8,32,40,Clouds
74100,52,1554602400,7,25,32,Clouds
74101,53,1554602400,37,3,40,Clouds
74102,54,1554602400,18,15,33,Clouds
74103,55,1554602400,36,0,36,Clouds
74104,56,1554602400,39,1,40,Clouds
74105,57,1554602400,17,6,23,Clouds
74106,58,1554602400,35,5,40,Clouds
74107,59,1554602400,19,1,20,Clouds
74108,60,1554602400,20,10,30,Clouds
74109,61,1554602400,23,2,25,Clouds
74110,62,1554602400,37,3,40,Clouds
74111,63,1554602400,14,21,35,Clouds
74112,64,1554602400,23,17,40,Clouds
74113,65,1554602400,34,6,40,Clouds
74114,66,1554602400,27,13,40,Clouds
74115,67,1554602400,39,1,40,Clouds
74116,68,1554602400,27,13,40,Clouds
74117,69,1554602400,11,29,40,Clouds
74118,70,1554602400,2,26,28,Clouds
74119,71,1554602400,19,21,40,Clouds
74120,72,1554602400,16,15,31,Clouds
74121,73,1554602400,23,7,30,Clouds
74122,74,1554602400,28,2,30,Clouds
74123,75,1554602400,23,17,40,Clouds
74124,76,1554602400,26,12,38,Clouds
74125,77,1554602400,1,28,29,Clouds
74126,78,1554602400,31,9,40,Clouds
74127,79,1554602400,25,2,27,Clouds
74128,80,1554602400,28,12,40,Clouds
74129,81,1554602400,13,27,40,Clouds
74130,82,1554602400,17,5,22,Clouds
74131,83,1554602400,23,17,40,Clouds
74132,84,1554602400,21,9,30,Clouds
74133,85,1554602400,27,8,35,Clouds
74134,86,1554602400,17,21,38,Clouds
74135,87,1554602400,29,9,38,Clouds
74136,88,1554602400,17,13,30,Clouds
74137,89,1554602400,37,3,40,Clouds
74138,90,1554602400,40,0,40,Clouds
74139,91,1554602400,8,22,30,Clouds
74140,92,1554602400,13,27,40,Clouds
74141,93,1554602400,13,27,40,Clouds
74142,94,1554602400,10,30,40,Clouds
74143,95,1554602400,36,4,40,Clouds
74144,96,1554602400,30,0,30,Clouds
74145,97,1554602400,35,5,40,Clouds
74146,98,1554602400,14,26,40,Clouds
74147,99,1554602400,20,10,30,Clouds
74148,100,1554602400,8,17,25,Clouds
74149,101,1554602400,17,13,30,Clouds
74150,102,1554602400,30,10,40,Clouds
74151,103,1554602400,40,0,40,Clouds
74152,104,1554602400,40,0,40,Clouds
74153,105,1554602400,34,2,36,Clouds
74154,106,1554602400,31,9,40,Clouds
74155,107,1554602400,30,10,40,Clouds
74156,108,1554602400,33,7,40,Clouds
74157,109,1554602400,2,27,29,Clouds
74158,110,1554602400,35,5,40,Clouds
74159,111,1554602400,27,13,40,Clouds
74160,112,1554602400,20,10,30,Clouds
74161,113,1554602400,39,1,40,Clouds
74162,114,1554602400,40,0,40,Clouds
74163,115,1554602400,6,24,30,Clouds
74164,2,1554606000,7,12,19,Clouds
74165,3,1554606000,8,12,20,Clouds
74166,4,1554606000,3,17,20,Clouds
74167,5,1554606000,32,8,40,Clouds
74168,6,1554606000,7,13,20,Clouds
74169,7,1554606000,26,3,29,Clouds
74170,8,1554606000,11,19,30,Clouds
74171,9,1554606000,12,12,24,Clouds
74172,10,1554606000,11,5,16,Clouds
74173,11,1554606000,29,1,30,Clouds
74174,12,1554606000,15,5,20,Clouds
74175,13,1554606000,26,4,30,Clouds
74176,14,1554606000,4,26,30,Clouds
74177,15,1554606000,13,3,16,Clouds
74178,16,1554606000,0,20,20,Clouds
74179,17,1554606000,1,19,20,Clouds
74180,18,1554606000,7,23,30,Clouds
74181,19,1554606000,15,15,30,Clouds
74182,21,1554606000,21,9,30,Clouds
74183,22,1554606000,4,16,20,Clouds
74184,23,1554606000,12,18,30,Clouds
74185,24,1554606000,16,4,20,Clouds
74186,25,1554606000,29,1,30,Clouds
74187,26,1554606000,18,2,20,Clouds
74188,27,1554606000,20,0,20,Clouds
74189,28,1554606000,28,2,30,Clouds
74190,29,1554606000,5,24,29,Clouds
74191,30,1554606000,18,2,20,Clouds
74192,31,1554606000,20,0,20,Clouds
74193,32,1554606000,16,14,30,Clouds
74194,33,1554606000,8,15,23,Clouds
74195,34,1554606000,5,25,30,Clouds
74196,35,1554606000,5,25,30,Clouds
74197,36,1554606000,19,21,40,Clouds
74198,37,1554606000,8,22,30,Clouds
74199,38,1554606000,18,22,40,Clouds
74200,39,1554606000,19,1,20,Clouds
74201,40,1554606000,2,19,21,Clouds
74202,41,1554606000,19,1,20,Clouds
74203,42,1554606000,3,27,30,Clouds
74204,43,1554606000,21,9,30,Clouds
74205,44,1554606000,22,8,30,Clouds
74206,45,1554606000,29,1,30,Clouds
74207,46,1554606000,3,17,20,Clouds
74208,47,1554606000,38,2,40,Clouds
74209,48,1554606000,25,15,40,Clouds
74210,49,1554606000,34,6,40,Clouds
74211,50,1554606000,27,13,40,Clouds
74212,51,1554606000,8,32,40,Clouds
74213,52,1554606000,7,25,32,Clouds
74214,53,1554606000,37,3,40,Clouds
74215,54,1554606000,18,15,33,Clouds
74216,55,1554606000,36,0,36,Clouds
74217,56,1554606000,39,1,40,Clouds
74218,57,1554606000,17,6,23,Clouds
74219,58,1554606000,35,5,40,Clouds
74220,59,1554606000,19,1,20,Clouds
74221,60,1554606000,20,10,30,Clouds
74222,61,1554606000,23,2,25,Clouds
74223,62,1554606000,37,3,40,Clouds
74224,63,1554606000,14,21,35,Clouds
74225,64,1554606000,23,17,40,Clouds
74226,65,1554606000,34,6,40,Clouds
74227,66,1554606000,27,13,40,Clouds
74228,67,1554606000,39,1,40,Clouds
74229,68,1554606000,27,13,40,Clouds
74230,69,1554606000,11,29,40,Clouds
74231,70,1554606000,2,26,28,Clouds
74232,71,1554606000,19,21,40,Clouds
74233,72,1554606000,16,15,31,Clouds
74234,73,1554606000,23,7,30,Clouds
74235,74,1554606000,28,2,30,Clouds
74236,75,1554606000,23,17,40,Clouds
74237,76,1554606000,26,12,38,Clouds
74238,77,1554606000,1,28,29,Clouds
74239,78,1554606000,31,9,40,Clouds
74240,79,1554606000,25,2,27,Clouds
74241,80,1554606000,28,12,40,Clouds
74242,81,1554606000,13,27,40,Clouds
74243,82,1554606000,17,5,22,Clouds
74244,83,1554606000,23,17,40,Clouds
74245,84,1554606000,21,9,30,Clouds
74246,85,1554606000,27,8,35,Clouds
74247,86,1554606000,17,21,38,Clouds
74248,87,1554606000,29,9,38,Clouds
74249,88,1554606000,17,13,30,Clouds
74250,89,1554606000,37,3,40,Clouds
74251,90,1554606000,40,0,40,Clouds
74252,91,1554606000,8,22,30,Clouds
74253,92,1554606000,13,27,40,Clouds
74254,93,1554606000,13,27,40,Clouds
74255,94,1554606000,10,30,40,Clouds
74256,95,1554606000,36,4,40,Clouds
74257,96,1554606000,30,0,30,Clouds
74258,97,1554606000,34,6,40,Clouds
74259,98,1554606000,14,26,40,Clouds
74260,99,1554606000,20,10,30,Clouds
74261,100,1554606000,8,17,25,Clouds
74262,101,1554606000,17,13,30,Clouds
74263,102,1554606000,30,10,40,Clouds
74264,103,1554606000,40,0,40,Clouds
74265,104,1554606000,40,0,40,Clouds
74266,105,1554606000,34,2,36,Clouds
74267,106,1554606000,31,9,40,Clouds
74268,107,1554606000,30,10,40,Clouds
74269,108,1554606000,33,7,40,Clouds
74270,109,1554606000,2,27,29,Clouds
74271,110,1554606000,35,5,40,Clouds
74272,111,1554606000,27,13,40,Clouds
74273,112,1554606000,20,10,30,Clouds
74274,113,1554606000,39,1,40,Clouds
74275,114,1554606000,40,0,40,Clouds
74276,115,1554606000,6,24,30,Clouds
74277,2,1554609600,7,12,19,Clouds
74278,3,1554609600,8,12,20,Clouds
74279,4,1554609600,3,17,20,Clouds
74280,5,1554609600,32,8,40,Clouds
74281,6,1554609600,7,13,20,Clouds
74282,7,1554609600,26,3,29,Clouds
74283,8,1554609600,11,19,30,Clouds
74284,9,1554609600,12,12,24,Clouds
74285,10,1554609600,11,5,16,Clouds
74286,11,1554609600,29,1,30,Clouds
74287,12,1554609600,15,5,20,Clouds
74288,13,1554609600,26,4,30,Clouds
74289,14,1554609600,4,26,30,Clouds
74290,15,1554609600,13,3,16,Clouds
74291,16,1554609600,0,20,20,Clouds
74292,17,1554609600,1,19,20,Clouds
74293,18,1554609600,7,23,30,Clouds
74294,19,1554609600,15,15,30,Clouds
74295,21,1554609600,21,9,30,Clouds
74296,22,1554609600,4,16,20,Clouds
74297,23,1554609600,12,18,30,Clouds
74298,24,1554609600,16,4,20,Clouds
74299,25,1554609600,29,1,30,Clouds
74300,26,1554609600,18,2,20,Clouds
74301,27,1554609600,20,0,20,Clouds
74302,28,1554609600,28,2,30,Clouds
74303,29,1554609600,5,24,29,Clouds
74304,30,1554609600,18,2,20,Clouds
74305,31,1554609600,20,0,20,Clouds
74306,32,1554609600,16,14,30,Clouds
74307,33,1554609600,8,15,23,Clouds
74308,34,1554609600,5,25,30,Clouds
74309,35,1554609600,5,25,30,Clouds
74310,36,1554609600,19,21,40,Clouds
74311,37,1554609600,8,22,30,Clouds
74312,38,1554609600,18,22,40,Clouds
74313,39,1554609600,19,1,20,Clouds
74314,40,1554609600,2,19,21,Clouds
74315,41,1554609600,19,1,20,Clouds
74316,42,1554609600,3,27,30,Clouds
74317,43,1554609600,21,9,30,Clouds
74318,44,1554609600,21,9,30,Clouds
74319,45,1554609600,29,1,30,Clouds
74320,46,1554609600,3,17,20,Clouds
74321,47,1554609600,38,2,40,Clouds
74322,48,1554609600,25,15,40,Clouds
74323,49,1554609600,34,6,40,Clouds
74324,50,1554609600,27,13,40,Clouds
74325,51,1554609600,8,32,40,Clouds
74326,52,1554609600,7,25,32,Clouds
74327,53,1554609600,37,3,40,Clouds
74328,54,1554609600,18,15,33,Clouds
74329,55,1554609600,36,0,36,Clouds
74330,56,1554609600,39,1,40,Clouds
74331,57,1554609600,17,6,23,Clouds
74332,58,1554609600,35,5,40,Clouds
74333,59,1554609600,19,1,20,Clouds
74334,60,1554609600,20,10,30,Clouds
74335,61,1554609600,23,2,25,Clouds
74336,62,1554609600,37,3,40,Clouds
74337,63,1554609600,14,21,35,Clouds
74338,64,1554609600,23,17,40,Clouds
74339,65,1554609600,34,6,40,Clouds
74340,66,1554609600,27,13,40,Clouds
74341,67,1554609600,39,1,40,Clouds
74342,68,1554609600,27,13,40,Clouds
74343,69,1554609600,11,29,40,Clouds
74344,70,1554609600,2,26,28,Clouds
74345,71,1554609600,19,21,40,Clouds
74346,72,1554609600,16,15,31,Clouds
74347,73,1554609600,23,7,30,Clouds
74348,74,1554609600,28,2,30,Clouds
74349,75,1554609600,23,17,40,Clouds
74350,76,1554609600,26,12,38,Clouds
74351,77,1554609600,1,28,29,Clouds
74352,78,1554609600,31,9,40,Clouds
74353,79,1554609600,25,2,27,Clouds
74354,80,1554609600,28,12,40,Clouds
74355,81,1554609600,13,27,40,Clouds
74356,82,1554609600,17,5,22,Clouds
74357,83,1554609600,23,17,40,Clouds
74358,84,1554609600,21,9,30,Clouds
74359,85,1554609600,27,8,35,Clouds
74360,86,1554609600,17,21,38,Clouds
74361,87,1554609600,29,9,38,Clouds
74362,88,1554609600,17,13,30,Clouds
74363,89,1554609600,37,3,40,Clouds
74364,90,1554609600,40,0,40,Clouds
74365,91,1554609600,8,22,30,Clouds
74366,92,1554609600,13,27,40,Clouds
74367,93,1554609600,13,27,40,Clouds
74368,94,1554609600,10,30,40,Clouds
74369,95,1554609600,36,4,40,Clouds
74370,96,1554609600,30,0,30,Clouds
74371,97,1554609600,34,6,40,Clouds
74372,98,1554609600,14,26,40,Clouds
74373,99,1554609600,20,10,30,Clouds
74374,100,1554609600,8,17,25,Clouds
74375,101,1554609600,17,13,30,Clouds
74376,102,1554609600,30,10,40,Clouds
74377,103,1554609600,40,0,40,Clouds
74378,104,1554609600,40,0,40,Clouds
74379,105,1554609600,34,2,36,Clouds
74380,106,1554609600,31,9,40,Clouds
74381,107,1554609600,30,10,40,Clouds
74382,108,1554609600,33,7,40,Clouds
74383,109,1554609600,2,27,29,Clouds
74384,110,1554609600,35,5,40,Clouds
74385,111,1554609600,27,13,40,Clouds
74386,112,1554609600,20,10,30,Clouds
74387,113,1554609600,39,1,40,Clouds
74388,114,1554609600,40,0,40,Clouds
74389,115,1554609600,6,24,30,Clouds
74390,2,1554613200,7,12,19,Mist
74391,3,1554613200,8,12,20,Mist
74392,4,1554613200,3,17,20,Mist
74393,5,1554613200,32,8,40,Mist
74394,6,1554613200,7,13,20,Mist
74395,7,1554613200,26,3,29,Mist
74396,8,1554613200,11,19,30,Mist
74397,9,1554613200,12,12,24,Mist
74398,10,1554613200,11,5,16,Mist
74399,11,1554613200,29,1,30,Mist
74400,12,1554613200,15,5,20,Mist
74401,13,1554613200,26,4,30,Mist
74402,14,1554613200,4,26,30,Mist
74403,15,1554613200,13,3,16,Mist
74404,16,1554613200,0,20,20,Mist
74405,17,1554613200,1,19,20,Mist
74406,18,1554613200,7,23,30,Mist
74407,19,1554613200,15,15,30,Mist
74408,21,1554613200,21,9,30,Mist
74409,22,1554613200,4,16,20,Mist
74410,23,1554613200,12,18,30,Mist
74411,24,1554613200,16,4,20,Mist
74412,25,1554613200,29,1,30,Mist
74413,26,1554613200,18,2,20,Mist
74414,27,1554613200,20,0,20,Mist
74415,28,1554613200,28,2,30,Mist
74416,29,1554613200,5,24,29,Mist
74417,30,1554613200,18,2,20,Mist
74418,31,1554613200,20,0,20,Mist
74419,32,1554613200,16,14,30,Mist
74420,33,1554613200,8,15,23,Mist
74421,34,1554613200,5,25,30,Mist
74422,35,1554613200,5,25,30,Mist
74423,36,1554613200,19,21,40,Mist
74424,37,1554613200,8,22,30,Mist
74425,38,1554613200,18,22,40,Mist
74426,39,1554613200,19,1,20,Mist
74427,40,1554613200,2,19,21,Mist
74428,41,1554613200,19,1,20,Mist
74429,42,1554613200,3,27,30,Mist
74430,43,1554613200,21,9,30,Mist
74431,44,1554613200,21,9,30,Mist
74432,45,1554613200,29,1,30,Mist
74433,46,1554613200,3,17,20,Mist
74434,47,1554613200,38,2,40,Mist
74435,48,1554613200,25,15,40,Mist
74436,49,1554613200,34,6,40,Mist
74437,50,1554613200,27,13,40,Mist
74438,51,1554613200,8,32,40,Mist
74439,52,1554613200,7,25,32,Mist
74440,53,1554613200,37,3,40,Mist
74441,54,1554613200,18,15,33,Mist
74442,55,1554613200,36,0,36,Mist
74443,56,1554613200,39,1,40,Mist
74444,57,1554613200,17,6,23,Mist
74445,58,1554613200,35,5,40,Mist
74446,59,1554613200,19,1,20,Mist
74447,60,1554613200,20,10,30,Mist
74448,61,1554613200,23,2,25,Mist
74449,62,1554613200,37,3,40,Mist
74450,63,1554613200,14,21,35,Mist
74451,64,1554613200,23,17,40,Mist
74452,65,1554613200,34,6,40,Mist
74453,66,1554613200,27,13,40,Mist
74454,67,1554613200,39,1,40,Mist
74455,68,1554613200,27,13,40,Mist
74456,69,1554613200,11,29,40,Mist
74457,70,1554613200,2,26,28,Mist
74458,71,1554613200,19,21,40,Mist
74459,72,1554613200,16,15,31,Mist
74460,73,1554613200,23,7,30,Mist
74461,74,1554613200,28,2,30,Mist
74462,75,1554613200,23,17,40,Mist
74463,76,1554613200,26,12,38,Mist
74464,77,1554613200,1,28,29,Mist
74465,78,1554613200,31,9,40,Mist
74466,79,1554613200,25,2,27,Mist
74467,80,1554613200,28,12,40,Mist
74468,81,1554613200,13,27,40,Mist
74469,82,1554613200,17,5,22,Mist
74470,83,1554613200,23,17,40,Mist
74471,84,1554613200,21,9,30,Mist
74472,85,1554613200,27,8,35,Mist
74473,86,1554613200,17,21,38,Mist
74474,87,1554613200,29,9,38,Mist
74475,88,1554613200,17,13,30,Mist
74476,89,1554613200,37,3,40,Mist
74477,90,1554613200,40,0,40,Mist
74478,91,1554613200,8,22,30,Mist
74479,92,1554613200,13,27,40,Mist
74480,93,1554613200,13,27,40,Mist
74481,94,1554613200,10,30,40,Mist
74482,95,1554613200,36,4,40,Mist
74483,96,1554613200,30,0,30,Mist
74484,97,1554613200,34,6,40,Mist
74485,98,1554613200,14,26,40,Mist
74486,99,1554613200,20,10,30,Mist
74487,100,1554613200,8,17,25,Mist
74488,101,1554613200,17,13,30,Mist
74489,102,1554613200,30,10,40,Mist
74490,103,1554613200,40,0,40,Mist
74491,104,1554613200,40,0,40,Mist
74492,105,1554613200,34,2,36,Mist
74493,106,1554613200,31,9,40,Mist
74494,107,1554613200,30,10,40,Mist
74495,108,1554613200,33,7,40,Mist
74496,109,1554613200,2,27,29,Mist
74497,110,1554613200,35,5,40,Mist
74498,111,1554613200,27,13,40,Mist
74499,112,1554613200,21,9,30,Mist
74500,113,1554613200,39,1,40,Mist
74501,114,1554613200,40,0,40,Mist
74502,115,1554613200,6,24,30,Mist
74503,2,1554616800,7,12,19,Mist
74504,3,1554616800,8,12,20,Mist
74505,4,1554616800,3,17,20,Mist
74506,5,1554616800,33,7,40,Mist
74507,6,1554616800,7,13,20,Mist
74508,7,1554616800,26,3,29,Mist
74509,8,1554616800,11,19,30,Mist
74510,9,1554616800,12,12,24,Mist
74511,10,1554616800,12,4,16,Mist
74512,11,1554616800,29,1,30,Mist
74513,12,1554616800,16,4,20,Mist
74514,13,1554616800,26,4,30,Mist
74515,14,1554616800,4,26,30,Mist
74516,15,1554616800,12,4,16,Mist
74517,16,1554616800,0,20,20,Mist
74518,17,1554616800,1,19,20,Mist
74519,18,1554616800,7,23,30,Mist
74520,19,1554616800,14,16,30,Mist
74521,21,1554616800,21,9,30,Mist
74522,22,1554616800,3,17,20,Mist
74523,23,1554616800,12,18,30,Mist
74524,24,1554616800,14,6,20,Mist
74525,25,1554616800,29,1,30,Mist
74526,26,1554616800,18,2,20,Mist
74527,27,1554616800,19,1,20,Mist
74528,28,1554616800,30,0,30,Mist
74529,29,1554616800,4,25,29,Mist
74530,30,1554616800,18,2,20,Mist
74531,31,1554616800,20,0,20,Mist
74532,32,1554616800,17,13,30,Mist
74533,33,1554616800,8,15,23,Mist
74534,34,1554616800,5,25,30,Mist
74535,35,1554616800,4,26,30,Mist
74536,36,1554616800,19,21,40,Mist
74537,37,1554616800,7,23,30,Mist
74538,38,1554616800,18,22,40,Mist
74539,39,1554616800,19,1,20,Mist
74540,40,1554616800,2,19,21,Mist
74541,41,1554616800,20,0,20,Mist
74542,42,1554616800,3,27,30,Mist
74543,43,1554616800,21,9,30,Mist
74544,44,1554616800,21,9,30,Mist
74545,45,1554616800,28,2,30,Mist
74546,46,1554616800,4,16,20,Mist
74547,47,1554616800,38,2,40,Mist
74548,48,1554616800,25,15,40,Mist
74549,49,1554616800,35,5,40,Mist
74550,50,1554616800,27,13,40,Mist
74551,51,1554616800,8,32,40,Mist
74552,52,1554616800,7,25,32,Mist
74553,53,1554616800,38,2,40,Mist
74554,54,1554616800,20,13,33,Mist
74555,55,1554616800,36,0,36,Mist
74556,56,1554616800,39,1,40,Mist
74557,57,1554616800,17,6,23,Mist
74558,58,1554616800,34,6,40,Mist
74559,59,1554616800,18,2,20,Mist
74560,60,1554616800,20,10,30,Mist
74561,61,1554616800,24,1,25,Mist
74562,62,1554616800,37,3,40,Mist
74563,63,1554616800,16,19,35,Mist
74564,64,1554616800,23,17,40,Mist
74565,65,1554616800,34,6,40,Mist
74566,66,1554616800,26,14,40,Mist
74567,67,1554616800,39,1,40,Mist
74568,68,1554616800,27,13,40,Mist
74569,69,1554616800,10,30,40,Mist
74570,70,1554616800,2,26,28,Mist
74571,71,1554616800,21,19,40,Mist
74572,72,1554616800,16,15,31,Mist
74573,73,1554616800,23,7,30,Mist
74574,74,1554616800,27,3,30,Mist
74575,75,1554616800,24,16,40,Mist
74576,76,1554616800,24,14,38,Mist
74577,77,1554616800,1,28,29,Mist
74578,78,1554616800,32,8,40,Mist
74579,79,1554616800,25,2,27,Mist
74580,80,1554616800,27,13,40,Mist
74581,81,1554616800,13,27,40,Mist
74582,82,1554616800,18,4,22,Mist
74583,83,1554616800,23,17,40,Mist
74584,84,1554616800,20,10,30,Mist
74585,85,1554616800,28,7,35,Mist
74586,86,1554616800,18,20,38,Mist
74587,87,1554616800,29,9,38,Mist
74588,88,1554616800,17,13,30,Mist
74589,89,1554616800,37,3,40,Mist
74590,90,1554616800,40,0,40,Mist
74591,91,1554616800,7,23,30,Mist
74592,92,1554616800,13,27,40,Mist
74593,93,1554616800,13,27,40,Mist
74594,94,1554616800,10,30,40,Mist
74595,95,1554616800,36,4,40,Mist
74596,96,1554616800,30,0,30,Mist
74597,97,1554616800,34,6,40,Mist
74598,98,1554616800,15,25,40,Mist
74599,99,1554616800,20,10,30,Mist
74600,100,1554616800,8,17,25,Mist
74601,101,1554616800,17,13,30,Mist
74602,102,1554616800,30,10,40,Mist
74603,103,1554616800,40,0,40,Mist
74604,104,1554616800,40,0,40,Mist
74605,105,1554616800,34,2,36,Mist
74606,106,1554616800,31,9,40,Mist
74607,107,1554616800,30,10,40,Mist
74608,108,1554616800,33,7,40,Mist
74609,109,1554616800,2,27,29,Mist
74610,110,1554616800,35,5,40,Mist
74611,111,1554616800,27,13,40,Mist
74612,112,1554616800,22,8,30,Mist
74613,113,1554616800,39,1,40,Mist
74614,114,1554616800,40,0,40,Mist
74615,115,1554616800,5,25,30,Mist
74616,2,1554620400,9,10,19,Mist
74617,3,1554620400,8,12,20,Mist
74618,4,1554620400,4,16,20,Mist
74619,5,1554620400,33,7,40,Mist
74620,6,1554620400,7,13,20,Mist
74621,7,1554620400,27,2,29,Mist
74622,8,1554620400,9,21,30,Mist
74623,9,1554620400,9,15,24,Mist
74624,10,1554620400,12,4,16,Mist
74625,11,1554620400,29,1,30,Mist
74626,12,1554620400,17,3,20,Mist
74627,13,1554620400,26,4,30,Mist
74628,14,1554620400,3,27,30,Mist
74629,15,1554620400,12,4,16,Mist
74630,16,1554620400,0,20,20,Mist
74631,17,1554620400,1,19,20,Mist
74632,18,1554620400,9,21,30,Mist
74633,19,1554620400,9,21,30,Mist
74634,21,1554620400,21,9,30,Mist
74635,22,1554620400,3,17,20,Mist
74636,23,1554620400,11,19,30,Mist
74637,24,1554620400,11,9,20,Mist
74638,25,1554620400,29,1,30,Mist
74639,26,1554620400,17,3,20,Mist
74640,27,1554620400,18,2,20,Mist
74641,28,1554620400,30,0,30,Mist
74642,29,1554620400,3,26,29,Mist
74643,30,1554620400,17,3,20,Mist
74644,31,1554620400,19,1,20,Mist
74645,32,1554620400,16,14,30,Mist
74646,33,1554620400,10,13,23,Mist
74647,34,1554620400,6,24,30,Mist
74648,35,1554620400,6,24,30,Mist
74649,36,1554620400,17,23,40,Mist
74650,37,1554620400,6,24,30,Mist
74651,38,1554620400,16,24,40,Mist
74652,39,1554620400,19,1,20,Mist
74653,40,1554620400,2,19,21,Mist
74654,41,1554620400,20,0,20,Mist
74655,42,1554620400,5,25,30,Mist
74656,43,1554620400,22,8,30,Mist
74657,44,1554620400,24,6,30,Mist
74658,45,1554620400,27,3,30,Mist
74659,46,1554620400,5,15,20,Mist
74660,47,1554620400,38,2,40,Mist
74661,48,1554620400,25,15,40,Mist
74662,49,1554620400,37,3,40,Mist
74663,50,1554620400,29,11,40,Mist
74664,51,1554620400,7,33,40,Mist
74665,52,1554620400,2,30,32,Mist
74666,53,1554620400,38,2,40,Mist
74667,54,1554620400,20,13,33,Mist
74668,55,1554620400,36,0,36,Mist
74669,56,1554620400,37,3,40,Mist
74670,57,1554620400,17,6,23,Mist
74671,58,1554620400,30,10,40,Mist
74672,59,1554620400,18,2,20,Mist
74673,60,1554620400,21,9,30,Mist
74674,61,1554620400,24,1,25,Mist
74675,62,1554620400,37,3,40,Mist
74676,63,1554620400,16,19,35,Mist
74677,64,1554620400,23,17,40,Mist
74678,65,1554620400,34,6,40,Mist
74679,66,1554620400,24,16,40,Mist
74680,67,1554620400,38,2,40,Mist
74681,68,1554620400,26,14,40,Mist
74682,69,1554620400,10,30,40,Mist
74683,70,1554620400,0,28,28,Mist
74684,71,1554620400,21,19,40,Mist
74685,72,1554620400,14,17,31,Mist
74686,73,1554620400,24,6,30,Mist
74687,74,1554620400,27,3,30,Mist
74688,75,1554620400,25,15,40,Mist
74689,76,1554620400,26,12,38,Mist
74690,77,1554620400,2,27,29,Mist
74691,78,1554620400,34,6,40,Mist
74692,79,1554620400,25,2,27,Mist
74693,80,1554620400,29,11,40,Mist
74694,81,1554620400,13,27,40,Mist
74695,82,1554620400,19,3,22,Mist
74696,83,1554620400,23,17,40,Mist
74697,84,1554620400,20,10,30,Mist
74698,85,1554620400,28,7,35,Mist
74699,86,1554620400,16,22,38,Mist
74700,87,1554620400,30,8,38,Mist
74701,88,1554620400,22,8,30,Mist
74702,89,1554620400,37,3,40,Mist
74703,90,1554620400,38,2,40,Mist
74704,91,1554620400,7,23,30,Mist
74705,92,1554620400,13,27,40,Mist
74706,93,1554620400,13,27,40,Mist
74707,94,1554620400,10,30,40,Mist
74708,95,1554620400,37,3,40,Mist
74709,96,1554620400,30,0,30,Mist
74710,97,1554620400,33,7,40,Mist
74711,98,1554620400,15,25,40,Mist
74712,99,1554620400,20,10,30,Mist
74713,100,1554620400,7,18,25,Mist
74714,101,1554620400,19,11,30,Mist
74715,102,1554620400,30,10,40,Mist
74716,103,1554620400,40,0,40,Mist
74717,104,1554620400,40,0,40,Mist
74718,105,1554620400,34,2,36,Mist
74719,106,1554620400,31,9,40,Mist
74720,107,1554620400,31,9,40,Mist
74721,108,1554620400,37,3,40,Mist
74722,109,1554620400,5,24,29,Mist
74723,110,1554620400,34,6,40,Mist
74724,111,1554620400,30,10,40,Mist
74725,112,1554620400,22,8,30,Mist
74726,113,1554620400,38,2,40,Mist
74727,114,1554620400,40,0,40,Mist
74728,115,1554620400,5,25,30,Mist
74729,2,1554624000,14,5,19,Mist
74730,3,1554624000,6,14,20,Mist
74731,4,1554624000,6,14,20,Mist
74732,5,1554624000,33,7,40,Mist
74733,6,1554624000,7,13,20,Mist
74734,7,1554624000,28,1,29,Mist
74735,8,1554624000,9,21,30,Mist
74736,9,1554624000,7,17,24,Mist
74737,10,1554624000,8,8,16,Mist
74738,11,1554624000,29,1,30,Mist
74739,12,1554624000,19,1,20,Mist
74740,13,1554624000,25,5,30,Mist
74741,14,1554624000,0,30,30,Mist
74742,15,1554624000,12,4,16,Mist
74743,16,1554624000,0,20,20,Mist
74744,17,1554624000,0,20,20,Mist
74745,18,1554624000,10,20,30,Mist
74746,19,1554624000,4,26,30,Mist
74747,21,1554624000,21,9,30,Mist
74748,22,1554624000,3,17,20,Mist
74749,23,1554624000,11,19,30,Mist
74750,24,1554624000,8,12,20,Mist
74751,25,1554624000,28,2,30,Mist
74752,26,1554624000,18,2,20,Mist
74753,27,1554624000,16,4,20,Mist
74754,28,1554624000,30,0,30,Mist
74755,29,1554624000,0,29,29,Mist
74756,30,1554624000,16,4,20,Mist
74757,31,1554624000,20,0,20,Mist
74758,32,1554624000,15,15,30,Mist
74759,33,1554624000,8,15,23,Mist
74760,34,1554624000,7,23,30,Mist
74761,35,1554624000,7,23,30,Mist
74762,36,1554624000,16,24,40,Mist
74763,37,1554624000,6,24,30,Mist
74764,38,1554624000,13,27,40,Mist
74765,39,1554624000,18,2,20,Mist
74766,40,1554624000,2,19,21,Mist
74767,41,1554624000,20,0,20,Mist
74768,42,1554624000,6,24,30,Mist
74769,43,1554624000,22,8,30,Mist
74770,44,1554624000,22,8,30,Mist
74771,45,1554624000,28,2,30,Mist
74772,46,1554624000,5,15,20,Mist
74773,47,1554624000,38,2,40,Mist
74774,48,1554624000,27,13,40,Mist
74775,49,1554624000,39,1,40,Mist
74776,50,1554624000,34,6,40,Mist
74777,51,1554624000,6,34,40,Mist
74778,52,1554624000,2,30,32,Mist
74779,53,1554624000,38,2,40,Mist
74780,54,1554624000,19,14,33,Mist
74781,55,1554624000,36,0,36,Mist
74782,56,1554624000,36,4,40,Mist
74783,57,1554624000,15,8,23,Mist
74784,58,1554624000,27,13,40,Mist
74785,59,1554624000,19,1,20,Mist
74786,60,1554624000,24,6,30,Mist
74787,61,1554624000,25,0,25,Mist
74788,62,1554624000,36,4,40,Mist
74789,63,1554624000,16,19,35,Mist
74790,64,1554624000,24,16,40,Mist
74791,65,1554624000,34,6,40,Mist
74792,66,1554624000,24,16,40,Mist
74793,67,1554624000,38,2,40,Mist
74794,68,1554624000,23,17,40,Mist
74795,69,1554624000,8,32,40,Mist
74796,70,1554624000,0,28,28,Mist
74797,71,1554624000,23,17,40,Mist
74798,72,1554624000,14,17,31,Mist
74799,73,1554624000,23,7,30,Mist
74800,74,1554624000,28,2,30,Mist
74801,75,1554624000,25,15,40,Mist
74802,76,1554624000,28,10,38,Mist
74803,77,1554624000,1,28,29,Mist
74804,78,1554624000,36,4,40,Mist
74805,79,1554624000,24,3,27,Mist
74806,80,1554624000,29,11,40,Mist
74807,81,1554624000,12,28,40,Mist
74808,82,1554624000,19,3,22,Mist
74809,83,1554624000,23,17,40,Mist
74810,84,1554624000,22,8,30,Mist
74811,85,1554624000,29,6,35,Mist
74812,86,1554624000,17,21,38,Mist
74813,87,1554624000,31,7,38,Mist
74814,88,1554624000,24,6,30,Mist
74815,89,1554624000,37,3,40,Mist
74816,90,1554624000,34,6,40,Mist
74817,91,1554624000,7,23,30,Mist
74818,92,1554624000,16,24,40,Mist
74819,93,1554624000,13,27,40,Mist
74820,94,1554624000,10,30,40,Mist
74821,95,1554624000,37,3,40,Mist
74822,96,1554624000,30,0,30,Mist
74823,97,1554624000,34,6,40,Mist
74824,98,1554624000,15,25,40,Mist
74825,99,1554624000,20,10,30,Mist
74826,100,1554624000,2,23,25,Mist
74827,101,1554624000,22,8,30,Mist
74828,102,1554624000,31,9,40,Mist
74829,103,1554624000,40,0,40,Mist
74830,104,1554624000,40,0,40,Mist
74831,105,1554624000,34,2,36,Mist
74832,106,1554624000,32,8,40,Mist
74833,107,1554624000,33,7,40,Mist
74834,108,1554624000,39,1,40,Mist
74835,109,1554624000,4,25,29,Mist
74836,110,1554624000,35,5,40,Mist
74837,111,1554624000,33,7,40,Mist
74838,112,1554624000,26,4,30,Mist
74839,113,1554624000,38,2,40,Mist
74840,114,1554624000,39,1,40,Mist
74841,115,1554624000,10,20,30,Mist
74842,2,1554627600,20,0,20,Clouds
74843,3,1554627600,5,15,20,Clouds
74844,4,1554627600,6,14,20,Clouds
74845,5,1554627600,35,5,40,Clouds
74846,6,1554627600,7,13,20,Clouds
74847,7,1554627600,29,0,29,Clouds
74848,8,1554627600,7,23,30,Clouds
74849,9,1554627600,1,23,24,Clouds
74850,10,1554627600,5,10,15,Clouds
74851,11,1554627600,29,1,30,Clouds
74852,12,1554627600,20,0,20,Clouds
74853,13,1554627600,24,6,30,Clouds
74854,14,1554627600,0,29,29,Clouds
74855,15,1554627600,15,1,16,Clouds
74856,16,1554627600,0,20,20,Clouds
74857,17,1554627600,1,19,20,Clouds
74858,18,1554627600,9,21,30,Clouds
74859,19,1554627600,3,27,30,Clouds
74860,21,1554627600,21,9,30,Clouds
74861,22,1554627600,1,19,20,Clouds
74862,23,1554627600,8,21,29,Clouds
74863,24,1554627600,6,14,20,Clouds
74864,25,1554627600,25,5,30,Clouds
74865,26,1554627600,17,3,20,Clouds
74866,27,1554627600,12,8,20,Clouds
74867,28,1554627600,30,0,30,Clouds
74868,29,1554627600,0,29,29,Clouds
74869,30,1554627600,14,6,20,Clouds
74870,31,1554627600,19,1,20,Clouds
74871,32,1554627600,12,18,30,Clouds
74872,33,1554627600,0,23,23,Clouds
74873,34,1554627600,7,23,30,Clouds
74874,35,1554627600,9,21,30,Clouds
74875,36,1554627600,15,25,40,Clouds
74876,37,1554627600,6,24,30,Clouds
74877,38,1554627600,11,29,40,Clouds
74878,39,1554627600,19,1,20,Clouds
74879,40,1554627600,0,20,20,Clouds
74880,41,1554627600,20,0,20,Clouds
74881,42,1554627600,10,20,30,Clouds
74882,43,1554627600,21,9,30,Clouds
74883,44,1554627600,27,3,30,Clouds
74884,45,1554627600,28,2,30,Clouds
74885,46,1554627600,2,18,20,Clouds
74886,47,1554627600,38,2,40,Clouds
74887,48,1554627600,26,14,40,Clouds
74888,49,1554627600,40,0,40,Clouds
74889,50,1554627600,35,5,40,Clouds
74890,51,1554627600,24,15,39,Clouds
74891,52,1554627600,3,29,32,Clouds
74892,53,1554627600,38,2,40,Clouds
74893,54,1554627600,19,14,33,Clouds
74894,55,1554627600,36,0,36,Clouds
74895,56,1554627600,37,3,40,Clouds
74896,57,1554627600,13,10,23,Clouds
74897,58,1554627600,28,12,40,Clouds
74898,59,1554627600,19,1,20,Clouds
74899,60,1554627600,25,5,30,Clouds
74900,61,1554627600,25,0,25,Clouds
74901,62,1554627600,35,5,40,Clouds
74902,63,1554627600,14,21,35,Clouds
74903,64,1554627600,24,16,40,Clouds
74904,65,1554627600,34,6,40,Clouds
74905,66,1554627600,26,13,39,Clouds
74906,67,1554627600,40,0,40,Clouds
74907,68,1554627600,22,18,40,Clouds
74908,69,1554627600,8,31,39,Clouds
74909,70,1554627600,1,26,27,Clouds
74910,71,1554627600,23,17,40,Clouds
74911,72,1554627600,15,15,30,Clouds
74912,73,1554627600,26,4,30,Clouds
74913,74,1554627600,29,1,30,Clouds
74914,75,1554627600,26,13,39,Clouds
74915,76,1554627600,30,8,38,Clouds
74916,77,1554627600,0,28,28,Clouds
74917,78,1554627600,39,1,40,Clouds
74918,79,1554627600,25,2,27,Clouds
74919,80,1554627600,29,11,40,Clouds
74920,81,1554627600,11,29,40,Clouds
74921,82,1554627600,19,3,22,Clouds
74922,83,1554627600,26,14,40,Clouds
74923,84,1554627600,22,7,29,Clouds
74924,85,1554627600,14,21,35,Clouds
74925,86,1554627600,16,22,38,Clouds
74926,87,1554627600,37,1,38,Clouds
74927,88,1554627600,26,4,30,Clouds
74928,89,1554627600,37,3,40,Clouds
74929,90,1554627600,35,5,40,Clouds
74930,91,1554627600,8,22,30,Clouds
74931,92,1554627600,18,22,40,Clouds
74932,93,1554627600,13,27,40,Clouds
74933,94,1554627600,10,30,40,Clouds
74934,95,1554627600,37,3,40,Clouds
74935,96,1554627600,30,0,30,Clouds
74936,97,1554627600,36,4,40,Clouds
74937,98,1554627600,15,24,39,Clouds
74938,99,1554627600,19,11,30,Clouds
74939,100,1554627600,1,24,25,Clouds
74940,101,1554627600,21,8,29,Clouds
74941,102,1554627600,34,6,40,Clouds
74942,103,1554627600,39,1,40,Clouds
74943,104,1554627600,40,0,40,Clouds
74944,105,1554627600,34,2,36,Clouds
74945,106,1554627600,33,7,40,Clouds
74946,107,1554627600,35,5,40,Clouds
74947,108,1554627600,40,0,40,Clouds
74948,109,1554627600,4,25,29,Clouds
74949,110,1554627600,35,5,40,Clouds
74950,111,1554627600,36,4,40,Clouds
74951,112,1554627600,29,1,30,Clouds
74952,113,1554627600,38,2,40,Clouds
74953,114,1554627600,39,1,40,Clouds
74954,115,1554627600,13,16,29,Clouds
74955,2,1554631200,18,2,20,Clouds
74956,3,1554631200,8,12,20,Clouds
74957,4,1554631200,6,14,20,Clouds
74958,5,1554631200,34,6,40,Clouds
74959,6,1554631200,3,17,20,Clouds
74960,7,1554631200,29,0,29,Clouds
74961,8,1554631200,9,21,30,Clouds
74962,9,1554631200,0,24,24,Clouds
74963,10,1554631200,4,11,15,Clouds
74964,11,1554631200,29,1,30,Clouds
74965,12,1554631200,20,0,20,Clouds
74966,13,1554631200,23,7,30,Clouds
74967,14,1554631200,11,18,29,Clouds
74968,15,1554631200,16,0,16,Clouds
74969,16,1554631200,0,20,20,Clouds
74970,17,1554631200,0,20,20,Clouds
74971,18,1554631200,6,24,30,Clouds
74972,19,1554631200,1,29,30,Clouds
74973,21,1554631200,23,7,30,Clouds
74974,22,1554631200,0,20,20,Clouds
74975,23,1554631200,6,24,30,Clouds
74976,24,1554631200,12,8,20,Clouds
74977,25,1554631200,25,5,30,Clouds
74978,26,1554631200,17,3,20,Clouds
74979,27,1554631200,5,15,20,Clouds
74980,28,1554631200,30,0,30,Clouds
74981,29,1554631200,0,29,29,Clouds
74982,30,1554631200,17,3,20,Clouds
74983,31,1554631200,17,3,20,Clouds
74984,32,1554631200,9,21,30,Clouds
74985,33,1554631200,17,6,23,Clouds
74986,34,1554631200,9,21,30,Clouds
74987,35,1554631200,7,23,30,Clouds
74988,36,1554631200,12,28,40,Clouds
74989,37,1554631200,5,25,30,Clouds
74990,38,1554631200,6,34,40,Clouds
74991,39,1554631200,16,4,20,Clouds
74992,40,1554631200,0,20,20,Clouds
74993,41,1554631200,19,1,20,Clouds
74994,42,1554631200,7,23,30,Clouds
74995,43,1554631200,24,6,30,Clouds
74996,44,1554631200,29,1,30,Clouds
74997,45,1554631200,30,0,30,Clouds
74998,46,1554631200,0,20,20,Clouds
74999,47,1554631200,38,2,40,Clouds
75000,48,1554631200,25,15,40,Clouds
75001,49,1554631200,38,2,40,Clouds
75002,50,1554631200,39,1,40,Clouds
75003,51,1554631200,23,16,39,Clouds
75004,52,1554631200,0,32,32,Clouds
75005,53,1554631200,37,3,40,Clouds
75006,54,1554631200,17,16,33,Clouds
75007,55,1554631200,35,1,36,Clouds
75008,56,1554631200,38,2,40,Clouds
75009,57,1554631200,13,10,23,Clouds
75010,58,1554631200,27,13,40,Clouds
75011,59,1554631200,19,1,20,Clouds
75012,60,1554631200,30,0,30,Clouds
75013,61,1554631200,25,0,25,Clouds
75014,62,1554631200,35,5,40,Clouds
75015,63,1554631200,15,20,35,Clouds
75016,64,1554631200,26,14,40,Clouds
75017,65,1554631200,35,5,40,Clouds
75018,66,1554631200,34,6,40,Clouds
75019,67,1554631200,36,4,40,Clouds
75020,68,1554631200,19,21,40,Clouds
75021,69,1554631200,5,34,39,Clouds
75022,70,1554631200,1,26,27,Clouds
75023,71,1554631200,26,14,40,Clouds
75024,72,1554631200,15,15,30,Clouds
75025,73,1554631200,28,2,30,Clouds
75026,74,1554631200,30,0,30,Clouds
75027,75,1554631200,27,12,39,Clouds
75028,76,1554631200,29,9,38,Clouds
75029,77,1554631200,0,28,28,Clouds
75030,78,1554631200,40,0,40,Clouds
75031,79,1554631200,26,1,27,Clouds
75032,80,1554631200,31,9,40,Clouds
75033,81,1554631200,12,28,40,Clouds
75034,82,1554631200,18,4,22,Clouds
75035,83,1554631200,27,13,40,Clouds
75036,84,1554631200,25,4,29,Clouds
75037,85,1554631200,14,21,35,Clouds
75038,86,1554631200,16,21,37,Clouds
75039,87,1554631200,38,0,38,Clouds
75040,88,1554631200,28,2,30,Clouds
75041,89,1554631200,37,3,40,Clouds
75042,90,1554631200,34,6,40,Clouds
75043,91,1554631200,13,17,30,Clouds
75044,92,1554631200,18,22,40,Clouds
75045,93,1554631200,13,27,40,Clouds
75046,94,1554631200,10,30,40,Clouds
75047,95,1554631200,39,1,40,Clouds
75048,96,1554631200,30,0,30,Clouds
75049,97,1554631200,33,7,40,Clouds
75050,98,1554631200,14,25,39,Clouds
75051,99,1554631200,21,9,30,Clouds
75052,100,1554631200,1,23,24,Clouds
75053,101,1554631200,22,6,28,Clouds
75054,102,1554631200,36,4,40,Clouds
75055,103,1554631200,20,20,40,Clouds
75056,104,1554631200,40,0,40,Clouds
75057,105,1554631200,34,2,36,Clouds
75058,106,1554631200,35,5,40,Clouds
75059,107,1554631200,35,5,40,Clouds
75060,108,1554631200,39,1,40,Clouds
75061,109,1554631200,4,25,29,Clouds
75062,110,1554631200,34,6,40,Clouds
75063,111,1554631200,40,0,40,Clouds
75064,112,1554631200,30,0,30,Clouds
75065,113,1554631200,38,2,40,Clouds
75066,114,1554631200,39,1,40,Clouds
75067,115,1554631200,15,15,30,Clouds
75068,2,1554634800,20,0,20,Clouds
75069,3,1554634800,10,10,20,Clouds
75070,4,1554634800,5,15,20,Clouds
75071,5,1554634800,35,5,40,Clouds
75072,6,1554634800,5,15,20,Clouds
75073,7,1554634800,28,1,29,Clouds
75074,8,1554634800,7,23,30,Clouds
75075,9,1554634800,0,24,24,Clouds
75076,10,1554634800,0,16,16,Clouds
75077,11,1554634800,28,2,30,Clouds
75078,12,1554634800,20,0,20,Clouds
75079,13,1554634800,23,7,30,Clouds
75080,14,1554634800,0,30,30,Clouds
75081,15,1554634800,16,0,16,Clouds
75082,16,1554634800,1,19,20,Clouds
75083,17,1554634800,0,20,20,Clouds
75084,18,1554634800,5,25,30,Clouds
75085,19,1554634800,10,20,30,Clouds
75086,21,1554634800,10,20,30,Clouds
75087,22,1554634800,0,20,20,Clouds
75088,23,1554634800,6,24,30,Clouds
75089,24,1554634800,17,3,20,Clouds
75090,25,1554634800,24,6,30,Clouds
75091,26,1554634800,18,2,20,Clouds
75092,27,1554634800,0,20,20,Clouds
75093,28,1554634800,23,7,30,Clouds
75094,29,1554634800,13,16,29,Clouds
75095,30,1554634800,18,2,20,Clouds
75096,31,1554634800,13,7,20,Clouds
75097,32,1554634800,7,23,30,Clouds
75098,33,1554634800,11,12,23,Clouds
75099,34,1554634800,19,11,30,Clouds
75100,35,1554634800,4,26,30,Clouds
75101,36,1554634800,13,27,40,Clouds
75102,37,1554634800,0,30,30,Clouds
75103,38,1554634800,6,34,40,Clouds
75104,39,1554634800,15,5,20,Clouds
75105,40,1554634800,3,18,21,Clouds
75106,41,1554634800,19,1,20,Clouds
75107,42,1554634800,8,22,30,Clouds
75108,43,1554634800,26,4,30,Clouds
75109,44,1554634800,30,0,30,Clouds
75110,45,1554634800,30,0,30,Clouds
75111,46,1554634800,0,20,20,Clouds
75112,47,1554634800,38,2,40,Clouds
75113,48,1554634800,24,16,40,Clouds
75114,49,1554634800,39,1,40,Clouds
75115,50,1554634800,40,0,40,Clouds
75116,51,1554634800,11,29,40,Clouds
75117,52,1554634800,0,32,32,Clouds
75118,53,1554634800,37,3,40,Clouds
75119,54,1554634800,19,14,33,Clouds
75120,55,1554634800,35,1,36,Clouds
75121,56,1554634800,40,0,40,Clouds
75122,57,1554634800,13,10,23,Clouds
75123,58,1554634800,29,11,40,Clouds
75124,59,1554634800,20,0,20,Clouds
75125,60,1554634800,30,0,30,Clouds
75126,61,1554634800,25,0,25,Clouds
75127,62,1554634800,40,0,40,Clouds
75128,63,1554634800,14,21,35,Clouds
75129,64,1554634800,25,15,40,Clouds
75130,65,1554634800,36,4,40,Clouds
75131,66,1554634800,36,4,40,Clouds
75132,67,1554634800,34,6,40,Clouds
75133,68,1554634800,17,23,40,Clouds
75134,69,1554634800,8,32,40,Clouds
75135,70,1554634800,8,20,28,Clouds
75136,71,1554634800,24,16,40,Clouds
75137,72,1554634800,20,10,30,Clouds
75138,73,1554634800,29,1,30,Clouds
75139,74,1554634800,29,1,30,Clouds
75140,75,1554634800,29,10,39,Clouds
75141,76,1554634800,32,6,38,Clouds
75142,77,1554634800,17,11,28,Clouds
75143,78,1554634800,40,0,40,Clouds
75144,79,1554634800,27,0,27,Clouds
75145,80,1554634800,32,8,40,Clouds
75146,81,1554634800,12,28,40,Clouds
75147,82,1554634800,18,4,22,Clouds
75148,83,1554634800,28,12,40,Clouds
75149,84,1554634800,29,0,29,Clouds
75150,85,1554634800,20,15,35,Clouds
75151,86,1554634800,18,19,37,Clouds
75152,87,1554634800,36,2,38,Clouds
75153,88,1554634800,30,0,30,Clouds
75154,89,1554634800,37,3,40,Clouds
75155,90,1554634800,35,5,40,Clouds
75156,91,1554634800,13,17,30,Clouds
75157,92,1554634800,20,20,40,Clouds
75158,93,1554634800,13,27,40,Clouds
75159,94,1554634800,10,30,40,Clouds
75160,95,1554634800,38,2,40,Clouds
75161,96,1554634800,28,2,30,Clouds
75162,97,1554634800,19,21,40,Clouds
75163,98,1554634800,18,22,40,Clouds
75164,99,1554634800,21,9,30,Clouds
75165,100,1554634800,0,24,24,Clouds
75166,101,1554634800,28,0,28,Clouds
75167,102,1554634800,40,0,40,Clouds
75168,103,1554634800,21,19,40,Clouds
75169,104,1554634800,40,0,40,Clouds
75170,105,1554634800,35,1,36,Clouds
75171,106,1554634800,29,11,40,Clouds
75172,107,1554634800,34,6,40,Clouds
75173,108,1554634800,40,0,40,Clouds
75174,109,1554634800,3,26,29,Clouds
75175,110,1554634800,39,1,40,Clouds
75176,111,1554634800,40,0,40,Clouds
75177,112,1554634800,30,0,30,Clouds
75178,113,1554634800,38,2,40,Clouds
75179,114,1554634800,38,2,40,Clouds
75180,115,1554634800,16,14,30,Clouds
75181,2,1554638400,20,0,20,Clouds
75182,3,1554638400,14,6,20,Clouds
75183,4,1554638400,4,16,20,Clouds
75184,5,1554638400,38,2,40,Clouds
75185,6,1554638400,5,15,20,Clouds
75186,7,1554638400,29,0,29,Clouds
75187,8,1554638400,5,25,30,Clouds
75188,9,1554638400,11,13,24,Clouds
75189,10,1554638400,0,16,16,Clouds
75190,11,1554638400,28,2,30,Clouds
75191,12,1554638400,19,1,20,Clouds
75192,13,1554638400,22,8,30,Clouds
75193,14,1554638400,0,30,30,Clouds
75194,15,1554638400,15,1,16,Clouds
75195,16,1554638400,0,20,20,Clouds
75196,17,1554638400,1,19,20,Clouds
75197,18,1554638400,7,23,30,Clouds
75198,19,1554638400,13,17,30,Clouds
75199,21,1554638400,5,25,30,Clouds
75200,22,1554638400,1,19,20,Clouds
75201,23,1554638400,0,30,30,Clouds
75202,24,1554638400,16,4,20,Clouds
75203,25,1554638400,23,7,30,Clouds
75204,26,1554638400,14,6,20,Clouds
75205,27,1554638400,1,19,20,Clouds
75206,28,1554638400,30,0,30,Clouds
75207,29,1554638400,9,20,29,Clouds
75208,30,1554638400,20,0,20,Clouds
75209,31,1554638400,17,3,20,Clouds
75210,32,1554638400,2,28,30,Clouds
75211,33,1554638400,8,15,23,Clouds
75212,34,1554638400,28,2,30,Clouds
75213,35,1554638400,8,22,30,Clouds
75214,36,1554638400,9,31,40,Clouds
75215,37,1554638400,0,30,30,Clouds
75216,38,1554638400,7,33,40,Clouds
75217,39,1554638400,20,0,20,Clouds
75218,40,1554638400,0,21,21,Clouds
75219,41,1554638400,18,2,20,Clouds
75220,42,1554638400,16,14,30,Clouds
75221,43,1554638400,10,20,30,Clouds
75222,44,1554638400,30,0,30,Clouds
75223,45,1554638400,30,0,30,Clouds
75224,46,1554638400,2,18,20,Clouds
75225,47,1554638400,40,0,40,Clouds
75226,48,1554638400,18,22,40,Clouds
75227,49,1554638400,39,1,40,Clouds
75228,50,1554638400,39,1,40,Clouds
75229,51,1554638400,0,40,40,Clouds
75230,52,1554638400,11,21,32,Clouds
75231,53,1554638400,33,7,40,Clouds
75232,54,1554638400,19,14,33,Clouds
75233,55,1554638400,34,2,36,Clouds
75234,56,1554638400,40,0,40,Clouds
75235,57,1554638400,14,9,23,Clouds
75236,58,1554638400,34,6,40,Clouds
75237,59,1554638400,20,0,20,Clouds
75238,60,1554638400,30,0,30,Clouds
75239,61,1554638400,24,1,25,Clouds
75240,62,1554638400,40,0,40,Clouds
75241,63,1554638400,17,18,35,Clouds
75242,64,1554638400,24,16,40,Clouds
75243,65,1554638400,40,0,40,Clouds
75244,66,1554638400,37,3,40,Clouds
75245,67,1554638400,35,5,40,Clouds
75246,68,1554638400,17,23,40,Clouds
75247,69,1554638400,5,35,40,Clouds
75248,70,1554638400,9,19,28,Clouds
75249,71,1554638400,25,15,40,Clouds
75250,72,1554638400,17,14,31,Clouds
75251,73,1554638400,30,0,30,Clouds
75252,74,1554638400,30,0,30,Clouds
75253,75,1554638400,32,8,40,Clouds
75254,76,1554638400,34,4,38,Clouds
75255,77,1554638400,17,12,29,Clouds
75256,78,1554638400,38,2,40,Clouds
75257,79,1554638400,27,0,27,Clouds
75258,80,1554638400,34,6,40,Clouds
75259,81,1554638400,13,27,40,Clouds
75260,82,1554638400,20,2,22,Clouds
75261,83,1554638400,28,12,40,Clouds
75262,84,1554638400,29,1,30,Clouds
75263,85,1554638400,27,8,35,Clouds
75264,86,1554638400,23,15,38,Clouds
75265,87,1554638400,37,1,38,Clouds
75266,88,1554638400,30,0,30,Clouds
75267,89,1554638400,38,2,40,Clouds
75268,90,1554638400,37,3,40,Clouds
75269,91,1554638400,18,12,30,Clouds
75270,92,1554638400,16,24,40,Clouds
75271,93,1554638400,13,27,40,Clouds
75272,94,1554638400,10,30,40,Clouds
75273,95,1554638400,40,0,40,Clouds
75274,96,1554638400,30,0,30,Clouds
75275,97,1554638400,24,16,40,Clouds
75276,98,1554638400,9,31,40,Clouds
75277,99,1554638400,21,9,30,Clouds
75278,100,1554638400,1,24,25,Clouds
75279,101,1554638400,30,0,30,Clouds
75280,102,1554638400,40,0,40,Clouds
75281,103,1554638400,21,19,40,Clouds
75282,104,1554638400,40,0,40,Clouds
75283,105,1554638400,36,0,36,Clouds
75284,106,1554638400,30,10,40,Clouds
75285,107,1554638400,36,4,40,Clouds
75286,108,1554638400,34,6,40,Clouds
75287,109,1554638400,8,21,29,Clouds
75288,110,1554638400,39,1,40,Clouds
75289,111,1554638400,40,0,40,Clouds
75290,112,1554638400,29,1,30,Clouds
75291,113,1554638400,37,3,40,Clouds
75292,114,1554638400,36,4,40,Clouds
75293,115,1554638400,21,9,30,Clouds
75294,2,1554642000,19,1,20,Clouds
75295,3,1554642000,15,5,20,Clouds
75296,4,1554642000,5,15,20,Clouds
75297,5,1554642000,40,0,40,Clouds
75298,6,1554642000,8,12,20,Clouds
75299,7,1554642000,27,2,29,Clouds
75300,8,1554642000,4,26,30,Clouds
75301,9,1554642000,7,17,24,Clouds
75302,10,1554642000,1,15,16,Clouds
75303,11,1554642000,28,2,30,Clouds
75304,12,1554642000,19,1,20,Clouds
75305,13,1554642000,23,7,30,Clouds
75306,14,1554642000,15,15,30,Clouds
75307,15,1554642000,15,1,16,Clouds
75308,16,1554642000,0,20,20,Clouds
75309,17,1554642000,0,20,20,Clouds
75310,18,1554642000,8,22,30,Clouds
75311,19,1554642000,7,23,30,Clouds
75312,21,1554642000,1,29,30,Clouds
75313,22,1554642000,0,20,20,Clouds
75314,23,1554642000,11,19,30,Clouds
75315,24,1554642000,12,8,20,Clouds
75316,25,1554642000,22,8,30,Clouds
75317,26,1554642000,14,6,20,Clouds
75318,27,1554642000,3,17,20,Clouds
75319,28,1554642000,17,13,30,Clouds
75320,29,1554642000,1,28,29,Clouds
75321,30,1554642000,19,1,20,Clouds
75322,31,1554642000,11,9,20,Clouds
75323,32,1554642000,1,29,30,Clouds
75324,33,1554642000,0,23,23,Clouds
75325,34,1554642000,28,2,30,Clouds
75326,35,1554642000,17,13,30,Clouds
75327,36,1554642000,10,30,40,Clouds
75328,37,1554642000,1,29,30,Clouds
75329,38,1554642000,9,31,40,Clouds
75330,39,1554642000,18,2,20,Clouds
75331,40,1554642000,1,20,21,Clouds
75332,41,1554642000,18,2,20,Clouds
75333,42,1554642000,24,6,30,Clouds
75334,43,1554642000,10,20,30,Clouds
75335,44,1554642000,30,0,30,Clouds
75336,45,1554642000,30,0,30,Clouds
75337,46,1554642000,3,17,20,Clouds
75338,47,1554642000,40,0,40,Clouds
75339,48,1554642000,21,19,40,Clouds
75340,49,1554642000,39,1,40,Clouds
75341,50,1554642000,40,0,40,Clouds
75342,51,1554642000,0,40,40,Clouds
75343,52,1554642000,6,26,32,Clouds
75344,53,1554642000,34,6,40,Clouds
75345,54,1554642000,18,15,33,Clouds
75346,55,1554642000,33,3,36,Clouds
75347,56,1554642000,36,4,40,Clouds
75348,57,1554642000,14,9,23,Clouds
75349,58,1554642000,36,4,40,Clouds
75350,59,1554642000,18,2,20,Clouds
75351,60,1554642000,29,1,30,Clouds
75352,61,1554642000,16,9,25,Clouds
75353,62,1554642000,39,1,40,Clouds
75354,63,1554642000,15,20,35,Clouds
75355,64,1554642000,25,15,40,Clouds
75356,65,1554642000,36,4,40,Clouds
75357,66,1554642000,33,7,40,Clouds
75358,67,1554642000,37,3,40,Clouds
75359,68,1554642000,20,20,40,Clouds
75360,69,1554642000,5,35,40,Clouds
75361,70,1554642000,6,22,28,Clouds
75362,71,1554642000,27,13,40,Clouds
75363,72,1554642000,18,13,31,Clouds
75364,73,1554642000,28,2,30,Clouds
75365,74,1554642000,30,0,30,Clouds
75366,75,1554642000,36,4,40,Clouds
75367,76,1554642000,34,4,38,Clouds
75368,77,1554642000,14,15,29,Clouds
75369,78,1554642000,40,0,40,Clouds
75370,79,1554642000,27,0,27,Clouds
75371,80,1554642000,38,2,40,Clouds
75372,81,1554642000,13,27,40,Clouds
75373,82,1554642000,22,0,22,Clouds
75374,83,1554642000,31,9,40,Clouds
75375,84,1554642000,29,1,30,Clouds
75376,85,1554642000,21,14,35,Clouds
75377,86,1554642000,25,13,38,Clouds
75378,87,1554642000,38,0,38,Clouds
75379,88,1554642000,29,1,30,Clouds
75380,89,1554642000,38,2,40,Clouds
75381,90,1554642000,39,1,40,Clouds
75382,91,1554642000,19,11,30,Clouds
75383,92,1554642000,17,23,40,Clouds
75384,93,1554642000,13,27,40,Clouds
75385,94,1554642000,10,30,40,Clouds
75386,95,1554642000,40,0,40,Clouds
75387,96,1554642000,30,0,30,Clouds
75388,97,1554642000,30,10,40,Clouds
75389,98,1554642000,5,35,40,Clouds
75390,99,1554642000,21,9,30,Clouds
75391,100,1554642000,3,22,25,Clouds
75392,101,1554642000,29,1,30,Clouds
75393,102,1554642000,31,9,40,Clouds
75394,103,1554642000,22,18,40,Clouds
75395,104,1554642000,40,0,40,Clouds
75396,105,1554642000,36,0,36,Clouds
75397,106,1554642000,29,11,40,Clouds
75398,107,1554642000,40,0,40,Clouds
75399,108,1554642000,34,6,40,Clouds
75400,109,1554642000,7,22,29,Clouds
75401,110,1554642000,40,0,40,Clouds
75402,111,1554642000,39,1,40,Clouds
75403,112,1554642000,30,0,30,Clouds
75404,113,1554642000,36,4,40,Clouds
75405,114,1554642000,38,2,40,Clouds
75406,115,1554642000,27,3,30,Clouds
75407,2,1554645600,19,1,20,Clouds
75408,3,1554645600,14,6,20,Clouds
75409,4,1554645600,6,14,20,Clouds
75410,5,1554645600,32,8,40,Clouds
75411,6,1554645600,8,12,20,Clouds
75412,7,1554645600,28,1,29,Clouds
75413,8,1554645600,2,28,30,Clouds
75414,9,1554645600,2,22,24,Clouds
75415,10,1554645600,1,15,16,Clouds
75416,11,1554645600,28,2,30,Clouds
75417,12,1554645600,19,1,20,Clouds
75418,13,1554645600,25,5,30,Clouds
75419,14,1554645600,12,18,30,Clouds
75420,15,1554645600,15,1,16,Clouds
75421,16,1554645600,18,2,20,Clouds
75422,17,1554645600,0,20,20,Clouds
75423,18,1554645600,11,19,30,Clouds
75424,19,1554645600,3,27,30,Clouds
75425,21,1554645600,0,30,30,Clouds
75426,22,1554645600,5,15,20,Clouds
75427,23,1554645600,14,16,30,Clouds
75428,24,1554645600,12,8,20,Clouds
75429,25,1554645600,21,9,30,Clouds
75430,26,1554645600,8,12,20,Clouds
75431,27,1554645600,3,17,20,Clouds
75432,28,1554645600,21,9,30,Clouds
75433,29,1554645600,0,29,29,Clouds
75434,30,1554645600,18,2,20,Clouds
75435,31,1554645600,14,6,20,Clouds
75436,32,1554645600,1,29,30,Clouds
75437,33,1554645600,0,23,23,Clouds
75438,34,1554645600,23,7,30,Clouds
75439,35,1554645600,14,16,30,Clouds
75440,36,1554645600,7,33,40,Clouds
75441,37,1554645600,0,30,30,Clouds
75442,38,1554645600,5,35,40,Clouds
75443,39,1554645600,17,3,20,Clouds
75444,40,1554645600,1,20,21,Clouds
75445,41,1554645600,19,1,20,Clouds
75446,42,1554645600,24,6,30,Clouds
75447,43,1554645600,13,17,30,Clouds
75448,44,1554645600,27,3,30,Clouds
75449,45,1554645600,29,1,30,Clouds
75450,46,1554645600,2,18,20,Clouds
75451,47,1554645600,40,0,40,Clouds
75452,48,1554645600,24,16,40,Clouds
75453,49,1554645600,35,5,40,Clouds
75454,50,1554645600,38,2,40,Clouds
75455,51,1554645600,1,39,40,Clouds
75456,52,1554645600,7,25,32,Clouds
75457,53,1554645600,33,7,40,Clouds
75458,54,1554645600,19,14,33,Clouds
75459,55,1554645600,33,3,36,Clouds
75460,56,1554645600,38,2,40,Clouds
75461,57,1554645600,15,8,23,Clouds
75462,58,1554645600,34,6,40,Clouds
75463,59,1554645600,17,3,20,Clouds
75464,60,1554645600,28,2,30,Clouds
75465,61,1554645600,20,5,25,Clouds
75466,62,1554645600,40,0,40,Clouds
75467,63,1554645600,16,19,35,Clouds
75468,64,1554645600,24,16,40,Clouds
75469,65,1554645600,38,2,40,Clouds
75470,66,1554645600,34,6,40,Clouds
75471,67,1554645600,35,5,40,Clouds
75472,68,1554645600,26,14,40,Clouds
75473,69,1554645600,4,36,40,Clouds
75474,70,1554645600,0,28,28,Clouds
75475,71,1554645600,27,13,40,Clouds
75476,72,1554645600,22,9,31,Clouds
75477,73,1554645600,29,1,30,Clouds
75478,74,1554645600,28,2,30,Clouds
75479,75,1554645600,37,3,40,Clouds
75480,76,1554645600,36,2,38,Clouds
75481,77,1554645600,4,25,29,Clouds
75482,78,1554645600,40,0,40,Clouds
75483,79,1554645600,26,1,27,Clouds
75484,80,1554645600,39,1,40,Clouds
75485,81,1554645600,13,27,40,Clouds
75486,82,1554645600,21,1,22,Clouds
75487,83,1554645600,33,7,40,Clouds
75488,84,1554645600,30,0,30,Clouds
75489,85,1554645600,22,13,35,Clouds
75490,86,1554645600,30,8,38,Clouds
75491,87,1554645600,38,0,38,Clouds
75492,88,1554645600,30,0,30,Clouds
75493,89,1554645600,38,2,40,Clouds
75494,90,1554645600,36,4,40,Clouds
75495,91,1554645600,21,9,30,Clouds
75496,92,1554645600,16,24,40,Clouds
75497,93,1554645600,14,26,40,Clouds
75498,94,1554645600,10,30,40,Clouds
75499,95,1554645600,39,1,40,Clouds
75500,96,1554645600,30,0,30,Clouds
75501,97,1554645600,32,8,40,Clouds
75502,98,1554645600,4,36,40,Clouds
75503,99,1554645600,21,9,30,Clouds
75504,100,1554645600,9,16,25,Clouds
75505,101,1554645600,27,3,30,Clouds
75506,102,1554645600,33,7,40,Clouds
75507,103,1554645600,24,16,40,Clouds
75508,104,1554645600,39,1,40,Clouds
75509,105,1554645600,36,0,36,Clouds
75510,106,1554645600,35,5,40,Clouds
75511,107,1554645600,40,0,40,Clouds
75512,108,1554645600,36,4,40,Clouds
75513,109,1554645600,9,20,29,Clouds
75514,110,1554645600,39,1,40,Clouds
75515,111,1554645600,39,1,40,Clouds
75516,112,1554645600,29,1,30,Clouds
75517,113,1554645600,36,4,40,Clouds
75518,114,1554645600,37,3,40,Clouds
75519,115,1554645600,24,6,30,Clouds
75520,2,1554649200,20,0,20,Clouds
75521,3,1554649200,13,7,20,Clouds
75522,4,1554649200,9,11,20,Clouds
75523,5,1554649200,35,5,40,Clouds
75524,6,1554649200,10,10,20,Clouds
75525,7,1554649200,28,1,29,Clouds
75526,8,1554649200,0,30,30,Clouds
75527,9,1554649200,1,23,24,Clouds
75528,10,1554649200,1,15,16,Clouds
75529,11,1554649200,30,0,30,Clouds
75530,12,1554649200,20,0,20,Clouds
75531,13,1554649200,25,5,30,Clouds
75532,14,1554649200,7,23,30,Clouds
75533,15,1554649200,14,2,16,Clouds
75534,16,1554649200,12,8,20,Clouds
75535,17,1554649200,1,19,20,Clouds
75536,18,1554649200,13,17,30,Clouds
75537,19,1554649200,12,18,30,Clouds
75538,21,1554649200,1,29,30,Clouds
75539,22,1554649200,0,20,20,Clouds
75540,23,1554649200,7,23,30,Clouds
75541,24,1554649200,8,12,20,Clouds
75542,25,1554649200,21,9,30,Clouds
75543,26,1554649200,5,15,20,Clouds
75544,27,1554649200,4,16,20,Clouds
75545,28,1554649200,22,8,30,Clouds
75546,29,1554649200,1,28,29,Clouds
75547,30,1554649200,17,3,20,Clouds
75548,31,1554649200,12,8,20,Clouds
75549,32,1554649200,17,13,30,Clouds
75550,33,1554649200,0,23,23,Clouds
75551,34,1554649200,25,5,30,Clouds
75552,35,1554649200,14,16,30,Clouds
75553,36,1554649200,4,36,40,Clouds
75554,37,1554649200,0,30,30,Clouds
75555,38,1554649200,13,27,40,Clouds
75556,39,1554649200,14,6,20,Clouds
75557,40,1554649200,0,21,21,Clouds
75558,41,1554649200,19,1,20,Clouds
75559,42,1554649200,24,6,30,Clouds
75560,43,1554649200,17,13,30,Clouds
75561,44,1554649200,28,2,30,Clouds
75562,45,1554649200,26,4,30,Clouds
75563,46,1554649200,0,20,20,Clouds
75564,47,1554649200,39,1,40,Clouds
75565,48,1554649200,22,18,40,Clouds
75566,49,1554649200,33,7,40,Clouds
75567,50,1554649200,38,2,40,Clouds
75568,51,1554649200,1,39,40,Clouds
75569,52,1554649200,0,32,32,Clouds
75570,53,1554649200,31,9,40,Clouds
75571,54,1554649200,15,18,33,Clouds
75572,55,1554649200,33,3,36,Clouds
75573,56,1554649200,40,0,40,Clouds
75574,57,1554649200,14,9,23,Clouds
75575,58,1554649200,33,7,40,Clouds
75576,59,1554649200,15,5,20,Clouds
75577,60,1554649200,29,1,30,Clouds
75578,61,1554649200,18,7,25,Clouds
75579,62,1554649200,40,0,40,Clouds
75580,63,1554649200,15,20,35,Clouds
75581,64,1554649200,26,14,40,Clouds
75582,65,1554649200,38,2,40,Clouds
75583,66,1554649200,39,1,40,Clouds
75584,67,1554649200,38,2,40,Clouds
75585,68,1554649200,27,13,40,Clouds
75586,69,1554649200,8,32,40,Clouds
75587,70,1554649200,1,27,28,Clouds
75588,71,1554649200,24,16,40,Clouds
75589,72,1554649200,28,3,31,Clouds
75590,73,1554649200,29,1,30,Clouds
75591,74,1554649200,26,4,30,Clouds
75592,75,1554649200,39,1,40,Clouds
75593,76,1554649200,36,2,38,Clouds
75594,77,1554649200,5,24,29,Clouds
75595,78,1554649200,40,0,40,Clouds
75596,79,1554649200,27,0,27,Clouds
75597,80,1554649200,21,19,40,Clouds
75598,81,1554649200,13,27,40,Clouds
75599,82,1554649200,20,2,22,Clouds
75600,83,1554649200,38,2,40,Clouds
75601,84,1554649200,28,2,30,Clouds
75602,85,1554649200,25,10,35,Clouds
75603,86,1554649200,26,12,38,Clouds
75604,87,1554649200,36,2,38,Clouds
75605,88,1554649200,26,4,30,Clouds
75606,89,1554649200,37,3,40,Clouds
75607,90,1554649200,38,2,40,Clouds
75608,91,1554649200,19,11,30,Clouds
75609,92,1554649200,16,24,40,Clouds
75610,93,1554649200,14,26,40,Clouds
75611,94,1554649200,10,30,40,Clouds
75612,95,1554649200,39,1,40,Clouds
75613,96,1554649200,29,1,30,Clouds
75614,97,1554649200,37,3,40,Clouds
75615,98,1554649200,6,34,40,Clouds
75616,99,1554649200,23,7,30,Clouds
75617,100,1554649200,15,10,25,Clouds
75618,101,1554649200,28,2,30,Clouds
75619,102,1554649200,33,7,40,Clouds
75620,103,1554649200,25,15,40,Clouds
75621,104,1554649200,39,1,40,Clouds
75622,105,1554649200,36,0,36,Clouds
75623,106,1554649200,36,4,40,Clouds
75624,107,1554649200,40,0,40,Clouds
75625,108,1554649200,33,7,40,Clouds
75626,109,1554649200,11,18,29,Clouds
75627,110,1554649200,36,4,40,Clouds
75628,111,1554649200,40,0,40,Clouds
75629,112,1554649200,29,1,30,Clouds
75630,113,1554649200,37,3,40,Clouds
75631,114,1554649200,37,3,40,Clouds
75632,115,1554649200,30,0,30,Clouds
75633,2,1554652800,19,1,20,Clouds
75634,3,1554652800,14,5,19,Clouds
75635,4,1554652800,5,15,20,Clouds
75636,5,1554652800,40,0,40,Clouds
75637,6,1554652800,5,15,20,Clouds
75638,7,1554652800,7,22,29,Clouds
75639,8,1554652800,2,28,30,Clouds
75640,9,1554652800,2,22,24,Clouds
75641,10,1554652800,1,15,16,Clouds
75642,11,1554652800,29,1,30,Clouds
75643,12,1554652800,17,3,20,Clouds
75644,13,1554652800,24,6,30,Clouds
75645,14,1554652800,0,30,30,Clouds
75646,15,1554652800,15,1,16,Clouds
75647,16,1554652800,10,10,20,Clouds
75648,17,1554652800,1,19,20,Clouds
75649,18,1554652800,8,22,30,Clouds
75650,19,1554652800,19,11,30,Clouds
75651,21,1554652800,3,27,30,Clouds
75652,22,1554652800,1,19,20,Clouds
75653,23,1554652800,7,23,30,Clouds
75654,24,1554652800,6,14,20,Clouds
75655,25,1554652800,21,9,30,Clouds
75656,26,1554652800,4,16,20,Clouds
75657,27,1554652800,0,20,20,Clouds
75658,28,1554652800,27,3,30,Clouds
75659,29,1554652800,1,28,29,Clouds
75660,30,1554652800,17,3,20,Clouds
75661,31,1554652800,18,2,20,Clouds
75662,32,1554652800,12,18,30,Clouds
75663,33,1554652800,3,20,23,Clouds
75664,34,1554652800,29,1,30,Clouds
75665,35,1554652800,17,13,30,Clouds
75666,36,1554652800,1,39,40,Clouds
75667,37,1554652800,4,26,30,Clouds
75668,38,1554652800,15,25,40,Clouds
75669,39,1554652800,14,6,20,Clouds
75670,40,1554652800,1,20,21,Clouds
75671,41,1554652800,19,1,20,Clouds
75672,42,1554652800,22,8,30,Clouds
75673,43,1554652800,24,6,30,Clouds
75674,44,1554652800,26,4,30,Clouds
75675,45,1554652800,26,4,30,Clouds
75676,46,1554652800,0,20,20,Clouds
75677,47,1554652800,39,1,40,Clouds
75678,48,1554652800,21,19,40,Clouds
75679,49,1554652800,29,11,40,Clouds
75680,50,1554652800,37,3,40,Clouds
75681,51,1554652800,16,24,40,Clouds
75682,52,1554652800,15,17,32,Clouds
75683,53,1554652800,30,10,40,Clouds
75684,54,1554652800,15,18,33,Clouds
75685,55,1554652800,33,3,36,Clouds
75686,56,1554652800,38,2,40,Clouds
75687,57,1554652800,13,10,23,Clouds
75688,58,1554652800,38,2,40,Clouds
75689,59,1554652800,15,5,20,Clouds
75690,60,1554652800,29,1,30,Clouds
75691,61,1554652800,22,3,25,Clouds
75692,62,1554652800,36,4,40,Clouds
75693,63,1554652800,14,21,35,Clouds
75694,64,1554652800,27,13,40,Clouds
75695,65,1554652800,38,2,40,Clouds
75696,66,1554652800,37,3,40,Clouds
75697,67,1554652800,38,2,40,Clouds
75698,68,1554652800,29,11,40,Clouds
75699,69,1554652800,11,29,40,Clouds
75700,70,1554652800,1,27,28,Clouds
75701,71,1554652800,20,20,40,Clouds
75702,72,1554652800,28,3,31,Clouds
75703,73,1554652800,26,4,30,Clouds
75704,74,1554652800,26,4,30,Clouds
75705,75,1554652800,37,3,40,Clouds
75706,76,1554652800,38,0,38,Clouds
75707,77,1554652800,2,27,29,Clouds
75708,78,1554652800,40,0,40,Clouds
75709,79,1554652800,27,0,27,Clouds
75710,80,1554652800,28,12,40,Clouds
75711,81,1554652800,13,27,40,Clouds
75712,82,1554652800,22,0,22,Clouds
75713,83,1554652800,39,1,40,Clouds
75714,84,1554652800,29,1,30,Clouds
75715,85,1554652800,28,7,35,Clouds
75716,86,1554652800,24,14,38,Clouds
75717,87,1554652800,37,1,38,Clouds
75718,88,1554652800,27,3,30,Clouds
75719,89,1554652800,39,1,40,Clouds
75720,90,1554652800,38,2,40,Clouds
75721,91,1554652800,16,14,30,Clouds
75722,92,1554652800,20,20,40,Clouds
75723,93,1554652800,14,26,40,Clouds
75724,94,1554652800,10,30,40,Clouds
75725,95,1554652800,35,5,40,Clouds
75726,96,1554652800,27,3,30,Clouds
75727,97,1554652800,39,1,40,Clouds
75728,98,1554652800,3,37,40,Clouds
75729,99,1554652800,20,10,30,Clouds
75730,100,1554652800,17,8,25,Clouds
75731,101,1554652800,22,8,30,Clouds
75732,102,1554652800,36,4,40,Clouds
75733,103,1554652800,26,14,40,Clouds
75734,104,1554652800,39,1,40,Clouds
75735,105,1554652800,36,0,36,Clouds
75736,106,1554652800,40,0,40,Clouds
75737,107,1554652800,40,0,40,Clouds
75738,108,1554652800,31,9,40,Clouds
75739,109,1554652800,13,16,29,Clouds
75740,110,1554652800,35,5,40,Clouds
75741,111,1554652800,39,1,40,Clouds
75742,112,1554652800,28,2,30,Clouds
75743,113,1554652800,39,1,40,Clouds
75744,114,1554652800,40,0,40,Clouds
75745,115,1554652800,29,1,30,Clouds
75746,2,1554656400,19,1,20,Clouds
75747,3,1554656400,15,4,19,Clouds
75748,4,1554656400,7,13,20,Clouds
75749,5,1554656400,36,4,40,Clouds
75750,6,1554656400,5,15,20,Clouds
75751,7,1554656400,8,21,29,Clouds
75752,8,1554656400,5,25,30,Clouds
75753,9,1554656400,2,22,24,Clouds
75754,10,1554656400,0,16,16,Clouds
75755,11,1554656400,27,3,30,Clouds
75756,12,1554656400,18,2,20,Clouds
75757,13,1554656400,27,3,30,Clouds
75758,14,1554656400,0,30,30,Clouds
75759,15,1554656400,15,1,16,Clouds
75760,16,1554656400,10,10,20,Clouds
75761,17,1554656400,3,17,20,Clouds
75762,18,1554656400,7,23,30,Clouds
75763,19,1554656400,28,2,30,Clouds
75764,21,1554656400,6,24,30,Clouds
75765,22,1554656400,1,19,20,Clouds
75766,23,1554656400,7,23,30,Clouds
75767,24,1554656400,5,15,20,Clouds
75768,25,1554656400,20,10,30,Clouds
75769,26,1554656400,2,18,20,Clouds
75770,27,1554656400,6,14,20,Clouds
75771,28,1554656400,30,0,30,Clouds
75772,29,1554656400,0,29,29,Clouds
75773,30,1554656400,19,1,20,Clouds
75774,31,1554656400,20,0,20,Clouds
75775,32,1554656400,9,21,30,Clouds
75776,33,1554656400,9,14,23,Clouds
75777,34,1554656400,22,8,30,Clouds
75778,35,1554656400,10,20,30,Clouds
75779,36,1554656400,0,40,40,Clouds
75780,37,1554656400,5,25,30,Clouds
75781,38,1554656400,12,28,40,Clouds
75782,39,1554656400,17,3,20,Clouds
75783,40,1554656400,8,13,21,Clouds
75784,41,1554656400,19,1,20,Clouds
75785,42,1554656400,23,7,30,Clouds
75786,43,1554656400,24,6,30,Clouds
75787,44,1554656400,29,1,30,Clouds
75788,45,1554656400,29,1,30,Clouds
75789,46,1554656400,4,16,20,Clouds
75790,47,1554656400,38,2,40,Clouds
75791,48,1554656400,18,22,40,Clouds
75792,49,1554656400,30,10,40,Clouds
75793,50,1554656400,40,0,40,Clouds
75794,51,1554656400,15,25,40,Clouds
75795,52,1554656400,20,12,32,Clouds
75796,53,1554656400,26,14,40,Clouds
75797,54,1554656400,15,18,33,Clouds
75798,55,1554656400,32,4,36,Clouds
75799,56,1554656400,30,10,40,Clouds
75800,57,1554656400,13,10,23,Clouds
75801,58,1554656400,36,4,40,Clouds
75802,59,1554656400,15,5,20,Clouds
75803,60,1554656400,23,7,30,Clouds
75804,61,1554656400,22,3,25,Clouds
75805,62,1554656400,34,6,40,Clouds
75806,63,1554656400,12,23,35,Clouds
75807,64,1554656400,30,10,40,Clouds
75808,65,1554656400,40,0,40,Clouds
75809,66,1554656400,40,0,40,Clouds
75810,67,1554656400,36,4,40,Clouds
75811,68,1554656400,21,19,40,Clouds
75812,69,1554656400,5,35,40,Clouds
75813,70,1554656400,1,27,28,Clouds
75814,71,1554656400,14,26,40,Clouds
75815,72,1554656400,28,3,31,Clouds
75816,73,1554656400,28,2,30,Clouds
75817,74,1554656400,23,7,30,Clouds
75818,75,1554656400,38,2,40,Clouds
75819,76,1554656400,37,1,38,Clouds
75820,77,1554656400,5,24,29,Clouds
75821,78,1554656400,40,0,40,Clouds
75822,79,1554656400,27,0,27,Clouds
75823,80,1554656400,30,10,40,Clouds
75824,81,1554656400,13,27,40,Clouds
75825,82,1554656400,22,0,22,Clouds
75826,83,1554656400,38,2,40,Clouds
75827,84,1554656400,30,0,30,Clouds
75828,85,1554656400,30,5,35,Clouds
75829,86,1554656400,35,3,38,Clouds
75830,87,1554656400,32,6,38,Clouds
75831,88,1554656400,27,3,30,Clouds
75832,89,1554656400,38,2,40,Clouds
75833,90,1554656400,40,0,40,Clouds
75834,91,1554656400,15,15,30,Clouds
75835,92,1554656400,22,18,40,Clouds
75836,93,1554656400,14,26,40,Clouds
75837,94,1554656400,10,30,40,Clouds
75838,95,1554656400,35,5,40,Clouds
75839,96,1554656400,26,4,30,Clouds
75840,97,1554656400,38,2,40,Clouds
75841,98,1554656400,22,18,40,Clouds
75842,99,1554656400,20,10,30,Clouds
75843,100,1554656400,11,14,25,Clouds
75844,101,1554656400,24,6,30,Clouds
75845,102,1554656400,39,1,40,Clouds
75846,103,1554656400,27,13,40,Clouds
75847,104,1554656400,39,1,40,Clouds
75848,105,1554656400,35,1,36,Clouds
75849,106,1554656400,40,0,40,Clouds
75850,107,1554656400,39,1,40,Clouds
75851,108,1554656400,29,11,40,Clouds
75852,109,1554656400,18,11,29,Clouds
75853,110,1554656400,33,7,40,Clouds
75854,111,1554656400,20,20,40,Clouds
75855,112,1554656400,29,1,30,Clouds
75856,113,1554656400,39,1,40,Clouds
75857,114,1554656400,38,2,40,Clouds
75858,115,1554656400,24,6,30,Clouds
75859,2,1554660000,17,3,20,Clouds
75860,3,1554660000,15,4,19,Clouds
75861,4,1554660000,13,7,20,Clouds
75862,5,1554660000,36,4,40,Clouds
75863,6,1554660000,3,17,20,Clouds
75864,7,1554660000,9,20,29,Clouds
75865,8,1554660000,2,28,30,Clouds
75866,9,1554660000,8,16,24,Clouds
75867,10,1554660000,0,16,16,Clouds
75868,11,1554660000,27,3,30,Clouds
75869,12,1554660000,17,3,20,Clouds
75870,13,1554660000,23,7,30,Clouds
75871,14,1554660000,6,24,30,Clouds
75872,15,1554660000,16,0,16,Clouds
75873,16,1554660000,10,10,20,Clouds
75874,17,1554660000,2,18,20,Clouds
75875,18,1554660000,3,27,30,Clouds
75876,19,1554660000,28,2,30,Clouds
75877,21,1554660000,5,25,30,Clouds
75878,22,1554660000,0,20,20,Clouds
75879,23,1554660000,13,17,30,Clouds
75880,24,1554660000,9,11,20,Clouds
75881,25,1554660000,20,10,30,Clouds
75882,26,1554660000,3,17,20,Clouds
75883,27,1554660000,13,7,20,Clouds
75884,28,1554660000,29,1,30,Clouds
75885,29,1554660000,0,29,29,Clouds
75886,30,1554660000,20,0,20,Clouds
75887,31,1554660000,16,4,20,Clouds
75888,32,1554660000,15,15,30,Clouds
75889,33,1554660000,17,6,23,Clouds
75890,34,1554660000,16,14,30,Clouds
75891,35,1554660000,11,19,30,Clouds
75892,36,1554660000,1,39,40,Clouds
75893,37,1554660000,4,26,30,Clouds
75894,38,1554660000,17,23,40,Clouds
75895,39,1554660000,15,5,20,Clouds
75896,40,1554660000,4,17,21,Clouds
75897,41,1554660000,18,2,20,Clouds
75898,42,1554660000,18,12,30,Clouds
75899,43,1554660000,22,8,30,Clouds
75900,44,1554660000,28,2,30,Clouds
75901,45,1554660000,25,5,30,Clouds
75902,46,1554660000,5,15,20,Clouds
75903,47,1554660000,38,2,40,Clouds
75904,48,1554660000,21,19,40,Clouds
75905,49,1554660000,29,11,40,Clouds
75906,50,1554660000,40,0,40,Clouds
75907,51,1554660000,11,29,40,Clouds
75908,52,1554660000,16,16,32,Clouds
75909,53,1554660000,23,17,40,Clouds
75910,54,1554660000,9,24,33,Clouds
75911,55,1554660000,31,5,36,Clouds
75912,56,1554660000,33,7,40,Clouds
75913,57,1554660000,15,8,23,Clouds
75914,58,1554660000,32,8,40,Clouds
75915,59,1554660000,12,8,20,Clouds
75916,60,1554660000,26,4,30,Clouds
75917,61,1554660000,25,0,25,Clouds
75918,62,1554660000,38,2,40,Clouds
75919,63,1554660000,13,22,35,Clouds
75920,64,1554660000,28,12,40,Clouds
75921,65,1554660000,39,1,40,Clouds
75922,66,1554660000,40,0,40,Clouds
75923,67,1554660000,28,12,40,Clouds
75924,68,1554660000,22,18,40,Clouds
75925,69,1554660000,1,39,40,Clouds
75926,70,1554660000,3,25,28,Clouds
75927,71,1554660000,12,28,40,Clouds
75928,72,1554660000,27,4,31,Clouds
75929,73,1554660000,29,1,30,Clouds
75930,74,1554660000,26,4,30,Clouds
75931,75,1554660000,39,1,40,Clouds
75932,76,1554660000,34,4,38,Clouds
75933,77,1554660000,7,22,29,Clouds
75934,78,1554660000,40,0,40,Clouds
75935,79,1554660000,26,1,27,Clouds
75936,80,1554660000,32,8,40,Clouds
75937,81,1554660000,12,28,40,Clouds
75938,82,1554660000,21,1,22,Clouds
75939,83,1554660000,38,2,40,Clouds
75940,84,1554660000,29,1,30,Clouds
75941,85,1554660000,24,11,35,Clouds
75942,86,1554660000,33,5,38,Clouds
75943,87,1554660000,33,5,38,Clouds
75944,88,1554660000,27,3,30,Clouds
75945,89,1554660000,37,3,40,Clouds
75946,90,1554660000,39,1,40,Clouds
75947,91,1554660000,10,20,30,Clouds
75948,92,1554660000,24,16,40,Clouds
75949,93,1554660000,14,26,40,Clouds
75950,94,1554660000,9,31,40,Clouds
75951,95,1554660000,35,5,40,Clouds
75952,96,1554660000,27,3,30,Clouds
75953,97,1554660000,40,0,40,Clouds
75954,98,1554660000,22,18,40,Clouds
75955,99,1554660000,21,9,30,Clouds
75956,100,1554660000,13,12,25,Clouds
75957,101,1554660000,19,11,30,Clouds
75958,102,1554660000,21,19,40,Clouds
75959,103,1554660000,28,12,40,Clouds
75960,104,1554660000,39,1,40,Clouds
75961,105,1554660000,34,2,36,Clouds
75962,106,1554660000,40,0,40,Clouds
75963,107,1554660000,38,2,40,Clouds
75964,108,1554660000,31,9,40,Clouds
75965,109,1554660000,13,16,29,Clouds
75966,110,1554660000,33,7,40,Clouds
75967,111,1554660000,22,18,40,Clouds
75968,112,1554660000,22,8,30,Clouds
75969,113,1554660000,40,0,40,Clouds
75970,114,1554660000,40,0,40,Clouds
75971,115,1554660000,21,9,30,Clouds
75972,2,1554663600,17,3,20,Clouds
75973,3,1554663600,18,1,19,Clouds
75974,4,1554663600,13,7,20,Clouds
75975,5,1554663600,33,7,40,Clouds
75976,6,1554663600,6,14,20,Clouds
75977,7,1554663600,5,24,29,Clouds
75978,8,1554663600,0,30,30,Clouds
75979,9,1554663600,1,23,24,Clouds
75980,10,1554663600,0,16,16,Clouds
75981,11,1554663600,28,2,30,Clouds
75982,12,1554663600,17,3,20,Clouds
75983,13,1554663600,22,8,30,Clouds
75984,14,1554663600,2,28,30,Clouds
75985,15,1554663600,15,1,16,Clouds
75986,16,1554663600,11,9,20,Clouds
75987,17,1554663600,3,17,20,Clouds
75988,18,1554663600,2,28,30,Clouds
75989,19,1554663600,22,8,30,Clouds
75990,21,1554663600,14,16,30,Clouds
75991,22,1554663600,7,13,20,Clouds
75992,23,1554663600,19,11,30,Clouds
75993,24,1554663600,17,3,20,Clouds
75994,25,1554663600,22,8,30,Clouds
75995,26,1554663600,6,14,20,Clouds
75996,27,1554663600,20,0,20,Clouds
75997,28,1554663600,25,5,30,Clouds
75998,29,1554663600,3,26,29,Clouds
75999,30,1554663600,20,0,20,Clouds
76000,31,1554663600,20,0,20,Clouds
76001,32,1554663600,18,12,30,Clouds
76002,33,1554663600,20,3,23,Clouds
76003,34,1554663600,15,15,30,Clouds
76004,35,1554663600,4,26,30,Clouds
76005,36,1554663600,4,36,40,Clouds
76006,37,1554663600,25,5,30,Clouds
76007,38,1554663600,17,23,40,Clouds
76008,39,1554663600,18,2,20,Clouds
76009,40,1554663600,14,7,21,Clouds
76010,41,1554663600,18,2,20,Clouds
76011,42,1554663600,12,18,30,Clouds
76012,43,1554663600,21,9,30,Clouds
76013,44,1554663600,28,2,30,Clouds
76014,45,1554663600,26,4,30,Clouds
76015,46,1554663600,10,10,20,Clouds
76016,47,1554663600,38,2,40,Clouds
76017,48,1554663600,20,20,40,Clouds
76018,49,1554663600,22,18,40,Clouds
76019,50,1554663600,37,3,40,Clouds
76020,51,1554663600,15,25,40,Clouds
76021,52,1554663600,23,9,32,Clouds
76022,53,1554663600,23,17,40,Clouds
76023,54,1554663600,10,23,33,Clouds
76024,55,1554663600,31,5,36,Clouds
76025,56,1554663600,26,14,40,Clouds
76026,57,1554663600,17,6,23,Clouds
76027,58,1554663600,35,5,40,Clouds
76028,59,1554663600,12,8,20,Clouds
76029,60,1554663600,25,5,30,Clouds
76030,61,1554663600,23,2,25,Clouds
76031,62,1554663600,36,4,40,Clouds
76032,63,1554663600,12,23,35,Clouds
76033,64,1554663600,25,15,40,Clouds
76034,65,1554663600,38,2,40,Clouds
76035,66,1554663600,33,7,40,Clouds
76036,67,1554663600,32,8,40,Clouds
76037,68,1554663600,11,29,40,Clouds
76038,69,1554663600,0,40,40,Clouds
76039,70,1554663600,3,25,28,Clouds
76040,71,1554663600,15,25,40,Clouds
76041,72,1554663600,28,3,31,Clouds
76042,73,1554663600,28,2,30,Clouds
76043,74,1554663600,26,4,30,Clouds
76044,75,1554663600,40,0,40,Clouds
76045,76,1554663600,31,7,38,Clouds
76046,77,1554663600,9,20,29,Clouds
76047,78,1554663600,38,2,40,Clouds
76048,79,1554663600,26,1,27,Clouds
76049,80,1554663600,33,7,40,Clouds
76050,81,1554663600,12,28,40,Clouds
76051,82,1554663600,22,0,22,Clouds
76052,83,1554663600,35,5,40,Clouds
76053,84,1554663600,26,4,30,Clouds
76054,85,1554663600,19,16,35,Clouds
76055,86,1554663600,33,5,38,Clouds
76056,87,1554663600,34,4,38,Clouds
76057,88,1554663600,27,3,30,Clouds
76058,89,1554663600,37,3,40,Clouds
76059,90,1554663600,38,2,40,Clouds
76060,91,1554663600,3,27,30,Clouds
76061,92,1554663600,22,18,40,Clouds
76062,93,1554663600,14,26,40,Clouds
76063,94,1554663600,9,31,40,Clouds
76064,95,1554663600,35,5,40,Clouds
76065,96,1554663600,29,1,30,Clouds
76066,97,1554663600,34,6,40,Clouds
76067,98,1554663600,23,17,40,Clouds
76068,99,1554663600,19,11,30,Clouds
76069,100,1554663600,13,12,25,Clouds
76070,101,1554663600,16,14,30,Clouds
76071,102,1554663600,20,20,40,Clouds
76072,103,1554663600,28,12,40,Clouds
76073,104,1554663600,39,1,40,Clouds
76074,105,1554663600,34,2,36,Clouds
76075,106,1554663600,40,0,40,Clouds
76076,107,1554663600,38,2,40,Clouds
76077,108,1554663600,31,9,40,Clouds
76078,109,1554663600,13,16,29,Clouds
76079,110,1554663600,36,4,40,Clouds
76080,111,1554663600,20,20,40,Clouds
76081,112,1554663600,21,9,30,Clouds
76082,113,1554663600,32,8,40,Clouds
76083,114,1554663600,30,10,40,Clouds
76084,115,1554663600,18,12,30,Clouds
76085,2,1554667200,20,0,20,Clouds
76086,3,1554667200,19,0,19,Clouds
76087,4,1554667200,11,9,20,Clouds
76088,5,1554667200,27,13,40,Clouds
76089,6,1554667200,5,15,20,Clouds
76090,7,1554667200,5,24,29,Clouds
76091,8,1554667200,2,28,30,Clouds
76092,9,1554667200,2,22,24,Clouds
76093,10,1554667200,2,14,16,Clouds
76094,11,1554667200,30,0,30,Clouds
76095,12,1554667200,17,3,20,Clouds
76096,13,1554667200,20,10,30,Clouds
76097,14,1554667200,5,25,30,Clouds
76098,15,1554667200,16,0,16,Clouds
76099,16,1554667200,10,10,20,Clouds
76100,17,1554667200,3,17,20,Clouds
76101,18,1554667200,0,30,30,Clouds
76102,19,1554667200,20,10,30,Clouds
76103,21,1554667200,21,9,30,Clouds
76104,22,1554667200,10,10,20,Clouds
76105,23,1554667200,18,12,30,Clouds
76106,24,1554667200,20,0,20,Clouds
76107,25,1554667200,23,7,30,Clouds
76108,26,1554667200,8,12,20,Clouds
76109,27,1554667200,18,2,20,Clouds
76110,28,1554667200,28,2,30,Clouds
76111,29,1554667200,7,22,29,Clouds
76112,30,1554667200,20,0,20,Clouds
76113,31,1554667200,15,5,20,Clouds
76114,32,1554667200,19,11,30,Clouds
76115,33,1554667200,21,2,23,Clouds
76116,34,1554667200,9,21,30,Clouds
76117,35,1554667200,1,29,30,Clouds
76118,36,1554667200,24,16,40,Clouds
76119,37,1554667200,23,7,30,Clouds
76120,38,1554667200,24,16,40,Clouds
76121,39,1554667200,16,4,20,Clouds
76122,40,1554667200,17,4,21,Clouds
76123,41,1554667200,16,4,20,Clouds
76124,42,1554667200,8,22,30,Clouds
76125,43,1554667200,19,11,30,Clouds
76126,44,1554667200,25,5,30,Clouds
76127,45,1554667200,27,3,30,Clouds
76128,46,1554667200,5,15,20,Clouds
76129,47,1554667200,36,4,40,Clouds
76130,48,1554667200,20,20,40,Clouds
76131,49,1554667200,25,15,40,Clouds
76132,50,1554667200,28,12,40,Clouds
76133,51,1554667200,12,28,40,Clouds
76134,52,1554667200,24,8,32,Clouds
76135,53,1554667200,24,16,40,Clouds
76136,54,1554667200,11,22,33,Clouds
76137,55,1554667200,30,6,36,Clouds
76138,56,1554667200,23,17,40,Clouds
76139,57,1554667200,16,7,23,Clouds
76140,58,1554667200,31,9,40,Clouds
76141,59,1554667200,11,9,20,Clouds
76142,60,1554667200,27,3,30,Clouds
76143,61,1554667200,21,4,25,Clouds
76144,62,1554667200,35,5,40,Clouds
76145,63,1554667200,13,22,35,Clouds
76146,64,1554667200,24,16,40,Clouds
76147,65,1554667200,38,2,40,Clouds
76148,66,1554667200,28,12,40,Clouds
76149,67,1554667200,35,5,40,Clouds
76150,68,1554667200,9,31,40,Clouds
76151,69,1554667200,1,39,40,Clouds
76152,70,1554667200,0,28,28,Clouds
76153,71,1554667200,14,26,40,Clouds
76154,72,1554667200,13,18,31,Clouds
76155,73,1554667200,29,1,30,Clouds
76156,74,1554667200,25,5,30,Clouds
76157,75,1554667200,38,2,40,Clouds
76158,76,1554667200,29,9,38,Clouds
76159,77,1554667200,12,17,29,Clouds
76160,78,1554667200,40,0,40,Clouds
76161,79,1554667200,26,1,27,Clouds
76162,80,1554667200,25,15,40,Clouds
76163,81,1554667200,13,27,40,Clouds
76164,82,1554667200,22,0,22,Clouds
76165,83,1554667200,37,3,40,Clouds
76166,84,1554667200,24,6,30,Clouds
76167,85,1554667200,20,15,35,Clouds
76168,86,1554667200,30,8,38,Clouds
76169,87,1554667200,31,7,38,Clouds
76170,88,1554667200,27,3,30,Clouds
76171,89,1554667200,38,2,40,Clouds
76172,90,1554667200,38,2,40,Clouds
76173,91,1554667200,1,29,30,Clouds
76174,92,1554667200,19,21,40,Clouds
76175,93,1554667200,15,25,40,Clouds
76176,94,1554667200,9,31,40,Clouds
76177,95,1554667200,35,5,40,Clouds
76178,96,1554667200,29,1,30,Clouds
76179,97,1554667200,32,8,40,Clouds
76180,98,1554667200,30,10,40,Clouds
76181,99,1554667200,19,11,30,Clouds
76182,100,1554667200,17,8,25,Clouds
76183,101,1554667200,18,12,30,Clouds
76184,102,1554667200,23,17,40,Clouds
76185,103,1554667200,28,12,40,Clouds
76186,104,1554667200,39,1,40,Clouds
76187,105,1554667200,34,2,36,Clouds
76188,106,1554667200,40,0,40,Clouds
76189,107,1554667200,39,0,39,Clouds
76190,108,1554667200,32,8,40,Clouds
76191,109,1554667200,13,16,29,Clouds
76192,110,1554667200,35,5,40,Clouds
76193,111,1554667200,22,18,40,Clouds
76194,112,1554667200,20,10,30,Clouds
76195,113,1554667200,32,8,40,Clouds
76196,114,1554667200,30,10,40,Clouds
76197,115,1554667200,18,12,30,Clouds
76198,2,1554670800,11,9,20,Clouds
76199,3,1554670800,20,0,20,Clouds
76200,4,1554670800,8,12,20,Clouds
76201,5,1554670800,29,11,40,Clouds
76202,6,1554670800,10,10,20,Clouds
76203,7,1554670800,8,21,29,Clouds
76204,8,1554670800,1,29,30,Clouds
76205,9,1554670800,6,18,24,Clouds
76206,10,1554670800,2,14,16,Clouds
76207,11,1554670800,30,0,30,Clouds
76208,12,1554670800,16,4,20,Clouds
76209,13,1554670800,21,9,30,Clouds
76210,14,1554670800,9,21,30,Clouds
76211,15,1554670800,16,0,16,Clouds
76212,16,1554670800,12,8,20,Clouds
76213,17,1554670800,3,17,20,Clouds
76214,18,1554670800,0,30,30,Clouds
76215,19,1554670800,21,9,30,Clouds
76216,21,1554670800,21,9,30,Clouds
76217,22,1554670800,9,11,20,Clouds
76218,23,1554670800,18,12,30,Clouds
76219,24,1554670800,19,1,20,Clouds
76220,25,1554670800,23,7,30,Clouds
76221,26,1554670800,8,12,20,Clouds
76222,27,1554670800,20,0,20,Clouds
76223,28,1554670800,21,9,30,Clouds
76224,29,1554670800,0,29,29,Clouds
76225,30,1554670800,20,0,20,Clouds
76226,31,1554670800,20,0,20,Clouds
76227,32,1554670800,19,11,30,Clouds
76228,33,1554670800,22,1,23,Clouds
76229,34,1554670800,6,24,30,Clouds
76230,35,1554670800,1,29,30,Clouds
76231,36,1554670800,24,16,40,Clouds
76232,37,1554670800,22,8,30,Clouds
76233,38,1554670800,24,16,40,Clouds
76234,39,1554670800,15,5,20,Clouds
76235,40,1554670800,15,6,21,Clouds
76236,41,1554670800,16,4,20,Clouds
76237,42,1554670800,6,24,30,Clouds
76238,43,1554670800,18,12,30,Clouds
76239,44,1554670800,27,3,30,Clouds
76240,45,1554670800,28,2,30,Clouds
76241,46,1554670800,6,14,20,Clouds
76242,47,1554670800,38,2,40,Clouds
76243,48,1554670800,23,17,40,Clouds
76244,49,1554670800,27,13,40,Clouds
76245,50,1554670800,24,16,40,Clouds
76246,51,1554670800,13,27,40,Clouds
76247,52,1554670800,21,11,32,Clouds
76248,53,1554670800,40,0,40,Clouds
76249,54,1554670800,8,25,33,Clouds
76250,55,1554670800,29,7,36,Clouds
76251,56,1554670800,22,18,40,Clouds
76252,57,1554670800,17,6,23,Clouds
76253,58,1554670800,23,17,40,Clouds
76254,59,1554670800,13,7,20,Clouds
76255,60,1554670800,25,5,30,Clouds
76256,61,1554670800,21,4,25,Clouds
76257,62,1554670800,35,5,40,Clouds
76258,63,1554670800,14,21,35,Clouds
76259,64,1554670800,23,17,40,Clouds
76260,65,1554670800,37,3,40,Clouds
76261,66,1554670800,29,11,40,Clouds
76262,67,1554670800,34,5,39,Clouds
76263,68,1554670800,8,32,40,Clouds
76264,69,1554670800,1,39,40,Clouds
76265,70,1554670800,0,28,28,Clouds
76266,71,1554670800,14,26,40,Clouds
76267,72,1554670800,8,23,31,Clouds
76268,73,1554670800,30,0,30,Clouds
76269,74,1554670800,23,7,30,Clouds
76270,75,1554670800,37,3,40,Clouds
76271,76,1554670800,33,5,38,Clouds
76272,77,1554670800,15,14,29,Clouds
76273,78,1554670800,34,6,40,Clouds
76274,79,1554670800,25,2,27,Clouds
76275,80,1554670800,26,14,40,Clouds
76276,81,1554670800,15,25,40,Clouds
76277,82,1554670800,22,0,22,Clouds
76278,83,1554670800,36,4,40,Clouds
76279,84,1554670800,25,5,30,Clouds
76280,85,1554670800,20,15,35,Clouds
76281,86,1554670800,33,5,38,Clouds
76282,87,1554670800,32,6,38,Clouds
76283,88,1554670800,26,4,30,Clouds
76284,89,1554670800,38,2,40,Clouds
76285,90,1554670800,38,2,40,Clouds
76286,91,1554670800,1,29,30,Clouds
76287,92,1554670800,20,20,40,Clouds
76288,93,1554670800,16,24,40,Clouds
76289,94,1554670800,9,31,40,Clouds
76290,95,1554670800,33,7,40,Clouds
76291,96,1554670800,29,1,30,Clouds
76292,97,1554670800,29,11,40,Clouds
76293,98,1554670800,31,9,40,Clouds
76294,99,1554670800,19,11,30,Clouds
76295,100,1554670800,24,1,25,Clouds
76296,101,1554670800,19,11,30,Clouds
76297,102,1554670800,22,18,40,Clouds
76298,103,1554670800,28,12,40,Clouds
76299,104,1554670800,39,1,40,Clouds
76300,105,1554670800,36,0,36,Clouds
76301,106,1554670800,40,0,40,Clouds
76302,107,1554670800,40,0,40,Clouds
76303,108,1554670800,31,9,40,Clouds
76304,109,1554670800,13,16,29,Clouds
76305,110,1554670800,36,4,40,Clouds
76306,111,1554670800,20,20,40,Clouds
76307,112,1554670800,18,12,30,Clouds
76308,113,1554670800,32,8,40,Clouds
76309,114,1554670800,29,11,40,Clouds
76310,115,1554670800,11,19,30,Clouds
76311,2,1554674400,12,8,20,Clouds
76312,3,1554674400,19,1,20,Clouds
76313,4,1554674400,7,13,20,Clouds
76314,5,1554674400,27,13,40,Clouds
76315,6,1554674400,10,10,20,Clouds
76316,7,1554674400,9,20,29,Clouds
76317,8,1554674400,1,29,30,Clouds
76318,9,1554674400,6,18,24,Clouds
76319,10,1554674400,7,9,16,Clouds
76320,11,1554674400,29,1,30,Clouds
76321,12,1554674400,16,4,20,Clouds
76322,13,1554674400,21,9,30,Clouds
76323,14,1554674400,8,22,30,Clouds
76324,15,1554674400,16,0,16,Clouds
76325,16,1554674400,15,5,20,Clouds
76326,17,1554674400,2,18,20,Clouds
76327,18,1554674400,0,30,30,Clouds
76328,19,1554674400,20,10,30,Clouds
76329,21,1554674400,22,8,30,Clouds
76330,22,1554674400,10,10,20,Clouds
76331,23,1554674400,22,8,30,Clouds
76332,24,1554674400,20,0,20,Clouds
76333,25,1554674400,24,6,30,Clouds
76334,26,1554674400,10,10,20,Clouds
76335,27,1554674400,20,0,20,Clouds
76336,28,1554674400,21,9,30,Clouds
76337,29,1554674400,5,24,29,Clouds
76338,30,1554674400,20,0,20,Clouds
76339,31,1554674400,20,0,20,Clouds
76340,32,1554674400,19,11,30,Clouds
76341,33,1554674400,22,1,23,Clouds
76342,34,1554674400,4,26,30,Clouds
76343,35,1554674400,2,27,29,Clouds
76344,36,1554674400,23,17,40,Clouds
76345,37,1554674400,22,8,30,Clouds
76346,38,1554674400,25,15,40,Clouds
76347,39,1554674400,15,5,20,Clouds
76348,40,1554674400,21,0,21,Clouds
76349,41,1554674400,16,4,20,Clouds
76350,42,1554674400,1,29,30,Clouds
76351,43,1554674400,17,13,30,Clouds
76352,44,1554674400,29,1,30,Clouds
76353,45,1554674400,30,0,30,Clouds
76354,46,1554674400,6,14,20,Clouds
76355,47,1554674400,38,2,40,Clouds
76356,48,1554674400,24,16,40,Clouds
76357,49,1554674400,26,14,40,Clouds
76358,50,1554674400,21,19,40,Clouds
76359,51,1554674400,13,27,40,Clouds
76360,52,1554674400,24,8,32,Clouds
76361,53,1554674400,40,0,40,Clouds
76362,54,1554674400,8,25,33,Clouds
76363,55,1554674400,29,7,36,Clouds
76364,56,1554674400,20,20,40,Clouds
76365,57,1554674400,17,6,23,Clouds
76366,58,1554674400,17,23,40,Clouds
76367,59,1554674400,14,6,20,Clouds
76368,60,1554674400,22,8,30,Clouds
76369,61,1554674400,23,2,25,Clouds
76370,62,1554674400,35,5,40,Clouds
76371,63,1554674400,15,20,35,Clouds
76372,64,1554674400,26,14,40,Clouds
76373,65,1554674400,37,3,40,Clouds
76374,66,1554674400,27,13,40,Clouds
76375,67,1554674400,29,10,39,Clouds
76376,68,1554674400,0,40,40,Clouds
76377,69,1554674400,0,40,40,Clouds
76378,70,1554674400,0,28,28,Clouds
76379,71,1554674400,14,26,40,Clouds
76380,72,1554674400,5,26,31,Clouds
76381,73,1554674400,29,1,30,Clouds
76382,74,1554674400,22,8,30,Clouds
76383,75,1554674400,36,4,40,Clouds
76384,76,1554674400,33,5,38,Clouds
76385,77,1554674400,20,9,29,Clouds
76386,78,1554674400,31,9,40,Clouds
76387,79,1554674400,25,2,27,Clouds
76388,80,1554674400,27,13,40,Clouds
76389,81,1554674400,17,23,40,Clouds
76390,82,1554674400,21,1,22,Clouds
76391,83,1554674400,37,3,40,Clouds
76392,84,1554674400,24,6,30,Clouds
76393,85,1554674400,20,15,35,Clouds
76394,86,1554674400,37,1,38,Clouds
76395,87,1554674400,28,10,38,Clouds
76396,88,1554674400,23,7,30,Clouds
76397,89,1554674400,38,2,40,Clouds
76398,90,1554674400,39,1,40,Clouds
76399,91,1554674400,1,29,30,Clouds
76400,92,1554674400,25,15,40,Clouds
76401,93,1554674400,17,23,40,Clouds
76402,94,1554674400,9,31,40,Clouds
76403,95,1554674400,32,8,40,Clouds
76404,96,1554674400,28,2,30,Clouds
76405,97,1554674400,28,12,40,Clouds
76406,98,1554674400,33,7,40,Clouds
76407,99,1554674400,19,11,30,Clouds
76408,100,1554674400,24,1,25,Clouds
76409,101,1554674400,19,11,30,Clouds
76410,102,1554674400,26,14,40,Clouds
76411,103,1554674400,28,12,40,Clouds
76412,104,1554674400,40,0,40,Clouds
76413,105,1554674400,36,0,36,Clouds
76414,106,1554674400,40,0,40,Clouds
76415,107,1554674400,38,2,40,Clouds
76416,108,1554674400,32,8,40,Clouds
76417,109,1554674400,14,15,29,Clouds
76418,110,1554674400,38,2,40,Clouds
76419,111,1554674400,19,21,40,Clouds
76420,112,1554674400,17,13,30,Clouds
76421,113,1554674400,32,8,40,Clouds
76422,114,1554674400,27,13,40,Clouds
76423,115,1554674400,9,21,30,Clouds
76424,2,1554678000,12,8,20,Clouds
76425,3,1554678000,19,1,20,Clouds
76426,4,1554678000,6,14,20,Clouds
76427,5,1554678000,33,7,40,Clouds
76428,6,1554678000,9,11,20,Clouds
76429,7,1554678000,12,17,29,Clouds
76430,8,1554678000,3,27,30,Clouds
76431,9,1554678000,12,12,24,Clouds
76432,10,1554678000,8,8,16,Clouds
76433,11,1554678000,29,1,30,Clouds
76434,12,1554678000,15,5,20,Clouds
76435,13,1554678000,23,7,30,Clouds
76436,14,1554678000,14,16,30,Clouds
76437,15,1554678000,16,0,16,Clouds
76438,16,1554678000,16,4,20,Clouds
76439,17,1554678000,2,18,20,Clouds
76440,18,1554678000,0,30,30,Clouds
76441,19,1554678000,18,12,30,Clouds
76442,21,1554678000,24,6,30,Clouds
76443,22,1554678000,12,8,20,Clouds
76444,23,1554678000,26,4,30,Clouds
76445,24,1554678000,20,0,20,Clouds
76446,25,1554678000,26,4,30,Clouds
76447,26,1554678000,10,10,20,Clouds
76448,27,1554678000,19,1,20,Clouds
76449,28,1554678000,19,11,30,Clouds
76450,29,1554678000,5,24,29,Clouds
76451,30,1554678000,19,1,20,Clouds
76452,31,1554678000,19,1,20,Clouds
76453,32,1554678000,22,8,30,Clouds
76454,33,1554678000,23,0,23,Clouds
76455,34,1554678000,0,30,30,Clouds
76456,35,1554678000,0,29,29,Clouds
76457,36,1554678000,22,18,40,Clouds
76458,37,1554678000,21,9,30,Clouds
76459,38,1554678000,26,14,40,Clouds
76460,39,1554678000,12,8,20,Clouds
76461,40,1554678000,20,1,21,Clouds
76462,41,1554678000,17,3,20,Clouds
76463,42,1554678000,6,24,30,Clouds
76464,43,1554678000,12,18,30,Clouds
76465,44,1554678000,30,0,30,Clouds
76466,45,1554678000,27,3,30,Clouds
76467,46,1554678000,10,10,20,Clouds
76468,47,1554678000,37,3,40,Clouds
76469,48,1554678000,22,18,40,Clouds
76470,49,1554678000,21,19,40,Clouds
76471,50,1554678000,15,25,40,Clouds
76472,51,1554678000,15,25,40,Clouds
76473,52,1554678000,23,9,32,Clouds
76474,53,1554678000,40,0,40,Clouds
76475,54,1554678000,7,26,33,Clouds
76476,55,1554678000,27,9,36,Clouds
76477,56,1554678000,22,18,40,Clouds
76478,57,1554678000,16,7,23,Clouds
76479,58,1554678000,17,23,40,Clouds
76480,59,1554678000,15,5,20,Clouds
76481,60,1554678000,26,4,30,Clouds
76482,61,1554678000,23,2,25,Clouds
76483,62,1554678000,34,6,40,Clouds
76484,63,1554678000,18,17,35,Clouds
76485,64,1554678000,22,18,40,Clouds
76486,65,1554678000,36,4,40,Clouds
76487,66,1554678000,22,18,40,Clouds
76488,67,1554678000,30,9,39,Clouds
76489,68,1554678000,0,40,40,Clouds
76490,69,1554678000,0,40,40,Clouds
76491,70,1554678000,0,28,28,Clouds
76492,71,1554678000,14,26,40,Clouds
76493,72,1554678000,5,26,31,Clouds
76494,73,1554678000,28,2,30,Clouds
76495,74,1554678000,21,9,30,Clouds
76496,75,1554678000,37,3,40,Clouds
76497,76,1554678000,35,3,38,Clouds
76498,77,1554678000,18,11,29,Clouds
76499,78,1554678000,28,12,40,Clouds
76500,79,1554678000,25,2,27,Clouds
76501,80,1554678000,26,14,40,Clouds
76502,81,1554678000,17,23,40,Clouds
76503,82,1554678000,21,1,22,Clouds
76504,83,1554678000,38,2,40,Clouds
76505,84,1554678000,21,9,30,Clouds
76506,85,1554678000,17,18,35,Clouds
76507,86,1554678000,37,1,38,Clouds
76508,87,1554678000,28,10,38,Clouds
76509,88,1554678000,26,4,30,Clouds
76510,89,1554678000,38,2,40,Clouds
76511,90,1554678000,31,9,40,Clouds
76512,91,1554678000,2,28,30,Clouds
76513,92,1554678000,24,16,40,Clouds
76514,93,1554678000,17,23,40,Clouds
76515,94,1554678000,9,31,40,Clouds
76516,95,1554678000,29,11,40,Clouds
76517,96,1554678000,28,2,30,Clouds
76518,97,1554678000,23,17,40,Clouds
76519,98,1554678000,36,4,40,Clouds
76520,99,1554678000,21,9,30,Clouds
76521,100,1554678000,24,1,25,Clouds
76522,101,1554678000,21,9,30,Clouds
76523,102,1554678000,27,13,40,Clouds
76524,103,1554678000,28,12,40,Clouds
76525,104,1554678000,40,0,40,Clouds
76526,105,1554678000,36,0,36,Clouds
76527,106,1554678000,38,2,40,Clouds
76528,107,1554678000,34,6,40,Clouds
76529,108,1554678000,33,7,40,Clouds
76530,109,1554678000,12,17,29,Clouds
76531,110,1554678000,38,2,40,Clouds
76532,111,1554678000,15,25,40,Clouds
76533,112,1554678000,14,16,30,Clouds
76534,113,1554678000,33,7,40,Clouds
76535,114,1554678000,29,11,40,Clouds
76536,115,1554678000,5,25,30,Clouds
76537,2,1554681600,10,10,20,Clouds
76538,3,1554681600,20,0,20,Clouds
76539,4,1554681600,7,13,20,Clouds
76540,5,1554681600,32,7,39,Clouds
76541,6,1554681600,14,6,20,Clouds
76542,7,1554681600,11,18,29,Clouds
76543,8,1554681600,8,22,30,Clouds
76544,9,1554681600,13,11,24,Clouds
76545,10,1554681600,11,5,16,Clouds
76546,11,1554681600,29,1,30,Clouds
76547,12,1554681600,15,5,20,Clouds
76548,13,1554681600,22,8,30,Clouds
76549,14,1554681600,19,11,30,Clouds
76550,15,1554681600,16,0,16,Clouds
76551,16,1554681600,16,4,20,Clouds
76552,17,1554681600,1,19,20,Clouds
76553,18,1554681600,7,23,30,Clouds
76554,19,1554681600,18,12,30,Clouds
76555,21,1554681600,25,5,30,Clouds
76556,22,1554681600,14,6,20,Clouds
76557,23,1554681600,28,2,30,Clouds
76558,24,1554681600,20,0,20,Clouds
76559,25,1554681600,27,3,30,Clouds
76560,26,1554681600,13,7,20,Clouds
76561,27,1554681600,20,0,20,Clouds
76562,28,1554681600,20,10,30,Clouds
76563,29,1554681600,6,23,29,Clouds
76564,30,1554681600,19,1,20,Clouds
76565,31,1554681600,20,0,20,Clouds
76566,32,1554681600,21,9,30,Clouds
76567,33,1554681600,23,0,23,Clouds
76568,34,1554681600,0,30,30,Clouds
76569,35,1554681600,2,27,29,Clouds
76570,36,1554681600,22,18,40,Clouds
76571,37,1554681600,21,9,30,Clouds
76572,38,1554681600,29,11,40,Clouds
76573,39,1554681600,12,8,20,Clouds
76574,40,1554681600,21,0,21,Clouds
76575,41,1554681600,15,5,20,Clouds
76576,42,1554681600,6,24,30,Clouds
76577,43,1554681600,11,19,30,Clouds
76578,44,1554681600,29,1,30,Clouds
76579,45,1554681600,28,2,30,Clouds
76580,46,1554681600,11,9,20,Clouds
76581,47,1554681600,37,3,40,Clouds
76582,48,1554681600,23,17,40,Clouds
76583,49,1554681600,21,19,40,Clouds
76584,50,1554681600,16,24,40,Clouds
76585,51,1554681600,15,25,40,Clouds
76586,52,1554681600,25,7,32,Clouds
76587,53,1554681600,40,0,40,Clouds
76588,54,1554681600,10,23,33,Clouds
76589,55,1554681600,27,9,36,Clouds
76590,56,1554681600,20,20,40,Clouds
76591,57,1554681600,16,7,23,Clouds
76592,58,1554681600,18,22,40,Clouds
76593,59,1554681600,16,4,20,Clouds
76594,60,1554681600,28,2,30,Clouds
76595,61,1554681600,20,5,25,Clouds
76596,62,1554681600,33,7,40,Clouds
76597,63,1554681600,17,18,35,Clouds
76598,64,1554681600,19,21,40,Clouds
76599,65,1554681600,35,5,40,Clouds
76600,66,1554681600,24,16,40,Clouds
76601,67,1554681600,31,8,39,Clouds
76602,68,1554681600,1,39,40,Clouds
76603,69,1554681600,0,40,40,Clouds
76604,70,1554681600,0,28,28,Clouds
76605,71,1554681600,14,26,40,Clouds
76606,72,1554681600,5,26,31,Clouds
76607,73,1554681600,26,4,30,Clouds
76608,74,1554681600,22,8,30,Clouds
76609,75,1554681600,37,3,40,Clouds
76610,76,1554681600,33,5,38,Clouds
76611,77,1554681600,19,10,29,Clouds
76612,78,1554681600,24,16,40,Clouds
76613,79,1554681600,25,2,27,Clouds
76614,80,1554681600,25,15,40,Clouds
76615,81,1554681600,17,23,40,Clouds
76616,82,1554681600,20,2,22,Clouds
76617,83,1554681600,39,1,40,Clouds
76618,84,1554681600,19,11,30,Clouds
76619,85,1554681600,19,16,35,Clouds
76620,86,1554681600,38,0,38,Clouds
76621,87,1554681600,27,11,38,Clouds
76622,88,1554681600,24,6,30,Clouds
76623,89,1554681600,38,2,40,Clouds
76624,90,1554681600,27,13,40,Clouds
76625,91,1554681600,1,29,30,Clouds
76626,92,1554681600,26,14,40,Clouds
76627,93,1554681600,17,23,40,Clouds
76628,94,1554681600,9,31,40,Clouds
76629,95,1554681600,29,11,40,Clouds
76630,96,1554681600,28,2,30,Clouds
76631,97,1554681600,22,18,40,Clouds
76632,98,1554681600,40,0,40,Clouds
76633,99,1554681600,21,9,30,Clouds
76634,100,1554681600,24,1,25,Clouds
76635,101,1554681600,18,12,30,Clouds
76636,102,1554681600,26,14,40,Clouds
76637,103,1554681600,28,12,40,Clouds
76638,104,1554681600,40,0,40,Clouds
76639,105,1554681600,36,0,36,Clouds
76640,106,1554681600,38,2,40,Clouds
76641,107,1554681600,33,7,40,Clouds
76642,108,1554681600,33,7,40,Clouds
76643,109,1554681600,10,19,29,Clouds
76644,110,1554681600,35,5,40,Clouds
76645,111,1554681600,13,27,40,Clouds
76646,112,1554681600,7,23,30,Clouds
76647,113,1554681600,33,7,40,Clouds
76648,114,1554681600,29,11,40,Clouds
76649,115,1554681600,3,27,30,Clouds
76650,2,1554685200,10,10,20,Clouds
76651,3,1554685200,20,0,20,Clouds
76652,4,1554685200,7,13,20,Clouds
76653,5,1554685200,31,9,40,Clouds
76654,6,1554685200,15,5,20,Clouds
76655,7,1554685200,11,18,29,Clouds
76656,8,1554685200,8,22,30,Clouds
76657,9,1554685200,15,9,24,Clouds
76658,10,1554685200,12,4,16,Clouds
76659,11,1554685200,29,1,30,Clouds
76660,12,1554685200,14,6,20,Clouds
76661,13,1554685200,22,8,30,Clouds
76662,14,1554685200,24,6,30,Clouds
76663,15,1554685200,16,0,16,Clouds
76664,16,1554685200,16,4,20,Clouds
76665,17,1554685200,1,19,20,Clouds
76666,18,1554685200,8,22,30,Clouds
76667,19,1554685200,19,11,30,Clouds
76668,21,1554685200,26,4,30,Clouds
76669,22,1554685200,16,4,20,Clouds
76670,23,1554685200,28,2,30,Clouds
76671,24,1554685200,18,2,20,Clouds
76672,25,1554685200,27,3,30,Clouds
76673,26,1554685200,13,7,20,Clouds
76674,27,1554685200,20,0,20,Clouds
76675,28,1554685200,19,11,30,Clouds
76676,29,1554685200,7,22,29,Clouds
76677,30,1554685200,19,1,20,Clouds
76678,31,1554685200,19,1,20,Clouds
76679,32,1554685200,21,9,30,Clouds
76680,33,1554685200,23,0,23,Clouds
76681,34,1554685200,1,29,30,Clouds
76682,35,1554685200,0,29,29,Clouds
76683,36,1554685200,24,16,40,Clouds
76684,37,1554685200,22,8,30,Clouds
76685,38,1554685200,27,13,40,Clouds
76686,39,1554685200,13,7,20,Clouds
76687,40,1554685200,21,0,21,Clouds
76688,41,1554685200,15,5,20,Clouds
76689,42,1554685200,7,23,30,Clouds
76690,43,1554685200,10,20,30,Clouds
76691,44,1554685200,26,4,30,Clouds
76692,45,1554685200,28,2,30,Clouds
76693,46,1554685200,10,10,20,Clouds
76694,47,1554685200,37,3,40,Clouds
76695,48,1554685200,25,15,40,Clouds
76696,49,1554685200,19,21,40,Clouds
76697,50,1554685200,16,24,40,Clouds
76698,51,1554685200,16,24,40,Clouds
76699,52,1554685200,26,6,32,Clouds
76700,53,1554685200,40,0,40,Clouds
76701,54,1554685200,11,22,33,Clouds
76702,55,1554685200,27,9,36,Clouds
76703,56,1554685200,19,21,40,Clouds
76704,57,1554685200,16,7,23,Clouds
76705,58,1554685200,16,24,40,Clouds
76706,59,1554685200,17,3,20,Clouds
76707,60,1554685200,25,5,30,Clouds
76708,61,1554685200,18,7,25,Clouds
76709,62,1554685200,31,9,40,Clouds
76710,63,1554685200,17,18,35,Clouds
76711,64,1554685200,18,22,40,Clouds
76712,65,1554685200,36,4,40,Clouds
76713,66,1554685200,23,17,40,Clouds
76714,67,1554685200,31,8,39,Clouds
76715,68,1554685200,1,39,40,Clouds
76716,69,1554685200,0,40,40,Clouds
76717,70,1554685200,0,28,28,Clouds
76718,71,1554685200,13,27,40,Clouds
76719,72,1554685200,5,26,31,Clouds
76720,73,1554685200,26,4,30,Clouds
76721,74,1554685200,20,10,30,Clouds
76722,75,1554685200,36,4,40,Clouds
76723,76,1554685200,32,6,38,Clouds
76724,77,1554685200,20,9,29,Clouds
76725,78,1554685200,24,16,40,Clouds
76726,79,1554685200,25,2,27,Clouds
76727,80,1554685200,25,15,40,Clouds
76728,81,1554685200,17,23,40,Clouds
76729,82,1554685200,20,2,22,Clouds
76730,83,1554685200,38,2,40,Clouds
76731,84,1554685200,17,13,30,Clouds
76732,85,1554685200,19,16,35,Clouds
76733,86,1554685200,38,0,38,Clouds
76734,87,1554685200,27,11,38,Clouds
76735,88,1554685200,22,8,30,Clouds
76736,89,1554685200,38,2,40,Clouds
76737,90,1554685200,26,14,40,Clouds
76738,91,1554685200,1,29,30,Clouds
76739,92,1554685200,26,14,40,Clouds
76740,93,1554685200,17,23,40,Clouds
76741,94,1554685200,9,31,40,Clouds
76742,95,1554685200,29,11,40,Clouds
76743,96,1554685200,27,3,30,Clouds
76744,97,1554685200,22,18,40,Clouds
76745,98,1554685200,40,0,40,Clouds
76746,99,1554685200,21,9,30,Clouds
76747,100,1554685200,24,1,25,Clouds
76748,101,1554685200,18,12,30,Clouds
76749,102,1554685200,24,16,40,Clouds
76750,103,1554685200,28,12,40,Clouds
76751,104,1554685200,40,0,40,Clouds
76752,105,1554685200,36,0,36,Clouds
76753,106,1554685200,38,2,40,Clouds
76754,107,1554685200,33,7,40,Clouds
76755,108,1554685200,33,7,40,Clouds
76756,109,1554685200,10,19,29,Clouds
76757,110,1554685200,35,5,40,Clouds
76758,111,1554685200,11,29,40,Clouds
76759,112,1554685200,7,23,30,Clouds
76760,113,1554685200,33,7,40,Clouds
76761,114,1554685200,30,10,40,Clouds
76762,115,1554685200,4,26,30,Clouds
76763,2,1554688800,10,10,20,Clouds
76764,3,1554688800,20,0,20,Clouds
76765,4,1554688800,7,13,20,Clouds
76766,5,1554688800,31,9,40,Clouds
76767,6,1554688800,15,5,20,Clouds
76768,7,1554688800,11,18,29,Clouds
76769,8,1554688800,8,22,30,Clouds
76770,9,1554688800,15,9,24,Clouds
76771,10,1554688800,12,4,16,Clouds
76772,11,1554688800,29,1,30,Clouds
76773,12,1554688800,14,6,20,Clouds
76774,13,1554688800,22,8,30,Clouds
76775,14,1554688800,24,6,30,Clouds
76776,15,1554688800,16,0,16,Clouds
76777,16,1554688800,16,4,20,Clouds
76778,17,1554688800,1,19,20,Clouds
76779,18,1554688800,8,22,30,Clouds
76780,19,1554688800,19,11,30,Clouds
76781,21,1554688800,26,4,30,Clouds
76782,22,1554688800,16,4,20,Clouds
76783,23,1554688800,28,2,30,Clouds
76784,24,1554688800,18,2,20,Clouds
76785,25,1554688800,27,3,30,Clouds
76786,26,1554688800,13,7,20,Clouds
76787,27,1554688800,20,0,20,Clouds
76788,28,1554688800,18,12,30,Clouds
76789,29,1554688800,7,22,29,Clouds
76790,30,1554688800,19,1,20,Clouds
76791,31,1554688800,19,1,20,Clouds
76792,32,1554688800,21,9,30,Clouds
76793,33,1554688800,23,0,23,Clouds
76794,34,1554688800,1,29,30,Clouds
76795,35,1554688800,0,29,29,Clouds
76796,36,1554688800,24,16,40,Clouds
76797,37,1554688800,22,8,30,Clouds
76798,38,1554688800,27,13,40,Clouds
76799,39,1554688800,13,7,20,Clouds
76800,40,1554688800,21,0,21,Clouds
76801,41,1554688800,15,5,20,Clouds
76802,42,1554688800,7,23,30,Clouds
76803,43,1554688800,10,20,30,Clouds
76804,44,1554688800,26,4,30,Clouds
76805,45,1554688800,28,2,30,Clouds
76806,46,1554688800,10,10,20,Clouds
76807,47,1554688800,37,3,40,Clouds
76808,48,1554688800,25,15,40,Clouds
76809,49,1554688800,19,21,40,Clouds
76810,50,1554688800,16,24,40,Clouds
76811,51,1554688800,16,24,40,Clouds
76812,52,1554688800,26,6,32,Clouds
76813,53,1554688800,40,0,40,Clouds
76814,54,1554688800,11,22,33,Clouds
76815,55,1554688800,27,9,36,Clouds
76816,56,1554688800,19,21,40,Clouds
76817,57,1554688800,16,7,23,Clouds
76818,58,1554688800,16,24,40,Clouds
76819,59,1554688800,17,3,20,Clouds
76820,60,1554688800,25,5,30,Clouds
76821,61,1554688800,18,7,25,Clouds
76822,62,1554688800,31,9,40,Clouds
76823,63,1554688800,17,18,35,Clouds
76824,64,1554688800,18,22,40,Clouds
76825,65,1554688800,36,4,40,Clouds
76826,66,1554688800,23,17,40,Clouds
76827,67,1554688800,31,8,39,Clouds
76828,68,1554688800,1,39,40,Clouds
76829,69,1554688800,0,40,40,Clouds
76830,70,1554688800,0,28,28,Clouds
76831,71,1554688800,13,27,40,Clouds
76832,72,1554688800,5,26,31,Clouds
76833,73,1554688800,26,4,30,Clouds
76834,74,1554688800,20,10,30,Clouds
76835,75,1554688800,36,4,40,Clouds
76836,76,1554688800,32,6,38,Clouds
76837,77,1554688800,20,9,29,Clouds
76838,78,1554688800,24,16,40,Clouds
76839,79,1554688800,25,2,27,Clouds
76840,80,1554688800,25,15,40,Clouds
76841,81,1554688800,17,23,40,Clouds
76842,82,1554688800,20,2,22,Clouds
76843,83,1554688800,38,2,40,Clouds
76844,84,1554688800,17,13,30,Clouds
76845,85,1554688800,19,16,35,Clouds
76846,86,1554688800,38,0,38,Clouds
76847,87,1554688800,25,13,38,Clouds
76848,88,1554688800,22,8,30,Clouds
76849,89,1554688800,38,2,40,Clouds
76850,90,1554688800,26,14,40,Clouds
76851,91,1554688800,1,29,30,Clouds
76852,92,1554688800,26,14,40,Clouds
76853,93,1554688800,17,23,40,Clouds
76854,94,1554688800,9,31,40,Clouds
76855,95,1554688800,29,11,40,Clouds
76856,96,1554688800,27,3,30,Clouds
76857,97,1554688800,22,18,40,Clouds
76858,98,1554688800,40,0,40,Clouds
76859,99,1554688800,21,9,30,Clouds
76860,100,1554688800,24,1,25,Clouds
76861,101,1554688800,18,12,30,Clouds
76862,102,1554688800,24,16,40,Clouds
76863,103,1554688800,28,12,40,Clouds
76864,104,1554688800,40,0,40,Clouds
76865,105,1554688800,36,0,36,Clouds
76866,106,1554688800,38,2,40,Clouds
76867,107,1554688800,33,7,40,Clouds
76868,108,1554688800,33,7,40,Clouds
76869,109,1554688800,10,19,29,Clouds
76870,110,1554688800,35,5,40,Clouds
76871,111,1554688800,11,29,40,Clouds
76872,112,1554688800,7,23,30,Clouds
76873,113,1554688800,33,7,40,Clouds
76874,114,1554688800,30,10,40,Clouds
76875,115,1554688800,4,26,30,Clouds
76876,2,1554692400,10,10,20,Clouds
76877,3,1554692400,20,0,20,Clouds
76878,4,1554692400,7,13,20,Clouds
76879,5,1554692400,31,9,40,Clouds
76880,6,1554692400,15,5,20,Clouds
76881,7,1554692400,11,18,29,Clouds
76882,8,1554692400,8,22,30,Clouds
76883,9,1554692400,15,9,24,Clouds
76884,10,1554692400,12,4,16,Clouds
76885,11,1554692400,29,1,30,Clouds
76886,12,1554692400,13,7,20,Clouds
76887,13,1554692400,22,8,30,Clouds
76888,14,1554692400,24,6,30,Clouds
76889,15,1554692400,16,0,16,Clouds
76890,16,1554692400,16,4,20,Clouds
76891,17,1554692400,1,19,20,Clouds
76892,18,1554692400,8,22,30,Clouds
76893,19,1554692400,19,11,30,Clouds
76894,21,1554692400,26,4,30,Clouds
76895,22,1554692400,16,4,20,Clouds
76896,23,1554692400,28,2,30,Clouds
76897,24,1554692400,18,2,20,Clouds
76898,25,1554692400,27,3,30,Clouds
76899,26,1554692400,13,7,20,Clouds
76900,27,1554692400,20,0,20,Clouds
76901,28,1554692400,18,12,30,Clouds
76902,29,1554692400,7,22,29,Clouds
76903,30,1554692400,19,1,20,Clouds
76904,31,1554692400,19,1,20,Clouds
76905,32,1554692400,21,9,30,Clouds
76906,33,1554692400,23,0,23,Clouds
76907,34,1554692400,1,29,30,Clouds
76908,35,1554692400,0,29,29,Clouds
76909,36,1554692400,24,16,40,Clouds
76910,37,1554692400,22,8,30,Clouds
76911,38,1554692400,27,13,40,Clouds
76912,39,1554692400,13,7,20,Clouds
76913,40,1554692400,21,0,21,Clouds
76914,41,1554692400,15,5,20,Clouds
76915,42,1554692400,7,23,30,Clouds
76916,43,1554692400,10,20,30,Clouds
76917,44,1554692400,26,4,30,Clouds
76918,45,1554692400,28,2,30,Clouds
76919,46,1554692400,10,10,20,Clouds
76920,47,1554692400,37,3,40,Clouds
76921,48,1554692400,25,15,40,Clouds
76922,49,1554692400,19,21,40,Clouds
76923,50,1554692400,16,24,40,Clouds
76924,51,1554692400,16,24,40,Clouds
76925,52,1554692400,26,6,32,Clouds
76926,53,1554692400,40,0,40,Clouds
76927,54,1554692400,11,22,33,Clouds
76928,55,1554692400,27,9,36,Clouds
76929,56,1554692400,19,21,40,Clouds
76930,57,1554692400,16,7,23,Clouds
76931,58,1554692400,16,24,40,Clouds
76932,59,1554692400,17,3,20,Clouds
76933,60,1554692400,25,5,30,Clouds
76934,61,1554692400,18,7,25,Clouds
76935,62,1554692400,31,9,40,Clouds
76936,63,1554692400,17,18,35,Clouds
76937,64,1554692400,18,22,40,Clouds
76938,65,1554692400,36,4,40,Clouds
76939,66,1554692400,23,17,40,Clouds
76940,67,1554692400,31,9,40,Clouds
76941,68,1554692400,1,39,40,Clouds
76942,69,1554692400,0,40,40,Clouds
76943,70,1554692400,0,28,28,Clouds
76944,71,1554692400,13,27,40,Clouds
76945,72,1554692400,5,26,31,Clouds
76946,73,1554692400,26,4,30,Clouds
76947,74,1554692400,20,10,30,Clouds
76948,75,1554692400,36,4,40,Clouds
76949,76,1554692400,32,6,38,Clouds
76950,77,1554692400,20,9,29,Clouds
76951,78,1554692400,24,16,40,Clouds
76952,79,1554692400,25,2,27,Clouds
76953,80,1554692400,25,15,40,Clouds
76954,81,1554692400,17,23,40,Clouds
76955,82,1554692400,20,2,22,Clouds
76956,83,1554692400,38,2,40,Clouds
76957,84,1554692400,17,13,30,Clouds
76958,85,1554692400,19,16,35,Clouds
76959,86,1554692400,38,0,38,Clouds
76960,87,1554692400,25,13,38,Clouds
76961,88,1554692400,22,8,30,Clouds
76962,89,1554692400,38,2,40,Clouds
76963,90,1554692400,26,14,40,Clouds
76964,91,1554692400,1,29,30,Clouds
76965,92,1554692400,26,14,40,Clouds
76966,93,1554692400,17,23,40,Clouds
76967,94,1554692400,9,31,40,Clouds
76968,95,1554692400,29,11,40,Clouds
76969,96,1554692400,27,3,30,Clouds
76970,97,1554692400,22,18,40,Clouds
76971,98,1554692400,40,0,40,Clouds
76972,99,1554692400,21,9,30,Clouds
76973,100,1554692400,24,1,25,Clouds
76974,101,1554692400,18,12,30,Clouds
76975,102,1554692400,24,16,40,Clouds
76976,103,1554692400,28,12,40,Clouds
76977,104,1554692400,40,0,40,Clouds
76978,105,1554692400,36,0,36,Clouds
76979,106,1554692400,38,2,40,Clouds
76980,107,1554692400,33,7,40,Clouds
76981,108,1554692400,33,7,40,Clouds
76982,109,1554692400,10,19,29,Clouds
76983,110,1554692400,35,5,40,Clouds
76984,111,1554692400,11,29,40,Clouds
76985,112,1554692400,7,23,30,Clouds
76986,113,1554692400,33,7,40,Clouds
76987,114,1554692400,30,10,40,Clouds
76988,115,1554692400,4,26,30,Clouds
76989,2,1554696000,10,10,20,Clouds
76990,3,1554696000,20,0,20,Clouds
76991,4,1554696000,7,13,20,Clouds
76992,5,1554696000,31,9,40,Clouds
76993,6,1554696000,15,5,20,Clouds
76994,7,1554696000,11,18,29,Clouds
76995,8,1554696000,8,22,30,Clouds
76996,9,1554696000,15,9,24,Clouds
76997,10,1554696000,12,4,16,Clouds
76998,11,1554696000,29,1,30,Clouds
76999,12,1554696000,12,8,20,Clouds
77000,13,1554696000,22,8,30,Clouds
77001,14,1554696000,24,6,30,Clouds
77002,15,1554696000,16,0,16,Clouds
77003,16,1554696000,16,4,20,Clouds
77004,17,1554696000,1,19,20,Clouds
77005,18,1554696000,8,22,30,Clouds
77006,19,1554696000,19,11,30,Clouds
77007,21,1554696000,26,4,30,Clouds
77008,22,1554696000,16,4,20,Clouds
77009,23,1554696000,28,2,30,Clouds
77010,24,1554696000,18,2,20,Clouds
77011,25,1554696000,27,3,30,Clouds
77012,26,1554696000,13,7,20,Clouds
77013,27,1554696000,20,0,20,Clouds
77014,28,1554696000,18,12,30,Clouds
77015,29,1554696000,7,22,29,Clouds
77016,30,1554696000,19,1,20,Clouds
77017,31,1554696000,19,1,20,Clouds
77018,32,1554696000,21,9,30,Clouds
77019,33,1554696000,23,0,23,Clouds
77020,34,1554696000,1,29,30,Clouds
77021,35,1554696000,0,29,29,Clouds
77022,36,1554696000,24,16,40,Clouds
77023,37,1554696000,22,8,30,Clouds
77024,38,1554696000,27,13,40,Clouds
77025,39,1554696000,13,7,20,Clouds
77026,40,1554696000,21,0,21,Clouds
77027,41,1554696000,15,5,20,Clouds
77028,42,1554696000,7,23,30,Clouds
77029,43,1554696000,10,20,30,Clouds
77030,44,1554696000,26,4,30,Clouds
77031,45,1554696000,28,2,30,Clouds
77032,46,1554696000,10,10,20,Clouds
77033,47,1554696000,37,3,40,Clouds
77034,48,1554696000,25,15,40,Clouds
77035,49,1554696000,19,21,40,Clouds
77036,50,1554696000,16,24,40,Clouds
77037,51,1554696000,16,24,40,Clouds
77038,52,1554696000,26,6,32,Clouds
77039,53,1554696000,40,0,40,Clouds
77040,54,1554696000,11,22,33,Clouds
77041,55,1554696000,27,9,36,Clouds
77042,56,1554696000,19,21,40,Clouds
77043,57,1554696000,16,7,23,Clouds
77044,58,1554696000,16,24,40,Clouds
77045,59,1554696000,17,3,20,Clouds
77046,60,1554696000,25,5,30,Clouds
77047,61,1554696000,18,7,25,Clouds
77048,62,1554696000,31,9,40,Clouds
77049,63,1554696000,17,18,35,Clouds
77050,64,1554696000,18,22,40,Clouds
77051,65,1554696000,36,4,40,Clouds
77052,66,1554696000,23,17,40,Clouds
77053,67,1554696000,31,9,40,Clouds
77054,68,1554696000,1,39,40,Clouds
77055,69,1554696000,0,40,40,Clouds
77056,70,1554696000,0,28,28,Clouds
77057,71,1554696000,13,27,40,Clouds
77058,72,1554696000,5,26,31,Clouds
77059,73,1554696000,26,4,30,Clouds
77060,74,1554696000,20,10,30,Clouds
77061,75,1554696000,36,4,40,Clouds
77062,76,1554696000,32,6,38,Clouds
77063,77,1554696000,20,9,29,Clouds
77064,78,1554696000,24,16,40,Clouds
77065,79,1554696000,25,2,27,Clouds
77066,80,1554696000,25,15,40,Clouds
77067,81,1554696000,17,23,40,Clouds
77068,82,1554696000,20,2,22,Clouds
77069,83,1554696000,38,2,40,Clouds
77070,84,1554696000,17,13,30,Clouds
77071,85,1554696000,19,16,35,Clouds
77072,86,1554696000,38,0,38,Clouds
77073,87,1554696000,25,13,38,Clouds
77074,88,1554696000,22,8,30,Clouds
77075,89,1554696000,38,2,40,Clouds
77076,90,1554696000,26,14,40,Clouds
77077,91,1554696000,1,29,30,Clouds
77078,92,1554696000,26,14,40,Clouds
77079,93,1554696000,17,23,40,Clouds
77080,94,1554696000,9,31,40,Clouds
77081,95,1554696000,29,11,40,Clouds
77082,96,1554696000,27,3,30,Clouds
77083,97,1554696000,22,18,40,Clouds
77084,98,1554696000,40,0,40,Clouds
77085,99,1554696000,21,9,30,Clouds
77086,100,1554696000,24,1,25,Clouds
77087,101,1554696000,18,12,30,Clouds
77088,102,1554696000,24,16,40,Clouds
77089,103,1554696000,28,12,40,Clouds
77090,104,1554696000,40,0,40,Clouds
77091,105,1554696000,36,0,36,Clouds
77092,106,1554696000,38,2,40,Clouds
77093,107,1554696000,33,7,40,Clouds
77094,108,1554696000,33,7,40,Clouds
77095,109,1554696000,10,19,29,Clouds
77096,110,1554696000,35,5,40,Clouds
77097,111,1554696000,11,29,40,Clouds
77098,112,1554696000,7,23,30,Clouds
77099,113,1554696000,33,7,40,Clouds
77100,114,1554696000,30,10,40,Clouds
77101,115,1554696000,4,26,30,Clouds
77102,2,1554699600,10,10,20,Mist
77103,3,1554699600,20,0,20,Mist
77104,4,1554699600,7,13,20,Mist
77105,5,1554699600,31,9,40,Mist
77106,6,1554699600,15,5,20,Mist
77107,7,1554699600,11,18,29,Mist
77108,8,1554699600,8,22,30,Mist
77109,9,1554699600,15,9,24,Mist
77110,10,1554699600,12,4,16,Mist
77111,11,1554699600,29,1,30,Mist
77112,12,1554699600,12,8,20,Mist
77113,13,1554699600,22,8,30,Mist
77114,14,1554699600,24,6,30,Mist
77115,15,1554699600,16,0,16,Mist
77116,16,1554699600,16,4,20,Mist
77117,17,1554699600,1,19,20,Mist
77118,18,1554699600,8,22,30,Mist
77119,19,1554699600,19,11,30,Mist
77120,21,1554699600,26,4,30,Mist
77121,22,1554699600,16,4,20,Mist
77122,23,1554699600,28,2,30,Mist
77123,24,1554699600,18,2,20,Mist
77124,25,1554699600,27,3,30,Mist
77125,26,1554699600,13,7,20,Mist
77126,27,1554699600,20,0,20,Mist
77127,28,1554699600,18,12,30,Mist
77128,29,1554699600,7,22,29,Mist
77129,30,1554699600,19,1,20,Mist
77130,31,1554699600,19,1,20,Mist
77131,32,1554699600,21,9,30,Mist
77132,33,1554699600,23,0,23,Mist
77133,34,1554699600,1,29,30,Mist
77134,35,1554699600,0,29,29,Mist
77135,36,1554699600,24,16,40,Mist
77136,37,1554699600,22,8,30,Mist
77137,38,1554699600,27,13,40,Mist
77138,39,1554699600,13,7,20,Mist
77139,40,1554699600,21,0,21,Mist
77140,41,1554699600,15,5,20,Mist
77141,42,1554699600,7,23,30,Mist
77142,43,1554699600,10,20,30,Mist
77143,44,1554699600,26,4,30,Mist
77144,45,1554699600,28,2,30,Mist
77145,46,1554699600,10,10,20,Mist
77146,47,1554699600,37,3,40,Mist
77147,48,1554699600,25,15,40,Mist
77148,49,1554699600,19,21,40,Mist
77149,50,1554699600,16,24,40,Mist
77150,51,1554699600,16,24,40,Mist
77151,52,1554699600,26,6,32,Mist
77152,53,1554699600,40,0,40,Mist
77153,54,1554699600,11,22,33,Mist
77154,55,1554699600,27,9,36,Mist
77155,56,1554699600,19,21,40,Mist
77156,57,1554699600,16,7,23,Mist
77157,58,1554699600,16,24,40,Mist
77158,59,1554699600,17,3,20,Mist
77159,60,1554699600,25,5,30,Mist
77160,61,1554699600,18,7,25,Mist
77161,62,1554699600,31,9,40,Mist
77162,63,1554699600,17,18,35,Mist
77163,64,1554699600,18,22,40,Mist
77164,65,1554699600,36,4,40,Mist
77165,66,1554699600,23,17,40,Mist
77166,67,1554699600,31,9,40,Mist
77167,68,1554699600,1,39,40,Mist
77168,69,1554699600,0,40,40,Mist
77169,70,1554699600,0,28,28,Mist
77170,71,1554699600,13,27,40,Mist
77171,72,1554699600,5,26,31,Mist
77172,73,1554699600,26,4,30,Mist
77173,74,1554699600,20,10,30,Mist
77174,75,1554699600,36,4,40,Mist
77175,76,1554699600,32,6,38,Mist
77176,77,1554699600,20,9,29,Mist
77177,78,1554699600,24,16,40,Mist
77178,79,1554699600,25,2,27,Mist
77179,80,1554699600,25,15,40,Mist
77180,81,1554699600,17,23,40,Mist
77181,82,1554699600,20,2,22,Mist
77182,83,1554699600,38,2,40,Mist
77183,84,1554699600,17,13,30,Mist
77184,85,1554699600,19,16,35,Mist
77185,86,1554699600,38,0,38,Mist
77186,87,1554699600,25,13,38,Mist
77187,88,1554699600,22,8,30,Mist
77188,89,1554699600,38,2,40,Mist
77189,90,1554699600,26,14,40,Mist
77190,91,1554699600,1,29,30,Mist
77191,92,1554699600,26,14,40,Mist
77192,93,1554699600,17,23,40,Mist
77193,94,1554699600,9,31,40,Mist
77194,95,1554699600,29,11,40,Mist
77195,96,1554699600,27,3,30,Mist
77196,97,1554699600,22,18,40,Mist
77197,98,1554699600,40,0,40,Mist
77198,99,1554699600,21,9,30,Mist
77199,100,1554699600,24,1,25,Mist
77200,101,1554699600,18,12,30,Mist
77201,102,1554699600,24,16,40,Mist
77202,103,1554699600,28,12,40,Mist
77203,104,1554699600,40,0,40,Mist
77204,105,1554699600,36,0,36,Mist
77205,106,1554699600,38,2,40,Mist
77206,107,1554699600,33,7,40,Mist
77207,108,1554699600,33,7,40,Mist
77208,109,1554699600,10,19,29,Mist
77209,110,1554699600,35,5,40,Mist
77210,111,1554699600,11,29,40,Mist
77211,112,1554699600,7,23,30,Mist
77212,113,1554699600,33,7,40,Mist
77213,114,1554699600,30,10,40,Mist
77214,115,1554699600,4,26,30,Mist
77215,2,1554703200,10,10,20,Mist
77216,3,1554703200,20,0,20,Mist
77217,4,1554703200,8,12,20,Mist
77218,5,1554703200,32,8,40,Mist
77219,6,1554703200,15,5,20,Mist
77220,7,1554703200,12,17,29,Mist
77221,8,1554703200,4,26,30,Mist
77222,9,1554703200,11,13,24,Mist
77223,10,1554703200,12,4,16,Mist
77224,11,1554703200,28,2,30,Mist
77225,12,1554703200,14,6,20,Mist
77226,13,1554703200,22,8,30,Mist
77227,14,1554703200,18,12,30,Mist
77228,15,1554703200,16,0,16,Mist
77229,16,1554703200,16,4,20,Mist
77230,17,1554703200,0,20,20,Mist
77231,18,1554703200,11,19,30,Mist
77232,19,1554703200,18,12,30,Mist
77233,21,1554703200,25,5,30,Mist
77234,22,1554703200,15,5,20,Mist
77235,23,1554703200,28,2,30,Mist
77236,24,1554703200,18,1,19,Mist
77237,25,1554703200,27,3,30,Mist
77238,26,1554703200,13,7,20,Mist
77239,27,1554703200,19,1,20,Mist
77240,28,1554703200,19,11,30,Mist
77241,29,1554703200,24,5,29,Mist
77242,30,1554703200,19,1,20,Mist
77243,31,1554703200,18,2,20,Mist
77244,32,1554703200,17,13,30,Mist
77245,33,1554703200,17,6,23,Mist
77246,34,1554703200,5,25,30,Mist
77247,35,1554703200,4,26,30,Mist
77248,36,1554703200,20,20,40,Mist
77249,37,1554703200,21,9,30,Mist
77250,38,1554703200,29,11,40,Mist
77251,39,1554703200,14,6,20,Mist
77252,40,1554703200,19,2,21,Mist
77253,41,1554703200,15,5,20,Mist
77254,42,1554703200,8,22,30,Mist
77255,43,1554703200,14,16,30,Mist
77256,44,1554703200,30,0,30,Mist
77257,45,1554703200,28,2,30,Mist
77258,46,1554703200,10,10,20,Mist
77259,47,1554703200,37,3,40,Mist
77260,48,1554703200,24,16,40,Mist
77261,49,1554703200,16,24,40,Mist
77262,50,1554703200,17,23,40,Mist
77263,51,1554703200,31,9,40,Mist
77264,52,1554703200,22,10,32,Mist
77265,53,1554703200,40,0,40,Mist
77266,54,1554703200,10,23,33,Mist
77267,55,1554703200,27,9,36,Mist
77268,56,1554703200,22,18,40,Mist
77269,57,1554703200,16,7,23,Mist
77270,58,1554703200,8,32,40,Mist
77271,59,1554703200,17,3,20,Mist
77272,60,1554703200,30,0,30,Mist
77273,61,1554703200,21,4,25,Mist
77274,62,1554703200,28,12,40,Mist
77275,63,1554703200,16,19,35,Mist
77276,64,1554703200,36,4,40,Mist
77277,65,1554703200,37,3,40,Mist
77278,66,1554703200,22,18,40,Mist
77279,67,1554703200,33,7,40,Mist
77280,68,1554703200,2,38,40,Mist
77281,69,1554703200,0,40,40,Mist
77282,70,1554703200,0,28,28,Mist
77283,71,1554703200,12,28,40,Mist
77284,72,1554703200,6,25,31,Mist
77285,73,1554703200,26,4,30,Mist
77286,74,1554703200,20,10,30,Mist
77287,75,1554703200,38,2,40,Mist
77288,76,1554703200,33,5,38,Mist
77289,77,1554703200,19,10,29,Mist
77290,78,1554703200,24,16,40,Mist
77291,79,1554703200,25,2,27,Mist
77292,80,1554703200,26,14,40,Mist
77293,81,1554703200,17,23,40,Mist
77294,82,1554703200,20,2,22,Mist
77295,83,1554703200,40,0,40,Mist
77296,84,1554703200,18,12,30,Mist
77297,85,1554703200,19,16,35,Mist
77298,86,1554703200,38,0,38,Mist
77299,87,1554703200,27,11,38,Mist
77300,88,1554703200,22,8,30,Mist
77301,89,1554703200,38,2,40,Mist
77302,90,1554703200,23,17,40,Mist
77303,91,1554703200,3,27,30,Mist
77304,92,1554703200,9,31,40,Mist
77305,93,1554703200,17,23,40,Mist
77306,94,1554703200,9,31,40,Mist
77307,95,1554703200,29,11,40,Mist
77308,96,1554703200,27,3,30,Mist
77309,97,1554703200,23,17,40,Mist
77310,98,1554703200,40,0,40,Mist
77311,99,1554703200,21,9,30,Mist
77312,100,1554703200,6,19,25,Mist
77313,101,1554703200,24,6,30,Mist
77314,102,1554703200,26,14,40,Mist
77315,103,1554703200,29,11,40,Mist
77316,104,1554703200,40,0,40,Mist
77317,105,1554703200,36,0,36,Mist
77318,106,1554703200,38,2,40,Mist
77319,107,1554703200,40,0,40,Mist
77320,108,1554703200,35,5,40,Mist
77321,109,1554703200,15,14,29,Mist
77322,110,1554703200,34,6,40,Mist
77323,111,1554703200,15,25,40,Mist
77324,112,1554703200,10,20,30,Mist
77325,113,1554703200,31,9,40,Mist
77326,114,1554703200,28,12,40,Mist
77327,115,1554703200,6,24,30,Mist
77328,2,1554706800,19,1,20,Mist
77329,3,1554706800,19,1,20,Mist
77330,4,1554706800,10,10,20,Mist
77331,5,1554706800,28,12,40,Mist
77332,6,1554706800,17,3,20,Mist
77333,7,1554706800,14,15,29,Mist
77334,8,1554706800,0,30,30,Mist
77335,9,1554706800,3,21,24,Mist
77336,10,1554706800,11,5,16,Mist
77337,11,1554706800,26,4,30,Mist
77338,12,1554706800,19,1,20,Mist
77339,13,1554706800,22,8,30,Mist
77340,14,1554706800,11,19,30,Mist
77341,15,1554706800,16,0,16,Mist
77342,16,1554706800,16,4,20,Mist
77343,17,1554706800,17,3,20,Mist
77344,18,1554706800,9,21,30,Mist
77345,19,1554706800,11,19,30,Mist
77346,21,1554706800,25,5,30,Mist
77347,22,1554706800,16,4,20,Mist
77348,23,1554706800,25,5,30,Mist
77349,24,1554706800,20,0,20,Mist
77350,25,1554706800,23,7,30,Mist
77351,26,1554706800,12,8,20,Mist
77352,27,1554706800,15,5,20,Mist
77353,28,1554706800,30,0,30,Mist
77354,29,1554706800,18,11,29,Mist
77355,30,1554706800,18,2,20,Mist
77356,31,1554706800,17,3,20,Mist
77357,32,1554706800,15,15,30,Mist
77358,33,1554706800,11,12,23,Mist
77359,34,1554706800,30,0,30,Mist
77360,35,1554706800,7,23,30,Mist
77361,36,1554706800,18,22,40,Mist
77362,37,1554706800,20,10,30,Mist
77363,38,1554706800,33,7,40,Mist
77364,39,1554706800,15,5,20,Mist
77365,40,1554706800,16,5,21,Mist
77366,41,1554706800,17,3,20,Mist
77367,42,1554706800,13,17,30,Mist
77368,43,1554706800,27,3,30,Mist
77369,44,1554706800,30,0,30,Mist
77370,45,1554706800,30,0,30,Mist
77371,46,1554706800,8,12,20,Mist
77372,47,1554706800,35,5,40,Mist
77373,48,1554706800,24,16,40,Mist
77374,49,1554706800,18,22,40,Mist
77375,50,1554706800,24,16,40,Mist
77376,51,1554706800,29,11,40,Mist
77377,52,1554706800,20,12,32,Mist
77378,53,1554706800,38,2,40,Mist
77379,54,1554706800,10,23,33,Mist
77380,55,1554706800,21,15,36,Mist
77381,56,1554706800,22,18,40,Mist
77382,57,1554706800,15,8,23,Mist
77383,58,1554706800,14,26,40,Mist
77384,59,1554706800,18,2,20,Mist
77385,60,1554706800,24,6,30,Mist
77386,61,1554706800,25,0,25,Mist
77387,62,1554706800,18,22,40,Mist
77388,63,1554706800,15,20,35,Mist
77389,64,1554706800,32,8,40,Mist
77390,65,1554706800,32,8,40,Mist
77391,66,1554706800,8,32,40,Mist
77392,67,1554706800,27,13,40,Mist
77393,68,1554706800,16,24,40,Mist
77394,69,1554706800,1,39,40,Mist
77395,70,1554706800,7,21,28,Mist
77396,71,1554706800,12,28,40,Mist
77397,72,1554706800,11,20,31,Mist
77398,73,1554706800,29,1,30,Mist
77399,74,1554706800,24,6,30,Mist
77400,75,1554706800,35,5,40,Mist
77401,76,1554706800,38,0,38,Mist
77402,77,1554706800,23,6,29,Mist
77403,78,1554706800,31,9,40,Mist
77404,79,1554706800,25,2,27,Mist
77405,80,1554706800,27,13,40,Mist
77406,81,1554706800,15,25,40,Mist
77407,82,1554706800,22,0,22,Mist
77408,83,1554706800,40,0,40,Mist
77409,84,1554706800,16,14,30,Mist
77410,85,1554706800,26,9,35,Mist
77411,86,1554706800,27,11,38,Mist
77412,87,1554706800,30,8,38,Mist
77413,88,1554706800,30,0,30,Mist
77414,89,1554706800,37,3,40,Mist
77415,90,1554706800,13,27,40,Mist
77416,91,1554706800,0,30,30,Mist
77417,92,1554706800,12,28,40,Mist
77418,93,1554706800,7,33,40,Mist
77419,94,1554706800,10,30,40,Mist
77420,95,1554706800,37,3,40,Mist
77421,96,1554706800,28,2,30,Mist
77422,97,1554706800,30,10,40,Mist
77423,98,1554706800,40,0,40,Mist
77424,99,1554706800,17,13,30,Mist
77425,100,1554706800,13,12,25,Mist
77426,101,1554706800,29,1,30,Mist
77427,102,1554706800,27,13,40,Mist
77428,103,1554706800,29,11,40,Mist
77429,104,1554706800,40,0,40,Mist
77430,105,1554706800,35,1,36,Mist
77431,106,1554706800,40,0,40,Mist
77432,107,1554706800,40,0,40,Mist
77433,108,1554706800,40,0,40,Mist
77434,109,1554706800,18,11,29,Mist
77435,110,1554706800,38,2,40,Mist
77436,111,1554706800,26,14,40,Mist
77437,112,1554706800,20,10,30,Mist
77438,113,1554706800,28,12,40,Mist
77439,114,1554706800,22,18,40,Mist
77440,115,1554706800,8,22,30,Mist
77441,2,1554710400,20,0,20,Mist
77442,3,1554710400,20,0,20,Mist
77443,4,1554710400,11,9,20,Mist
77444,5,1554710400,38,2,40,Mist
77445,6,1554710400,18,2,20,Mist
77446,7,1554710400,27,2,29,Mist
77447,8,1554710400,11,19,30,Mist
77448,9,1554710400,7,17,24,Mist
77449,10,1554710400,7,9,16,Mist
77450,11,1554710400,19,11,30,Mist
77451,12,1554710400,20,0,20,Mist
77452,13,1554710400,15,15,30,Mist
77453,14,1554710400,6,23,29,Mist
77454,15,1554710400,16,0,16,Mist
77455,16,1554710400,15,5,20,Mist
77456,17,1554710400,17,3,20,Mist
77457,18,1554710400,14,16,30,Mist
77458,19,1554710400,16,14,30,Mist
77459,21,1554710400,24,4,28,Mist
77460,22,1554710400,15,4,19,Mist
77461,23,1554710400,28,2,30,Mist
77462,24,1554710400,20,0,20,Mist
77463,25,1554710400,10,20,30,Mist
77464,26,1554710400,12,8,20,Mist
77465,27,1554710400,12,8,20,Mist
77466,28,1554710400,26,4,30,Mist
77467,29,1554710400,16,13,29,Mist
77468,30,1554710400,18,2,20,Mist
77469,31,1554710400,18,2,20,Mist
77470,32,1554710400,6,24,30,Mist
77471,33,1554710400,12,11,23,Mist
77472,34,1554710400,29,1,30,Mist
77473,35,1554710400,24,6,30,Mist
77474,36,1554710400,11,29,40,Mist
77475,37,1554710400,18,12,30,Mist
77476,38,1554710400,36,4,40,Mist
77477,39,1554710400,17,3,20,Mist
77478,40,1554710400,8,13,21,Mist
77479,41,1554710400,19,1,20,Mist
77480,42,1554710400,30,0,30,Mist
77481,43,1554710400,29,1,30,Mist
77482,44,1554710400,29,1,30,Mist
77483,45,1554710400,30,0,30,Mist
77484,46,1554710400,9,11,20,Mist
77485,47,1554710400,30,10,40,Mist
77486,48,1554710400,23,17,40,Mist
77487,49,1554710400,32,8,40,Mist
77488,50,1554710400,35,5,40,Mist
77489,51,1554710400,21,19,40,Mist
77490,52,1554710400,17,15,32,Mist
77491,53,1554710400,29,11,40,Mist
77492,54,1554710400,9,24,33,Mist
77493,55,1554710400,19,16,35,Mist
77494,56,1554710400,9,30,39,Mist
77495,57,1554710400,14,9,23,Mist
77496,58,1554710400,1,37,38,Mist
77497,59,1554710400,20,0,20,Mist
77498,60,1554710400,30,0,30,Mist
77499,61,1554710400,25,0,25,Mist
77500,62,1554710400,18,22,40,Mist
77501,63,1554710400,9,26,35,Mist
77502,64,1554710400,28,11,39,Mist
77503,65,1554710400,31,9,40,Mist
77504,66,1554710400,0,38,38,Mist
77505,67,1554710400,23,16,39,Mist
77506,68,1554710400,1,39,40,Mist
77507,69,1554710400,0,40,40,Mist
77508,70,1554710400,1,25,26,Mist
77509,71,1554710400,14,26,40,Mist
77510,72,1554710400,29,1,30,Mist
77511,73,1554710400,30,0,30,Mist
77512,74,1554710400,30,0,30,Mist
77513,75,1554710400,39,1,40,Mist
77514,76,1554710400,37,1,38,Mist
77515,77,1554710400,24,5,29,Mist
77516,78,1554710400,39,1,40,Mist
77517,79,1554710400,25,2,27,Mist
77518,80,1554710400,39,1,40,Mist
77519,81,1554710400,15,25,40,Mist
77520,82,1554710400,21,1,22,Mist
77521,83,1554710400,40,0,40,Mist
77522,84,1554710400,30,0,30,Mist
77523,85,1554710400,35,0,35,Mist
77524,86,1554710400,35,3,38,Mist
77525,87,1554710400,32,6,38,Mist
77526,88,1554710400,29,1,30,Mist
77527,89,1554710400,30,10,40,Mist
77528,90,1554710400,0,40,40,Mist
77529,91,1554710400,1,27,28,Mist
77530,92,1554710400,30,10,40,Mist
77531,93,1554710400,40,0,40,Mist
77532,94,1554710400,23,17,40,Mist
77533,95,1554710400,40,0,40,Mist
77534,96,1554710400,30,0,30,Mist
77535,97,1554710400,40,0,40,Mist
77536,98,1554710400,38,2,40,Mist
77537,99,1554710400,20,10,30,Mist
77538,100,1554710400,25,0,25,Mist
77539,101,1554710400,29,0,29,Mist
77540,102,1554710400,35,5,40,Mist
77541,103,1554710400,30,10,40,Mist
77542,104,1554710400,40,0,40,Mist
77543,105,1554710400,36,0,36,Mist
77544,106,1554710400,40,0,40,Mist
77545,107,1554710400,40,0,40,Mist
77546,108,1554710400,40,0,40,Mist
77547,109,1554710400,27,2,29,Mist
77548,110,1554710400,40,0,40,Mist
77549,111,1554710400,39,1,40,Mist
77550,112,1554710400,30,0,30,Mist
77551,113,1554710400,24,15,39,Mist
77552,114,1554710400,15,25,40,Mist
77553,115,1554710400,13,17,30,Mist
77554,2,1554714000,20,0,20,Mist
77555,3,1554714000,17,3,20,Mist
77556,4,1554714000,18,2,20,Mist
77557,5,1554714000,40,0,40,Mist
77558,6,1554714000,18,2,20,Mist
77559,7,1554714000,29,0,29,Mist
77560,8,1554714000,10,20,30,Mist
77561,9,1554714000,11,12,23,Mist
77562,10,1554714000,16,0,16,Mist
77563,11,1554714000,6,24,30,Mist
77564,12,1554714000,20,0,20,Mist
77565,13,1554714000,5,25,30,Mist
77566,14,1554714000,24,5,29,Mist
77567,15,1554714000,16,0,16,Mist
77568,16,1554714000,19,1,20,Mist
77569,17,1554714000,18,2,20,Mist
77570,18,1554714000,30,0,30,Mist
77571,19,1554714000,0,30,30,Mist
77572,21,1554714000,11,17,28,Mist
77573,22,1554714000,18,1,19,Mist
77574,23,1554714000,29,1,30,Mist
77575,24,1554714000,20,0,20,Mist
77576,25,1554714000,1,29,30,Mist
77577,26,1554714000,6,14,20,Mist
77578,27,1554714000,19,1,20,Mist
77579,28,1554714000,30,0,30,Mist
77580,29,1554714000,29,0,29,Mist
77581,30,1554714000,20,0,20,Mist
77582,31,1554714000,20,0,20,Mist
77583,32,1554714000,7,23,30,Mist
77584,33,1554714000,22,1,23,Mist
77585,34,1554714000,30,0,30,Mist
77586,35,1554714000,28,1,29,Mist
77587,36,1554714000,0,40,40,Mist
77588,37,1554714000,11,18,29,Mist
77589,38,1554714000,39,1,40,Mist
77590,39,1554714000,17,3,20,Mist
77591,40,1554714000,19,2,21,Mist
77592,41,1554714000,20,0,20,Mist
77593,42,1554714000,30,0,30,Mist
77594,43,1554714000,30,0,30,Mist
77595,44,1554714000,30,0,30,Mist
77596,45,1554714000,30,0,30,Mist
77597,46,1554714000,17,3,20,Mist
77598,47,1554714000,0,40,40,Mist
77599,48,1554714000,0,40,40,Mist
77600,49,1554714000,11,27,38,Mist
77601,50,1554714000,40,0,40,Mist
77602,51,1554714000,32,8,40,Mist
77603,52,1554714000,18,14,32,Mist
77604,53,1554714000,23,17,40,Mist
77605,54,1554714000,8,25,33,Mist
77606,55,1554714000,27,6,33,Mist
77607,56,1554714000,0,38,38,Mist
77608,57,1554714000,0,23,23,Mist
77609,58,1554714000,0,38,38,Mist
77610,59,1554714000,20,0,20,Mist
77611,60,1554714000,30,0,30,Mist
77612,61,1554714000,25,0,25,Mist
77613,62,1554714000,0,40,40,Mist
77614,63,1554714000,0,35,35,Mist
77615,64,1554714000,16,23,39,Mist
77616,65,1554714000,23,17,40,Mist
77617,66,1554714000,10,28,38,Mist
77618,67,1554714000,23,16,39,Mist
77619,68,1554714000,0,39,39,Mist
77620,69,1554714000,0,39,39,Mist
77621,70,1554714000,0,25,25,Mist
77622,71,1554714000,34,6,40,Mist
77623,72,1554714000,29,1,30,Mist
77624,73,1554714000,30,0,30,Mist
77625,74,1554714000,30,0,30,Mist
77626,75,1554714000,40,0,40,Mist
77627,76,1554714000,38,0,38,Mist
77628,77,1554714000,28,1,29,Mist
77629,78,1554714000,39,1,40,Mist
77630,79,1554714000,26,1,27,Mist
77631,80,1554714000,39,1,40,Mist
77632,81,1554714000,40,0,40,Mist
77633,82,1554714000,22,0,22,Mist
77634,83,1554714000,40,0,40,Mist
77635,84,1554714000,30,0,30,Mist
77636,85,1554714000,35,0,35,Mist
77637,86,1554714000,37,1,38,Mist
77638,87,1554714000,38,0,38,Mist
77639,88,1554714000,30,0,30,Mist
77640,89,1554714000,30,10,40,Mist
77641,90,1554714000,1,39,40,Mist
77642,91,1554714000,6,22,28,Mist
77643,92,1554714000,39,1,40,Mist
77644,93,1554714000,40,0,40,Mist
77645,94,1554714000,40,0,40,Mist
77646,95,1554714000,40,0,40,Mist
77647,96,1554714000,30,0,30,Mist
77648,97,1554714000,40,0,40,Mist
77649,98,1554714000,40,0,40,Mist
77650,99,1554714000,13,17,30,Mist
77651,100,1554714000,25,0,25,Mist
77652,101,1554714000,27,2,29,Mist
77653,102,1554714000,40,0,40,Mist
77654,103,1554714000,40,0,40,Mist
77655,104,1554714000,40,0,40,Mist
77656,105,1554714000,36,0,36,Mist
77657,106,1554714000,40,0,40,Mist
77658,107,1554714000,40,0,40,Mist
77659,108,1554714000,40,0,40,Mist
77660,109,1554714000,29,0,29,Mist
77661,110,1554714000,40,0,40,Mist
77662,111,1554714000,39,1,40,Mist
77663,112,1554714000,30,0,30,Mist
77664,113,1554714000,15,24,39,Mist
77665,114,1554714000,1,38,39,Mist
77666,115,1554714000,30,0,30,Mist
77667,2,1554717600,19,1,20,Mist
77668,3,1554717600,19,1,20,Mist
77669,4,1554717600,16,4,20,Mist
77670,5,1554717600,28,12,40,Mist
77671,6,1554717600,17,3,20,Mist
77672,7,1554717600,29,0,29,Mist
77673,8,1554717600,2,27,29,Mist
77674,9,1554717600,20,3,23,Mist
77675,10,1554717600,12,4,16,Mist
77676,11,1554717600,0,30,30,Mist
77677,12,1554717600,20,0,20,Mist
77678,13,1554717600,3,27,30,Mist
77679,14,1554717600,25,4,29,Mist
77680,15,1554717600,16,0,16,Mist
77681,16,1554717600,19,1,20,Mist
77682,17,1554717600,19,1,20,Mist
77683,18,1554717600,28,2,30,Mist
77684,19,1554717600,0,30,30,Mist
77685,21,1554717600,15,13,28,Mist
77686,22,1554717600,15,4,19,Mist
77687,23,1554717600,28,2,30,Mist
77688,24,1554717600,19,1,20,Mist
77689,25,1554717600,0,30,30,Mist
77690,26,1554717600,2,18,20,Mist
77691,27,1554717600,17,3,20,Mist
77692,28,1554717600,27,3,30,Mist
77693,29,1554717600,25,4,29,Mist
77694,30,1554717600,20,0,20,Mist
77695,31,1554717600,19,1,20,Mist
77696,32,1554717600,3,27,30,Mist
77697,33,1554717600,22,1,23,Mist
77698,34,1554717600,30,0,30,Mist
77699,35,1554717600,28,1,29,Mist
77700,36,1554717600,2,38,40,Mist
77701,37,1554717600,14,15,29,Mist
77702,38,1554717600,39,1,40,Mist
77703,39,1554717600,10,10,20,Mist
77704,40,1554717600,19,2,21,Mist
77705,41,1554717600,10,9,19,Mist
77706,42,1554717600,29,1,30,Mist
77707,43,1554717600,30,0,30,Mist
77708,44,1554717600,30,0,30,Mist
77709,45,1554717600,29,1,30,Mist
77710,46,1554717600,14,6,20,Mist
77711,47,1554717600,8,32,40,Mist
77712,48,1554717600,1,39,40,Mist
77713,49,1554717600,8,30,38,Mist
77714,50,1554717600,40,0,40,Mist
77715,51,1554717600,32,8,40,Mist
77716,52,1554717600,13,19,32,Mist
77717,53,1554717600,16,24,40,Mist
77718,54,1554717600,5,28,33,Mist
77719,55,1554717600,15,18,33,Mist
77720,56,1554717600,11,29,40,Mist
77721,57,1554717600,0,23,23,Mist
77722,58,1554717600,1,37,38,Mist
77723,59,1554717600,19,1,20,Mist
77724,60,1554717600,13,17,30,Mist
77725,61,1554717600,24,1,25,Mist
77726,62,1554717600,5,35,40,Mist
77727,63,1554717600,0,35,35,Mist
77728,64,1554717600,6,33,39,Mist
77729,65,1554717600,15,25,40,Mist
77730,66,1554717600,11,27,38,Mist
77731,67,1554717600,22,17,39,Mist
77732,68,1554717600,9,30,39,Mist
77733,69,1554717600,0,39,39,Mist
77734,70,1554717600,2,23,25,Mist
77735,71,1554717600,36,4,40,Mist
77736,72,1554717600,29,1,30,Mist
77737,73,1554717600,30,0,30,Mist
77738,74,1554717600,30,0,30,Mist
77739,75,1554717600,40,0,40,Mist
77740,76,1554717600,38,0,38,Mist
77741,77,1554717600,28,1,29,Mist
77742,78,1554717600,40,0,40,Mist
77743,79,1554717600,10,17,27,Mist
77744,80,1554717600,40,0,40,Mist
77745,81,1554717600,40,0,40,Mist
77746,82,1554717600,22,0,22,Mist
77747,83,1554717600,40,0,40,Mist
77748,84,1554717600,30,0,30,Mist
77749,85,1554717600,35,0,35,Mist
77750,86,1554717600,38,0,38,Mist
77751,87,1554717600,38,0,38,Mist
77752,88,1554717600,30,0,30,Mist
77753,89,1554717600,7,32,39,Mist
77754,90,1554717600,0,40,40,Mist
77755,91,1554717600,5,23,28,Mist
77756,92,1554717600,40,0,40,Mist
77757,93,1554717600,40,0,40,Mist
77758,94,1554717600,40,0,40,Mist
77759,95,1554717600,40,0,40,Mist
77760,96,1554717600,30,0,30,Mist
77761,97,1554717600,40,0,40,Mist
77762,98,1554717600,39,1,40,Mist
77763,99,1554717600,5,25,30,Mist
77764,100,1554717600,25,0,25,Mist
77765,101,1554717600,29,0,29,Mist
77766,102,1554717600,40,0,40,Mist
77767,103,1554717600,40,0,40,Mist
77768,104,1554717600,40,0,40,Mist
77769,105,1554717600,36,0,36,Mist
77770,106,1554717600,40,0,40,Mist
77771,107,1554717600,40,0,40,Mist
77772,108,1554717600,40,0,40,Mist
77773,109,1554717600,29,0,29,Mist
77774,110,1554717600,40,0,40,Mist
77775,111,1554717600,39,1,40,Mist
77776,112,1554717600,27,3,30,Mist
77777,113,1554717600,0,39,39,Mist
77778,114,1554717600,0,39,39,Mist
77779,115,1554717600,18,12,30,Mist
77780,2,1554721200,19,1,20,Rain
77781,3,1554721200,18,2,20,Rain
77782,4,1554721200,18,2,20,Rain
77783,5,1554721200,34,6,40,Rain
77784,6,1554721200,20,0,20,Rain
77785,7,1554721200,29,0,29,Rain
77786,8,1554721200,0,29,29,Rain
77787,9,1554721200,20,4,24,Rain
77788,10,1554721200,12,4,16,Rain
77789,11,1554721200,6,24,30,Rain
77790,12,1554721200,10,10,20,Rain
77791,13,1554721200,1,29,30,Rain
77792,14,1554721200,21,8,29,Rain
77793,15,1554721200,16,0,16,Rain
77794,16,1554721200,15,5,20,Rain
77795,17,1554721200,16,4,20,Rain
77796,18,1554721200,30,0,30,Rain
77797,19,1554721200,0,30,30,Rain
77798,21,1554721200,10,18,28,Rain
77799,22,1554721200,18,1,19,Rain
77800,23,1554721200,28,2,30,Rain
77801,24,1554721200,17,3,20,Rain
77802,25,1554721200,0,30,30,Rain
77803,26,1554721200,3,17,20,Rain
77804,27,1554721200,18,2,20,Rain
77805,28,1554721200,30,0,30,Rain
77806,29,1554721200,29,0,29,Rain
77807,30,1554721200,20,0,20,Rain
77808,31,1554721200,15,5,20,Rain
77809,32,1554721200,1,29,30,Rain
77810,33,1554721200,23,0,23,Rain
77811,34,1554721200,18,12,30,Rain
77812,35,1554721200,30,0,30,Rain
77813,36,1554721200,1,39,40,Rain
77814,37,1554721200,17,13,30,Rain
77815,38,1554721200,37,3,40,Rain
77816,39,1554721200,9,11,20,Rain
77817,40,1554721200,18,3,21,Rain
77818,41,1554721200,14,5,19,Rain
77819,42,1554721200,28,2,30,Rain
77820,43,1554721200,13,17,30,Rain
77821,44,1554721200,30,0,30,Rain
77822,45,1554721200,30,0,30,Rain
77823,46,1554721200,19,1,20,Rain
77824,47,1554721200,5,35,40,Rain
77825,48,1554721200,0,40,40,Rain
77826,49,1554721200,2,36,38,Rain
77827,50,1554721200,39,1,40,Rain
77828,51,1554721200,33,7,40,Rain
77829,52,1554721200,12,20,32,Rain
77830,53,1554721200,14,26,40,Rain
77831,54,1554721200,8,25,33,Rain
77832,55,1554721200,18,18,36,Rain
77833,56,1554721200,6,34,40,Rain
77834,57,1554721200,0,23,23,Rain
77835,58,1554721200,1,37,38,Rain
77836,59,1554721200,20,0,20,Rain
77837,60,1554721200,21,9,30,Rain
77838,61,1554721200,25,0,25,Rain
77839,62,1554721200,4,36,40,Rain
77840,63,1554721200,0,35,35,Rain
77841,64,1554721200,5,34,39,Rain
77842,65,1554721200,16,24,40,Rain
77843,66,1554721200,12,26,38,Rain
77844,67,1554721200,29,10,39,Rain
77845,68,1554721200,19,20,39,Rain
77846,69,1554721200,2,37,39,Rain
77847,70,1554721200,4,21,25,Rain
77848,71,1554721200,38,2,40,Rain
77849,72,1554721200,30,0,30,Rain
77850,73,1554721200,28,2,30,Rain
77851,74,1554721200,30,0,30,Rain
77852,75,1554721200,40,0,40,Rain
77853,76,1554721200,35,3,38,Rain
77854,77,1554721200,28,1,29,Rain
77855,78,1554721200,30,10,40,Rain
77856,79,1554721200,17,10,27,Rain
77857,80,1554721200,39,1,40,Rain
77858,81,1554721200,40,0,40,Rain
77859,82,1554721200,22,0,22,Rain
77860,83,1554721200,39,1,40,Rain
77861,84,1554721200,29,1,30,Rain
77862,85,1554721200,35,0,35,Rain
77863,86,1554721200,38,0,38,Rain
77864,87,1554721200,38,0,38,Rain
77865,88,1554721200,29,1,30,Rain
77866,89,1554721200,4,35,39,Rain
77867,90,1554721200,1,39,40,Rain
77868,91,1554721200,2,26,28,Rain
77869,92,1554721200,40,0,40,Rain
77870,93,1554721200,39,1,40,Rain
77871,94,1554721200,40,0,40,Rain
77872,95,1554721200,40,0,40,Rain
77873,96,1554721200,30,0,30,Rain
77874,97,1554721200,40,0,40,Rain
77875,98,1554721200,34,6,40,Rain
77876,99,1554721200,5,25,30,Rain
77877,100,1554721200,25,0,25,Rain
77878,101,1554721200,29,1,30,Rain
77879,102,1554721200,40,0,40,Rain
77880,103,1554721200,40,0,40,Rain
77881,104,1554721200,40,0,40,Rain
77882,105,1554721200,36,0,36,Rain
77883,106,1554721200,39,1,40,Rain
77884,107,1554721200,40,0,40,Rain
77885,108,1554721200,40,0,40,Rain
77886,109,1554721200,27,2,29,Rain
77887,110,1554721200,40,0,40,Rain
77888,111,1554721200,40,0,40,Rain
77889,112,1554721200,30,0,30,Rain
77890,113,1554721200,5,34,39,Rain
77891,114,1554721200,5,34,39,Rain
77892,115,1554721200,21,9,30,Rain
77893,2,1554724800,20,0,20,Rain
77894,3,1554724800,19,1,20,Rain
77895,4,1554724800,20,0,20,Rain
77896,5,1554724800,36,4,40,Rain
77897,6,1554724800,20,0,20,Rain
77898,7,1554724800,29,0,29,Rain
77899,8,1554724800,6,23,29,Rain
77900,9,1554724800,19,5,24,Rain
77901,10,1554724800,9,6,15,Rain
77902,11,1554724800,6,24,30,Rain
77903,12,1554724800,11,9,20,Rain
77904,13,1554724800,1,29,30,Rain
77905,14,1554724800,20,10,30,Rain
77906,15,1554724800,16,0,16,Rain
77907,16,1554724800,17,3,20,Rain
77908,17,1554724800,18,2,20,Rain
77909,18,1554724800,27,3,30,Rain
77910,19,1554724800,2,28,30,Rain
77911,21,1554724800,6,24,30,Rain
77912,22,1554724800,19,0,19,Rain
77913,23,1554724800,29,1,30,Rain
77914,24,1554724800,19,1,20,Rain
77915,25,1554724800,0,30,30,Rain
77916,26,1554724800,3,17,20,Rain
77917,27,1554724800,8,12,20,Rain
77918,28,1554724800,16,14,30,Rain
77919,29,1554724800,26,3,29,Rain
77920,30,1554724800,18,2,20,Rain
77921,31,1554724800,14,6,20,Rain
77922,32,1554724800,1,29,30,Rain
77923,33,1554724800,18,5,23,Rain
77924,34,1554724800,20,10,30,Rain
77925,35,1554724800,29,1,30,Rain
77926,36,1554724800,1,39,40,Rain
77927,37,1554724800,17,13,30,Rain
77928,38,1554724800,36,4,40,Rain
77929,39,1554724800,17,3,20,Rain
77930,40,1554724800,19,2,21,Rain
77931,41,1554724800,12,7,19,Rain
77932,42,1554724800,30,0,30,Rain
77933,43,1554724800,15,15,30,Rain
77934,44,1554724800,30,0,30,Rain
77935,45,1554724800,30,0,30,Rain
77936,46,1554724800,18,2,20,Rain
77937,47,1554724800,2,38,40,Rain
77938,48,1554724800,1,39,40,Rain
77939,49,1554724800,4,34,38,Rain
77940,50,1554724800,37,3,40,Rain
77941,51,1554724800,36,4,40,Rain
77942,52,1554724800,10,22,32,Rain
77943,53,1554724800,13,27,40,Rain
77944,54,1554724800,9,24,33,Rain
77945,55,1554724800,21,15,36,Rain
77946,56,1554724800,5,35,40,Rain
77947,57,1554724800,1,22,23,Rain
77948,58,1554724800,5,34,39,Rain
77949,59,1554724800,20,0,20,Rain
77950,60,1554724800,23,7,30,Rain
77951,61,1554724800,25,0,25,Rain
77952,62,1554724800,6,34,40,Rain
77953,63,1554724800,0,35,35,Rain
77954,64,1554724800,2,37,39,Rain
77955,65,1554724800,16,24,40,Rain
77956,66,1554724800,12,26,38,Rain
77957,67,1554724800,27,12,39,Rain
77958,68,1554724800,18,21,39,Rain
77959,69,1554724800,0,39,39,Rain
77960,70,1554724800,2,23,25,Rain
77961,71,1554724800,40,0,40,Rain
77962,72,1554724800,31,0,31,Rain
77963,73,1554724800,30,0,30,Rain
77964,74,1554724800,28,2,30,Rain
77965,75,1554724800,40,0,40,Rain
77966,76,1554724800,34,4,38,Rain
77967,77,1554724800,28,1,29,Rain
77968,78,1554724800,31,9,40,Rain
77969,79,1554724800,20,7,27,Rain
77970,80,1554724800,39,1,40,Rain
77971,81,1554724800,40,0,40,Rain
77972,82,1554724800,22,0,22,Rain
77973,83,1554724800,40,0,40,Rain
77974,84,1554724800,29,1,30,Rain
77975,85,1554724800,35,0,35,Rain
77976,86,1554724800,37,1,38,Rain
77977,87,1554724800,38,0,38,Rain
77978,88,1554724800,29,1,30,Rain
77979,89,1554724800,5,35,40,Rain
77980,90,1554724800,2,38,40,Rain
77981,91,1554724800,0,28,28,Rain
77982,92,1554724800,40,0,40,Rain
77983,93,1554724800,39,1,40,Rain
77984,94,1554724800,40,0,40,Rain
77985,95,1554724800,40,0,40,Rain
77986,96,1554724800,30,0,30,Rain
77987,97,1554724800,40,0,40,Rain
77988,98,1554724800,35,5,40,Rain
77989,99,1554724800,5,25,30,Rain
77990,100,1554724800,24,1,25,Rain
77991,101,1554724800,30,0,30,Rain
77992,102,1554724800,40,0,40,Rain
77993,103,1554724800,40,0,40,Rain
77994,104,1554724800,40,0,40,Rain
77995,105,1554724800,36,0,36,Rain
77996,106,1554724800,40,0,40,Rain
77997,107,1554724800,39,1,40,Rain
77998,108,1554724800,40,0,40,Rain
77999,109,1554724800,26,3,29,Rain
78000,110,1554724800,40,0,40,Rain
78001,111,1554724800,40,0,40,Rain
78002,112,1554724800,30,0,30,Rain
78003,113,1554724800,1,39,40,Rain
78004,114,1554724800,3,37,40,Rain
78005,115,1554724800,27,3,30,Rain
78006,2,1554728400,20,0,20,Rain
78007,3,1554728400,20,0,20,Rain
78008,4,1554728400,20,0,20,Rain
78009,5,1554728400,35,5,40,Rain
78010,6,1554728400,19,1,20,Rain
78011,7,1554728400,29,0,29,Rain
78012,8,1554728400,7,22,29,Rain
78013,9,1554728400,18,6,24,Rain
78014,10,1554728400,9,7,16,Rain
78015,11,1554728400,7,23,30,Rain
78016,12,1554728400,12,8,20,Rain
78017,13,1554728400,1,29,30,Rain
78018,14,1554728400,15,15,30,Rain
78019,15,1554728400,15,1,16,Rain
78020,16,1554728400,18,2,20,Rain
78021,17,1554728400,18,2,20,Rain
78022,18,1554728400,25,5,30,Rain
78023,19,1554728400,1,29,30,Rain
78024,21,1554728400,3,27,30,Rain
78025,22,1554728400,14,5,19,Rain
78026,23,1554728400,28,2,30,Rain
78027,24,1554728400,20,0,20,Rain
78028,25,1554728400,1,29,30,Rain
78029,26,1554728400,3,17,20,Rain
78030,27,1554728400,10,10,20,Rain
78031,28,1554728400,25,5,30,Rain
78032,29,1554728400,24,5,29,Rain
78033,30,1554728400,20,0,20,Rain
78034,31,1554728400,17,3,20,Rain
78035,32,1554728400,4,26,30,Rain
78036,33,1554728400,20,3,23,Rain
78037,34,1554728400,21,9,30,Rain
78038,35,1554728400,30,0,30,Rain
78039,36,1554728400,4,36,40,Rain
78040,37,1554728400,20,10,30,Rain
78041,38,1554728400,34,6,40,Rain
78042,39,1554728400,17,3,20,Rain
78043,40,1554728400,21,0,21,Rain
78044,41,1554728400,12,7,19,Rain
78045,42,1554728400,29,1,30,Rain
78046,43,1554728400,10,20,30,Rain
78047,44,1554728400,27,3,30,Rain
78048,45,1554728400,29,1,30,Rain
78049,46,1554728400,20,0,20,Rain
78050,47,1554728400,2,38,40,Rain
78051,48,1554728400,1,39,40,Rain
78052,49,1554728400,6,32,38,Rain
78053,50,1554728400,39,1,40,Rain
78054,51,1554728400,39,1,40,Rain
78055,52,1554728400,12,20,32,Rain
78056,53,1554728400,11,29,40,Rain
78057,54,1554728400,8,25,33,Rain
78058,55,1554728400,22,14,36,Rain
78059,56,1554728400,7,33,40,Rain
78060,57,1554728400,0,23,23,Rain
78061,58,1554728400,9,31,40,Rain
78062,59,1554728400,20,0,20,Rain
78063,60,1554728400,25,5,30,Rain
78064,61,1554728400,25,0,25,Rain
78065,62,1554728400,9,31,40,Rain
78066,63,1554728400,0,35,35,Rain
78067,64,1554728400,14,25,39,Rain
78068,65,1554728400,28,12,40,Rain
78069,66,1554728400,18,20,38,Rain
78070,67,1554728400,26,13,39,Rain
78071,68,1554728400,10,29,39,Rain
78072,69,1554728400,0,39,39,Rain
78073,70,1554728400,0,25,25,Rain
78074,71,1554728400,40,0,40,Rain
78075,72,1554728400,31,0,31,Rain
78076,73,1554728400,27,3,30,Rain
78077,74,1554728400,30,0,30,Rain
78078,75,1554728400,39,1,40,Rain
78079,76,1554728400,35,3,38,Rain
78080,77,1554728400,29,0,29,Rain
78081,78,1554728400,33,7,40,Rain
78082,79,1554728400,21,6,27,Rain
78083,80,1554728400,38,2,40,Rain
78084,81,1554728400,40,0,40,Rain
78085,82,1554728400,22,0,22,Rain
78086,83,1554728400,40,0,40,Rain
78087,84,1554728400,29,1,30,Rain
78088,85,1554728400,35,0,35,Rain
78089,86,1554728400,38,0,38,Rain
78090,87,1554728400,37,1,38,Rain
78091,88,1554728400,29,1,30,Rain
78092,89,1554728400,5,35,40,Rain
78093,90,1554728400,3,37,40,Rain
78094,91,1554728400,0,28,28,Rain
78095,92,1554728400,40,0,40,Rain
78096,93,1554728400,39,1,40,Rain
78097,94,1554728400,40,0,40,Rain
78098,95,1554728400,40,0,40,Rain
78099,96,1554728400,29,1,30,Rain
78100,97,1554728400,29,11,40,Rain
78101,98,1554728400,35,5,40,Rain
78102,99,1554728400,4,26,30,Rain
78103,100,1554728400,23,2,25,Rain
78104,101,1554728400,30,0,30,Rain
78105,102,1554728400,40,0,40,Rain
78106,103,1554728400,40,0,40,Rain
78107,104,1554728400,40,0,40,Rain
78108,105,1554728400,36,0,36,Rain
78109,106,1554728400,38,2,40,Rain
78110,107,1554728400,40,0,40,Rain
78111,108,1554728400,40,0,40,Rain
78112,109,1554728400,27,2,29,Rain
78113,110,1554728400,40,0,40,Rain
78114,111,1554728400,40,0,40,Rain
78115,112,1554728400,27,3,30,Rain
78116,113,1554728400,0,40,40,Rain
78117,114,1554728400,4,36,40,Rain
78118,115,1554728400,24,6,30,Rain
78119,2,1554732000,19,1,20,Drizzle
78120,3,1554732000,14,6,20,Drizzle
78121,4,1554732000,20,0,20,Drizzle
78122,5,1554732000,32,8,40,Drizzle
78123,6,1554732000,18,2,20,Drizzle
78124,7,1554732000,29,0,29,Drizzle
78125,8,1554732000,11,18,29,Drizzle
78126,9,1554732000,18,6,24,Drizzle
78127,10,1554732000,12,4,16,Drizzle
78128,11,1554732000,8,22,30,Drizzle
78129,12,1554732000,15,5,20,Drizzle
78130,13,1554732000,1,29,30,Drizzle
78131,14,1554732000,14,16,30,Drizzle
78132,15,1554732000,12,4,16,Drizzle
78133,16,1554732000,18,2,20,Drizzle
78134,17,1554732000,18,2,20,Drizzle
78135,18,1554732000,22,8,30,Drizzle
78136,19,1554732000,1,29,30,Drizzle
78137,21,1554732000,2,28,30,Drizzle
78138,22,1554732000,16,3,19,Drizzle
78139,23,1554732000,26,4,30,Drizzle
78140,24,1554732000,20,0,20,Drizzle
78141,25,1554732000,1,29,30,Drizzle
78142,26,1554732000,1,19,20,Drizzle
78143,27,1554732000,8,12,20,Drizzle
78144,28,1554732000,19,11,30,Drizzle
78145,29,1554732000,24,5,29,Drizzle
78146,30,1554732000,19,1,20,Drizzle
78147,31,1554732000,16,4,20,Drizzle
78148,32,1554732000,14,16,30,Drizzle
78149,33,1554732000,17,6,23,Drizzle
78150,34,1554732000,26,4,30,Drizzle
78151,35,1554732000,30,0,30,Drizzle
78152,36,1554732000,3,37,40,Drizzle
78153,37,1554732000,22,8,30,Drizzle
78154,38,1554732000,37,3,40,Drizzle
78155,39,1554732000,16,4,20,Drizzle
78156,40,1554732000,19,2,21,Drizzle
78157,41,1554732000,8,11,19,Drizzle
78158,42,1554732000,28,2,30,Drizzle
78159,43,1554732000,11,19,30,Drizzle
78160,44,1554732000,30,0,30,Drizzle
78161,45,1554732000,28,2,30,Drizzle
78162,46,1554732000,20,0,20,Drizzle
78163,47,1554732000,0,40,40,Drizzle
78164,48,1554732000,10,30,40,Drizzle
78165,49,1554732000,13,25,38,Drizzle
78166,50,1554732000,38,2,40,Drizzle
78167,51,1554732000,38,2,40,Drizzle
78168,52,1554732000,12,20,32,Drizzle
78169,53,1554732000,11,29,40,Drizzle
78170,54,1554732000,4,29,33,Drizzle
78171,55,1554732000,21,15,36,Drizzle
78172,56,1554732000,5,35,40,Drizzle
78173,57,1554732000,2,21,23,Drizzle
78174,58,1554732000,3,37,40,Drizzle
78175,59,1554732000,19,1,20,Drizzle
78176,60,1554732000,27,3,30,Drizzle
78177,61,1554732000,25,0,25,Drizzle
78178,62,1554732000,6,34,40,Drizzle
78179,63,1554732000,7,28,35,Drizzle
78180,64,1554732000,13,26,39,Drizzle
78181,65,1554732000,28,12,40,Drizzle
78182,66,1554732000,19,19,38,Drizzle
78183,67,1554732000,26,13,39,Drizzle
78184,68,1554732000,7,32,39,Drizzle
78185,69,1554732000,1,38,39,Drizzle
78186,70,1554732000,0,25,25,Drizzle
78187,71,1554732000,38,2,40,Drizzle
78188,72,1554732000,29,2,31,Drizzle
78189,73,1554732000,30,0,30,Drizzle
78190,74,1554732000,29,1,30,Drizzle
78191,75,1554732000,38,2,40,Drizzle
78192,76,1554732000,38,0,38,Drizzle
78193,77,1554732000,28,1,29,Drizzle
78194,78,1554732000,33,7,40,Drizzle
78195,79,1554732000,21,6,27,Drizzle
78196,80,1554732000,25,15,40,Drizzle
78197,81,1554732000,40,0,40,Drizzle
78198,82,1554732000,22,0,22,Drizzle
78199,83,1554732000,32,8,40,Drizzle
78200,84,1554732000,29,1,30,Drizzle
78201,85,1554732000,34,1,35,Drizzle
78202,86,1554732000,37,1,38,Drizzle
78203,87,1554732000,37,1,38,Drizzle
78204,88,1554732000,29,1,30,Drizzle
78205,89,1554732000,5,35,40,Drizzle
78206,90,1554732000,0,40,40,Drizzle
78207,91,1554732000,0,28,28,Drizzle
78208,92,1554732000,40,0,40,Drizzle
78209,93,1554732000,39,1,40,Drizzle
78210,94,1554732000,40,0,40,Drizzle
78211,95,1554732000,40,0,40,Drizzle
78212,96,1554732000,29,1,30,Drizzle
78213,97,1554732000,30,10,40,Drizzle
78214,98,1554732000,37,3,40,Drizzle
78215,99,1554732000,6,24,30,Drizzle
78216,100,1554732000,22,3,25,Drizzle
78217,101,1554732000,30,0,30,Drizzle
78218,102,1554732000,40,0,40,Drizzle
78219,103,1554732000,40,0,40,Drizzle
78220,104,1554732000,40,0,40,Drizzle
78221,105,1554732000,36,0,36,Drizzle
78222,106,1554732000,31,9,40,Drizzle
78223,107,1554732000,32,8,40,Drizzle
78224,108,1554732000,40,0,40,Drizzle
78225,109,1554732000,29,0,29,Drizzle
78226,110,1554732000,39,1,40,Drizzle
78227,111,1554732000,40,0,40,Drizzle
78228,112,1554732000,27,3,30,Drizzle
78229,113,1554732000,1,39,40,Drizzle
78230,114,1554732000,0,40,40,Drizzle
78231,115,1554732000,27,3,30,Drizzle
78232,2,1554735600,20,0,20,Drizzle
78233,3,1554735600,16,4,20,Drizzle
78234,4,1554735600,19,1,20,Drizzle
78235,5,1554735600,29,11,40,Drizzle
78236,6,1554735600,20,0,20,Drizzle
78237,7,1554735600,29,0,29,Drizzle
78238,8,1554735600,16,14,30,Drizzle
78239,9,1554735600,17,7,24,Drizzle
78240,10,1554735600,9,7,16,Drizzle
78241,11,1554735600,6,24,30,Drizzle
78242,12,1554735600,20,0,20,Drizzle
78243,13,1554735600,0,30,30,Drizzle
78244,14,1554735600,14,16,30,Drizzle
78245,15,1554735600,11,5,16,Drizzle
78246,16,1554735600,18,2,20,Drizzle
78247,17,1554735600,18,2,20,Drizzle
78248,18,1554735600,20,10,30,Drizzle
78249,19,1554735600,1,29,30,Drizzle
78250,21,1554735600,3,27,30,Drizzle
78251,22,1554735600,17,2,19,Drizzle
78252,23,1554735600,26,4,30,Drizzle
78253,24,1554735600,19,1,20,Drizzle
78254,25,1554735600,2,28,30,Drizzle
78255,26,1554735600,1,19,20,Drizzle
78256,27,1554735600,13,7,20,Drizzle
78257,28,1554735600,19,11,30,Drizzle
78258,29,1554735600,24,5,29,Drizzle
78259,30,1554735600,17,3,20,Drizzle
78260,31,1554735600,15,5,20,Drizzle
78261,32,1554735600,21,9,30,Drizzle
78262,33,1554735600,18,5,23,Drizzle
78263,34,1554735600,28,2,30,Drizzle
78264,35,1554735600,30,0,30,Drizzle
78265,36,1554735600,4,36,40,Drizzle
78266,37,1554735600,24,6,30,Drizzle
78267,38,1554735600,35,5,40,Drizzle
78268,39,1554735600,13,7,20,Drizzle
78269,40,1554735600,19,2,21,Drizzle
78270,41,1554735600,11,8,19,Drizzle
78271,42,1554735600,30,0,30,Drizzle
78272,43,1554735600,13,17,30,Drizzle
78273,44,1554735600,28,2,30,Drizzle
78274,45,1554735600,29,1,30,Drizzle
78275,46,1554735600,19,1,20,Drizzle
78276,47,1554735600,1,39,40,Drizzle
78277,48,1554735600,9,31,40,Drizzle
78278,49,1554735600,14,26,40,Drizzle
78279,50,1554735600,40,0,40,Drizzle
78280,51,1554735600,37,3,40,Drizzle
78281,52,1554735600,10,22,32,Drizzle
78282,53,1554735600,12,28,40,Drizzle
78283,54,1554735600,4,29,33,Drizzle
78284,55,1554735600,22,14,36,Drizzle
78285,56,1554735600,3,37,40,Drizzle
78286,57,1554735600,2,21,23,Drizzle
78287,58,1554735600,5,35,40,Drizzle
78288,59,1554735600,18,2,20,Drizzle
78289,60,1554735600,25,5,30,Drizzle
78290,61,1554735600,15,10,25,Drizzle
78291,62,1554735600,5,35,40,Drizzle
78292,63,1554735600,5,30,35,Drizzle
78293,64,1554735600,26,14,40,Drizzle
78294,65,1554735600,25,15,40,Drizzle
78295,66,1554735600,19,21,40,Drizzle
78296,67,1554735600,25,15,40,Drizzle
78297,68,1554735600,10,30,40,Drizzle
78298,69,1554735600,1,38,39,Drizzle
78299,70,1554735600,0,25,25,Drizzle
78300,71,1554735600,37,3,40,Drizzle
78301,72,1554735600,22,9,31,Drizzle
78302,73,1554735600,29,1,30,Drizzle
78303,74,1554735600,28,2,30,Drizzle
78304,75,1554735600,39,1,40,Drizzle
78305,76,1554735600,38,0,38,Drizzle
78306,77,1554735600,28,1,29,Drizzle
78307,78,1554735600,33,7,40,Drizzle
78308,79,1554735600,23,4,27,Drizzle
78309,80,1554735600,29,11,40,Drizzle
78310,81,1554735600,40,0,40,Drizzle
78311,82,1554735600,22,0,22,Drizzle
78312,83,1554735600,32,8,40,Drizzle
78313,84,1554735600,29,1,30,Drizzle
78314,85,1554735600,34,1,35,Drizzle
78315,86,1554735600,36,2,38,Drizzle
78316,87,1554735600,37,1,38,Drizzle
78317,88,1554735600,29,1,30,Drizzle
78318,89,1554735600,6,34,40,Drizzle
78319,90,1554735600,3,37,40,Drizzle
78320,91,1554735600,0,28,28,Drizzle
78321,92,1554735600,40,0,40,Drizzle
78322,93,1554735600,39,1,40,Drizzle
78323,94,1554735600,40,0,40,Drizzle
78324,95,1554735600,40,0,40,Drizzle
78325,96,1554735600,28,2,30,Drizzle
78326,97,1554735600,29,11,40,Drizzle
78327,98,1554735600,37,3,40,Drizzle
78328,99,1554735600,5,25,30,Drizzle
78329,100,1554735600,20,5,25,Drizzle
78330,101,1554735600,29,1,30,Drizzle
78331,102,1554735600,22,18,40,Drizzle
78332,103,1554735600,40,0,40,Drizzle
78333,104,1554735600,40,0,40,Drizzle
78334,105,1554735600,35,1,36,Drizzle
78335,106,1554735600,32,8,40,Drizzle
78336,107,1554735600,32,8,40,Drizzle
78337,108,1554735600,29,11,40,Drizzle
78338,109,1554735600,29,0,29,Drizzle
78339,110,1554735600,30,10,40,Drizzle
78340,111,1554735600,40,0,40,Drizzle
78341,112,1554735600,28,2,30,Drizzle
78342,113,1554735600,0,40,40,Drizzle
78343,114,1554735600,2,38,40,Drizzle
78344,115,1554735600,29,1,30,Drizzle
78345,2,1554739200,19,1,20,Drizzle
78346,3,1554739200,16,4,20,Drizzle
78347,4,1554739200,20,0,20,Drizzle
78348,5,1554739200,27,13,40,Drizzle
78349,6,1554739200,19,1,20,Drizzle
78350,7,1554739200,29,0,29,Drizzle
78351,8,1554739200,13,17,30,Drizzle
78352,9,1554739200,18,6,24,Drizzle
78353,10,1554739200,10,6,16,Drizzle
78354,11,1554739200,7,23,30,Drizzle
78355,12,1554739200,18,2,20,Drizzle
78356,13,1554739200,3,27,30,Drizzle
78357,14,1554739200,27,3,30,Drizzle
78358,15,1554739200,16,0,16,Drizzle
78359,16,1554739200,20,0,20,Drizzle
78360,17,1554739200,17,3,20,Drizzle
78361,18,1554739200,26,4,30,Drizzle
78362,19,1554739200,13,17,30,Drizzle
78363,21,1554739200,8,22,30,Drizzle
78364,22,1554739200,17,3,20,Drizzle
78365,23,1554739200,21,9,30,Drizzle
78366,24,1554739200,20,0,20,Drizzle
78367,25,1554739200,7,23,30,Drizzle
78368,26,1554739200,1,19,20,Drizzle
78369,27,1554739200,13,7,20,Drizzle
78370,28,1554739200,22,8,30,Drizzle
78371,29,1554739200,24,5,29,Drizzle
78372,30,1554739200,20,0,20,Drizzle
78373,31,1554739200,14,6,20,Drizzle
78374,32,1554739200,18,12,30,Drizzle
78375,33,1554739200,17,6,23,Drizzle
78376,34,1554739200,24,6,30,Drizzle
78377,35,1554739200,28,2,30,Drizzle
78378,36,1554739200,6,34,40,Drizzle
78379,37,1554739200,25,5,30,Drizzle
78380,38,1554739200,34,6,40,Drizzle
78381,39,1554739200,10,10,20,Drizzle
78382,40,1554739200,21,0,21,Drizzle
78383,41,1554739200,13,6,19,Drizzle
78384,42,1554739200,28,2,30,Drizzle
78385,43,1554739200,29,1,30,Drizzle
78386,44,1554739200,29,1,30,Drizzle
78387,45,1554739200,25,5,30,Drizzle
78388,46,1554739200,19,1,20,Drizzle
78389,47,1554739200,4,36,40,Drizzle
78390,48,1554739200,10,30,40,Drizzle
78391,49,1554739200,12,28,40,Drizzle
78392,50,1554739200,35,5,40,Drizzle
78393,51,1554739200,37,3,40,Drizzle
78394,52,1554739200,11,21,32,Drizzle
78395,53,1554739200,12,28,40,Drizzle
78396,54,1554739200,5,28,33,Drizzle
78397,55,1554739200,30,6,36,Drizzle
78398,56,1554739200,8,32,40,Drizzle
78399,57,1554739200,1,22,23,Drizzle
78400,58,1554739200,8,32,40,Drizzle
78401,59,1554739200,20,0,20,Drizzle
78402,60,1554739200,24,6,30,Drizzle
78403,61,1554739200,16,9,25,Drizzle
78404,62,1554739200,3,37,40,Drizzle
78405,63,1554739200,1,34,35,Drizzle
78406,64,1554739200,27,13,40,Drizzle
78407,65,1554739200,26,14,40,Drizzle
78408,66,1554739200,25,15,40,Drizzle
78409,67,1554739200,19,21,40,Drizzle
78410,68,1554739200,8,32,40,Drizzle
78411,69,1554739200,0,40,40,Drizzle
78412,70,1554739200,5,23,28,Drizzle
78413,71,1554739200,40,0,40,Drizzle
78414,72,1554739200,15,16,31,Drizzle
78415,73,1554739200,29,1,30,Drizzle
78416,74,1554739200,29,1,30,Drizzle
78417,75,1554739200,40,0,40,Drizzle
78418,76,1554739200,36,2,38,Drizzle
78419,77,1554739200,11,18,29,Drizzle
78420,78,1554739200,32,8,40,Drizzle
78421,79,1554739200,24,3,27,Drizzle
78422,80,1554739200,31,9,40,Drizzle
78423,81,1554739200,22,18,40,Drizzle
78424,82,1554739200,22,0,22,Drizzle
78425,83,1554739200,32,8,40,Drizzle
78426,84,1554739200,30,0,30,Drizzle
78427,85,1554739200,35,0,35,Drizzle
78428,86,1554739200,35,3,38,Drizzle
78429,87,1554739200,35,3,38,Drizzle
78430,88,1554739200,26,4,30,Drizzle
78431,89,1554739200,6,34,40,Drizzle
78432,90,1554739200,9,31,40,Drizzle
78433,91,1554739200,4,26,30,Drizzle
78434,92,1554739200,40,0,40,Drizzle
78435,93,1554739200,39,1,40,Drizzle
78436,94,1554739200,39,1,40,Drizzle
78437,95,1554739200,38,2,40,Drizzle
78438,96,1554739200,28,2,30,Drizzle
78439,97,1554739200,28,12,40,Drizzle
78440,98,1554739200,37,3,40,Drizzle
78441,99,1554739200,6,24,30,Drizzle
78442,100,1554739200,17,8,25,Drizzle
78443,101,1554739200,30,0,30,Drizzle
78444,102,1554739200,22,18,40,Drizzle
78445,103,1554739200,40,0,40,Drizzle
78446,104,1554739200,40,0,40,Drizzle
78447,105,1554739200,35,1,36,Drizzle
78448,106,1554739200,33,7,40,Drizzle
78449,107,1554739200,32,8,40,Drizzle
78450,108,1554739200,28,12,40,Drizzle
78451,109,1554739200,25,4,29,Drizzle
78452,110,1554739200,30,10,40,Drizzle
78453,111,1554739200,39,1,40,Drizzle
78454,112,1554739200,30,0,30,Drizzle
78455,113,1554739200,2,38,40,Drizzle
78456,114,1554739200,5,35,40,Drizzle
78457,115,1554739200,30,0,30,Drizzle
78458,2,1554742800,19,1,20,Mist
78459,3,1554742800,20,0,20,Mist
78460,4,1554742800,20,0,20,Mist
78461,5,1554742800,12,28,40,Mist
78462,6,1554742800,17,3,20,Mist
78463,7,1554742800,29,0,29,Mist
78464,8,1554742800,15,15,30,Mist
78465,9,1554742800,23,1,24,Mist
78466,10,1554742800,14,2,16,Mist
78467,11,1554742800,30,0,30,Mist
78468,12,1554742800,16,4,20,Mist
78469,13,1554742800,3,27,30,Mist
78470,14,1554742800,24,6,30,Mist
78471,15,1554742800,16,0,16,Mist
78472,16,1554742800,8,12,20,Mist
78473,17,1554742800,18,2,20,Mist
78474,18,1554742800,29,1,30,Mist
78475,19,1554742800,19,11,30,Mist
78476,21,1554742800,7,23,30,Mist
78477,22,1554742800,15,5,20,Mist
78478,23,1554742800,22,8,30,Mist
78479,24,1554742800,12,8,20,Mist
78480,25,1554742800,10,20,30,Mist
78481,26,1554742800,3,17,20,Mist
78482,27,1554742800,15,5,20,Mist
78483,28,1554742800,25,5,30,Mist
78484,29,1554742800,29,0,29,Mist
78485,30,1554742800,18,2,20,Mist
78486,31,1554742800,14,6,20,Mist
78487,32,1554742800,9,21,30,Mist
78488,33,1554742800,10,13,23,Mist
78489,34,1554742800,19,11,30,Mist
78490,35,1554742800,30,0,30,Mist
78491,36,1554742800,9,31,40,Mist
78492,37,1554742800,30,0,30,Mist
78493,38,1554742800,12,28,40,Mist
78494,39,1554742800,15,5,20,Mist
78495,40,1554742800,18,3,21,Mist
78496,41,1554742800,10,9,19,Mist
78497,42,1554742800,30,0,30,Mist
78498,43,1554742800,19,11,30,Mist
78499,44,1554742800,27,2,29,Mist
78500,45,1554742800,21,9,30,Mist
78501,46,1554742800,20,0,20,Mist
78502,47,1554742800,12,28,40,Mist
78503,48,1554742800,8,32,40,Mist
78504,49,1554742800,12,28,40,Mist
78505,50,1554742800,35,5,40,Mist
78506,51,1554742800,40,0,40,Mist
78507,52,1554742800,19,13,32,Mist
78508,53,1554742800,24,16,40,Mist
78509,54,1554742800,11,22,33,Mist
78510,55,1554742800,36,0,36,Mist
78511,56,1554742800,33,7,40,Mist
78512,57,1554742800,10,13,23,Mist
78513,58,1554742800,10,30,40,Mist
78514,59,1554742800,20,0,20,Mist
78515,60,1554742800,14,16,30,Mist
78516,61,1554742800,17,8,25,Mist
78517,62,1554742800,14,26,40,Mist
78518,63,1554742800,3,32,35,Mist
78519,64,1554742800,27,13,40,Mist
78520,65,1554742800,40,0,40,Mist
78521,66,1554742800,40,0,40,Mist
78522,67,1554742800,19,21,40,Mist
78523,68,1554742800,13,27,40,Mist
78524,69,1554742800,7,33,40,Mist
78525,70,1554742800,8,20,28,Mist
78526,71,1554742800,40,0,40,Mist
78527,72,1554742800,21,10,31,Mist
78528,73,1554742800,28,2,30,Mist
78529,74,1554742800,9,21,30,Mist
78530,75,1554742800,38,2,40,Mist
78531,76,1554742800,38,0,38,Mist
78532,77,1554742800,19,10,29,Mist
78533,78,1554742800,34,6,40,Mist
78534,79,1554742800,27,0,27,Mist
78535,80,1554742800,38,2,40,Mist
78536,81,1554742800,26,14,40,Mist
78537,82,1554742800,22,0,22,Mist
78538,83,1554742800,25,15,40,Mist
78539,84,1554742800,25,5,30,Mist
78540,85,1554742800,32,3,35,Mist
78541,86,1554742800,28,10,38,Mist
78542,87,1554742800,36,2,38,Mist
78543,88,1554742800,26,4,30,Mist
78544,89,1554742800,18,22,40,Mist
78545,90,1554742800,26,14,40,Mist
78546,91,1554742800,8,22,30,Mist
78547,92,1554742800,31,9,40,Mist
78548,93,1554742800,36,4,40,Mist
78549,94,1554742800,39,1,40,Mist
78550,95,1554742800,34,6,40,Mist
78551,96,1554742800,29,1,30,Mist
78552,97,1554742800,26,14,40,Mist
78553,98,1554742800,39,1,40,Mist
78554,99,1554742800,4,26,30,Mist
78555,100,1554742800,4,21,25,Mist
78556,101,1554742800,28,2,30,Mist
78557,102,1554742800,26,14,40,Mist
78558,103,1554742800,38,2,40,Mist
78559,104,1554742800,40,0,40,Mist
78560,105,1554742800,35,1,36,Mist
78561,106,1554742800,34,6,40,Mist
78562,107,1554742800,27,13,40,Mist
78563,108,1554742800,27,13,40,Mist
78564,109,1554742800,22,7,29,Mist
78565,110,1554742800,28,12,40,Mist
78566,111,1554742800,37,3,40,Mist
78567,112,1554742800,30,0,30,Mist
78568,113,1554742800,7,33,40,Mist
78569,114,1554742800,28,12,40,Mist
78570,115,1554742800,28,2,30,Mist
78571,2,1554746400,16,4,20,Rain
78572,3,1554746400,16,4,20,Rain
78573,4,1554746400,19,1,20,Rain
78574,5,1554746400,21,19,40,Rain
78575,6,1554746400,18,2,20,Rain
78576,7,1554746400,29,0,29,Rain
78577,8,1554746400,19,11,30,Rain
78578,9,1554746400,22,2,24,Rain
78579,10,1554746400,16,0,16,Rain
78580,11,1554746400,30,0,30,Rain
78581,12,1554746400,16,4,20,Rain
78582,13,1554746400,13,13,26,Rain
78583,14,1554746400,19,11,30,Rain
78584,15,1554746400,13,3,16,Rain
78585,16,1554746400,1,19,20,Rain
78586,17,1554746400,18,2,20,Rain
78587,18,1554746400,20,10,30,Rain
78588,19,1554746400,30,0,30,Rain
78589,21,1554746400,4,26,30,Rain
78590,22,1554746400,9,11,20,Rain
78591,23,1554746400,19,11,30,Rain
78592,24,1554746400,16,4,20,Rain
78593,25,1554746400,27,3,30,Rain
78594,26,1554746400,6,14,20,Rain
78595,27,1554746400,20,0,20,Rain
78596,28,1554746400,22,8,30,Rain
78597,29,1554746400,29,0,29,Rain
78598,30,1554746400,18,2,20,Rain
78599,31,1554746400,12,8,20,Rain
78600,32,1554746400,11,19,30,Rain
78601,33,1554746400,10,13,23,Rain
78602,34,1554746400,0,30,30,Rain
78603,35,1554746400,22,8,30,Rain
78604,36,1554746400,25,15,40,Rain
78605,37,1554746400,29,1,30,Rain
78606,38,1554746400,23,17,40,Rain
78607,39,1554746400,18,2,20,Rain
78608,40,1554746400,17,4,21,Rain
78609,41,1554746400,18,1,19,Rain
78610,42,1554746400,24,6,30,Rain
78611,43,1554746400,12,18,30,Rain
78612,44,1554746400,14,15,29,Rain
78613,45,1554746400,19,11,30,Rain
78614,46,1554746400,18,2,20,Rain
78615,47,1554746400,40,0,40,Rain
78616,48,1554746400,14,26,40,Rain
78617,49,1554746400,36,4,40,Rain
78618,50,1554746400,30,10,40,Rain
78619,51,1554746400,34,6,40,Rain
78620,52,1554746400,32,0,32,Rain
78621,53,1554746400,31,9,40,Rain
78622,54,1554746400,31,2,33,Rain
78623,55,1554746400,36,0,36,Rain
78624,56,1554746400,40,0,40,Rain
78625,57,1554746400,23,0,23,Rain
78626,58,1554746400,40,0,40,Rain
78627,59,1554746400,17,3,20,Rain
78628,60,1554746400,9,21,30,Rain
78629,61,1554746400,19,6,25,Rain
78630,62,1554746400,38,2,40,Rain
78631,63,1554746400,13,22,35,Rain
78632,64,1554746400,31,9,40,Rain
78633,65,1554746400,40,0,40,Rain
78634,66,1554746400,40,0,40,Rain
78635,67,1554746400,40,0,40,Rain
78636,68,1554746400,25,15,40,Rain
78637,69,1554746400,8,32,40,Rain
78638,70,1554746400,12,16,28,Rain
78639,71,1554746400,33,7,40,Rain
78640,72,1554746400,28,3,31,Rain
78641,73,1554746400,30,0,30,Rain
78642,74,1554746400,12,18,30,Rain
78643,75,1554746400,26,14,40,Rain
78644,76,1554746400,19,19,38,Rain
78645,77,1554746400,16,13,29,Rain
78646,78,1554746400,32,8,40,Rain
78647,79,1554746400,26,1,27,Rain
78648,80,1554746400,14,26,40,Rain
78649,81,1554746400,29,11,40,Rain
78650,82,1554746400,20,2,22,Rain
78651,83,1554746400,16,24,40,Rain
78652,84,1554746400,18,12,30,Rain
78653,85,1554746400,21,14,35,Rain
78654,86,1554746400,23,15,38,Rain
78655,87,1554746400,32,6,38,Rain
78656,88,1554746400,25,5,30,Rain
78657,89,1554746400,36,4,40,Rain
78658,90,1554746400,36,4,40,Rain
78659,91,1554746400,11,19,30,Rain
78660,92,1554746400,10,30,40,Rain
78661,93,1554746400,0,40,40,Rain
78662,94,1554746400,19,21,40,Rain
78663,95,1554746400,14,26,40,Rain
78664,96,1554746400,29,1,30,Rain
78665,97,1554746400,27,13,40,Rain
78666,98,1554746400,39,1,40,Rain
78667,99,1554746400,3,27,30,Rain
78668,100,1554746400,1,24,25,Rain
78669,101,1554746400,26,4,30,Rain
78670,102,1554746400,29,11,40,Rain
78671,103,1554746400,39,1,40,Rain
78672,104,1554746400,40,0,40,Rain
78673,105,1554746400,36,0,36,Rain
78674,106,1554746400,33,7,40,Rain
78675,107,1554746400,26,14,40,Rain
78676,108,1554746400,26,14,40,Rain
78677,109,1554746400,23,6,29,Rain
78678,110,1554746400,27,13,40,Rain
78679,111,1554746400,34,6,40,Rain
78680,112,1554746400,18,12,30,Rain
78681,113,1554746400,19,21,40,Rain
78682,114,1554746400,40,0,40,Rain
78683,115,1554746400,20,10,30,Rain
78684,2,1554750000,12,8,20,Drizzle
78685,3,1554750000,18,2,20,Drizzle
78686,4,1554750000,19,1,20,Drizzle
78687,5,1554750000,17,23,40,Drizzle
78688,6,1554750000,20,0,20,Drizzle
78689,7,1554750000,27,2,29,Drizzle
78690,8,1554750000,14,16,30,Drizzle
78691,9,1554750000,14,10,24,Drizzle
78692,10,1554750000,16,0,16,Drizzle
78693,11,1554750000,27,3,30,Drizzle
78694,12,1554750000,10,10,20,Drizzle
78695,13,1554750000,29,1,30,Drizzle
78696,14,1554750000,23,7,30,Drizzle
78697,15,1554750000,12,4,16,Drizzle
78698,16,1554750000,2,18,20,Drizzle
78699,17,1554750000,20,0,20,Drizzle
78700,18,1554750000,17,13,30,Drizzle
78701,19,1554750000,30,0,30,Drizzle
78702,21,1554750000,17,13,30,Drizzle
78703,22,1554750000,1,19,20,Drizzle
78704,23,1554750000,14,16,30,Drizzle
78705,24,1554750000,20,0,20,Drizzle
78706,25,1554750000,30,0,30,Drizzle
78707,26,1554750000,7,13,20,Drizzle
78708,27,1554750000,20,0,20,Drizzle
78709,28,1554750000,26,4,30,Drizzle
78710,29,1554750000,28,1,29,Drizzle
78711,30,1554750000,20,0,20,Drizzle
78712,31,1554750000,15,5,20,Drizzle
78713,32,1554750000,10,20,30,Drizzle
78714,33,1554750000,21,2,23,Drizzle
78715,34,1554750000,19,11,30,Drizzle
78716,35,1554750000,25,5,30,Drizzle
78717,36,1554750000,32,8,40,Drizzle
78718,37,1554750000,30,0,30,Drizzle
78719,38,1554750000,18,22,40,Drizzle
78720,39,1554750000,8,12,20,Drizzle
78721,40,1554750000,19,2,21,Drizzle
78722,41,1554750000,20,0,20,Drizzle
78723,42,1554750000,16,14,30,Drizzle
78724,43,1554750000,17,13,30,Drizzle
78725,44,1554750000,11,18,29,Drizzle
78726,45,1554750000,15,15,30,Drizzle
78727,46,1554750000,18,2,20,Drizzle
78728,47,1554750000,40,0,40,Drizzle
78729,48,1554750000,19,21,40,Drizzle
78730,49,1554750000,37,3,40,Drizzle
78731,50,1554750000,20,20,40,Drizzle
78732,51,1554750000,39,1,40,Drizzle
78733,52,1554750000,32,0,32,Drizzle
78734,53,1554750000,39,1,40,Drizzle
78735,54,1554750000,33,0,33,Drizzle
78736,55,1554750000,35,1,36,Drizzle
78737,56,1554750000,33,7,40,Drizzle
78738,57,1554750000,21,2,23,Drizzle
78739,58,1554750000,40,0,40,Drizzle
78740,59,1554750000,17,3,20,Drizzle
78741,60,1554750000,0,30,30,Drizzle
78742,61,1554750000,17,8,25,Drizzle
78743,62,1554750000,40,0,40,Drizzle
78744,63,1554750000,14,21,35,Drizzle
78745,64,1554750000,26,14,40,Drizzle
78746,65,1554750000,40,0,40,Drizzle
78747,66,1554750000,37,3,40,Drizzle
78748,67,1554750000,38,2,40,Drizzle
78749,68,1554750000,38,2,40,Drizzle
78750,69,1554750000,19,21,40,Drizzle
78751,70,1554750000,15,13,28,Drizzle
78752,71,1554750000,25,15,40,Drizzle
78753,72,1554750000,7,24,31,Drizzle
78754,73,1554750000,15,15,30,Drizzle
78755,74,1554750000,11,19,30,Drizzle
78756,75,1554750000,24,16,40,Drizzle
78757,76,1554750000,19,19,38,Drizzle
78758,77,1554750000,24,5,29,Drizzle
78759,78,1554750000,27,13,40,Drizzle
78760,79,1554750000,26,1,27,Drizzle
78761,80,1554750000,15,25,40,Drizzle
78762,81,1554750000,31,9,40,Drizzle
78763,82,1554750000,12,10,22,Drizzle
78764,83,1554750000,10,30,40,Drizzle
78765,84,1554750000,14,16,30,Drizzle
78766,85,1554750000,15,20,35,Drizzle
78767,86,1554750000,19,19,38,Drizzle
78768,87,1554750000,22,16,38,Drizzle
78769,88,1554750000,18,12,30,Drizzle
78770,89,1554750000,38,2,40,Drizzle
78771,90,1554750000,39,1,40,Drizzle
78772,91,1554750000,0,30,30,Drizzle
78773,92,1554750000,3,37,40,Drizzle
78774,93,1554750000,0,40,40,Drizzle
78775,94,1554750000,13,27,40,Drizzle
78776,95,1554750000,7,33,40,Drizzle
78777,96,1554750000,24,6,30,Drizzle
78778,97,1554750000,18,22,40,Drizzle
78779,98,1554750000,40,0,40,Drizzle
78780,99,1554750000,11,19,30,Drizzle
78781,100,1554750000,16,9,25,Drizzle
78782,101,1554750000,27,3,30,Drizzle
78783,102,1554750000,30,10,40,Drizzle
78784,103,1554750000,40,0,40,Drizzle
78785,104,1554750000,40,0,40,Drizzle
78786,105,1554750000,34,2,36,Drizzle
78787,106,1554750000,31,9,40,Drizzle
78788,107,1554750000,24,16,40,Drizzle
78789,108,1554750000,28,12,40,Drizzle
78790,109,1554750000,25,4,29,Drizzle
78791,110,1554750000,26,14,40,Drizzle
78792,111,1554750000,33,7,40,Drizzle
78793,112,1554750000,15,15,30,Drizzle
78794,113,1554750000,29,11,40,Drizzle
78795,114,1554750000,40,0,40,Drizzle
78796,115,1554750000,14,16,30,Drizzle
78797,2,1554753600,12,8,20,Drizzle
78798,3,1554753600,17,3,20,Drizzle
78799,4,1554753600,17,3,20,Drizzle
78800,5,1554753600,23,17,40,Drizzle
78801,6,1554753600,17,3,20,Drizzle
78802,7,1554753600,27,2,29,Drizzle
78803,8,1554753600,19,11,30,Drizzle
78804,9,1554753600,24,0,24,Drizzle
78805,10,1554753600,14,2,16,Drizzle
78806,11,1554753600,30,0,30,Drizzle
78807,12,1554753600,7,13,20,Drizzle
78808,13,1554753600,22,8,30,Drizzle
78809,14,1554753600,29,1,30,Drizzle
78810,15,1554753600,13,3,16,Drizzle
78811,16,1554753600,6,14,20,Drizzle
78812,17,1554753600,18,2,20,Drizzle
78813,18,1554753600,22,8,30,Drizzle
78814,19,1554753600,11,19,30,Drizzle
78815,21,1554753600,24,6,30,Drizzle
78816,22,1554753600,3,17,20,Drizzle
78817,23,1554753600,14,16,30,Drizzle
78818,24,1554753600,17,3,20,Drizzle
78819,25,1554753600,21,9,30,Drizzle
78820,26,1554753600,5,15,20,Drizzle
78821,27,1554753600,20,0,20,Drizzle
78822,28,1554753600,22,8,30,Drizzle
78823,29,1554753600,24,5,29,Drizzle
78824,30,1554753600,20,0,20,Drizzle
78825,31,1554753600,17,3,20,Drizzle
78826,32,1554753600,29,1,30,Drizzle
78827,33,1554753600,21,2,23,Drizzle
78828,34,1554753600,7,23,30,Drizzle
78829,35,1554753600,22,8,30,Drizzle
78830,36,1554753600,36,4,40,Drizzle
78831,37,1554753600,22,8,30,Drizzle
78832,38,1554753600,19,21,40,Drizzle
78833,39,1554753600,17,3,20,Drizzle
78834,40,1554753600,21,0,21,Drizzle
78835,41,1554753600,20,0,20,Drizzle
78836,42,1554753600,7,23,30,Drizzle
78837,43,1554753600,20,10,30,Drizzle
78838,44,1554753600,0,29,29,Drizzle
78839,45,1554753600,12,18,30,Drizzle
78840,46,1554753600,19,1,20,Drizzle
78841,47,1554753600,40,0,40,Drizzle
78842,48,1554753600,20,20,40,Drizzle
78843,49,1554753600,32,8,40,Drizzle
78844,50,1554753600,22,18,40,Drizzle
78845,51,1554753600,40,0,40,Drizzle
78846,52,1554753600,30,2,32,Drizzle
78847,53,1554753600,39,1,40,Drizzle
78848,54,1554753600,33,0,33,Drizzle
78849,55,1554753600,36,0,36,Drizzle
78850,56,1554753600,37,3,40,Drizzle
78851,57,1554753600,23,0,23,Drizzle
78852,58,1554753600,37,3,40,Drizzle
78853,59,1554753600,16,4,20,Drizzle
78854,60,1554753600,1,29,30,Drizzle
78855,61,1554753600,15,10,25,Drizzle
78856,62,1554753600,38,2,40,Drizzle
78857,63,1554753600,18,17,35,Drizzle
78858,64,1554753600,28,12,40,Drizzle
78859,65,1554753600,38,2,40,Drizzle
78860,66,1554753600,29,11,40,Drizzle
78861,67,1554753600,27,13,40,Drizzle
78862,68,1554753600,39,1,40,Drizzle
78863,69,1554753600,28,12,40,Drizzle
78864,70,1554753600,22,6,28,Drizzle
78865,71,1554753600,23,17,40,Drizzle
78866,72,1554753600,9,22,31,Drizzle
78867,73,1554753600,13,17,30,Drizzle
78868,74,1554753600,16,14,30,Drizzle
78869,75,1554753600,25,15,40,Drizzle
78870,76,1554753600,15,23,38,Drizzle
78871,77,1554753600,26,3,29,Drizzle
78872,78,1554753600,25,15,40,Drizzle
78873,79,1554753600,25,2,27,Drizzle
78874,80,1554753600,13,27,40,Drizzle
78875,81,1554753600,33,7,40,Drizzle
78876,82,1554753600,9,13,22,Drizzle
78877,83,1554753600,3,37,40,Drizzle
78878,84,1554753600,12,18,30,Drizzle
78879,85,1554753600,9,26,35,Drizzle
78880,86,1554753600,14,24,38,Drizzle
78881,87,1554753600,17,21,38,Drizzle
78882,88,1554753600,19,11,30,Drizzle
78883,89,1554753600,40,0,40,Drizzle
78884,90,1554753600,38,2,40,Drizzle
78885,91,1554753600,19,11,30,Drizzle
78886,92,1554753600,2,38,40,Drizzle
78887,93,1554753600,1,39,40,Drizzle
78888,94,1554753600,13,27,40,Drizzle
78889,95,1554753600,4,36,40,Drizzle
78890,96,1554753600,24,6,30,Drizzle
78891,97,1554753600,11,29,40,Drizzle
78892,98,1554753600,40,0,40,Drizzle
78893,99,1554753600,17,13,30,Drizzle
78894,100,1554753600,11,14,25,Drizzle
78895,101,1554753600,28,2,30,Drizzle
78896,102,1554753600,32,8,40,Drizzle
78897,103,1554753600,40,0,40,Drizzle
78898,104,1554753600,40,0,40,Drizzle
78899,105,1554753600,35,1,36,Drizzle
78900,106,1554753600,13,27,40,Drizzle
78901,107,1554753600,25,15,40,Drizzle
78902,108,1554753600,26,14,40,Drizzle
78903,109,1554753600,20,9,29,Drizzle
78904,110,1554753600,23,17,40,Drizzle
78905,111,1554753600,31,9,40,Drizzle
78906,112,1554753600,12,18,30,Drizzle
78907,113,1554753600,33,7,40,Drizzle
78908,114,1554753600,40,0,40,Drizzle
78909,115,1554753600,12,18,30,Drizzle
78910,2,1554757200,10,10,20,Drizzle
78911,3,1554757200,20,0,20,Drizzle
78912,4,1554757200,20,0,20,Drizzle
78913,5,1554757200,21,19,40,Drizzle
78914,6,1554757200,20,0,20,Drizzle
78915,7,1554757200,27,2,29,Drizzle
78916,8,1554757200,19,11,30,Drizzle
78917,9,1554757200,24,0,24,Drizzle
78918,10,1554757200,16,0,16,Drizzle
78919,11,1554757200,30,0,30,Drizzle
78920,12,1554757200,6,14,20,Drizzle
78921,13,1554757200,22,8,30,Drizzle
78922,14,1554757200,25,5,30,Drizzle
78923,15,1554757200,11,5,16,Drizzle
78924,16,1554757200,10,10,20,Drizzle
78925,17,1554757200,19,1,20,Drizzle
78926,18,1554757200,19,11,30,Drizzle
78927,19,1554757200,26,4,30,Drizzle
78928,21,1554757200,29,1,30,Drizzle
78929,22,1554757200,7,13,20,Drizzle
78930,23,1554757200,13,17,30,Drizzle
78931,24,1554757200,18,2,20,Drizzle
78932,25,1554757200,25,5,30,Drizzle
78933,26,1554757200,6,14,20,Drizzle
78934,27,1554757200,20,0,20,Drizzle
78935,28,1554757200,20,10,30,Drizzle
78936,29,1554757200,24,5,29,Drizzle
78937,30,1554757200,20,0,20,Drizzle
78938,31,1554757200,20,0,20,Drizzle
78939,32,1554757200,27,3,30,Drizzle
78940,33,1554757200,22,1,23,Drizzle
78941,34,1554757200,5,25,30,Drizzle
78942,35,1554757200,17,13,30,Drizzle
78943,36,1554757200,39,1,40,Drizzle
78944,37,1554757200,26,4,30,Drizzle
78945,38,1554757200,15,25,40,Drizzle
78946,39,1554757200,19,1,20,Drizzle
78947,40,1554757200,18,3,21,Drizzle
78948,41,1554757200,19,1,20,Drizzle
78949,42,1554757200,7,23,30,Drizzle
78950,43,1554757200,20,10,30,Drizzle
78951,44,1554757200,0,30,30,Drizzle
78952,45,1554757200,10,20,30,Drizzle
78953,46,1554757200,16,4,20,Drizzle
78954,47,1554757200,39,1,40,Drizzle
78955,48,1554757200,18,22,40,Drizzle
78956,49,1554757200,31,9,40,Drizzle
78957,50,1554757200,15,25,40,Drizzle
78958,51,1554757200,40,0,40,Drizzle
78959,52,1554757200,32,0,32,Drizzle
78960,53,1554757200,39,1,40,Drizzle
78961,54,1554757200,33,0,33,Drizzle
78962,55,1554757200,36,0,36,Drizzle
78963,56,1554757200,40,0,40,Drizzle
78964,57,1554757200,22,1,23,Drizzle
78965,58,1554757200,37,3,40,Drizzle
78966,59,1554757200,18,2,20,Drizzle
78967,60,1554757200,15,15,30,Drizzle
78968,61,1554757200,18,7,25,Drizzle
78969,62,1554757200,40,0,40,Drizzle
78970,63,1554757200,19,16,35,Drizzle
78971,64,1554757200,29,11,40,Drizzle
78972,65,1554757200,38,2,40,Drizzle
78973,66,1554757200,29,11,40,Drizzle
78974,67,1554757200,18,22,40,Drizzle
78975,68,1554757200,39,1,40,Drizzle
78976,69,1554757200,20,20,40,Drizzle
78977,70,1554757200,14,14,28,Drizzle
78978,71,1554757200,27,13,40,Drizzle
78979,72,1554757200,9,22,31,Drizzle
78980,73,1554757200,12,18,30,Drizzle
78981,74,1554757200,15,15,30,Drizzle
78982,75,1554757200,28,12,40,Drizzle
78983,76,1554757200,14,24,38,Drizzle
78984,77,1554757200,28,1,29,Drizzle
78985,78,1554757200,20,20,40,Drizzle
78986,79,1554757200,7,20,27,Drizzle
78987,80,1554757200,11,29,40,Drizzle
78988,81,1554757200,35,5,40,Drizzle
78989,82,1554757200,9,13,22,Drizzle
78990,83,1554757200,0,40,40,Drizzle
78991,84,1554757200,8,22,30,Drizzle
78992,85,1554757200,5,30,35,Drizzle
78993,86,1554757200,11,27,38,Drizzle
78994,87,1554757200,14,24,38,Drizzle
78995,88,1554757200,17,13,30,Drizzle
78996,89,1554757200,39,1,40,Drizzle
78997,90,1554757200,39,1,40,Drizzle
78998,91,1554757200,15,15,30,Drizzle
78999,92,1554757200,1,39,40,Drizzle
79000,93,1554757200,1,39,40,Drizzle
79001,94,1554757200,13,27,40,Drizzle
79002,95,1554757200,1,39,40,Drizzle
79003,96,1554757200,24,6,30,Drizzle
79004,97,1554757200,8,32,40,Drizzle
79005,98,1554757200,40,0,40,Drizzle
79006,99,1554757200,21,9,30,Drizzle
79007,100,1554757200,8,17,25,Drizzle
79008,101,1554757200,23,7,30,Drizzle
79009,102,1554757200,33,7,40,Drizzle
79010,103,1554757200,40,0,40,Drizzle
79011,104,1554757200,40,0,40,Drizzle
79012,105,1554757200,35,1,36,Drizzle
79013,106,1554757200,12,28,40,Drizzle
79014,107,1554757200,25,15,40,Drizzle
79015,108,1554757200,24,16,40,Drizzle
79016,109,1554757200,18,11,29,Drizzle
79017,110,1554757200,21,19,40,Drizzle
79018,111,1554757200,25,15,40,Drizzle
79019,112,1554757200,7,23,30,Drizzle
79020,113,1554757200,34,6,40,Drizzle
79021,114,1554757200,37,3,40,Drizzle
79022,115,1554757200,10,20,30,Drizzle
79023,2,1554760800,5,15,20,Rain
79024,3,1554760800,17,3,20,Rain
79025,4,1554760800,19,1,20,Rain
79026,5,1554760800,18,22,40,Rain
79027,6,1554760800,19,1,20,Rain
79028,7,1554760800,26,3,29,Rain
79029,8,1554760800,19,11,30,Rain
79030,9,1554760800,7,17,24,Rain
79031,10,1554760800,15,1,16,Rain
79032,11,1554760800,30,0,30,Rain
79033,12,1554760800,3,17,20,Rain
79034,13,1554760800,21,9,30,Rain
79035,14,1554760800,16,14,30,Rain
79036,15,1554760800,8,8,16,Rain
79037,16,1554760800,14,6,20,Rain
79038,17,1554760800,19,1,20,Rain
79039,18,1554760800,19,11,30,Rain
79040,19,1554760800,28,2,30,Rain
79041,21,1554760800,30,0,30,Rain
79042,22,1554760800,10,10,20,Rain
79043,23,1554760800,14,16,30,Rain
79044,24,1554760800,15,5,20,Rain
79045,25,1554760800,28,2,30,Rain
79046,26,1554760800,9,11,20,Rain
79047,27,1554760800,20,0,20,Rain
79048,28,1554760800,17,13,30,Rain
79049,29,1554760800,24,5,29,Rain
79050,30,1554760800,19,1,20,Rain
79051,31,1554760800,20,0,20,Rain
79052,32,1554760800,30,0,30,Rain
79053,33,1554760800,21,2,23,Rain
79054,34,1554760800,12,18,30,Rain
79055,35,1554760800,20,10,30,Rain
79056,36,1554760800,39,1,40,Rain
79057,37,1554760800,24,6,30,Rain
79058,38,1554760800,17,23,40,Rain
79059,39,1554760800,17,3,20,Rain
79060,40,1554760800,21,0,21,Rain
79061,41,1554760800,20,0,20,Rain
79062,42,1554760800,10,20,30,Rain
79063,43,1554760800,16,14,30,Rain
79064,44,1554760800,0,30,30,Rain
79065,45,1554760800,8,22,30,Rain
79066,46,1554760800,18,2,20,Rain
79067,47,1554760800,38,2,40,Rain
79068,48,1554760800,22,18,40,Rain
79069,49,1554760800,40,0,40,Rain
79070,50,1554760800,12,28,40,Rain
79071,51,1554760800,40,0,40,Rain
79072,52,1554760800,32,0,32,Rain
79073,53,1554760800,40,0,40,Rain
79074,54,1554760800,33,0,33,Rain
79075,55,1554760800,35,1,36,Rain
79076,56,1554760800,40,0,40,Rain
79077,57,1554760800,23,0,23,Rain
79078,58,1554760800,36,4,40,Rain
79079,59,1554760800,20,0,20,Rain
79080,60,1554760800,10,20,30,Rain
79081,61,1554760800,20,5,25,Rain
79082,62,1554760800,38,2,40,Rain
79083,63,1554760800,29,6,35,Rain
79084,64,1554760800,35,5,40,Rain
79085,65,1554760800,40,0,40,Rain
79086,66,1554760800,29,11,40,Rain
79087,67,1554760800,15,25,40,Rain
79088,68,1554760800,37,3,40,Rain
79089,69,1554760800,34,6,40,Rain
79090,70,1554760800,12,16,28,Rain
79091,71,1554760800,27,13,40,Rain
79092,72,1554760800,11,20,31,Rain
79093,73,1554760800,8,22,30,Rain
79094,74,1554760800,16,14,30,Rain
79095,75,1554760800,24,16,40,Rain
79096,76,1554760800,13,25,38,Rain
79097,77,1554760800,28,1,29,Rain
79098,78,1554760800,17,23,40,Rain
79099,79,1554760800,7,20,27,Rain
79100,80,1554760800,11,29,40,Rain
79101,81,1554760800,35,5,40,Rain
79102,82,1554760800,7,15,22,Rain
79103,83,1554760800,11,29,40,Rain
79104,84,1554760800,6,24,30,Rain
79105,85,1554760800,10,25,35,Rain
79106,86,1554760800,12,26,38,Rain
79107,87,1554760800,14,24,38,Rain
79108,88,1554760800,14,16,30,Rain
79109,89,1554760800,39,1,40,Rain
79110,90,1554760800,40,0,40,Rain
79111,91,1554760800,14,16,30,Rain
79112,92,1554760800,1,39,40,Rain
79113,93,1554760800,1,39,40,Rain
79114,94,1554760800,13,27,40,Rain
79115,95,1554760800,0,40,40,Rain
79116,96,1554760800,23,7,30,Rain
79117,97,1554760800,8,32,40,Rain
79118,98,1554760800,40,0,40,Rain
79119,99,1554760800,22,8,30,Rain
79120,100,1554760800,10,15,25,Rain
79121,101,1554760800,20,10,30,Rain
79122,102,1554760800,34,6,40,Rain
79123,103,1554760800,40,0,40,Rain
79124,104,1554760800,40,0,40,Rain
79125,105,1554760800,29,7,36,Rain
79126,106,1554760800,13,27,40,Rain
79127,107,1554760800,22,18,40,Rain
79128,108,1554760800,22,18,40,Rain
79129,109,1554760800,15,14,29,Rain
79130,110,1554760800,22,18,40,Rain
79131,111,1554760800,22,18,40,Rain
79132,112,1554760800,4,26,30,Rain
79133,113,1554760800,34,6,40,Rain
79134,114,1554760800,39,1,40,Rain
79135,115,1554760800,12,18,30,Rain
79136,2,1554764400,5,15,20,Drizzle
79137,3,1554764400,13,7,20,Drizzle
79138,4,1554764400,17,3,20,Drizzle
79139,5,1554764400,20,20,40,Drizzle
79140,6,1554764400,20,0,20,Drizzle
79141,7,1554764400,28,1,29,Drizzle
79142,8,1554764400,22,8,30,Drizzle
79143,9,1554764400,13,11,24,Drizzle
79144,10,1554764400,16,0,16,Drizzle
79145,11,1554764400,30,0,30,Drizzle
79146,12,1554764400,3,17,20,Drizzle
79147,13,1554764400,22,8,30,Drizzle
79148,14,1554764400,10,20,30,Drizzle
79149,15,1554764400,7,9,16,Drizzle
79150,16,1554764400,16,4,20,Drizzle
79151,17,1554764400,16,4,20,Drizzle
79152,18,1554764400,20,10,30,Drizzle
79153,19,1554764400,28,2,30,Drizzle
79154,21,1554764400,30,0,30,Drizzle
79155,22,1554764400,15,5,20,Drizzle
79156,23,1554764400,14,16,30,Drizzle
79157,24,1554764400,15,5,20,Drizzle
79158,25,1554764400,29,1,30,Drizzle
79159,26,1554764400,8,12,20,Drizzle
79160,27,1554764400,20,0,20,Drizzle
79161,28,1554764400,14,16,30,Drizzle
79162,29,1554764400,27,2,29,Drizzle
79163,30,1554764400,19,1,20,Drizzle
79164,31,1554764400,19,1,20,Drizzle
79165,32,1554764400,28,2,30,Drizzle
79166,33,1554764400,23,0,23,Drizzle
79167,34,1554764400,8,22,30,Drizzle
79168,35,1554764400,18,12,30,Drizzle
79169,36,1554764400,36,4,40,Drizzle
79170,37,1554764400,28,2,30,Drizzle
79171,38,1554764400,18,22,40,Drizzle
79172,39,1554764400,16,4,20,Drizzle
79173,40,1554764400,20,1,21,Drizzle
79174,41,1554764400,20,0,20,Drizzle
79175,42,1554764400,11,19,30,Drizzle
79176,43,1554764400,10,20,30,Drizzle
79177,44,1554764400,2,28,30,Drizzle
79178,45,1554764400,8,22,30,Drizzle
79179,46,1554764400,18,2,20,Drizzle
79180,47,1554764400,38,2,40,Drizzle
79181,48,1554764400,25,15,40,Drizzle
79182,49,1554764400,40,0,40,Drizzle
79183,50,1554764400,13,27,40,Drizzle
79184,51,1554764400,39,1,40,Drizzle
79185,52,1554764400,31,1,32,Drizzle
79186,53,1554764400,40,0,40,Drizzle
79187,54,1554764400,33,0,33,Drizzle
79188,55,1554764400,36,0,36,Drizzle
79189,56,1554764400,37,3,40,Drizzle
79190,57,1554764400,23,0,23,Drizzle
79191,58,1554764400,38,2,40,Drizzle
79192,59,1554764400,19,1,20,Drizzle
79193,60,1554764400,8,22,30,Drizzle
79194,61,1554764400,19,6,25,Drizzle
79195,62,1554764400,40,0,40,Drizzle
79196,63,1554764400,32,3,35,Drizzle
79197,64,1554764400,34,6,40,Drizzle
79198,65,1554764400,38,2,40,Drizzle
79199,66,1554764400,29,11,40,Drizzle
79200,67,1554764400,35,5,40,Drizzle
79201,68,1554764400,40,0,40,Drizzle
79202,69,1554764400,38,2,40,Drizzle
79203,70,1554764400,10,18,28,Drizzle
79204,71,1554764400,26,14,40,Drizzle
79205,72,1554764400,9,22,31,Drizzle
79206,73,1554764400,10,20,30,Drizzle
79207,74,1554764400,17,13,30,Drizzle
79208,75,1554764400,22,18,40,Drizzle
79209,76,1554764400,14,24,38,Drizzle
79210,77,1554764400,28,1,29,Drizzle
79211,78,1554764400,15,25,40,Drizzle
79212,79,1554764400,7,20,27,Drizzle
79213,80,1554764400,12,28,40,Drizzle
79214,81,1554764400,35,5,40,Drizzle
79215,82,1554764400,6,16,22,Drizzle
79216,83,1554764400,12,28,40,Drizzle
79217,84,1554764400,5,25,30,Drizzle
79218,85,1554764400,10,25,35,Drizzle
79219,86,1554764400,11,27,38,Drizzle
79220,87,1554764400,13,25,38,Drizzle
79221,88,1554764400,12,18,30,Drizzle
79222,89,1554764400,39,1,40,Drizzle
79223,90,1554764400,40,0,40,Drizzle
79224,91,1554764400,11,19,30,Drizzle
79225,92,1554764400,8,32,40,Drizzle
79226,93,1554764400,1,39,40,Drizzle
79227,94,1554764400,13,27,40,Drizzle
79228,95,1554764400,8,32,40,Drizzle
79229,96,1554764400,22,8,30,Drizzle
79230,97,1554764400,8,32,40,Drizzle
79231,98,1554764400,40,0,40,Drizzle
79232,99,1554764400,22,8,30,Drizzle
79233,100,1554764400,11,14,25,Drizzle
79234,101,1554764400,20,10,30,Drizzle
79235,102,1554764400,34,6,40,Drizzle
79236,103,1554764400,32,8,40,Drizzle
79237,104,1554764400,32,8,40,Drizzle
79238,105,1554764400,18,18,36,Drizzle
79239,106,1554764400,12,28,40,Drizzle
79240,107,1554764400,10,30,40,Drizzle
79241,108,1554764400,19,21,40,Drizzle
79242,109,1554764400,17,12,29,Drizzle
79243,110,1554764400,23,17,40,Drizzle
79244,111,1554764400,19,21,40,Drizzle
79245,112,1554764400,1,29,30,Drizzle
79246,113,1554764400,34,6,40,Drizzle
79247,114,1554764400,40,0,40,Drizzle
79248,115,1554764400,6,24,30,Drizzle
79249,2,1554768000,5,15,20,Rain
79250,3,1554768000,13,7,20,Rain
79251,4,1554768000,18,2,20,Rain
79252,5,1554768000,22,18,40,Rain
79253,6,1554768000,18,2,20,Rain
79254,7,1554768000,29,0,29,Rain
79255,8,1554768000,22,8,30,Rain
79256,9,1554768000,24,0,24,Rain
79257,10,1554768000,16,0,16,Rain
79258,11,1554768000,30,0,30,Rain
79259,12,1554768000,0,20,20,Rain
79260,13,1554768000,22,8,30,Rain
79261,14,1554768000,16,14,30,Rain
79262,15,1554768000,7,9,16,Rain
79263,16,1554768000,17,3,20,Rain
79264,17,1554768000,15,5,20,Rain
79265,18,1554768000,22,8,30,Rain
79266,19,1554768000,28,2,30,Rain
79267,21,1554768000,30,0,30,Rain
79268,22,1554768000,15,5,20,Rain
79269,23,1554768000,30,0,30,Rain
79270,24,1554768000,17,3,20,Rain
79271,25,1554768000,29,1,30,Rain
79272,26,1554768000,12,8,20,Rain
79273,27,1554768000,20,0,20,Rain
79274,28,1554768000,14,16,30,Rain
79275,29,1554768000,29,0,29,Rain
79276,30,1554768000,19,1,20,Rain
79277,31,1554768000,15,5,20,Rain
79278,32,1554768000,30,0,30,Rain
79279,33,1554768000,21,2,23,Rain
79280,34,1554768000,8,21,29,Rain
79281,35,1554768000,18,12,30,Rain
79282,36,1554768000,37,3,40,Rain
79283,37,1554768000,30,0,30,Rain
79284,38,1554768000,14,26,40,Rain
79285,39,1554768000,15,5,20,Rain
79286,40,1554768000,20,1,21,Rain
79287,41,1554768000,20,0,20,Rain
79288,42,1554768000,11,19,30,Rain
79289,43,1554768000,11,19,30,Rain
79290,44,1554768000,1,29,30,Rain
79291,45,1554768000,8,22,30,Rain
79292,46,1554768000,19,1,20,Rain
79293,47,1554768000,38,2,40,Rain
79294,48,1554768000,28,12,40,Rain
79295,49,1554768000,39,1,40,Rain
79296,50,1554768000,12,28,40,Rain
79297,51,1554768000,39,1,40,Rain
79298,52,1554768000,32,0,32,Rain
79299,53,1554768000,40,0,40,Rain
79300,54,1554768000,32,1,33,Rain
79301,55,1554768000,36,0,36,Rain
79302,56,1554768000,37,3,40,Rain
79303,57,1554768000,23,0,23,Rain
79304,58,1554768000,38,2,40,Rain
79305,59,1554768000,18,2,20,Rain
79306,60,1554768000,9,21,30,Rain
79307,61,1554768000,18,7,25,Rain
79308,62,1554768000,40,0,40,Rain
79309,63,1554768000,33,2,35,Rain
79310,64,1554768000,32,8,40,Rain
79311,65,1554768000,38,2,40,Rain
79312,66,1554768000,27,13,40,Rain
79313,67,1554768000,38,2,40,Rain
79314,68,1554768000,40,0,40,Rain
79315,69,1554768000,39,1,40,Rain
79316,70,1554768000,10,18,28,Rain
79317,71,1554768000,27,13,40,Rain
79318,72,1554768000,9,22,31,Rain
79319,73,1554768000,10,20,30,Rain
79320,74,1554768000,17,13,30,Rain
79321,75,1554768000,21,19,40,Rain
79322,76,1554768000,13,25,38,Rain
79323,77,1554768000,28,1,29,Rain
79324,78,1554768000,12,28,40,Rain
79325,79,1554768000,7,20,27,Rain
79326,80,1554768000,13,27,40,Rain
79327,81,1554768000,37,3,40,Rain
79328,82,1554768000,6,16,22,Rain
79329,83,1554768000,12,28,40,Rain
79330,84,1554768000,4,26,30,Rain
79331,85,1554768000,9,26,35,Rain
79332,86,1554768000,11,27,38,Rain
79333,87,1554768000,12,26,38,Rain
79334,88,1554768000,13,17,30,Rain
79335,89,1554768000,39,1,40,Rain
79336,90,1554768000,39,1,40,Rain
79337,91,1554768000,11,19,30,Rain
79338,92,1554768000,6,34,40,Rain
79339,93,1554768000,1,39,40,Rain
79340,94,1554768000,13,27,40,Rain
79341,95,1554768000,8,32,40,Rain
79342,96,1554768000,22,8,30,Rain
79343,97,1554768000,7,33,40,Rain
79344,98,1554768000,40,0,40,Rain
79345,99,1554768000,22,8,30,Rain
79346,100,1554768000,12,13,25,Rain
79347,101,1554768000,20,10,30,Rain
79348,102,1554768000,34,6,40,Rain
79349,103,1554768000,32,8,40,Rain
79350,104,1554768000,32,8,40,Rain
79351,105,1554768000,18,18,36,Rain
79352,106,1554768000,10,30,40,Rain
79353,107,1554768000,7,33,40,Rain
79354,108,1554768000,16,24,40,Rain
79355,109,1554768000,15,14,29,Rain
79356,110,1554768000,24,16,40,Rain
79357,111,1554768000,16,24,40,Rain
79358,112,1554768000,6,24,30,Rain
79359,113,1554768000,34,6,40,Rain
79360,114,1554768000,40,0,40,Rain
79361,115,1554768000,5,25,30,Rain
79362,2,1554771600,5,15,20,Drizzle
79363,3,1554771600,13,7,20,Drizzle
79364,4,1554771600,18,2,20,Drizzle
79365,5,1554771600,22,18,40,Drizzle
79366,6,1554771600,18,2,20,Drizzle
79367,7,1554771600,29,0,29,Drizzle
79368,8,1554771600,22,8,30,Drizzle
79369,9,1554771600,24,0,24,Drizzle
79370,10,1554771600,16,0,16,Drizzle
79371,11,1554771600,30,0,30,Drizzle
79372,12,1554771600,0,20,20,Drizzle
79373,13,1554771600,22,8,30,Drizzle
79374,14,1554771600,16,14,30,Drizzle
79375,15,1554771600,6,10,16,Drizzle
79376,16,1554771600,18,2,20,Drizzle
79377,17,1554771600,15,5,20,Drizzle
79378,18,1554771600,20,10,30,Drizzle
79379,19,1554771600,29,1,30,Drizzle
79380,21,1554771600,30,0,30,Drizzle
79381,22,1554771600,15,5,20,Drizzle
79382,23,1554771600,30,0,30,Drizzle
79383,24,1554771600,18,2,20,Drizzle
79384,25,1554771600,29,1,30,Drizzle
79385,26,1554771600,15,5,20,Drizzle
79386,27,1554771600,20,0,20,Drizzle
79387,28,1554771600,13,17,30,Drizzle
79388,29,1554771600,29,0,29,Drizzle
79389,30,1554771600,19,1,20,Drizzle
79390,31,1554771600,14,6,20,Drizzle
79391,32,1554771600,30,0,30,Drizzle
79392,33,1554771600,21,2,23,Drizzle
79393,34,1554771600,7,22,29,Drizzle
79394,35,1554771600,19,11,30,Drizzle
79395,36,1554771600,38,2,40,Drizzle
79396,37,1554771600,30,0,30,Drizzle
79397,38,1554771600,15,25,40,Drizzle
79398,39,1554771600,15,5,20,Drizzle
79399,40,1554771600,20,1,21,Drizzle
79400,41,1554771600,20,0,20,Drizzle
79401,42,1554771600,10,20,30,Drizzle
79402,43,1554771600,10,20,30,Drizzle
79403,44,1554771600,1,29,30,Drizzle
79404,45,1554771600,8,22,30,Drizzle
79405,46,1554771600,19,1,20,Drizzle
79406,47,1554771600,38,2,40,Drizzle
79407,48,1554771600,28,12,40,Drizzle
79408,49,1554771600,40,0,40,Drizzle
79409,50,1554771600,11,29,40,Drizzle
79410,51,1554771600,40,0,40,Drizzle
79411,52,1554771600,32,0,32,Drizzle
79412,53,1554771600,40,0,40,Drizzle
79413,54,1554771600,32,1,33,Drizzle
79414,55,1554771600,36,0,36,Drizzle
79415,56,1554771600,37,3,40,Drizzle
79416,57,1554771600,23,0,23,Drizzle
79417,58,1554771600,38,2,40,Drizzle
79418,59,1554771600,18,2,20,Drizzle
79419,60,1554771600,7,23,30,Drizzle
79420,61,1554771600,18,7,25,Drizzle
79421,62,1554771600,40,0,40,Drizzle
79422,63,1554771600,34,1,35,Drizzle
79423,64,1554771600,32,8,40,Drizzle
79424,65,1554771600,38,2,40,Drizzle
79425,66,1554771600,26,14,40,Drizzle
79426,67,1554771600,38,2,40,Drizzle
79427,68,1554771600,40,0,40,Drizzle
79428,69,1554771600,38,2,40,Drizzle
79429,70,1554771600,10,18,28,Drizzle
79430,71,1554771600,27,13,40,Drizzle
79431,72,1554771600,9,22,31,Drizzle
79432,73,1554771600,10,20,30,Drizzle
79433,74,1554771600,17,13,30,Drizzle
79434,75,1554771600,21,19,40,Drizzle
79435,76,1554771600,13,25,38,Drizzle
79436,77,1554771600,28,1,29,Drizzle
79437,78,1554771600,12,28,40,Drizzle
79438,79,1554771600,7,20,27,Drizzle
79439,80,1554771600,13,27,40,Drizzle
79440,81,1554771600,37,3,40,Drizzle
79441,82,1554771600,6,16,22,Drizzle
79442,83,1554771600,12,28,40,Drizzle
79443,84,1554771600,4,26,30,Drizzle
79444,85,1554771600,8,27,35,Drizzle
79445,86,1554771600,11,27,38,Drizzle
79446,87,1554771600,12,26,38,Drizzle
79447,88,1554771600,13,17,30,Drizzle
79448,89,1554771600,39,1,40,Drizzle
79449,90,1554771600,39,1,40,Drizzle
79450,91,1554771600,11,19,30,Drizzle
79451,92,1554771600,5,35,40,Drizzle
79452,93,1554771600,1,39,40,Drizzle
79453,94,1554771600,13,27,40,Drizzle
79454,95,1554771600,8,32,40,Drizzle
79455,96,1554771600,22,8,30,Drizzle
79456,97,1554771600,7,33,40,Drizzle
79457,98,1554771600,40,0,40,Drizzle
79458,99,1554771600,22,8,30,Drizzle
79459,100,1554771600,12,13,25,Drizzle
79460,101,1554771600,20,10,30,Drizzle
79461,102,1554771600,34,6,40,Drizzle
79462,103,1554771600,33,7,40,Drizzle
79463,104,1554771600,32,8,40,Drizzle
79464,105,1554771600,18,18,36,Drizzle
79465,106,1554771600,10,30,40,Drizzle
79466,107,1554771600,7,33,40,Drizzle
79467,108,1554771600,16,24,40,Drizzle
79468,109,1554771600,14,15,29,Drizzle
79469,110,1554771600,24,16,40,Drizzle
79470,111,1554771600,16,24,40,Drizzle
79471,112,1554771600,6,24,30,Drizzle
79472,113,1554771600,34,6,40,Drizzle
79473,114,1554771600,40,0,40,Drizzle
79474,115,1554771600,5,25,30,Drizzle
79475,2,1554775200,5,15,20,Rain
79476,3,1554775200,13,7,20,Rain
79477,4,1554775200,18,2,20,Rain
79478,5,1554775200,22,18,40,Rain
79479,6,1554775200,18,2,20,Rain
79480,7,1554775200,29,0,29,Rain
79481,8,1554775200,22,8,30,Rain
79482,9,1554775200,24,0,24,Rain
79483,10,1554775200,16,0,16,Rain
79484,11,1554775200,30,0,30,Rain
79485,12,1554775200,0,20,20,Rain
79486,13,1554775200,22,8,30,Rain
79487,14,1554775200,16,14,30,Rain
79488,15,1554775200,6,10,16,Rain
79489,16,1554775200,18,2,20,Rain
79490,17,1554775200,15,5,20,Rain
79491,18,1554775200,20,10,30,Rain
79492,19,1554775200,29,1,30,Rain
79493,21,1554775200,30,0,30,Rain
79494,22,1554775200,15,5,20,Rain
79495,23,1554775200,30,0,30,Rain
79496,24,1554775200,18,2,20,Rain
79497,25,1554775200,29,1,30,Rain
79498,26,1554775200,15,5,20,Rain
79499,27,1554775200,20,0,20,Rain
79500,28,1554775200,13,17,30,Rain
79501,29,1554775200,29,0,29,Rain
79502,30,1554775200,19,1,20,Rain
79503,31,1554775200,14,6,20,Rain
79504,32,1554775200,30,0,30,Rain
79505,33,1554775200,21,2,23,Rain
79506,34,1554775200,7,22,29,Rain
79507,35,1554775200,19,11,30,Rain
79508,36,1554775200,38,2,40,Rain
79509,37,1554775200,30,0,30,Rain
79510,38,1554775200,15,25,40,Rain
79511,39,1554775200,15,5,20,Rain
79512,40,1554775200,20,1,21,Rain
79513,41,1554775200,20,0,20,Rain
79514,42,1554775200,10,20,30,Rain
79515,43,1554775200,10,20,30,Rain
79516,44,1554775200,1,29,30,Rain
79517,45,1554775200,8,22,30,Rain
79518,46,1554775200,19,1,20,Rain
79519,47,1554775200,38,2,40,Rain
79520,48,1554775200,28,12,40,Rain
79521,49,1554775200,40,0,40,Rain
79522,50,1554775200,11,29,40,Rain
79523,51,1554775200,40,0,40,Rain
79524,52,1554775200,32,0,32,Rain
79525,53,1554775200,40,0,40,Rain
79526,54,1554775200,32,1,33,Rain
79527,55,1554775200,36,0,36,Rain
79528,56,1554775200,37,3,40,Rain
79529,57,1554775200,23,0,23,Rain
79530,58,1554775200,38,2,40,Rain
79531,59,1554775200,18,2,20,Rain
79532,60,1554775200,7,23,30,Rain
79533,61,1554775200,18,7,25,Rain
79534,62,1554775200,40,0,40,Rain
79535,63,1554775200,34,1,35,Rain
79536,64,1554775200,32,8,40,Rain
79537,65,1554775200,38,2,40,Rain
79538,66,1554775200,26,14,40,Rain
79539,67,1554775200,38,2,40,Rain
79540,68,1554775200,40,0,40,Rain
79541,69,1554775200,38,2,40,Rain
79542,70,1554775200,10,18,28,Rain
79543,71,1554775200,27,13,40,Rain
79544,72,1554775200,9,22,31,Rain
79545,73,1554775200,10,20,30,Rain
79546,74,1554775200,17,13,30,Rain
79547,75,1554775200,21,19,40,Rain
79548,76,1554775200,13,25,38,Rain
79549,77,1554775200,28,1,29,Rain
79550,78,1554775200,12,28,40,Rain
79551,79,1554775200,6,21,27,Rain
79552,80,1554775200,13,27,40,Rain
79553,81,1554775200,37,3,40,Rain
79554,82,1554775200,6,16,22,Rain
79555,83,1554775200,12,28,40,Rain
79556,84,1554775200,4,26,30,Rain
79557,85,1554775200,8,27,35,Rain
79558,86,1554775200,11,27,38,Rain
79559,87,1554775200,12,26,38,Rain
79560,88,1554775200,13,17,30,Rain
79561,89,1554775200,39,1,40,Rain
79562,90,1554775200,39,1,40,Rain
79563,91,1554775200,11,19,30,Rain
79564,92,1554775200,5,35,40,Rain
79565,93,1554775200,1,39,40,Rain
79566,94,1554775200,13,27,40,Rain
79567,95,1554775200,8,32,40,Rain
79568,96,1554775200,22,8,30,Rain
79569,97,1554775200,7,33,40,Rain
79570,98,1554775200,40,0,40,Rain
79571,99,1554775200,22,8,30,Rain
79572,100,1554775200,12,13,25,Rain
79573,101,1554775200,20,10,30,Rain
79574,102,1554775200,34,6,40,Rain
79575,103,1554775200,33,7,40,Rain
79576,104,1554775200,32,8,40,Rain
79577,105,1554775200,18,18,36,Rain
79578,106,1554775200,10,30,40,Rain
79579,107,1554775200,7,33,40,Rain
79580,108,1554775200,16,24,40,Rain
79581,109,1554775200,14,15,29,Rain
79582,110,1554775200,24,16,40,Rain
79583,111,1554775200,16,24,40,Rain
79584,112,1554775200,5,25,30,Rain
79585,113,1554775200,34,6,40,Rain
79586,114,1554775200,40,0,40,Rain
79587,115,1554775200,5,25,30,Rain
79588,2,1554778800,5,15,20,Rain
79589,3,1554778800,13,7,20,Rain
79590,4,1554778800,18,2,20,Rain
79591,5,1554778800,22,18,40,Rain
79592,6,1554778800,18,2,20,Rain
79593,7,1554778800,29,0,29,Rain
79594,8,1554778800,22,8,30,Rain
79595,9,1554778800,24,0,24,Rain
79596,10,1554778800,16,0,16,Rain
79597,11,1554778800,30,0,30,Rain
79598,12,1554778800,0,20,20,Rain
79599,13,1554778800,22,8,30,Rain
79600,14,1554778800,16,14,30,Rain
79601,15,1554778800,5,11,16,Rain
79602,16,1554778800,18,2,20,Rain
79603,17,1554778800,15,5,20,Rain
79604,18,1554778800,20,10,30,Rain
79605,19,1554778800,29,1,30,Rain
79606,21,1554778800,30,0,30,Rain
79607,22,1554778800,15,5,20,Rain
79608,23,1554778800,30,0,30,Rain
79609,24,1554778800,18,2,20,Rain
79610,25,1554778800,29,1,30,Rain
79611,26,1554778800,15,5,20,Rain
79612,27,1554778800,20,0,20,Rain
79613,28,1554778800,13,17,30,Rain
79614,29,1554778800,29,0,29,Rain
79615,30,1554778800,19,1,20,Rain
79616,31,1554778800,14,6,20,Rain
79617,32,1554778800,30,0,30,Rain
79618,33,1554778800,21,2,23,Rain
79619,34,1554778800,7,22,29,Rain
79620,35,1554778800,19,11,30,Rain
79621,36,1554778800,38,2,40,Rain
79622,37,1554778800,30,0,30,Rain
79623,38,1554778800,15,25,40,Rain
79624,39,1554778800,15,5,20,Rain
79625,40,1554778800,20,1,21,Rain
79626,41,1554778800,20,0,20,Rain
79627,42,1554778800,10,20,30,Rain
79628,43,1554778800,10,20,30,Rain
79629,44,1554778800,1,29,30,Rain
79630,45,1554778800,8,22,30,Rain
79631,46,1554778800,19,1,20,Rain
79632,47,1554778800,38,2,40,Rain
79633,48,1554778800,28,12,40,Rain
79634,49,1554778800,40,0,40,Rain
79635,50,1554778800,11,29,40,Rain
79636,51,1554778800,40,0,40,Rain
79637,52,1554778800,32,0,32,Rain
79638,53,1554778800,40,0,40,Rain
79639,54,1554778800,32,1,33,Rain
79640,55,1554778800,36,0,36,Rain
79641,56,1554778800,37,3,40,Rain
79642,57,1554778800,23,0,23,Rain
79643,58,1554778800,38,2,40,Rain
79644,59,1554778800,18,2,20,Rain
79645,60,1554778800,7,23,30,Rain
79646,61,1554778800,18,7,25,Rain
79647,62,1554778800,40,0,40,Rain
79648,63,1554778800,34,1,35,Rain
79649,64,1554778800,32,8,40,Rain
79650,65,1554778800,38,2,40,Rain
79651,66,1554778800,26,14,40,Rain
79652,67,1554778800,38,2,40,Rain
79653,68,1554778800,40,0,40,Rain
79654,69,1554778800,38,2,40,Rain
79655,70,1554778800,10,18,28,Rain
79656,71,1554778800,27,13,40,Rain
79657,72,1554778800,9,22,31,Rain
79658,73,1554778800,10,20,30,Rain
79659,74,1554778800,17,13,30,Rain
79660,75,1554778800,21,19,40,Rain
79661,76,1554778800,13,25,38,Rain
79662,77,1554778800,28,1,29,Rain
79663,78,1554778800,12,28,40,Rain
79664,79,1554778800,6,21,27,Rain
79665,80,1554778800,13,27,40,Rain
79666,81,1554778800,37,3,40,Rain
79667,82,1554778800,6,16,22,Rain
79668,83,1554778800,12,28,40,Rain
79669,84,1554778800,4,26,30,Rain
79670,85,1554778800,8,27,35,Rain
79671,86,1554778800,11,27,38,Rain
79672,87,1554778800,12,26,38,Rain
79673,88,1554778800,13,17,30,Rain
79674,89,1554778800,39,1,40,Rain
79675,90,1554778800,39,1,40,Rain
79676,91,1554778800,11,19,30,Rain
79677,92,1554778800,5,35,40,Rain
79678,93,1554778800,1,39,40,Rain
79679,94,1554778800,13,27,40,Rain
79680,95,1554778800,8,32,40,Rain
79681,96,1554778800,22,8,30,Rain
79682,97,1554778800,7,33,40,Rain
79683,98,1554778800,40,0,40,Rain
79684,99,1554778800,22,8,30,Rain
79685,100,1554778800,12,13,25,Rain
79686,101,1554778800,20,10,30,Rain
79687,102,1554778800,34,6,40,Rain
79688,103,1554778800,33,7,40,Rain
79689,104,1554778800,32,8,40,Rain
79690,105,1554778800,18,18,36,Rain
79691,106,1554778800,10,30,40,Rain
79692,107,1554778800,7,33,40,Rain
79693,108,1554778800,16,24,40,Rain
79694,109,1554778800,14,15,29,Rain
79695,110,1554778800,24,16,40,Rain
79696,111,1554778800,16,24,40,Rain
79697,112,1554778800,5,25,30,Rain
79698,113,1554778800,34,6,40,Rain
79699,114,1554778800,40,0,40,Rain
79700,115,1554778800,5,25,30,Rain
79701,2,1554782400,5,15,20,Rain
79702,3,1554782400,13,7,20,Rain
79703,4,1554782400,18,2,20,Rain
79704,5,1554782400,22,18,40,Rain
79705,6,1554782400,18,2,20,Rain
79706,7,1554782400,29,0,29,Rain
79707,8,1554782400,22,8,30,Rain
79708,9,1554782400,24,0,24,Rain
79709,10,1554782400,16,0,16,Rain
79710,11,1554782400,30,0,30,Rain
79711,12,1554782400,0,20,20,Rain
79712,13,1554782400,22,8,30,Rain
79713,14,1554782400,16,14,30,Rain
79714,15,1554782400,5,11,16,Rain
79715,16,1554782400,18,2,20,Rain
79716,17,1554782400,15,5,20,Rain
79717,18,1554782400,20,10,30,Rain
79718,19,1554782400,29,1,30,Rain
79719,21,1554782400,30,0,30,Rain
79720,22,1554782400,15,5,20,Rain
79721,23,1554782400,30,0,30,Rain
79722,24,1554782400,18,2,20,Rain
79723,25,1554782400,29,1,30,Rain
79724,26,1554782400,15,5,20,Rain
79725,27,1554782400,20,0,20,Rain
79726,28,1554782400,13,17,30,Rain
79727,29,1554782400,29,0,29,Rain
79728,30,1554782400,19,1,20,Rain
79729,31,1554782400,14,6,20,Rain
79730,32,1554782400,30,0,30,Rain
79731,33,1554782400,21,2,23,Rain
79732,34,1554782400,7,22,29,Rain
79733,35,1554782400,19,11,30,Rain
79734,36,1554782400,38,2,40,Rain
79735,37,1554782400,30,0,30,Rain
79736,38,1554782400,15,25,40,Rain
79737,39,1554782400,15,5,20,Rain
79738,40,1554782400,20,1,21,Rain
79739,41,1554782400,20,0,20,Rain
79740,42,1554782400,10,20,30,Rain
79741,43,1554782400,10,20,30,Rain
79742,44,1554782400,1,29,30,Rain
79743,45,1554782400,8,22,30,Rain
79744,46,1554782400,19,1,20,Rain
79745,47,1554782400,38,2,40,Rain
79746,48,1554782400,28,12,40,Rain
79747,49,1554782400,40,0,40,Rain
79748,50,1554782400,11,29,40,Rain
79749,51,1554782400,40,0,40,Rain
79750,52,1554782400,32,0,32,Rain
79751,53,1554782400,40,0,40,Rain
79752,54,1554782400,32,1,33,Rain
79753,55,1554782400,36,0,36,Rain
79754,56,1554782400,37,3,40,Rain
79755,57,1554782400,23,0,23,Rain
79756,58,1554782400,38,2,40,Rain
79757,59,1554782400,18,2,20,Rain
79758,60,1554782400,7,23,30,Rain
79759,61,1554782400,18,7,25,Rain
79760,62,1554782400,40,0,40,Rain
79761,63,1554782400,34,1,35,Rain
79762,64,1554782400,32,8,40,Rain
79763,65,1554782400,38,2,40,Rain
79764,66,1554782400,26,14,40,Rain
79765,67,1554782400,38,2,40,Rain
79766,68,1554782400,40,0,40,Rain
79767,69,1554782400,38,2,40,Rain
79768,70,1554782400,10,18,28,Rain
79769,71,1554782400,27,13,40,Rain
79770,72,1554782400,9,22,31,Rain
79771,73,1554782400,10,20,30,Rain
79772,74,1554782400,17,13,30,Rain
79773,75,1554782400,21,19,40,Rain
79774,76,1554782400,13,25,38,Rain
79775,77,1554782400,28,1,29,Rain
79776,78,1554782400,12,28,40,Rain
79777,79,1554782400,6,21,27,Rain
79778,80,1554782400,13,27,40,Rain
79779,81,1554782400,37,3,40,Rain
79780,82,1554782400,6,16,22,Rain
79781,83,1554782400,12,28,40,Rain
79782,84,1554782400,4,26,30,Rain
79783,85,1554782400,8,27,35,Rain
79784,86,1554782400,11,27,38,Rain
79785,87,1554782400,12,26,38,Rain
79786,88,1554782400,13,17,30,Rain
79787,89,1554782400,39,1,40,Rain
79788,90,1554782400,39,1,40,Rain
79789,91,1554782400,11,19,30,Rain
79790,92,1554782400,5,35,40,Rain
79791,93,1554782400,1,39,40,Rain
79792,94,1554782400,13,27,40,Rain
79793,95,1554782400,8,32,40,Rain
79794,96,1554782400,22,8,30,Rain
79795,97,1554782400,7,33,40,Rain
79796,98,1554782400,40,0,40,Rain
79797,99,1554782400,22,8,30,Rain
79798,100,1554782400,12,13,25,Rain
79799,101,1554782400,20,10,30,Rain
79800,102,1554782400,34,6,40,Rain
79801,103,1554782400,33,7,40,Rain
79802,104,1554782400,32,8,40,Rain
79803,105,1554782400,18,18,36,Rain
79804,106,1554782400,10,30,40,Rain
79805,107,1554782400,7,33,40,Rain
79806,108,1554782400,16,24,40,Rain
79807,109,1554782400,14,15,29,Rain
79808,110,1554782400,24,16,40,Rain
79809,111,1554782400,16,24,40,Rain
79810,112,1554782400,5,25,30,Rain
79811,113,1554782400,34,6,40,Rain
79812,114,1554782400,40,0,40,Rain
79813,115,1554782400,5,25,30,Rain
79814,2,1554786000,5,15,20,Mist
79815,3,1554786000,13,7,20,Mist
79816,4,1554786000,18,2,20,Mist
79817,5,1554786000,22,18,40,Mist
79818,6,1554786000,20,0,20,Mist
79819,7,1554786000,29,0,29,Mist
79820,8,1554786000,21,9,30,Mist
79821,9,1554786000,24,0,24,Mist
79822,10,1554786000,16,0,16,Mist
79823,11,1554786000,30,0,30,Mist
79824,12,1554786000,0,20,20,Mist
79825,13,1554786000,22,8,30,Mist
79826,14,1554786000,16,14,30,Mist
79827,15,1554786000,5,11,16,Mist
79828,16,1554786000,18,2,20,Mist
79829,17,1554786000,15,5,20,Mist
79830,18,1554786000,20,10,30,Mist
79831,19,1554786000,29,1,30,Mist
79832,21,1554786000,30,0,30,Mist
79833,22,1554786000,15,5,20,Mist
79834,23,1554786000,30,0,30,Mist
79835,24,1554786000,18,2,20,Mist
79836,25,1554786000,29,1,30,Mist
79837,26,1554786000,15,5,20,Mist
79838,27,1554786000,20,0,20,Mist
79839,28,1554786000,13,17,30,Mist
79840,29,1554786000,29,0,29,Mist
79841,30,1554786000,19,1,20,Mist
79842,31,1554786000,14,6,20,Mist
79843,32,1554786000,30,0,30,Mist
79844,33,1554786000,21,2,23,Mist
79845,34,1554786000,7,22,29,Mist
79846,35,1554786000,19,11,30,Mist
79847,36,1554786000,38,2,40,Mist
79848,37,1554786000,30,0,30,Mist
79849,38,1554786000,15,25,40,Mist
79850,39,1554786000,15,5,20,Mist
79851,40,1554786000,20,1,21,Mist
79852,41,1554786000,20,0,20,Mist
79853,42,1554786000,10,20,30,Mist
79854,43,1554786000,10,20,30,Mist
79855,44,1554786000,1,29,30,Mist
79856,45,1554786000,8,22,30,Mist
79857,46,1554786000,19,1,20,Mist
79858,47,1554786000,38,2,40,Mist
79859,48,1554786000,28,12,40,Mist
79860,49,1554786000,40,0,40,Mist
79861,50,1554786000,11,29,40,Mist
79862,51,1554786000,40,0,40,Mist
79863,52,1554786000,32,0,32,Mist
79864,53,1554786000,40,0,40,Mist
79865,54,1554786000,32,1,33,Mist
79866,55,1554786000,36,0,36,Mist
79867,56,1554786000,37,3,40,Mist
79868,57,1554786000,23,0,23,Mist
79869,58,1554786000,38,2,40,Mist
79870,59,1554786000,18,2,20,Mist
79871,60,1554786000,7,23,30,Mist
79872,61,1554786000,18,7,25,Mist
79873,62,1554786000,40,0,40,Mist
79874,63,1554786000,34,1,35,Mist
79875,64,1554786000,32,8,40,Mist
79876,65,1554786000,38,2,40,Mist
79877,66,1554786000,26,14,40,Mist
79878,67,1554786000,38,2,40,Mist
79879,68,1554786000,40,0,40,Mist
79880,69,1554786000,38,2,40,Mist
79881,70,1554786000,10,18,28,Mist
79882,71,1554786000,27,13,40,Mist
79883,72,1554786000,9,22,31,Mist
79884,73,1554786000,10,20,30,Mist
79885,74,1554786000,17,13,30,Mist
79886,75,1554786000,21,19,40,Mist
79887,76,1554786000,13,25,38,Mist
79888,77,1554786000,28,1,29,Mist
79889,78,1554786000,12,28,40,Mist
79890,79,1554786000,6,21,27,Mist
79891,80,1554786000,14,26,40,Mist
79892,81,1554786000,37,3,40,Mist
79893,82,1554786000,6,16,22,Mist
79894,83,1554786000,12,28,40,Mist
79895,84,1554786000,4,26,30,Mist
79896,85,1554786000,8,27,35,Mist
79897,86,1554786000,11,27,38,Mist
79898,87,1554786000,12,26,38,Mist
79899,88,1554786000,13,17,30,Mist
79900,89,1554786000,39,1,40,Mist
79901,90,1554786000,39,1,40,Mist
79902,91,1554786000,11,19,30,Mist
79903,92,1554786000,5,35,40,Mist
79904,93,1554786000,1,39,40,Mist
79905,94,1554786000,13,27,40,Mist
79906,95,1554786000,8,32,40,Mist
79907,96,1554786000,22,8,30,Mist
79908,97,1554786000,7,33,40,Mist
79909,98,1554786000,40,0,40,Mist
79910,99,1554786000,22,8,30,Mist
79911,100,1554786000,12,13,25,Mist
79912,101,1554786000,20,10,30,Mist
79913,102,1554786000,34,6,40,Mist
79914,103,1554786000,33,7,40,Mist
79915,104,1554786000,32,8,40,Mist
79916,105,1554786000,18,18,36,Mist
79917,106,1554786000,10,30,40,Mist
79918,107,1554786000,7,33,40,Mist
79919,108,1554786000,16,24,40,Mist
79920,109,1554786000,14,15,29,Mist
79921,110,1554786000,24,16,40,Mist
79922,111,1554786000,17,23,40,Mist
79923,112,1554786000,5,25,30,Mist
79924,113,1554786000,34,6,40,Mist
79925,114,1554786000,40,0,40,Mist
79926,115,1554786000,5,25,30,Mist
79927,2,1554789600,5,15,20,Clouds
79928,3,1554789600,13,7,20,Clouds
79929,4,1554789600,19,1,20,Clouds
79930,5,1554789600,24,16,40,Clouds
79931,6,1554789600,20,0,20,Clouds
79932,7,1554789600,29,0,29,Clouds
79933,8,1554789600,24,6,30,Clouds
79934,9,1554789600,20,4,24,Clouds
79935,10,1554789600,14,2,16,Clouds
79936,11,1554789600,29,1,30,Clouds
79937,12,1554789600,3,17,20,Clouds
79938,13,1554789600,30,0,30,Clouds
79939,14,1554789600,13,17,30,Clouds
79940,15,1554789600,5,11,16,Clouds
79941,16,1554789600,17,3,20,Clouds
79942,17,1554789600,16,4,20,Clouds
79943,18,1554789600,3,27,30,Clouds
79944,19,1554789600,24,6,30,Clouds
79945,21,1554789600,29,1,30,Clouds
79946,22,1554789600,13,7,20,Clouds
79947,23,1554789600,30,0,30,Clouds
79948,24,1554789600,16,4,20,Clouds
79949,25,1554789600,28,2,30,Clouds
79950,26,1554789600,15,5,20,Clouds
79951,27,1554789600,20,0,20,Clouds
79952,28,1554789600,4,26,30,Clouds
79953,29,1554789600,29,0,29,Clouds
79954,30,1554789600,19,1,20,Clouds
79955,31,1554789600,12,8,20,Clouds
79956,32,1554789600,30,0,30,Clouds
79957,33,1554789600,16,7,23,Clouds
79958,34,1554789600,11,19,30,Clouds
79959,35,1554789600,25,5,30,Clouds
79960,36,1554789600,36,4,40,Clouds
79961,37,1554789600,30,0,30,Clouds
79962,38,1554789600,15,25,40,Clouds
79963,39,1554789600,13,7,20,Clouds
79964,40,1554789600,21,0,21,Clouds
79965,41,1554789600,20,0,20,Clouds
79966,42,1554789600,11,19,30,Clouds
79967,43,1554789600,16,14,30,Clouds
79968,44,1554789600,9,21,30,Clouds
79969,45,1554789600,8,22,30,Clouds
79970,46,1554789600,20,0,20,Clouds
79971,47,1554789600,37,3,40,Clouds
79972,48,1554789600,35,5,40,Clouds
79973,49,1554789600,38,2,40,Clouds
79974,50,1554789600,13,27,40,Clouds
79975,51,1554789600,40,0,40,Clouds
79976,52,1554789600,26,6,32,Clouds
79977,53,1554789600,40,0,40,Clouds
79978,54,1554789600,32,1,33,Clouds
79979,55,1554789600,36,0,36,Clouds
79980,56,1554789600,39,1,40,Clouds
79981,57,1554789600,22,1,23,Clouds
79982,58,1554789600,34,6,40,Clouds
79983,59,1554789600,18,2,20,Clouds
79984,60,1554789600,3,27,30,Clouds
79985,61,1554789600,3,22,25,Clouds
79986,62,1554789600,38,2,40,Clouds
79987,63,1554789600,33,2,35,Clouds
79988,64,1554789600,31,9,40,Clouds
79989,65,1554789600,37,3,40,Clouds
79990,66,1554789600,37,3,40,Clouds
79991,67,1554789600,40,0,40,Clouds
79992,68,1554789600,39,1,40,Clouds
79993,69,1554789600,34,6,40,Clouds
79994,70,1554789600,6,22,28,Clouds
79995,71,1554789600,26,14,40,Clouds
79996,72,1554789600,11,20,31,Clouds
79997,73,1554789600,10,20,30,Clouds
79998,74,1554789600,18,12,30,Clouds
79999,75,1554789600,23,17,40,Clouds
80000,76,1554789600,15,23,38,Clouds
80001,77,1554789600,28,1,29,Clouds
80002,78,1554789600,12,28,40,Clouds
80003,79,1554789600,5,22,27,Clouds
80004,80,1554789600,14,26,40,Clouds
80005,81,1554789600,37,3,40,Clouds
80006,82,1554789600,6,16,22,Clouds
80007,83,1554789600,14,26,40,Clouds
80008,84,1554789600,5,25,30,Clouds
80009,85,1554789600,8,27,35,Clouds
80010,86,1554789600,12,26,38,Clouds
80011,87,1554789600,14,24,38,Clouds
80012,88,1554789600,11,19,30,Clouds
80013,89,1554789600,40,0,40,Clouds
80014,90,1554789600,37,3,40,Clouds
80015,91,1554789600,10,20,30,Clouds
80016,92,1554789600,6,34,40,Clouds
80017,93,1554789600,1,39,40,Clouds
80018,94,1554789600,13,27,40,Clouds
80019,95,1554789600,8,32,40,Clouds
80020,96,1554789600,22,8,30,Clouds
80021,97,1554789600,9,31,40,Clouds
80022,98,1554789600,40,0,40,Clouds
80023,99,1554789600,19,11,30,Clouds
80024,100,1554789600,10,15,25,Clouds
80025,101,1554789600,26,4,30,Clouds
80026,102,1554789600,34,6,40,Clouds
80027,103,1554789600,33,7,40,Clouds
80028,104,1554789600,32,8,40,Clouds
80029,105,1554789600,19,17,36,Clouds
80030,106,1554789600,10,30,40,Clouds
80031,107,1554789600,12,28,40,Clouds
80032,108,1554789600,19,21,40,Clouds
80033,109,1554789600,19,10,29,Clouds
80034,110,1554789600,23,17,40,Clouds
80035,111,1554789600,18,22,40,Clouds
80036,112,1554789600,9,21,30,Clouds
80037,113,1554789600,35,5,40,Clouds
80038,114,1554789600,39,1,40,Clouds
80039,115,1554789600,7,23,30,Clouds
80040,2,1554793200,15,5,20,Mist
80041,3,1554793200,17,3,20,Mist
80042,4,1554793200,20,0,20,Mist
80043,5,1554793200,24,16,40,Mist
80044,6,1554793200,19,1,20,Mist
80045,7,1554793200,29,0,29,Mist
80046,8,1554793200,19,11,30,Mist
80047,9,1554793200,11,13,24,Mist
80048,10,1554793200,13,3,16,Mist
80049,11,1554793200,25,5,30,Mist
80050,12,1554793200,11,9,20,Mist
80051,13,1554793200,28,2,30,Mist
80052,14,1554793200,24,6,30,Mist
80053,15,1554793200,6,10,16,Mist
80054,16,1554793200,18,2,20,Mist
80055,17,1554793200,13,7,20,Mist
80056,18,1554793200,0,30,30,Mist
80057,19,1554793200,28,2,30,Mist
80058,21,1554793200,28,2,30,Mist
80059,22,1554793200,18,2,20,Mist
80060,23,1554793200,25,5,30,Mist
80061,24,1554793200,16,4,20,Mist
80062,25,1554793200,24,6,30,Mist
80063,26,1554793200,19,1,20,Mist
80064,27,1554793200,18,2,20,Mist
80065,28,1554793200,11,19,30,Mist
80066,29,1554793200,24,5,29,Mist
80067,30,1554793200,18,2,20,Mist
80068,31,1554793200,11,9,20,Mist
80069,32,1554793200,24,6,30,Mist
80070,33,1554793200,2,21,23,Mist
80071,34,1554793200,15,15,30,Mist
80072,35,1554793200,30,0,30,Mist
80073,36,1554793200,34,6,40,Mist
80074,37,1554793200,27,3,30,Mist
80075,38,1554793200,16,24,40,Mist
80076,39,1554793200,18,2,20,Mist
80077,40,1554793200,19,2,21,Mist
80078,41,1554793200,17,3,20,Mist
80079,42,1554793200,20,10,30,Mist
80080,43,1554793200,29,1,30,Mist
80081,44,1554793200,7,23,30,Mist
80082,45,1554793200,11,19,30,Mist
80083,46,1554793200,14,6,20,Mist
80084,47,1554793200,34,6,40,Mist
80085,48,1554793200,34,6,40,Mist
80086,49,1554793200,36,4,40,Mist
80087,50,1554793200,14,26,40,Mist
80088,51,1554793200,34,6,40,Mist
80089,52,1554793200,24,8,32,Mist
80090,53,1554793200,37,3,40,Mist
80091,54,1554793200,30,3,33,Mist
80092,55,1554793200,30,6,36,Mist
80093,56,1554793200,40,0,40,Mist
80094,57,1554793200,23,0,23,Mist
80095,58,1554793200,39,1,40,Mist
80096,59,1554793200,20,0,20,Mist
80097,60,1554793200,21,9,30,Mist
80098,61,1554793200,11,14,25,Mist
80099,62,1554793200,32,8,40,Mist
80100,63,1554793200,33,2,35,Mist
80101,64,1554793200,39,1,40,Mist
80102,65,1554793200,33,7,40,Mist
80103,66,1554793200,25,15,40,Mist
80104,67,1554793200,35,5,40,Mist
80105,68,1554793200,29,11,40,Mist
80106,69,1554793200,20,20,40,Mist
80107,70,1554793200,16,12,28,Mist
80108,71,1554793200,25,15,40,Mist
80109,72,1554793200,16,15,31,Mist
80110,73,1554793200,17,13,30,Mist
80111,74,1554793200,26,4,30,Mist
80112,75,1554793200,23,17,40,Mist
80113,76,1554793200,21,17,38,Mist
80114,77,1554793200,28,1,29,Mist
80115,78,1554793200,16,24,40,Mist
80116,79,1554793200,3,24,27,Mist
80117,80,1554793200,17,23,40,Mist
80118,81,1554793200,35,5,40,Mist
80119,82,1554793200,8,14,22,Mist
80120,83,1554793200,17,23,40,Mist
80121,84,1554793200,5,25,30,Mist
80122,85,1554793200,16,19,35,Mist
80123,86,1554793200,12,26,38,Mist
80124,87,1554793200,16,22,38,Mist
80125,88,1554793200,20,10,30,Mist
80126,89,1554793200,39,1,40,Mist
80127,90,1554793200,28,12,40,Mist
80128,91,1554793200,10,20,30,Mist
80129,92,1554793200,5,35,40,Mist
80130,93,1554793200,9,31,40,Mist
80131,94,1554793200,15,25,40,Mist
80132,95,1554793200,13,27,40,Mist
80133,96,1554793200,25,5,30,Mist
80134,97,1554793200,18,22,40,Mist
80135,98,1554793200,39,1,40,Mist
80136,99,1554793200,29,1,30,Mist
80137,100,1554793200,8,17,25,Mist
80138,101,1554793200,30,0,30,Mist
80139,102,1554793200,38,2,40,Mist
80140,103,1554793200,32,8,40,Mist
80141,104,1554793200,32,8,40,Mist
80142,105,1554793200,18,18,36,Mist
80143,106,1554793200,12,28,40,Mist
80144,107,1554793200,14,26,40,Mist
80145,108,1554793200,27,13,40,Mist
80146,109,1554793200,22,7,29,Mist
80147,110,1554793200,26,14,40,Mist
80148,111,1554793200,6,34,40,Mist
80149,112,1554793200,21,9,30,Mist
80150,113,1554793200,31,9,40,Mist
80151,114,1554793200,32,8,40,Mist
80152,115,1554793200,10,20,30,Mist
80153,2,1554796800,20,0,20,Clouds
80154,3,1554796800,20,0,20,Clouds
80155,4,1554796800,19,1,20,Clouds
80156,5,1554796800,36,4,40,Clouds
80157,6,1554796800,20,0,20,Clouds
80158,7,1554796800,29,0,29,Clouds
80159,8,1554796800,27,3,30,Clouds
80160,9,1554796800,16,8,24,Clouds
80161,10,1554796800,16,0,16,Clouds
80162,11,1554796800,13,17,30,Clouds
80163,12,1554796800,16,4,20,Clouds
80164,13,1554796800,21,9,30,Clouds
80165,14,1554796800,18,12,30,Clouds
80166,15,1554796800,14,2,16,Clouds
80167,16,1554796800,17,3,20,Clouds
80168,17,1554796800,10,10,20,Clouds
80169,18,1554796800,0,30,30,Clouds
80170,19,1554796800,23,7,30,Clouds
80171,21,1554796800,26,4,30,Clouds
80172,22,1554796800,8,12,20,Clouds
80173,23,1554796800,22,8,30,Clouds
80174,24,1554796800,17,3,20,Clouds
80175,25,1554796800,23,7,30,Clouds
80176,26,1554796800,14,6,20,Clouds
80177,27,1554796800,12,8,20,Clouds
80178,28,1554796800,19,10,29,Clouds
80179,29,1554796800,29,0,29,Clouds
80180,30,1554796800,20,0,20,Clouds
80181,31,1554796800,17,3,20,Clouds
80182,32,1554796800,19,11,30,Clouds
80183,33,1554796800,5,18,23,Clouds
80184,34,1554796800,30,0,30,Clouds
80185,35,1554796800,30,0,30,Clouds
80186,36,1554796800,21,19,40,Clouds
80187,37,1554796800,25,5,30,Clouds
80188,38,1554796800,18,21,39,Clouds
80189,39,1554796800,15,4,19,Clouds
80190,40,1554796800,19,2,21,Clouds
80191,41,1554796800,18,2,20,Clouds
80192,42,1554796800,28,2,30,Clouds
80193,43,1554796800,30,0,30,Clouds
80194,44,1554796800,10,20,30,Clouds
80195,45,1554796800,15,15,30,Clouds
80196,46,1554796800,19,1,20,Clouds
80197,47,1554796800,34,6,40,Clouds
80198,48,1554796800,36,4,40,Clouds
80199,49,1554796800,33,7,40,Clouds
80200,50,1554796800,33,7,40,Clouds
80201,51,1554796800,26,14,40,Clouds
80202,52,1554796800,11,21,32,Clouds
80203,53,1554796800,30,10,40,Clouds
80204,54,1554796800,27,6,33,Clouds
80205,55,1554796800,25,11,36,Clouds
80206,56,1554796800,23,17,40,Clouds
80207,57,1554796800,19,4,23,Clouds
80208,58,1554796800,18,22,40,Clouds
80209,59,1554796800,18,2,20,Clouds
80210,60,1554796800,16,14,30,Clouds
80211,61,1554796800,13,12,25,Clouds
80212,62,1554796800,32,8,40,Clouds
80213,63,1554796800,25,10,35,Clouds
80214,64,1554796800,37,3,40,Clouds
80215,65,1554796800,36,4,40,Clouds
80216,66,1554796800,1,39,40,Clouds
80217,67,1554796800,28,12,40,Clouds
80218,68,1554796800,28,12,40,Clouds
80219,69,1554796800,2,38,40,Clouds
80220,70,1554796800,12,16,28,Clouds
80221,71,1554796800,29,11,40,Clouds
80222,72,1554796800,31,0,31,Clouds
80223,73,1554796800,29,1,30,Clouds
80224,74,1554796800,30,0,30,Clouds
80225,75,1554796800,40,0,40,Clouds
80226,76,1554796800,28,10,38,Clouds
80227,77,1554796800,25,4,29,Clouds
80228,78,1554796800,19,20,39,Clouds
80229,79,1554796800,2,25,27,Clouds
80230,80,1554796800,25,15,40,Clouds
80231,81,1554796800,34,6,40,Clouds
80232,82,1554796800,13,9,22,Clouds
80233,83,1554796800,33,7,40,Clouds
80234,84,1554796800,15,15,30,Clouds
80235,85,1554796800,32,3,35,Clouds
80236,86,1554796800,35,3,38,Clouds
80237,87,1554796800,26,12,38,Clouds
80238,88,1554796800,26,4,30,Clouds
80239,89,1554796800,35,5,40,Clouds
80240,90,1554796800,0,40,40,Clouds
80241,91,1554796800,19,11,30,Clouds
80242,92,1554796800,24,16,40,Clouds
80243,93,1554796800,34,6,40,Clouds
80244,94,1554796800,15,25,40,Clouds
80245,95,1554796800,19,21,40,Clouds
80246,96,1554796800,27,3,30,Clouds
80247,97,1554796800,40,0,40,Clouds
80248,98,1554796800,38,2,40,Clouds
80249,99,1554796800,29,1,30,Clouds
80250,100,1554796800,25,0,25,Clouds
80251,101,1554796800,30,0,30,Clouds
80252,102,1554796800,40,0,40,Clouds
80253,103,1554796800,31,9,40,Clouds
80254,104,1554796800,31,9,40,Clouds
80255,105,1554796800,19,17,36,Clouds
80256,106,1554796800,14,26,40,Clouds
80257,107,1554796800,30,10,40,Clouds
80258,108,1554796800,26,14,40,Clouds
80259,109,1554796800,27,2,29,Clouds
80260,110,1554796800,31,9,40,Clouds
80261,111,1554796800,20,20,40,Clouds
80262,112,1554796800,29,1,30,Clouds
80263,113,1554796800,38,2,40,Clouds
80264,114,1554796800,25,15,40,Clouds
80265,115,1554796800,22,8,30,Clouds
80266,2,1554800400,20,0,20,Clouds
80267,3,1554800400,15,5,20,Clouds
80268,4,1554800400,20,0,20,Clouds
80269,5,1554800400,40,0,40,Clouds
80270,6,1554800400,20,0,20,Clouds
80271,7,1554800400,29,0,29,Clouds
80272,8,1554800400,26,4,30,Clouds
80273,9,1554800400,11,13,24,Clouds
80274,10,1554800400,13,2,15,Clouds
80275,11,1554800400,0,30,30,Clouds
80276,12,1554800400,6,14,20,Clouds
80277,13,1554800400,15,15,30,Clouds
80278,14,1554800400,30,0,30,Clouds
80279,15,1554800400,13,3,16,Clouds
80280,16,1554800400,18,2,20,Clouds
80281,17,1554800400,20,0,20,Clouds
80282,18,1554800400,30,0,30,Clouds
80283,19,1554800400,9,21,30,Clouds
80284,21,1554800400,13,16,29,Clouds
80285,22,1554800400,20,0,20,Clouds
80286,23,1554800400,28,2,30,Clouds
80287,24,1554800400,18,2,20,Clouds
80288,25,1554800400,3,27,30,Clouds
80289,26,1554800400,10,10,20,Clouds
80290,27,1554800400,13,7,20,Clouds
80291,28,1554800400,28,1,29,Clouds
80292,29,1554800400,29,0,29,Clouds
80293,30,1554800400,20,0,20,Clouds
80294,31,1554800400,16,4,20,Clouds
80295,32,1554800400,27,3,30,Clouds
80296,33,1554800400,17,6,23,Clouds
80297,34,1554800400,24,6,30,Clouds
80298,35,1554800400,29,1,30,Clouds
80299,36,1554800400,0,40,40,Clouds
80300,37,1554800400,18,12,30,Clouds
80301,38,1554800400,38,1,39,Clouds
80302,39,1554800400,18,1,19,Clouds
80303,40,1554800400,18,3,21,Clouds
80304,41,1554800400,12,8,20,Clouds
80305,42,1554800400,28,2,30,Clouds
80306,43,1554800400,29,1,30,Clouds
80307,44,1554800400,30,0,30,Clouds
80308,45,1554800400,23,7,30,Clouds
80309,46,1554800400,19,1,20,Clouds
80310,47,1554800400,4,36,40,Clouds
80311,48,1554800400,31,9,40,Clouds
80312,49,1554800400,20,20,40,Clouds
80313,50,1554800400,38,2,40,Clouds
80314,51,1554800400,24,16,40,Clouds
80315,52,1554800400,17,15,32,Clouds
80316,53,1554800400,23,17,40,Clouds
80317,54,1554800400,22,11,33,Clouds
80318,55,1554800400,9,27,36,Clouds
80319,56,1554800400,10,30,40,Clouds
80320,57,1554800400,1,22,23,Clouds
80321,58,1554800400,0,40,40,Clouds
80322,59,1554800400,19,1,20,Clouds
80323,60,1554800400,30,0,30,Clouds
80324,61,1554800400,25,0,25,Clouds
80325,62,1554800400,6,34,40,Clouds
80326,63,1554800400,7,28,35,Clouds
80327,64,1554800400,23,17,40,Clouds
80328,65,1554800400,28,12,40,Clouds
80329,66,1554800400,2,38,40,Clouds
80330,67,1554800400,15,25,40,Clouds
80331,68,1554800400,0,40,40,Clouds
80332,69,1554800400,0,40,40,Clouds
80333,70,1554800400,9,18,27,Clouds
80334,71,1554800400,40,0,40,Clouds
80335,72,1554800400,31,0,31,Clouds
80336,73,1554800400,28,2,30,Clouds
80337,74,1554800400,29,1,30,Clouds
80338,75,1554800400,40,0,40,Clouds
80339,76,1554800400,38,0,38,Clouds
80340,77,1554800400,28,1,29,Clouds
80341,78,1554800400,40,0,40,Clouds
80342,79,1554800400,22,5,27,Clouds
80343,80,1554800400,40,0,40,Clouds
80344,81,1554800400,40,0,40,Clouds
80345,82,1554800400,22,0,22,Clouds
80346,83,1554800400,40,0,40,Clouds
80347,84,1554800400,30,0,30,Clouds
80348,85,1554800400,35,0,35,Clouds
80349,86,1554800400,37,1,38,Clouds
80350,87,1554800400,38,0,38,Clouds
80351,88,1554800400,30,0,30,Clouds
80352,89,1554800400,22,18,40,Clouds
80353,90,1554800400,0,39,39,Clouds
80354,91,1554800400,26,4,30,Clouds
80355,92,1554800400,40,0,40,Clouds
80356,93,1554800400,40,0,40,Clouds
80357,94,1554800400,38,2,40,Clouds
80358,95,1554800400,40,0,40,Clouds
80359,96,1554800400,30,0,30,Clouds
80360,97,1554800400,40,0,40,Clouds
80361,98,1554800400,39,1,40,Clouds
80362,99,1554800400,20,10,30,Clouds
80363,100,1554800400,15,10,25,Clouds
80364,101,1554800400,30,0,30,Clouds
80365,102,1554800400,40,0,40,Clouds
80366,103,1554800400,35,5,40,Clouds
80367,104,1554800400,29,11,40,Clouds
80368,105,1554800400,24,12,36,Clouds
80369,106,1554800400,27,13,40,Clouds
80370,107,1554800400,40,0,40,Clouds
80371,108,1554800400,31,9,40,Clouds
80372,109,1554800400,27,2,29,Clouds
80373,110,1554800400,40,0,40,Clouds
80374,111,1554800400,40,0,40,Clouds
80375,112,1554800400,30,0,30,Clouds
80376,113,1554800400,33,7,40,Clouds
80377,114,1554800400,11,29,40,Clouds
80378,115,1554800400,28,2,30,Clouds
80379,2,1554804000,19,1,20,Clouds
80380,3,1554804000,16,4,20,Clouds
80381,4,1554804000,15,5,20,Clouds
80382,5,1554804000,27,13,40,Clouds
80383,6,1554804000,17,3,20,Clouds
80384,7,1554804000,27,2,29,Clouds
80385,8,1554804000,23,7,30,Clouds
80386,9,1554804000,5,19,24,Clouds
80387,10,1554804000,13,2,15,Clouds
80388,11,1554804000,12,18,30,Clouds
80389,12,1554804000,6,14,20,Clouds
80390,13,1554804000,10,20,30,Clouds
80391,14,1554804000,24,6,30,Clouds
80392,15,1554804000,16,0,16,Clouds
80393,16,1554804000,16,4,20,Clouds
80394,17,1554804000,18,2,20,Clouds
80395,18,1554804000,28,2,30,Clouds
80396,19,1554804000,10,20,30,Clouds
80397,21,1554804000,3,26,29,Clouds
80398,22,1554804000,20,0,20,Clouds
80399,23,1554804000,24,6,30,Clouds
80400,24,1554804000,20,0,20,Clouds
80401,25,1554804000,0,30,30,Clouds
80402,26,1554804000,6,13,19,Clouds
80403,27,1554804000,5,15,20,Clouds
80404,28,1554804000,13,16,29,Clouds
80405,29,1554804000,29,0,29,Clouds
80406,30,1554804000,18,2,20,Clouds
80407,31,1554804000,19,1,20,Clouds
80408,32,1554804000,18,12,30,Clouds
80409,33,1554804000,8,15,23,Clouds
80410,34,1554804000,30,0,30,Clouds
80411,35,1554804000,29,1,30,Clouds
80412,36,1554804000,1,39,40,Clouds
80413,37,1554804000,20,10,30,Clouds
80414,38,1554804000,36,3,39,Clouds
80415,39,1554804000,7,12,19,Clouds
80416,40,1554804000,12,9,21,Clouds
80417,41,1554804000,3,17,20,Clouds
80418,42,1554804000,29,1,30,Clouds
80419,43,1554804000,27,3,30,Clouds
80420,44,1554804000,30,0,30,Clouds
80421,45,1554804000,27,3,30,Clouds
80422,46,1554804000,18,2,20,Clouds
80423,47,1554804000,0,39,39,Clouds
80424,48,1554804000,19,21,40,Clouds
80425,49,1554804000,13,27,40,Clouds
80426,50,1554804000,40,0,40,Clouds
80427,51,1554804000,21,19,40,Clouds
80428,52,1554804000,14,18,32,Clouds
80429,53,1554804000,10,30,40,Clouds
80430,54,1554804000,12,21,33,Clouds
80431,55,1554804000,7,29,36,Clouds
80432,56,1554804000,1,39,40,Clouds
80433,57,1554804000,1,22,23,Clouds
80434,58,1554804000,0,40,40,Clouds
80435,59,1554804000,20,0,20,Clouds
80436,60,1554804000,30,0,30,Clouds
80437,61,1554804000,25,0,25,Clouds
80438,62,1554804000,5,35,40,Clouds
80439,63,1554804000,0,35,35,Clouds
80440,64,1554804000,17,23,40,Clouds
80441,65,1554804000,15,25,40,Clouds
80442,66,1554804000,4,36,40,Clouds
80443,67,1554804000,6,33,39,Clouds
80444,68,1554804000,0,40,40,Clouds
80445,69,1554804000,15,25,40,Clouds
80446,70,1554804000,1,26,27,Clouds
80447,71,1554804000,39,1,40,Clouds
80448,72,1554804000,31,0,31,Clouds
80449,73,1554804000,29,1,30,Clouds
80450,74,1554804000,30,0,30,Clouds
80451,75,1554804000,40,0,40,Clouds
80452,76,1554804000,37,1,38,Clouds
80453,77,1554804000,28,1,29,Clouds
80454,78,1554804000,40,0,40,Clouds
80455,79,1554804000,23,4,27,Clouds
80456,80,1554804000,39,1,40,Clouds
80457,81,1554804000,40,0,40,Clouds
80458,82,1554804000,22,0,22,Clouds
80459,83,1554804000,40,0,40,Clouds
80460,84,1554804000,30,0,30,Clouds
80461,85,1554804000,35,0,35,Clouds
80462,86,1554804000,38,0,38,Clouds
80463,87,1554804000,37,1,38,Clouds
80464,88,1554804000,30,0,30,Clouds
80465,89,1554804000,12,28,40,Clouds
80466,90,1554804000,0,39,39,Clouds
80467,91,1554804000,12,18,30,Clouds
80468,92,1554804000,40,0,40,Clouds
80469,93,1554804000,40,0,40,Clouds
80470,94,1554804000,40,0,40,Clouds
80471,95,1554804000,40,0,40,Clouds
80472,96,1554804000,30,0,30,Clouds
80473,97,1554804000,40,0,40,Clouds
80474,98,1554804000,38,2,40,Clouds
80475,99,1554804000,16,14,30,Clouds
80476,100,1554804000,25,0,25,Clouds
80477,101,1554804000,28,2,30,Clouds
80478,102,1554804000,40,0,40,Clouds
80479,103,1554804000,37,3,40,Clouds
80480,104,1554804000,28,12,40,Clouds
80481,105,1554804000,26,10,36,Clouds
80482,106,1554804000,33,7,40,Clouds
80483,107,1554804000,40,0,40,Clouds
80484,108,1554804000,39,1,40,Clouds
80485,109,1554804000,29,0,29,Clouds
80486,110,1554804000,40,0,40,Clouds
80487,111,1554804000,39,1,40,Clouds
80488,112,1554804000,30,0,30,Clouds
80489,113,1554804000,19,20,39,Clouds
80490,114,1554804000,1,39,40,Clouds
80491,115,1554804000,29,1,30,Clouds
80492,2,1554807600,19,1,20,Clouds
80493,3,1554807600,10,10,20,Clouds
80494,4,1554807600,16,4,20,Clouds
80495,5,1554807600,32,8,40,Clouds
80496,6,1554807600,17,3,20,Clouds
80497,7,1554807600,28,1,29,Clouds
80498,8,1554807600,26,4,30,Clouds
80499,9,1554807600,5,19,24,Clouds
80500,10,1554807600,10,5,15,Clouds
80501,11,1554807600,11,19,30,Clouds
80502,12,1554807600,13,7,20,Clouds
80503,13,1554807600,11,19,30,Clouds
80504,14,1554807600,22,7,29,Clouds
80505,15,1554807600,15,1,16,Clouds
80506,16,1554807600,13,7,20,Clouds
80507,17,1554807600,20,0,20,Clouds
80508,18,1554807600,30,0,30,Clouds
80509,19,1554807600,5,25,30,Clouds
80510,21,1554807600,1,28,29,Clouds
80511,22,1554807600,18,2,20,Clouds
80512,23,1554807600,28,2,30,Clouds
80513,24,1554807600,17,3,20,Clouds
80514,25,1554807600,0,29,29,Clouds
80515,26,1554807600,4,15,19,Clouds
80516,27,1554807600,1,19,20,Clouds
80517,28,1554807600,25,4,29,Clouds
80518,29,1554807600,24,5,29,Clouds
80519,30,1554807600,20,0,20,Clouds
80520,31,1554807600,20,0,20,Clouds
80521,32,1554807600,10,20,30,Clouds
80522,33,1554807600,8,15,23,Clouds
80523,34,1554807600,29,1,30,Clouds
80524,35,1554807600,30,0,30,Clouds
80525,36,1554807600,1,39,40,Clouds
80526,37,1554807600,20,10,30,Clouds
80527,38,1554807600,39,0,39,Clouds
80528,39,1554807600,8,11,19,Clouds
80529,40,1554807600,13,8,21,Clouds
80530,41,1554807600,0,20,20,Clouds
80531,42,1554807600,30,0,30,Clouds
80532,43,1554807600,24,6,30,Clouds
80533,44,1554807600,28,2,30,Clouds
80534,45,1554807600,28,2,30,Clouds
80535,46,1554807600,19,1,20,Clouds
80536,47,1554807600,9,30,39,Clouds
80537,48,1554807600,11,29,40,Clouds
80538,49,1554807600,7,33,40,Clouds
80539,50,1554807600,40,0,40,Clouds
80540,51,1554807600,18,22,40,Clouds
80541,52,1554807600,13,19,32,Clouds
80542,53,1554807600,9,31,40,Clouds
80543,54,1554807600,18,15,33,Clouds
80544,55,1554807600,7,29,36,Clouds
80545,56,1554807600,10,30,40,Clouds
80546,57,1554807600,1,22,23,Clouds
80547,58,1554807600,8,32,40,Clouds
80548,59,1554807600,20,0,20,Clouds
80549,60,1554807600,17,13,30,Clouds
80550,61,1554807600,25,0,25,Clouds
80551,62,1554807600,6,34,40,Clouds
80552,63,1554807600,1,34,35,Clouds
80553,64,1554807600,32,8,40,Clouds
80554,65,1554807600,13,27,40,Clouds
80555,66,1554807600,6,34,40,Clouds
80556,67,1554807600,6,33,39,Clouds
80557,68,1554807600,7,33,40,Clouds
80558,69,1554807600,8,32,40,Clouds
80559,70,1554807600,3,24,27,Clouds
80560,71,1554807600,33,7,40,Clouds
80561,72,1554807600,31,0,31,Clouds
80562,73,1554807600,30,0,30,Clouds
80563,74,1554807600,30,0,30,Clouds
80564,75,1554807600,40,0,40,Clouds
80565,76,1554807600,37,1,38,Clouds
80566,77,1554807600,25,4,29,Clouds
80567,78,1554807600,31,9,40,Clouds
80568,79,1554807600,24,3,27,Clouds
80569,80,1554807600,40,0,40,Clouds
80570,81,1554807600,40,0,40,Clouds
80571,82,1554807600,22,0,22,Clouds
80572,83,1554807600,40,0,40,Clouds
80573,84,1554807600,29,1,30,Clouds
80574,85,1554807600,35,0,35,Clouds
80575,86,1554807600,38,0,38,Clouds
80576,87,1554807600,36,2,38,Clouds
80577,88,1554807600,29,1,30,Clouds
80578,89,1554807600,9,31,40,Clouds
80579,90,1554807600,1,38,39,Clouds
80580,91,1554807600,14,16,30,Clouds
80581,92,1554807600,40,0,40,Clouds
80582,93,1554807600,40,0,40,Clouds
80583,94,1554807600,40,0,40,Clouds
80584,95,1554807600,40,0,40,Clouds
80585,96,1554807600,30,0,30,Clouds
80586,97,1554807600,40,0,40,Clouds
80587,98,1554807600,34,6,40,Clouds
80588,99,1554807600,14,16,30,Clouds
80589,100,1554807600,25,0,25,Clouds
80590,101,1554807600,28,2,30,Clouds
80591,102,1554807600,40,0,40,Clouds
80592,103,1554807600,36,4,40,Clouds
80593,104,1554807600,28,12,40,Clouds
80594,105,1554807600,26,10,36,Clouds
80595,106,1554807600,34,6,40,Clouds
80596,107,1554807600,40,0,40,Clouds
80597,108,1554807600,40,0,40,Clouds
80598,109,1554807600,29,0,29,Clouds
80599,110,1554807600,39,1,40,Clouds
80600,111,1554807600,40,0,40,Clouds
80601,112,1554807600,30,0,30,Clouds
80602,113,1554807600,18,21,39,Clouds
80603,114,1554807600,0,40,40,Clouds
80604,115,1554807600,30,0,30,Clouds
80605,2,1554811200,19,1,20,Clouds
80606,3,1554811200,13,7,20,Clouds
80607,4,1554811200,20,0,20,Clouds
80608,5,1554811200,37,3,40,Clouds
80609,6,1554811200,19,1,20,Clouds
80610,7,1554811200,29,0,29,Clouds
80611,8,1554811200,29,1,30,Clouds
80612,9,1554811200,6,18,24,Clouds
80613,10,1554811200,13,2,15,Clouds
80614,11,1554811200,12,18,30,Clouds
80615,12,1554811200,12,8,20,Clouds
80616,13,1554811200,7,23,30,Clouds
80617,14,1554811200,16,13,29,Clouds
80618,15,1554811200,16,0,16,Clouds
80619,16,1554811200,16,4,20,Clouds
80620,17,1554811200,20,0,20,Clouds
80621,18,1554811200,29,1,30,Clouds
80622,19,1554811200,7,23,30,Clouds
80623,21,1554811200,0,29,29,Clouds
80624,22,1554811200,20,0,20,Clouds
80625,23,1554811200,30,0,30,Clouds
80626,24,1554811200,20,0,20,Clouds
80627,25,1554811200,1,28,29,Clouds
80628,26,1554811200,4,15,19,Clouds
80629,27,1554811200,0,20,20,Clouds
80630,28,1554811200,28,1,29,Clouds
80631,29,1554811200,22,7,29,Clouds
80632,30,1554811200,20,0,20,Clouds
80633,31,1554811200,20,0,20,Clouds
80634,32,1554811200,4,26,30,Clouds
80635,33,1554811200,7,16,23,Clouds
80636,34,1554811200,30,0,30,Clouds
80637,35,1554811200,30,0,30,Clouds
80638,36,1554811200,0,40,40,Clouds
80639,37,1554811200,21,9,30,Clouds
80640,38,1554811200,37,2,39,Clouds
80641,39,1554811200,4,15,19,Clouds
80642,40,1554811200,14,7,21,Clouds
80643,41,1554811200,0,20,20,Clouds
80644,42,1554811200,28,2,30,Clouds
80645,43,1554811200,23,7,30,Clouds
80646,44,1554811200,25,5,30,Clouds
80647,45,1554811200,27,3,30,Clouds
80648,46,1554811200,20,0,20,Clouds
80649,47,1554811200,9,30,39,Clouds
80650,48,1554811200,6,34,40,Clouds
80651,49,1554811200,10,30,40,Clouds
80652,50,1554811200,36,4,40,Clouds
80653,51,1554811200,19,21,40,Clouds
80654,52,1554811200,15,17,32,Clouds
80655,53,1554811200,6,34,40,Clouds
80656,54,1554811200,17,16,33,Clouds
80657,55,1554811200,9,27,36,Clouds
80658,56,1554811200,10,30,40,Clouds
80659,57,1554811200,0,23,23,Clouds
80660,58,1554811200,7,33,40,Clouds
80661,59,1554811200,20,0,20,Clouds
80662,60,1554811200,22,8,30,Clouds
80663,61,1554811200,25,0,25,Clouds
80664,62,1554811200,6,34,40,Clouds
80665,63,1554811200,1,34,35,Clouds
80666,64,1554811200,32,8,40,Clouds
80667,65,1554811200,12,28,40,Clouds
80668,66,1554811200,10,30,40,Clouds
80669,67,1554811200,8,31,39,Clouds
80670,68,1554811200,1,39,40,Clouds
80671,69,1554811200,11,29,40,Clouds
80672,70,1554811200,7,20,27,Clouds
80673,71,1554811200,39,1,40,Clouds
80674,72,1554811200,31,0,31,Clouds
80675,73,1554811200,30,0,30,Clouds
80676,74,1554811200,30,0,30,Clouds
80677,75,1554811200,40,0,40,Clouds
80678,76,1554811200,38,0,38,Clouds
80679,77,1554811200,27,2,29,Clouds
80680,78,1554811200,29,11,40,Clouds
80681,79,1554811200,14,13,27,Clouds
80682,80,1554811200,40,0,40,Clouds
80683,81,1554811200,40,0,40,Clouds
80684,82,1554811200,22,0,22,Clouds
80685,83,1554811200,40,0,40,Clouds
80686,84,1554811200,30,0,30,Clouds
80687,85,1554811200,35,0,35,Clouds
80688,86,1554811200,38,0,38,Clouds
80689,87,1554811200,38,0,38,Clouds
80690,88,1554811200,26,4,30,Clouds
80691,89,1554811200,9,31,40,Clouds
80692,90,1554811200,7,32,39,Clouds
80693,91,1554811200,10,20,30,Clouds
80694,92,1554811200,40,0,40,Clouds
80695,93,1554811200,40,0,40,Clouds
80696,94,1554811200,40,0,40,Clouds
80697,95,1554811200,38,2,40,Clouds
80698,96,1554811200,30,0,30,Clouds
80699,97,1554811200,40,0,40,Clouds
80700,98,1554811200,26,14,40,Clouds
80701,99,1554811200,15,15,30,Clouds
80702,100,1554811200,25,0,25,Clouds
80703,101,1554811200,28,2,30,Clouds
80704,102,1554811200,39,1,40,Clouds
80705,103,1554811200,40,0,40,Clouds
80706,104,1554811200,29,11,40,Clouds
80707,105,1554811200,27,9,36,Clouds
80708,106,1554811200,37,3,40,Clouds
80709,107,1554811200,38,2,40,Clouds
80710,108,1554811200,40,0,40,Clouds
80711,109,1554811200,29,0,29,Clouds
80712,110,1554811200,40,0,40,Clouds
80713,111,1554811200,40,0,40,Clouds
80714,112,1554811200,29,1,30,Clouds
80715,113,1554811200,19,20,39,Clouds
80716,114,1554811200,1,39,40,Clouds
80717,115,1554811200,30,0,30,Clouds
80718,2,1554814800,18,2,20,Clouds
80719,3,1554814800,20,0,20,Clouds
80720,4,1554814800,19,1,20,Clouds
80721,5,1554814800,36,4,40,Clouds
80722,6,1554814800,19,1,20,Clouds
80723,7,1554814800,21,8,29,Clouds
80724,8,1554814800,30,0,30,Clouds
80725,9,1554814800,2,22,24,Clouds
80726,10,1554814800,15,0,15,Clouds
80727,11,1554814800,19,11,30,Clouds
80728,12,1554814800,15,5,20,Clouds
80729,13,1554814800,12,18,30,Clouds
80730,14,1554814800,0,29,29,Clouds
80731,15,1554814800,15,1,16,Clouds
80732,16,1554814800,20,0,20,Clouds
80733,17,1554814800,19,1,20,Clouds
80734,18,1554814800,25,5,30,Clouds
80735,19,1554814800,5,25,30,Clouds
80736,21,1554814800,1,28,29,Clouds
80737,22,1554814800,20,0,20,Clouds
80738,23,1554814800,28,2,30,Clouds
80739,24,1554814800,18,2,20,Clouds
80740,25,1554814800,3,26,29,Clouds
80741,26,1554814800,7,12,19,Clouds
80742,27,1554814800,3,17,20,Clouds
80743,28,1554814800,28,1,29,Clouds
80744,29,1554814800,23,6,29,Clouds
80745,30,1554814800,17,3,20,Clouds
80746,31,1554814800,17,3,20,Clouds
80747,32,1554814800,5,25,30,Clouds
80748,33,1554814800,10,13,23,Clouds
80749,34,1554814800,30,0,30,Clouds
80750,35,1554814800,27,3,30,Clouds
80751,36,1554814800,11,29,40,Clouds
80752,37,1554814800,19,11,30,Clouds
80753,38,1554814800,39,0,39,Clouds
80754,39,1554814800,11,8,19,Clouds
80755,40,1554814800,16,5,21,Clouds
80756,41,1554814800,1,19,20,Clouds
80757,42,1554814800,27,3,30,Clouds
80758,43,1554814800,23,7,30,Clouds
80759,44,1554814800,30,0,30,Clouds
80760,45,1554814800,29,1,30,Clouds
80761,46,1554814800,19,1,20,Clouds
80762,47,1554814800,11,28,39,Clouds
80763,48,1554814800,14,26,40,Clouds
80764,49,1554814800,18,22,40,Clouds
80765,50,1554814800,39,1,40,Clouds
80766,51,1554814800,21,19,40,Clouds
80767,52,1554814800,15,17,32,Clouds
80768,53,1554814800,14,26,40,Clouds
80769,54,1554814800,15,18,33,Clouds
80770,55,1554814800,16,20,36,Clouds
80771,56,1554814800,16,23,39,Clouds
80772,57,1554814800,3,20,23,Clouds
80773,58,1554814800,22,18,40,Clouds
80774,59,1554814800,19,1,20,Clouds
80775,60,1554814800,24,6,30,Clouds
80776,61,1554814800,22,3,25,Clouds
80777,62,1554814800,10,30,40,Clouds
80778,63,1554814800,4,31,35,Clouds
80779,64,1554814800,30,10,40,Clouds
80780,65,1554814800,22,18,40,Clouds
80781,66,1554814800,8,32,40,Clouds
80782,67,1554814800,8,31,39,Clouds
80783,68,1554814800,3,37,40,Clouds
80784,69,1554814800,11,29,40,Clouds
80785,70,1554814800,8,19,27,Clouds
80786,71,1554814800,40,0,40,Clouds
80787,72,1554814800,17,14,31,Clouds
80788,73,1554814800,24,6,30,Clouds
80789,74,1554814800,30,0,30,Clouds
80790,75,1554814800,38,2,40,Clouds
80791,76,1554814800,38,0,38,Clouds
80792,77,1554814800,28,1,29,Clouds
80793,78,1554814800,29,11,40,Clouds
80794,79,1554814800,17,10,27,Clouds
80795,80,1554814800,31,9,40,Clouds
80796,81,1554814800,39,1,40,Clouds
80797,82,1554814800,22,0,22,Clouds
80798,83,1554814800,40,0,40,Clouds
80799,84,1554814800,30,0,30,Clouds
80800,85,1554814800,35,0,35,Clouds
80801,86,1554814800,38,0,38,Clouds
80802,87,1554814800,37,1,38,Clouds
80803,88,1554814800,27,3,30,Clouds
80804,89,1554814800,9,31,40,Clouds
80805,90,1554814800,13,26,39,Clouds
80806,91,1554814800,8,22,30,Clouds
80807,92,1554814800,40,0,40,Clouds
80808,93,1554814800,40,0,40,Clouds
80809,94,1554814800,40,0,40,Clouds
80810,95,1554814800,38,2,40,Clouds
80811,96,1554814800,30,0,30,Clouds
80812,97,1554814800,39,1,40,Clouds
80813,98,1554814800,17,23,40,Clouds
80814,99,1554814800,15,15,30,Clouds
80815,100,1554814800,21,4,25,Clouds
80816,101,1554814800,29,1,30,Clouds
80817,102,1554814800,40,0,40,Clouds
80818,103,1554814800,38,2,40,Clouds
80819,104,1554814800,30,10,40,Clouds
80820,105,1554814800,28,8,36,Clouds
80821,106,1554814800,40,0,40,Clouds
80822,107,1554814800,40,0,40,Clouds
80823,108,1554814800,40,0,40,Clouds
80824,109,1554814800,29,0,29,Clouds
80825,110,1554814800,40,0,40,Clouds
80826,111,1554814800,40,0,40,Clouds
80827,112,1554814800,30,0,30,Clouds
80828,113,1554814800,19,20,39,Clouds
80829,114,1554814800,8,32,40,Clouds
80830,115,1554814800,27,3,30,Clouds
80831,2,1554818400,20,0,20,Clouds
80832,3,1554818400,16,4,20,Clouds
80833,4,1554818400,18,2,20,Clouds
80834,5,1554818400,31,9,40,Clouds
80835,6,1554818400,18,2,20,Clouds
80836,7,1554818400,22,7,29,Clouds
80837,8,1554818400,25,5,30,Clouds
80838,9,1554818400,6,18,24,Clouds
80839,10,1554818400,13,2,15,Clouds
80840,11,1554818400,17,13,30,Clouds
80841,12,1554818400,15,5,20,Clouds
80842,13,1554818400,4,26,30,Clouds
80843,14,1554818400,5,24,29,Clouds
80844,15,1554818400,14,2,16,Clouds
80845,16,1554818400,20,0,20,Clouds
80846,17,1554818400,14,6,20,Clouds
80847,18,1554818400,22,8,30,Clouds
80848,19,1554818400,3,27,30,Clouds
80849,21,1554818400,11,18,29,Clouds
80850,22,1554818400,16,4,20,Clouds
80851,23,1554818400,25,5,30,Clouds
80852,24,1554818400,14,6,20,Clouds
80853,25,1554818400,0,29,29,Clouds
80854,26,1554818400,6,13,19,Clouds
80855,27,1554818400,5,15,20,Clouds
80856,28,1554818400,24,5,29,Clouds
80857,29,1554818400,24,5,29,Clouds
80858,30,1554818400,9,11,20,Clouds
80859,31,1554818400,17,3,20,Clouds
80860,32,1554818400,20,10,30,Clouds
80861,33,1554818400,23,0,23,Clouds
80862,34,1554818400,30,0,30,Clouds
80863,35,1554818400,30,0,30,Clouds
80864,36,1554818400,15,25,40,Clouds
80865,37,1554818400,19,11,30,Clouds
80866,38,1554818400,33,5,38,Clouds
80867,39,1554818400,15,4,19,Clouds
80868,40,1554818400,12,9,21,Clouds
80869,41,1554818400,4,16,20,Clouds
80870,42,1554818400,29,1,30,Clouds
80871,43,1554818400,30,0,30,Clouds
80872,44,1554818400,30,0,30,Clouds
80873,45,1554818400,29,1,30,Clouds
80874,46,1554818400,20,0,20,Clouds
80875,47,1554818400,7,32,39,Clouds
80876,48,1554818400,16,24,40,Clouds
80877,49,1554818400,13,27,40,Clouds
80878,50,1554818400,35,5,40,Clouds
80879,51,1554818400,23,17,40,Clouds
80880,52,1554818400,15,17,32,Clouds
80881,53,1554818400,13,27,40,Clouds
80882,54,1554818400,7,26,33,Clouds
80883,55,1554818400,22,14,36,Clouds
80884,56,1554818400,14,25,39,Clouds
80885,57,1554818400,2,21,23,Clouds
80886,58,1554818400,18,22,40,Clouds
80887,59,1554818400,20,0,20,Clouds
80888,60,1554818400,29,1,30,Clouds
80889,61,1554818400,16,9,25,Clouds
80890,62,1554818400,11,29,40,Clouds
80891,63,1554818400,12,23,35,Clouds
80892,64,1554818400,24,16,40,Clouds
80893,65,1554818400,16,24,40,Clouds
80894,66,1554818400,16,24,40,Clouds
80895,67,1554818400,17,22,39,Clouds
80896,68,1554818400,0,40,40,Clouds
80897,69,1554818400,0,40,40,Clouds
80898,70,1554818400,7,20,27,Clouds
80899,71,1554818400,40,0,40,Clouds
80900,72,1554818400,31,0,31,Clouds
80901,73,1554818400,26,4,30,Clouds
80902,74,1554818400,28,2,30,Clouds
80903,75,1554818400,40,0,40,Clouds
80904,76,1554818400,38,0,38,Clouds
80905,77,1554818400,21,8,29,Clouds
80906,78,1554818400,27,13,40,Clouds
80907,79,1554818400,21,6,27,Clouds
80908,80,1554818400,32,8,40,Clouds
80909,81,1554818400,22,18,40,Clouds
80910,82,1554818400,22,0,22,Clouds
80911,83,1554818400,38,2,40,Clouds
80912,84,1554818400,27,3,30,Clouds
80913,85,1554818400,35,0,35,Clouds
80914,86,1554818400,34,4,38,Clouds
80915,87,1554818400,37,1,38,Clouds
80916,88,1554818400,29,1,30,Clouds
80917,89,1554818400,10,30,40,Clouds
80918,90,1554818400,6,33,39,Clouds
80919,91,1554818400,10,20,30,Clouds
80920,92,1554818400,37,3,40,Clouds
80921,93,1554818400,40,0,40,Clouds
80922,94,1554818400,39,1,40,Clouds
80923,95,1554818400,40,0,40,Clouds
80924,96,1554818400,30,0,30,Clouds
80925,97,1554818400,40,0,40,Clouds
80926,98,1554818400,21,19,40,Clouds
80927,99,1554818400,16,14,30,Clouds
80928,100,1554818400,23,1,24,Clouds
80929,101,1554818400,28,2,30,Clouds
80930,102,1554818400,36,4,40,Clouds
80931,103,1554818400,39,1,40,Clouds
80932,104,1554818400,30,10,40,Clouds
80933,105,1554818400,31,5,36,Clouds
80934,106,1554818400,39,1,40,Clouds
80935,107,1554818400,38,2,40,Clouds
80936,108,1554818400,35,5,40,Clouds
80937,109,1554818400,27,2,29,Clouds
80938,110,1554818400,36,4,40,Clouds
80939,111,1554818400,39,1,40,Clouds
80940,112,1554818400,24,6,30,Clouds
80941,113,1554818400,19,20,39,Clouds
80942,114,1554818400,6,34,40,Clouds
80943,115,1554818400,29,1,30,Clouds
80944,2,1554822000,19,1,20,Clouds
80945,3,1554822000,20,0,20,Clouds
80946,4,1554822000,20,0,20,Clouds
80947,5,1554822000,34,6,40,Clouds
80948,6,1554822000,20,0,20,Clouds
80949,7,1554822000,26,3,29,Clouds
80950,8,1554822000,14,16,30,Clouds
80951,9,1554822000,3,21,24,Clouds
80952,10,1554822000,16,0,16,Clouds
80953,11,1554822000,17,13,30,Clouds
80954,12,1554822000,17,3,20,Clouds
80955,13,1554822000,5,25,30,Clouds
80956,14,1554822000,6,23,29,Clouds
80957,15,1554822000,15,1,16,Clouds
80958,16,1554822000,19,1,20,Clouds
80959,17,1554822000,13,7,20,Clouds
80960,18,1554822000,30,0,30,Clouds
80961,19,1554822000,5,25,30,Clouds
80962,21,1554822000,10,19,29,Clouds
80963,22,1554822000,17,3,20,Clouds
80964,23,1554822000,24,6,30,Clouds
80965,24,1554822000,17,3,20,Clouds
80966,25,1554822000,1,28,29,Clouds
80967,26,1554822000,3,16,19,Clouds
80968,27,1554822000,7,13,20,Clouds
80969,28,1554822000,14,15,29,Clouds
80970,29,1554822000,26,3,29,Clouds
80971,30,1554822000,12,8,20,Clouds
80972,31,1554822000,19,1,20,Clouds
80973,32,1554822000,15,15,30,Clouds
80974,33,1554822000,20,3,23,Clouds
80975,34,1554822000,26,4,30,Clouds
80976,35,1554822000,30,0,30,Clouds
80977,36,1554822000,9,31,40,Clouds
80978,37,1554822000,23,7,30,Clouds
80979,38,1554822000,27,12,39,Clouds
80980,39,1554822000,12,7,19,Clouds
80981,40,1554822000,14,7,21,Clouds
80982,41,1554822000,0,20,20,Clouds
80983,42,1554822000,27,3,30,Clouds
80984,43,1554822000,28,2,30,Clouds
80985,44,1554822000,30,0,30,Clouds
80986,45,1554822000,25,5,30,Clouds
80987,46,1554822000,20,0,20,Clouds
80988,47,1554822000,6,33,39,Clouds
80989,48,1554822000,16,24,40,Clouds
80990,49,1554822000,11,29,40,Clouds
80991,50,1554822000,34,6,40,Clouds
80992,51,1554822000,20,20,40,Clouds
80993,52,1554822000,19,13,32,Clouds
80994,53,1554822000,12,28,40,Clouds
80995,54,1554822000,10,23,33,Clouds
80996,55,1554822000,21,15,36,Clouds
80997,56,1554822000,9,30,39,Clouds
80998,57,1554822000,1,22,23,Clouds
80999,58,1554822000,18,22,40,Clouds
81000,59,1554822000,17,3,20,Clouds
81001,60,1554822000,27,3,30,Clouds
81002,61,1554822000,16,9,25,Clouds
81003,62,1554822000,10,30,40,Clouds
81004,63,1554822000,13,22,35,Clouds
81005,64,1554822000,20,20,40,Clouds
81006,65,1554822000,8,32,40,Clouds
81007,66,1554822000,20,20,40,Clouds
81008,67,1554822000,12,27,39,Clouds
81009,68,1554822000,1,39,40,Clouds
81010,69,1554822000,6,34,40,Clouds
81011,70,1554822000,4,23,27,Clouds
81012,71,1554822000,39,1,40,Clouds
81013,72,1554822000,28,3,31,Clouds
81014,73,1554822000,30,0,30,Clouds
81015,74,1554822000,27,3,30,Clouds
81016,75,1554822000,40,0,40,Clouds
81017,76,1554822000,34,4,38,Clouds
81018,77,1554822000,16,13,29,Clouds
81019,78,1554822000,27,13,40,Clouds
81020,79,1554822000,23,4,27,Clouds
81021,80,1554822000,34,6,40,Clouds
81022,81,1554822000,23,17,40,Clouds
81023,82,1554822000,22,0,22,Clouds
81024,83,1554822000,40,0,40,Clouds
81025,84,1554822000,30,0,30,Clouds
81026,85,1554822000,33,2,35,Clouds
81027,86,1554822000,34,4,38,Clouds
81028,87,1554822000,38,0,38,Clouds
81029,88,1554822000,30,0,30,Clouds
81030,89,1554822000,9,31,40,Clouds
81031,90,1554822000,7,32,39,Clouds
81032,91,1554822000,5,25,30,Clouds
81033,92,1554822000,37,3,40,Clouds
81034,93,1554822000,40,0,40,Clouds
81035,94,1554822000,38,2,40,Clouds
81036,95,1554822000,38,2,40,Clouds
81037,96,1554822000,30,0,30,Clouds
81038,97,1554822000,37,3,40,Clouds
81039,98,1554822000,24,16,40,Clouds
81040,99,1554822000,13,17,30,Clouds
81041,100,1554822000,17,8,25,Clouds
81042,101,1554822000,28,2,30,Clouds
81043,102,1554822000,36,4,40,Clouds
81044,103,1554822000,40,0,40,Clouds
81045,104,1554822000,30,10,40,Clouds
81046,105,1554822000,31,5,36,Clouds
81047,106,1554822000,38,2,40,Clouds
81048,107,1554822000,37,3,40,Clouds
81049,108,1554822000,37,3,40,Clouds
81050,109,1554822000,27,2,29,Clouds
81051,110,1554822000,35,5,40,Clouds
81052,111,1554822000,40,0,40,Clouds
81053,112,1554822000,24,6,30,Clouds
81054,113,1554822000,18,21,39,Clouds
81055,114,1554822000,8,32,40,Clouds
81056,115,1554822000,24,6,30,Clouds
81057,2,1554825600,20,0,20,Clouds
81058,3,1554825600,19,1,20,Clouds
81059,4,1554825600,20,0,20,Clouds
81060,5,1554825600,28,12,40,Clouds
81061,6,1554825600,13,7,20,Clouds
81062,7,1554825600,26,3,29,Clouds
81063,8,1554825600,14,16,30,Clouds
81064,9,1554825600,2,22,24,Clouds
81065,10,1554825600,12,5,17,Clouds
81066,11,1554825600,2,28,30,Clouds
81067,12,1554825600,20,0,20,Clouds
81068,13,1554825600,6,24,30,Clouds
81069,14,1554825600,16,13,29,Clouds
81070,15,1554825600,16,0,16,Clouds
81071,16,1554825600,18,2,20,Clouds
81072,17,1554825600,13,7,20,Clouds
81073,18,1554825600,30,0,30,Clouds
81074,19,1554825600,10,20,30,Clouds
81075,21,1554825600,12,18,30,Clouds
81076,22,1554825600,14,6,20,Clouds
81077,23,1554825600,24,6,30,Clouds
81078,24,1554825600,16,4,20,Clouds
81079,25,1554825600,6,24,30,Clouds
81080,26,1554825600,4,16,20,Clouds
81081,27,1554825600,8,12,20,Clouds
81082,28,1554825600,23,6,29,Clouds
81083,29,1554825600,22,7,29,Clouds
81084,30,1554825600,17,3,20,Clouds
81085,31,1554825600,17,3,20,Clouds
81086,32,1554825600,13,17,30,Clouds
81087,33,1554825600,20,3,23,Clouds
81088,34,1554825600,18,12,30,Clouds
81089,35,1554825600,27,3,30,Clouds
81090,36,1554825600,12,28,40,Clouds
81091,37,1554825600,23,7,30,Clouds
81092,38,1554825600,31,8,39,Clouds
81093,39,1554825600,8,12,20,Clouds
81094,40,1554825600,21,0,21,Clouds
81095,41,1554825600,1,19,20,Clouds
81096,42,1554825600,20,10,30,Clouds
81097,43,1554825600,29,1,30,Clouds
81098,44,1554825600,27,3,30,Clouds
81099,45,1554825600,22,8,30,Clouds
81100,46,1554825600,17,3,20,Clouds
81101,47,1554825600,9,31,40,Clouds
81102,48,1554825600,14,26,40,Clouds
81103,49,1554825600,8,32,40,Clouds
81104,50,1554825600,38,2,40,Clouds
81105,51,1554825600,24,16,40,Clouds
81106,52,1554825600,21,11,32,Clouds
81107,53,1554825600,18,22,40,Clouds
81108,54,1554825600,19,14,33,Clouds
81109,55,1554825600,27,9,36,Clouds
81110,56,1554825600,4,35,39,Clouds
81111,57,1554825600,1,22,23,Clouds
81112,58,1554825600,19,21,40,Clouds
81113,59,1554825600,20,0,20,Clouds
81114,60,1554825600,19,11,30,Clouds
81115,61,1554825600,13,12,25,Clouds
81116,62,1554825600,13,27,40,Clouds
81117,63,1554825600,12,23,35,Clouds
81118,64,1554825600,18,22,40,Clouds
81119,65,1554825600,9,31,40,Clouds
81120,66,1554825600,27,13,40,Clouds
81121,67,1554825600,15,24,39,Clouds
81122,68,1554825600,9,31,40,Clouds
81123,69,1554825600,16,24,40,Clouds
81124,70,1554825600,4,23,27,Clouds
81125,71,1554825600,37,3,40,Clouds
81126,72,1554825600,31,0,31,Clouds
81127,73,1554825600,29,1,30,Clouds
81128,74,1554825600,30,0,30,Clouds
81129,75,1554825600,36,4,40,Clouds
81130,76,1554825600,33,5,38,Clouds
81131,77,1554825600,1,28,29,Clouds
81132,78,1554825600,24,16,40,Clouds
81133,79,1554825600,27,0,27,Clouds
81134,80,1554825600,36,4,40,Clouds
81135,81,1554825600,23,17,40,Clouds
81136,82,1554825600,22,0,22,Clouds
81137,83,1554825600,39,1,40,Clouds
81138,84,1554825600,29,1,30,Clouds
81139,85,1554825600,32,3,35,Clouds
81140,86,1554825600,38,0,38,Clouds
81141,87,1554825600,36,2,38,Clouds
81142,88,1554825600,29,1,30,Clouds
81143,89,1554825600,12,28,40,Clouds
81144,90,1554825600,11,28,39,Clouds
81145,91,1554825600,7,23,30,Clouds
81146,92,1554825600,40,0,40,Clouds
81147,93,1554825600,40,0,40,Clouds
81148,94,1554825600,37,3,40,Clouds
81149,95,1554825600,36,4,40,Clouds
81150,96,1554825600,30,0,30,Clouds
81151,97,1554825600,35,5,40,Clouds
81152,98,1554825600,29,11,40,Clouds
81153,99,1554825600,13,17,30,Clouds
81154,100,1554825600,15,10,25,Clouds
81155,101,1554825600,28,2,30,Clouds
81156,102,1554825600,35,5,40,Clouds
81157,103,1554825600,40,0,40,Clouds
81158,104,1554825600,32,8,40,Clouds
81159,105,1554825600,32,4,36,Clouds
81160,106,1554825600,38,2,40,Clouds
81161,107,1554825600,34,6,40,Clouds
81162,108,1554825600,33,7,40,Clouds
81163,109,1554825600,25,4,29,Clouds
81164,110,1554825600,37,3,40,Clouds
81165,111,1554825600,38,2,40,Clouds
81166,112,1554825600,21,9,30,Clouds
81167,113,1554825600,21,19,40,Clouds
81168,114,1554825600,13,27,40,Clouds
81169,115,1554825600,24,6,30,Clouds
81170,2,1554829200,20,0,20,Clouds
81171,3,1554829200,19,1,20,Clouds
81172,4,1554829200,20,0,20,Clouds
81173,5,1554829200,19,21,40,Clouds
81174,6,1554829200,17,3,20,Clouds
81175,7,1554829200,27,2,29,Clouds
81176,8,1554829200,10,20,30,Clouds
81177,9,1554829200,6,18,24,Clouds
81178,10,1554829200,11,6,17,Clouds
81179,11,1554829200,28,2,30,Clouds
81180,12,1554829200,19,1,20,Clouds
81181,13,1554829200,14,16,30,Clouds
81182,14,1554829200,5,24,29,Clouds
81183,15,1554829200,15,1,16,Clouds
81184,16,1554829200,13,7,20,Clouds
81185,17,1554829200,16,4,20,Clouds
81186,18,1554829200,29,1,30,Clouds
81187,19,1554829200,30,0,30,Clouds
81188,21,1554829200,4,26,30,Clouds
81189,22,1554829200,5,15,20,Clouds
81190,23,1554829200,10,20,30,Clouds
81191,24,1554829200,20,0,20,Clouds
81192,25,1554829200,24,6,30,Clouds
81193,26,1554829200,2,18,20,Clouds
81194,27,1554829200,4,16,20,Clouds
81195,28,1554829200,28,1,29,Clouds
81196,29,1554829200,9,20,29,Clouds
81197,30,1554829200,20,0,20,Clouds
81198,31,1554829200,19,1,20,Clouds
81199,32,1554829200,16,14,30,Clouds
81200,33,1554829200,11,12,23,Clouds
81201,34,1554829200,25,5,30,Clouds
81202,35,1554829200,23,7,30,Clouds
81203,36,1554829200,23,17,40,Clouds
81204,37,1554829200,27,3,30,Clouds
81205,38,1554829200,17,22,39,Clouds
81206,39,1554829200,11,9,20,Clouds
81207,40,1554829200,21,0,21,Clouds
81208,41,1554829200,7,13,20,Clouds
81209,42,1554829200,20,10,30,Clouds
81210,43,1554829200,23,7,30,Clouds
81211,44,1554829200,21,9,30,Clouds
81212,45,1554829200,19,11,30,Clouds
81213,46,1554829200,11,9,20,Clouds
81214,47,1554829200,20,20,40,Clouds
81215,48,1554829200,6,34,40,Clouds
81216,49,1554829200,6,34,40,Clouds
81217,50,1554829200,38,2,40,Clouds
81218,51,1554829200,26,14,40,Clouds
81219,52,1554829200,21,11,32,Clouds
81220,53,1554829200,23,17,40,Clouds
81221,54,1554829200,31,2,33,Clouds
81222,55,1554829200,36,0,36,Clouds
81223,56,1554829200,40,0,40,Clouds
81224,57,1554829200,12,11,23,Clouds
81225,58,1554829200,39,1,40,Clouds
81226,59,1554829200,20,0,20,Clouds
81227,60,1554829200,7,23,30,Clouds
81228,61,1554829200,25,0,25,Clouds
81229,62,1554829200,27,13,40,Clouds
81230,63,1554829200,16,19,35,Clouds
81231,64,1554829200,18,22,40,Clouds
81232,65,1554829200,29,11,40,Clouds
81233,66,1554829200,39,1,40,Clouds
81234,67,1554829200,15,24,39,Clouds
81235,68,1554829200,17,23,40,Clouds
81236,69,1554829200,25,15,40,Clouds
81237,70,1554829200,10,18,28,Clouds
81238,71,1554829200,38,2,40,Clouds
81239,72,1554829200,25,6,31,Clouds
81240,73,1554829200,28,2,30,Clouds
81241,74,1554829200,26,4,30,Clouds
81242,75,1554829200,38,2,40,Clouds
81243,76,1554829200,33,5,38,Clouds
81244,77,1554829200,16,13,29,Clouds
81245,78,1554829200,28,12,40,Clouds
81246,79,1554829200,26,1,27,Clouds
81247,80,1554829200,23,17,40,Clouds
81248,81,1554829200,27,13,40,Clouds
81249,82,1554829200,22,0,22,Clouds
81250,83,1554829200,33,7,40,Clouds
81251,84,1554829200,28,2,30,Clouds
81252,85,1554829200,31,4,35,Clouds
81253,86,1554829200,32,6,38,Clouds
81254,87,1554829200,36,2,38,Clouds
81255,88,1554829200,28,2,30,Clouds
81256,89,1554829200,25,15,40,Clouds
81257,90,1554829200,19,21,40,Clouds
81258,91,1554829200,21,9,30,Clouds
81259,92,1554829200,28,12,40,Clouds
81260,93,1554829200,17,23,40,Clouds
81261,94,1554829200,37,3,40,Clouds
81262,95,1554829200,34,6,40,Clouds
81263,96,1554829200,26,4,30,Clouds
81264,97,1554829200,36,4,40,Clouds
81265,98,1554829200,27,13,40,Clouds
81266,99,1554829200,0,30,30,Clouds
81267,100,1554829200,0,25,25,Clouds
81268,101,1554829200,29,1,30,Clouds
81269,102,1554829200,40,0,40,Clouds
81270,103,1554829200,40,0,40,Clouds
81271,104,1554829200,40,0,40,Clouds
81272,105,1554829200,34,2,36,Clouds
81273,106,1554829200,36,4,40,Clouds
81274,107,1554829200,31,9,40,Clouds
81275,108,1554829200,32,8,40,Clouds
81276,109,1554829200,22,7,29,Clouds
81277,110,1554829200,35,5,40,Clouds
81278,111,1554829200,37,3,40,Clouds
81279,112,1554829200,21,9,30,Clouds
81280,113,1554829200,21,19,40,Clouds
81281,114,1554829200,40,0,40,Clouds
81282,115,1554829200,21,9,30,Clouds
81283,2,1554832800,14,6,20,Clouds
81284,3,1554832800,12,8,20,Clouds
81285,4,1554832800,20,0,20,Clouds
81286,5,1554832800,32,8,40,Clouds
81287,6,1554832800,17,3,20,Clouds
81288,7,1554832800,29,0,29,Clouds
81289,8,1554832800,12,18,30,Clouds
81290,9,1554832800,23,1,24,Clouds
81291,10,1554832800,6,11,17,Clouds
81292,11,1554832800,30,0,30,Clouds
81293,12,1554832800,17,3,20,Clouds
81294,13,1554832800,30,0,30,Clouds
81295,14,1554832800,2,28,30,Clouds
81296,15,1554832800,12,4,16,Clouds
81297,16,1554832800,6,14,20,Clouds
81298,17,1554832800,20,0,20,Clouds
81299,18,1554832800,23,7,30,Clouds
81300,19,1554832800,19,11,30,Clouds
81301,21,1554832800,0,30,30,Clouds
81302,22,1554832800,0,20,20,Clouds
81303,23,1554832800,3,27,30,Clouds
81304,24,1554832800,16,4,20,Clouds
81305,25,1554832800,30,0,30,Clouds
81306,26,1554832800,5,15,20,Clouds
81307,27,1554832800,8,12,20,Clouds
81308,28,1554832800,28,1,29,Clouds
81309,29,1554832800,20,9,29,Clouds
81310,30,1554832800,19,1,20,Clouds
81311,31,1554832800,17,3,20,Clouds
81312,32,1554832800,3,27,30,Clouds
81313,33,1554832800,6,17,23,Clouds
81314,34,1554832800,1,29,30,Clouds
81315,35,1554832800,29,1,30,Clouds
81316,36,1554832800,40,0,40,Clouds
81317,37,1554832800,29,1,30,Clouds
81318,38,1554832800,24,15,39,Clouds
81319,39,1554832800,20,0,20,Clouds
81320,40,1554832800,20,1,21,Clouds
81321,41,1554832800,20,0,20,Clouds
81322,42,1554832800,12,18,30,Clouds
81323,43,1554832800,3,27,30,Clouds
81324,44,1554832800,15,15,30,Clouds
81325,45,1554832800,17,13,30,Clouds
81326,46,1554832800,15,5,20,Clouds
81327,47,1554832800,40,0,40,Clouds
81328,48,1554832800,7,33,40,Clouds
81329,49,1554832800,36,4,40,Clouds
81330,50,1554832800,35,5,40,Clouds
81331,51,1554832800,35,5,40,Clouds
81332,52,1554832800,31,1,32,Clouds
81333,53,1554832800,40,0,40,Clouds
81334,54,1554832800,33,0,33,Clouds
81335,55,1554832800,35,1,36,Clouds
81336,56,1554832800,39,1,40,Clouds
81337,57,1554832800,23,0,23,Clouds
81338,58,1554832800,39,1,40,Clouds
81339,59,1554832800,20,0,20,Clouds
81340,60,1554832800,1,29,30,Clouds
81341,61,1554832800,25,0,25,Clouds
81342,62,1554832800,40,0,40,Clouds
81343,63,1554832800,33,2,35,Clouds
81344,64,1554832800,26,14,40,Clouds
81345,65,1554832800,39,1,40,Clouds
81346,66,1554832800,38,2,40,Clouds
81347,67,1554832800,30,9,39,Clouds
81348,68,1554832800,38,2,40,Clouds
81349,69,1554832800,38,2,40,Clouds
81350,70,1554832800,21,7,28,Clouds
81351,71,1554832800,35,5,40,Clouds
81352,72,1554832800,29,2,31,Clouds
81353,73,1554832800,30,0,30,Clouds
81354,74,1554832800,14,16,30,Clouds
81355,75,1554832800,33,7,40,Clouds
81356,76,1554832800,12,26,38,Clouds
81357,77,1554832800,24,5,29,Clouds
81358,78,1554832800,27,13,40,Clouds
81359,79,1554832800,27,0,27,Clouds
81360,80,1554832800,16,24,40,Clouds
81361,81,1554832800,28,12,40,Clouds
81362,82,1554832800,17,5,22,Clouds
81363,83,1554832800,26,14,40,Clouds
81364,84,1554832800,18,12,30,Clouds
81365,85,1554832800,27,8,35,Clouds
81366,86,1554832800,0,38,38,Clouds
81367,87,1554832800,26,12,38,Clouds
81368,88,1554832800,20,10,30,Clouds
81369,89,1554832800,40,0,40,Clouds
81370,90,1554832800,39,1,40,Clouds
81371,91,1554832800,16,14,30,Clouds
81372,92,1554832800,0,40,40,Clouds
81373,93,1554832800,0,40,40,Clouds
81374,94,1554832800,0,40,40,Clouds
81375,95,1554832800,24,16,40,Clouds
81376,96,1554832800,24,6,30,Clouds
81377,97,1554832800,27,13,40,Clouds
81378,98,1554832800,33,7,40,Clouds
81379,99,1554832800,8,22,30,Clouds
81380,100,1554832800,0,25,25,Clouds
81381,101,1554832800,24,6,30,Clouds
81382,102,1554832800,39,1,40,Clouds
81383,103,1554832800,40,0,40,Clouds
81384,104,1554832800,40,0,40,Clouds
81385,105,1554832800,34,2,36,Clouds
81386,106,1554832800,35,5,40,Clouds
81387,107,1554832800,29,11,40,Clouds
81388,108,1554832800,27,13,40,Clouds
81389,109,1554832800,19,10,29,Clouds
81390,110,1554832800,36,4,40,Clouds
81391,111,1554832800,35,5,40,Clouds
81392,112,1554832800,16,14,30,Clouds
81393,113,1554832800,40,0,40,Clouds
81394,114,1554832800,40,0,40,Clouds
81395,115,1554832800,14,16,30,Clouds
81396,2,1554836400,20,0,20,Clouds
81397,3,1554836400,14,6,20,Clouds
81398,4,1554836400,19,1,20,Clouds
81399,5,1554836400,24,16,40,Clouds
81400,6,1554836400,16,4,20,Clouds
81401,7,1554836400,26,3,29,Clouds
81402,8,1554836400,29,1,30,Clouds
81403,9,1554836400,24,0,24,Clouds
81404,10,1554836400,10,7,17,Clouds
81405,11,1554836400,29,1,30,Clouds
81406,12,1554836400,16,4,20,Clouds
81407,13,1554836400,30,0,30,Clouds
81408,14,1554836400,2,28,30,Clouds
81409,15,1554836400,11,5,16,Clouds
81410,16,1554836400,11,9,20,Clouds
81411,17,1554836400,20,0,20,Clouds
81412,18,1554836400,10,20,30,Clouds
81413,19,1554836400,23,7,30,Clouds
81414,21,1554836400,6,24,30,Clouds
81415,22,1554836400,1,19,20,Clouds
81416,23,1554836400,2,28,30,Clouds
81417,24,1554836400,16,4,20,Clouds
81418,25,1554836400,29,1,30,Clouds
81419,26,1554836400,18,2,20,Clouds
81420,27,1554836400,20,0,20,Clouds
81421,28,1554836400,28,1,29,Clouds
81422,29,1554836400,23,6,29,Clouds
81423,30,1554836400,15,5,20,Clouds
81424,31,1554836400,14,6,20,Clouds
81425,32,1554836400,0,30,30,Clouds
81426,33,1554836400,2,21,23,Clouds
81427,34,1554836400,5,25,30,Clouds
81428,35,1554836400,28,2,30,Clouds
81429,36,1554836400,38,2,40,Clouds
81430,37,1554836400,30,0,30,Clouds
81431,38,1554836400,17,22,39,Clouds
81432,39,1554836400,15,5,20,Clouds
81433,40,1554836400,19,2,21,Clouds
81434,41,1554836400,18,2,20,Clouds
81435,42,1554836400,0,30,30,Clouds
81436,43,1554836400,3,27,30,Clouds
81437,44,1554836400,3,27,30,Clouds
81438,45,1554836400,13,17,30,Clouds
81439,46,1554836400,13,7,20,Clouds
81440,47,1554836400,38,2,40,Clouds
81441,48,1554836400,30,10,40,Clouds
81442,49,1554836400,38,2,40,Clouds
81443,50,1554836400,29,11,40,Clouds
81444,51,1554836400,39,1,40,Clouds
81445,52,1554836400,31,1,32,Clouds
81446,53,1554836400,38,2,40,Clouds
81447,54,1554836400,33,0,33,Clouds
81448,55,1554836400,36,0,36,Clouds
81449,56,1554836400,35,5,40,Clouds
81450,57,1554836400,23,0,23,Clouds
81451,58,1554836400,38,2,40,Clouds
81452,59,1554836400,17,3,20,Clouds
81453,60,1554836400,0,30,30,Clouds
81454,61,1554836400,25,0,25,Clouds
81455,62,1554836400,40,0,40,Clouds
81456,63,1554836400,34,1,35,Clouds
81457,64,1554836400,32,8,40,Clouds
81458,65,1554836400,40,0,40,Clouds
81459,66,1554836400,38,2,40,Clouds
81460,67,1554836400,38,1,39,Clouds
81461,68,1554836400,39,1,40,Clouds
81462,69,1554836400,40,0,40,Clouds
81463,70,1554836400,21,6,27,Clouds
81464,71,1554836400,36,4,40,Clouds
81465,72,1554836400,5,26,31,Clouds
81466,73,1554836400,9,21,30,Clouds
81467,74,1554836400,13,17,30,Clouds
81468,75,1554836400,27,13,40,Clouds
81469,76,1554836400,9,29,38,Clouds
81470,77,1554836400,21,8,29,Clouds
81471,78,1554836400,20,20,40,Clouds
81472,79,1554836400,25,2,27,Clouds
81473,80,1554836400,12,28,40,Clouds
81474,81,1554836400,29,11,40,Clouds
81475,82,1554836400,10,12,22,Clouds
81476,83,1554836400,12,28,40,Clouds
81477,84,1554836400,9,21,30,Clouds
81478,85,1554836400,20,15,35,Clouds
81479,86,1554836400,4,34,38,Clouds
81480,87,1554836400,10,28,38,Clouds
81481,88,1554836400,19,11,30,Clouds
81482,89,1554836400,40,0,40,Clouds
81483,90,1554836400,40,0,40,Clouds
81484,91,1554836400,13,17,30,Clouds
81485,92,1554836400,2,38,40,Clouds
81486,93,1554836400,0,40,40,Clouds
81487,94,1554836400,0,40,40,Clouds
81488,95,1554836400,10,30,40,Clouds
81489,96,1554836400,20,10,30,Clouds
81490,97,1554836400,18,22,40,Clouds
81491,98,1554836400,40,0,40,Clouds
81492,99,1554836400,28,2,30,Clouds
81493,100,1554836400,0,25,25,Clouds
81494,101,1554836400,24,6,30,Clouds
81495,102,1554836400,40,0,40,Clouds
81496,103,1554836400,40,0,40,Clouds
81497,104,1554836400,40,0,40,Clouds
81498,105,1554836400,34,2,36,Clouds
81499,106,1554836400,33,7,40,Clouds
81500,107,1554836400,23,17,40,Clouds
81501,108,1554836400,27,13,40,Clouds
81502,109,1554836400,20,9,29,Clouds
81503,110,1554836400,36,4,40,Clouds
81504,111,1554836400,36,4,40,Clouds
81505,112,1554836400,14,16,30,Clouds
81506,113,1554836400,40,0,40,Clouds
81507,114,1554836400,40,0,40,Clouds
81508,115,1554836400,4,26,30,Clouds
81509,2,1554840000,19,1,20,Clouds
81510,3,1554840000,11,9,20,Clouds
81511,4,1554840000,20,0,20,Clouds
81512,5,1554840000,13,27,40,Clouds
81513,6,1554840000,15,5,20,Clouds
81514,7,1554840000,7,22,29,Clouds
81515,8,1554840000,30,0,30,Clouds
81516,9,1554840000,23,1,24,Clouds
81517,10,1554840000,14,2,16,Clouds
81518,11,1554840000,30,0,30,Clouds
81519,12,1554840000,11,9,20,Clouds
81520,13,1554840000,30,0,30,Clouds
81521,14,1554840000,11,19,30,Clouds
81522,15,1554840000,11,5,16,Clouds
81523,16,1554840000,18,2,20,Clouds
81524,17,1554840000,18,2,20,Clouds
81525,18,1554840000,23,7,30,Clouds
81526,19,1554840000,30,0,30,Clouds
81527,21,1554840000,16,14,30,Clouds
81528,22,1554840000,1,19,20,Clouds
81529,23,1554840000,8,22,30,Clouds
81530,24,1554840000,15,5,20,Clouds
81531,25,1554840000,26,4,30,Clouds
81532,26,1554840000,20,0,20,Clouds
81533,27,1554840000,19,1,20,Clouds
81534,28,1554840000,26,3,29,Clouds
81535,29,1554840000,19,10,29,Clouds
81536,30,1554840000,18,2,20,Clouds
81537,31,1554840000,12,8,20,Clouds
81538,32,1554840000,7,23,30,Clouds
81539,33,1554840000,7,16,23,Clouds
81540,34,1554840000,15,15,30,Clouds
81541,35,1554840000,19,11,30,Clouds
81542,36,1554840000,40,0,40,Clouds
81543,37,1554840000,30,0,30,Clouds
81544,38,1554840000,26,13,39,Clouds
81545,39,1554840000,20,0,20,Clouds
81546,40,1554840000,16,5,21,Clouds
81547,41,1554840000,20,0,20,Clouds
81548,42,1554840000,3,27,30,Clouds
81549,43,1554840000,6,24,30,Clouds
81550,44,1554840000,0,30,30,Clouds
81551,45,1554840000,6,24,30,Clouds
81552,46,1554840000,16,4,20,Clouds
81553,47,1554840000,40,0,40,Clouds
81554,48,1554840000,39,1,40,Clouds
81555,49,1554840000,37,3,40,Clouds
81556,50,1554840000,17,23,40,Clouds
81557,51,1554840000,40,0,40,Clouds
81558,52,1554840000,31,1,32,Clouds
81559,53,1554840000,40,0,40,Clouds
81560,54,1554840000,31,2,33,Clouds
81561,55,1554840000,36,0,36,Clouds
81562,56,1554840000,32,8,40,Clouds
81563,57,1554840000,23,0,23,Clouds
81564,58,1554840000,39,1,40,Clouds
81565,59,1554840000,19,1,20,Clouds
81566,60,1554840000,17,13,30,Clouds
81567,61,1554840000,23,2,25,Clouds
81568,62,1554840000,40,0,40,Clouds
81569,63,1554840000,35,0,35,Clouds
81570,64,1554840000,33,7,40,Clouds
81571,65,1554840000,39,1,40,Clouds
81572,66,1554840000,34,6,40,Clouds
81573,67,1554840000,28,11,39,Clouds
81574,68,1554840000,40,0,40,Clouds
81575,69,1554840000,39,1,40,Clouds
81576,70,1554840000,26,1,27,Clouds
81577,71,1554840000,38,2,40,Clouds
81578,72,1554840000,1,30,31,Clouds
81579,73,1554840000,8,22,30,Clouds
81580,74,1554840000,19,11,30,Clouds
81581,75,1554840000,28,12,40,Clouds
81582,76,1554840000,4,34,38,Clouds
81583,77,1554840000,18,11,29,Clouds
81584,78,1554840000,18,22,40,Clouds
81585,79,1554840000,23,4,27,Clouds
81586,80,1554840000,13,27,40,Clouds
81587,81,1554840000,28,12,40,Clouds
81588,82,1554840000,6,16,22,Clouds
81589,83,1554840000,7,33,40,Clouds
81590,84,1554840000,7,23,30,Clouds
81591,85,1554840000,16,19,35,Clouds
81592,86,1554840000,4,34,38,Clouds
81593,87,1554840000,6,32,38,Clouds
81594,88,1554840000,20,10,30,Clouds
81595,89,1554840000,35,5,40,Clouds
81596,90,1554840000,40,0,40,Clouds
81597,91,1554840000,17,13,30,Clouds
81598,92,1554840000,0,40,40,Clouds
81599,93,1554840000,2,38,40,Clouds
81600,94,1554840000,3,37,40,Clouds
81601,95,1554840000,12,28,40,Clouds
81602,96,1554840000,14,16,30,Clouds
81603,97,1554840000,16,24,40,Clouds
81604,98,1554840000,40,0,40,Clouds
81605,99,1554840000,30,0,30,Clouds
81606,100,1554840000,2,23,25,Clouds
81607,101,1554840000,19,11,30,Clouds
81608,102,1554840000,35,5,40,Clouds
81609,103,1554840000,40,0,40,Clouds
81610,104,1554840000,40,0,40,Clouds
81611,105,1554840000,34,2,36,Clouds
81612,106,1554840000,33,7,40,Clouds
81613,107,1554840000,20,20,40,Clouds
81614,108,1554840000,29,11,40,Clouds
81615,109,1554840000,17,12,29,Clouds
81616,110,1554840000,32,8,40,Clouds
81617,111,1554840000,28,12,40,Clouds
81618,112,1554840000,11,19,30,Clouds
81619,113,1554840000,40,0,40,Clouds
81620,114,1554840000,40,0,40,Clouds
81621,115,1554840000,0,30,30,Clouds
81622,2,1554847200,13,7,20,Clouds
81623,3,1554847200,7,13,20,Clouds
81624,4,1554847200,18,2,20,Clouds
81625,5,1554847200,17,23,40,Clouds
81626,6,1554847200,18,2,20,Clouds
81627,7,1554847200,13,16,29,Clouds
81628,8,1554847200,29,1,30,Clouds
81629,9,1554847200,24,0,24,Clouds
81630,10,1554847200,15,1,16,Clouds
81631,11,1554847200,30,0,30,Clouds
81632,12,1554847200,7,13,20,Clouds
81633,13,1554847200,30,0,30,Clouds
81634,14,1554847200,29,1,30,Clouds
81635,15,1554847200,8,8,16,Clouds
81636,16,1554847200,19,1,20,Clouds
81637,17,1554847200,20,0,20,Clouds
81638,18,1554847200,30,0,30,Clouds
81639,19,1554847200,29,1,30,Clouds
81640,21,1554847200,30,0,30,Clouds
81641,22,1554847200,18,2,20,Clouds
81642,23,1554847200,12,18,30,Clouds
81643,24,1554847200,18,2,20,Clouds
81644,25,1554847200,30,0,30,Clouds
81645,26,1554847200,20,0,20,Clouds
81646,27,1554847200,20,0,20,Clouds
81647,28,1554847200,22,8,30,Clouds
81648,29,1554847200,16,13,29,Clouds
81649,30,1554847200,19,1,20,Clouds
81650,31,1554847200,20,0,20,Clouds
81651,32,1554847200,21,9,30,Clouds
81652,33,1554847200,21,2,23,Clouds
81653,34,1554847200,7,23,30,Clouds
81654,35,1554847200,8,22,30,Clouds
81655,36,1554847200,40,0,40,Clouds
81656,37,1554847200,30,0,30,Clouds
81657,38,1554847200,35,5,40,Clouds
81658,39,1554847200,20,0,20,Clouds
81659,40,1554847200,18,3,21,Clouds
81660,41,1554847200,20,0,20,Clouds
81661,42,1554847200,3,27,30,Clouds
81662,43,1554847200,1,29,30,Clouds
81663,44,1554847200,0,30,30,Clouds
81664,45,1554847200,6,24,30,Clouds
81665,46,1554847200,20,0,20,Clouds
81666,47,1554847200,40,0,40,Clouds
81667,48,1554847200,40,0,40,Clouds
81668,49,1554847200,38,2,40,Clouds
81669,50,1554847200,0,40,40,Clouds
81670,51,1554847200,40,0,40,Clouds
81671,52,1554847200,32,0,32,Clouds
81672,53,1554847200,40,0,40,Clouds
81673,54,1554847200,30,3,33,Clouds
81674,55,1554847200,36,0,36,Clouds
81675,56,1554847200,40,0,40,Clouds
81676,57,1554847200,23,0,23,Clouds
81677,58,1554847200,39,1,40,Clouds
81678,59,1554847200,19,1,20,Clouds
81679,60,1554847200,1,29,30,Clouds
81680,61,1554847200,22,3,25,Clouds
81681,62,1554847200,38,2,40,Clouds
81682,63,1554847200,34,1,35,Clouds
81683,64,1554847200,38,2,40,Clouds
81684,65,1554847200,39,1,40,Clouds
81685,66,1554847200,35,5,40,Clouds
81686,67,1554847200,19,20,39,Clouds
81687,68,1554847200,31,9,40,Clouds
81688,69,1554847200,40,0,40,Clouds
81689,70,1554847200,22,5,27,Clouds
81690,71,1554847200,40,0,40,Clouds
81691,72,1554847200,3,28,31,Clouds
81692,73,1554847200,2,28,30,Clouds
81693,74,1554847200,18,12,30,Clouds
81694,75,1554847200,30,10,40,Clouds
81695,76,1554847200,2,36,38,Clouds
81696,77,1554847200,12,17,29,Clouds
81697,78,1554847200,14,26,40,Clouds
81698,79,1554847200,23,4,27,Clouds
81699,80,1554847200,12,28,40,Clouds
81700,81,1554847200,30,10,40,Clouds
81701,82,1554847200,4,18,22,Clouds
81702,83,1554847200,0,40,40,Clouds
81703,84,1554847200,5,25,30,Clouds
81704,85,1554847200,0,35,35,Clouds
81705,86,1554847200,0,38,38,Clouds
81706,87,1554847200,1,37,38,Clouds
81707,88,1554847200,6,24,30,Clouds
81708,89,1554847200,40,0,40,Clouds
81709,90,1554847200,40,0,40,Clouds
81710,91,1554847200,14,16,30,Clouds
81711,92,1554847200,0,40,40,Clouds
81712,93,1554847200,0,40,40,Clouds
81713,94,1554847200,0,40,40,Clouds
81714,95,1554847200,4,36,40,Clouds
81715,96,1554847200,11,19,30,Clouds
81716,97,1554847200,10,30,40,Clouds
81717,98,1554847200,40,0,40,Clouds
81718,99,1554847200,30,0,30,Clouds
81719,100,1554847200,0,25,25,Clouds
81720,101,1554847200,13,17,30,Clouds
81721,102,1554847200,38,2,40,Clouds
81722,103,1554847200,37,3,40,Clouds
81723,104,1554847200,40,0,40,Clouds
81724,105,1554847200,34,2,36,Clouds
81725,106,1554847200,34,6,40,Clouds
81726,107,1554847200,23,17,40,Clouds
81727,108,1554847200,26,14,40,Clouds
81728,109,1554847200,2,27,29,Clouds
81729,110,1554847200,29,11,40,Clouds
81730,111,1554847200,20,20,40,Clouds
81731,112,1554847200,8,22,30,Clouds
81732,113,1554847200,40,0,40,Clouds
81733,114,1554847200,40,0,40,Clouds
81734,115,1554847200,8,22,30,Clouds
81735,2,1554850800,10,10,20,Clouds
81736,3,1554850800,9,11,20,Clouds
81737,4,1554850800,16,4,20,Clouds
81738,5,1554850800,24,16,40,Clouds
81739,6,1554850800,20,0,20,Clouds
81740,7,1554850800,17,12,29,Clouds
81741,8,1554850800,28,2,30,Clouds
81742,9,1554850800,11,13,24,Clouds
81743,10,1554850800,15,1,16,Clouds
81744,11,1554850800,30,0,30,Clouds
81745,12,1554850800,4,16,20,Clouds
81746,13,1554850800,30,0,30,Clouds
81747,14,1554850800,30,0,30,Clouds
81748,15,1554850800,8,8,16,Clouds
81749,16,1554850800,20,0,20,Clouds
81750,17,1554850800,19,1,20,Clouds
81751,18,1554850800,30,0,30,Clouds
81752,19,1554850800,27,3,30,Clouds
81753,21,1554850800,30,0,30,Clouds
81754,22,1554850800,19,1,20,Clouds
81755,23,1554850800,22,8,30,Clouds
81756,24,1554850800,17,3,20,Clouds
81757,25,1554850800,30,0,30,Clouds
81758,26,1554850800,20,0,20,Clouds
81759,27,1554850800,20,0,20,Clouds
81760,28,1554850800,12,18,30,Clouds
81761,29,1554850800,22,7,29,Clouds
81762,30,1554850800,20,0,20,Clouds
81763,31,1554850800,16,4,20,Clouds
81764,32,1554850800,30,0,30,Clouds
81765,33,1554850800,21,2,23,Clouds
81766,34,1554850800,7,23,30,Clouds
81767,35,1554850800,3,27,30,Clouds
81768,36,1554850800,33,7,40,Clouds
81769,37,1554850800,23,7,30,Clouds
81770,38,1554850800,38,2,40,Clouds
81771,39,1554850800,17,3,20,Clouds
81772,40,1554850800,21,0,21,Clouds
81773,41,1554850800,19,1,20,Clouds
81774,42,1554850800,0,30,30,Clouds
81775,43,1554850800,2,28,30,Clouds
81776,44,1554850800,0,30,30,Clouds
81777,45,1554850800,8,22,30,Clouds
81778,46,1554850800,20,0,20,Clouds
81779,47,1554850800,40,0,40,Clouds
81780,48,1554850800,40,0,40,Clouds
81781,49,1554850800,40,0,40,Clouds
81782,50,1554850800,0,40,40,Clouds
81783,51,1554850800,39,1,40,Clouds
81784,52,1554850800,31,1,32,Clouds
81785,53,1554850800,33,7,40,Clouds
81786,54,1554850800,30,3,33,Clouds
81787,55,1554850800,36,0,36,Clouds
81788,56,1554850800,40,0,40,Clouds
81789,57,1554850800,23,0,23,Clouds
81790,58,1554850800,38,2,40,Clouds
81791,59,1554850800,19,1,20,Clouds
81792,60,1554850800,3,27,30,Clouds
81793,61,1554850800,23,2,25,Clouds
81794,62,1554850800,40,0,40,Clouds
81795,63,1554850800,35,0,35,Clouds
81796,64,1554850800,40,0,40,Clouds
81797,65,1554850800,40,0,40,Clouds
81798,66,1554850800,32,8,40,Clouds
81799,67,1554850800,18,21,39,Clouds
81800,68,1554850800,35,5,40,Clouds
81801,69,1554850800,39,1,40,Clouds
81802,70,1554850800,19,8,27,Clouds
81803,71,1554850800,35,5,40,Clouds
81804,72,1554850800,2,29,31,Clouds
81805,73,1554850800,0,30,30,Clouds
81806,74,1554850800,15,15,30,Clouds
81807,75,1554850800,27,13,40,Clouds
81808,76,1554850800,1,37,38,Clouds
81809,77,1554850800,14,15,29,Clouds
81810,78,1554850800,10,30,40,Clouds
81811,79,1554850800,23,4,27,Clouds
81812,80,1554850800,3,37,40,Clouds
81813,81,1554850800,29,11,40,Clouds
81814,82,1554850800,2,20,22,Clouds
81815,83,1554850800,14,26,40,Clouds
81816,84,1554850800,3,27,30,Clouds
81817,85,1554850800,8,27,35,Clouds
81818,86,1554850800,10,28,38,Clouds
81819,87,1554850800,0,38,38,Clouds
81820,88,1554850800,3,27,30,Clouds
81821,89,1554850800,40,0,40,Clouds
81822,90,1554850800,40,0,40,Clouds
81823,91,1554850800,14,16,30,Clouds
81824,92,1554850800,9,31,40,Clouds
81825,93,1554850800,0,40,40,Clouds
81826,94,1554850800,0,40,40,Clouds
81827,95,1554850800,1,39,40,Clouds
81828,96,1554850800,12,18,30,Clouds
81829,97,1554850800,9,31,40,Clouds
81830,98,1554850800,40,0,40,Clouds
81831,99,1554850800,30,0,30,Clouds
81832,100,1554850800,1,24,25,Clouds
81833,101,1554850800,12,18,30,Clouds
81834,102,1554850800,35,5,40,Clouds
81835,103,1554850800,38,2,40,Clouds
81836,104,1554850800,40,0,40,Clouds
81837,105,1554850800,33,3,36,Clouds
81838,106,1554850800,15,25,40,Clouds
81839,107,1554850800,20,20,40,Clouds
81840,108,1554850800,26,14,40,Clouds
81841,109,1554850800,1,28,29,Clouds
81842,110,1554850800,30,10,40,Clouds
81843,111,1554850800,17,23,40,Clouds
81844,112,1554850800,5,25,30,Clouds
81845,113,1554850800,40,0,40,Clouds
81846,114,1554850800,40,0,40,Clouds
81847,115,1554850800,4,26,30,Clouds
81848,2,1554858000,9,11,20,Clouds
81849,3,1554858000,13,7,20,Clouds
81850,4,1554858000,14,6,20,Clouds
81851,5,1554858000,26,14,40,Clouds
81852,6,1554858000,20,0,20,Clouds
81853,7,1554858000,20,9,29,Clouds
81854,8,1554858000,30,0,30,Clouds
81855,9,1554858000,24,0,24,Clouds
81856,10,1554858000,16,0,16,Clouds
81857,11,1554858000,30,0,30,Clouds
81858,12,1554858000,2,18,20,Clouds
81859,13,1554858000,30,0,30,Clouds
81860,14,1554858000,30,0,30,Clouds
81861,15,1554858000,6,10,16,Clouds
81862,16,1554858000,20,0,20,Clouds
81863,17,1554858000,17,3,20,Clouds
81864,18,1554858000,29,1,30,Clouds
81865,19,1554858000,30,0,30,Clouds
81866,21,1554858000,30,0,30,Clouds
81867,22,1554858000,20,0,20,Clouds
81868,23,1554858000,21,9,30,Clouds
81869,24,1554858000,18,2,20,Clouds
81870,25,1554858000,30,0,30,Clouds
81871,26,1554858000,19,1,20,Clouds
81872,27,1554858000,20,0,20,Clouds
81873,28,1554858000,8,22,30,Clouds
81874,29,1554858000,29,0,29,Clouds
81875,30,1554858000,18,2,20,Clouds
81876,31,1554858000,18,2,20,Clouds
81877,32,1554858000,30,0,30,Clouds
81878,33,1554858000,23,0,23,Clouds
81879,34,1554858000,6,24,30,Clouds
81880,35,1554858000,0,30,30,Clouds
81881,36,1554858000,40,0,40,Clouds
81882,37,1554858000,26,4,30,Clouds
81883,38,1554858000,40,0,40,Clouds
81884,39,1554858000,16,4,20,Clouds
81885,40,1554858000,20,1,21,Clouds
81886,41,1554858000,19,1,20,Clouds
81887,42,1554858000,0,30,30,Clouds
81888,43,1554858000,9,21,30,Clouds
81889,44,1554858000,0,30,30,Clouds
81890,45,1554858000,8,22,30,Clouds
81891,46,1554858000,20,0,20,Clouds
81892,47,1554858000,40,0,40,Clouds
81893,48,1554858000,40,0,40,Clouds
81894,49,1554858000,40,0,40,Clouds
81895,50,1554858000,0,40,40,Clouds
81896,51,1554858000,40,0,40,Clouds
81897,52,1554858000,32,0,32,Clouds
81898,53,1554858000,35,5,40,Clouds
81899,54,1554858000,33,0,33,Clouds
81900,55,1554858000,36,0,36,Clouds
81901,56,1554858000,40,0,40,Clouds
81902,57,1554858000,23,0,23,Clouds
81903,58,1554858000,40,0,40,Clouds
81904,59,1554858000,15,5,20,Clouds
81905,60,1554858000,0,30,30,Clouds
81906,61,1554858000,22,3,25,Clouds
81907,62,1554858000,40,0,40,Clouds
81908,63,1554858000,35,0,35,Clouds
81909,64,1554858000,40,0,40,Clouds
81910,65,1554858000,39,1,40,Clouds
81911,66,1554858000,26,14,40,Clouds
81912,67,1554858000,39,1,40,Clouds
81913,68,1554858000,38,2,40,Clouds
81914,69,1554858000,38,2,40,Clouds
81915,70,1554858000,20,8,28,Clouds
81916,71,1554858000,39,1,40,Clouds
81917,72,1554858000,4,27,31,Clouds
81918,73,1554858000,1,29,30,Clouds
81919,74,1554858000,13,17,30,Clouds
81920,75,1554858000,21,19,40,Clouds
81921,76,1554858000,0,38,38,Clouds
81922,77,1554858000,11,18,29,Clouds
81923,78,1554858000,8,32,40,Clouds
81924,79,1554858000,23,4,27,Clouds
81925,80,1554858000,1,39,40,Clouds
81926,81,1554858000,31,9,40,Clouds
81927,82,1554858000,2,20,22,Clouds
81928,83,1554858000,10,30,40,Clouds
81929,84,1554858000,2,28,30,Clouds
81930,85,1554858000,9,26,35,Clouds
81931,86,1554858000,7,31,38,Clouds
81932,87,1554858000,0,38,38,Clouds
81933,88,1554858000,0,30,30,Clouds
81934,89,1554858000,40,0,40,Clouds
81935,90,1554858000,40,0,40,Clouds
81936,91,1554858000,13,17,30,Clouds
81937,92,1554858000,5,35,40,Clouds
81938,93,1554858000,0,40,40,Clouds
81939,94,1554858000,0,40,40,Clouds
81940,95,1554858000,1,39,40,Clouds
81941,96,1554858000,11,19,30,Clouds
81942,97,1554858000,8,32,40,Clouds
81943,98,1554858000,40,0,40,Clouds
81944,99,1554858000,30,0,30,Clouds
81945,100,1554858000,2,23,25,Clouds
81946,101,1554858000,8,22,30,Clouds
81947,102,1554858000,34,6,40,Clouds
81948,103,1554858000,39,1,40,Clouds
81949,104,1554858000,40,0,40,Clouds
81950,105,1554858000,33,3,36,Clouds
81951,106,1554858000,14,26,40,Clouds
81952,107,1554858000,16,24,40,Clouds
81953,108,1554858000,23,17,40,Clouds
81954,109,1554858000,2,27,29,Clouds
81955,110,1554858000,30,10,40,Clouds
81956,111,1554858000,11,29,40,Clouds
81957,112,1554858000,10,20,30,Clouds
81958,113,1554858000,40,0,40,Clouds
81959,114,1554858000,40,0,40,Clouds
81960,115,1554858000,3,27,30,Clouds
81961,2,1554861600,9,11,20,Clouds
81962,3,1554861600,13,7,20,Clouds
81963,4,1554861600,14,6,20,Clouds
81964,5,1554861600,26,14,40,Clouds
81965,6,1554861600,20,0,20,Clouds
81966,7,1554861600,20,9,29,Clouds
81967,8,1554861600,29,1,30,Clouds
81968,9,1554861600,24,0,24,Clouds
81969,10,1554861600,16,0,16,Clouds
81970,11,1554861600,30,0,30,Clouds
81971,12,1554861600,2,18,20,Clouds
81972,13,1554861600,30,0,30,Clouds
81973,14,1554861600,30,0,30,Clouds
81974,15,1554861600,6,10,16,Clouds
81975,16,1554861600,20,0,20,Clouds
81976,17,1554861600,17,3,20,Clouds
81977,18,1554861600,29,1,30,Clouds
81978,19,1554861600,30,0,30,Clouds
81979,21,1554861600,30,0,30,Clouds
81980,22,1554861600,20,0,20,Clouds
81981,23,1554861600,21,9,30,Clouds
81982,24,1554861600,18,2,20,Clouds
81983,25,1554861600,30,0,30,Clouds
81984,26,1554861600,19,1,20,Clouds
81985,27,1554861600,20,0,20,Clouds
81986,28,1554861600,7,23,30,Clouds
81987,29,1554861600,29,0,29,Clouds
81988,30,1554861600,18,2,20,Clouds
81989,31,1554861600,18,2,20,Clouds
81990,32,1554861600,30,0,30,Clouds
81991,33,1554861600,23,0,23,Clouds
81992,34,1554861600,6,24,30,Clouds
81993,35,1554861600,0,30,30,Clouds
81994,36,1554861600,40,0,40,Clouds
81995,37,1554861600,26,4,30,Clouds
81996,38,1554861600,40,0,40,Clouds
81997,39,1554861600,16,4,20,Clouds
81998,40,1554861600,20,1,21,Clouds
81999,41,1554861600,19,1,20,Clouds
82000,42,1554861600,0,30,30,Clouds
82001,43,1554861600,9,21,30,Clouds
82002,44,1554861600,0,30,30,Clouds
82003,45,1554861600,8,22,30,Clouds
82004,46,1554861600,20,0,20,Clouds
82005,47,1554861600,40,0,40,Clouds
82006,48,1554861600,40,0,40,Clouds
82007,49,1554861600,40,0,40,Clouds
82008,50,1554861600,0,40,40,Clouds
82009,51,1554861600,40,0,40,Clouds
82010,52,1554861600,32,0,32,Clouds
82011,53,1554861600,35,5,40,Clouds
82012,54,1554861600,33,0,33,Clouds
82013,55,1554861600,36,0,36,Clouds
82014,56,1554861600,40,0,40,Clouds
82015,57,1554861600,23,0,23,Clouds
82016,58,1554861600,40,0,40,Clouds
82017,59,1554861600,15,5,20,Clouds
82018,60,1554861600,0,30,30,Clouds
82019,61,1554861600,22,3,25,Clouds
82020,62,1554861600,40,0,40,Clouds
82021,63,1554861600,35,0,35,Clouds
82022,64,1554861600,40,0,40,Clouds
82023,65,1554861600,39,1,40,Clouds
82024,66,1554861600,26,14,40,Clouds
82025,67,1554861600,39,1,40,Clouds
82026,68,1554861600,38,2,40,Clouds
82027,69,1554861600,38,2,40,Clouds
82028,70,1554861600,20,8,28,Clouds
82029,71,1554861600,39,1,40,Clouds
82030,72,1554861600,4,27,31,Clouds
82031,73,1554861600,1,29,30,Clouds
82032,74,1554861600,13,17,30,Clouds
82033,75,1554861600,21,19,40,Clouds
82034,76,1554861600,0,38,38,Clouds
82035,77,1554861600,11,18,29,Clouds
82036,78,1554861600,8,32,40,Clouds
82037,79,1554861600,23,4,27,Clouds
82038,80,1554861600,1,39,40,Clouds
82039,81,1554861600,31,9,40,Clouds
82040,82,1554861600,2,20,22,Clouds
82041,83,1554861600,10,30,40,Clouds
82042,84,1554861600,2,28,30,Clouds
82043,85,1554861600,9,26,35,Clouds
82044,86,1554861600,7,31,38,Clouds
82045,87,1554861600,0,38,38,Clouds
82046,88,1554861600,0,30,30,Clouds
82047,89,1554861600,40,0,40,Clouds
82048,90,1554861600,40,0,40,Clouds
82049,91,1554861600,13,17,30,Clouds
82050,92,1554861600,5,35,40,Clouds
82051,93,1554861600,0,40,40,Clouds
82052,94,1554861600,0,40,40,Clouds
82053,95,1554861600,1,39,40,Clouds
82054,96,1554861600,11,19,30,Clouds
82055,97,1554861600,8,32,40,Clouds
82056,98,1554861600,40,0,40,Clouds
82057,99,1554861600,30,0,30,Clouds
82058,100,1554861600,2,23,25,Clouds
82059,101,1554861600,8,22,30,Clouds
82060,102,1554861600,34,6,40,Clouds
82061,103,1554861600,39,1,40,Clouds
82062,104,1554861600,40,0,40,Clouds
82063,105,1554861600,33,3,36,Clouds
82064,106,1554861600,14,26,40,Clouds
82065,107,1554861600,16,24,40,Clouds
82066,108,1554861600,23,17,40,Clouds
82067,109,1554861600,2,27,29,Clouds
82068,110,1554861600,30,10,40,Clouds
82069,111,1554861600,11,29,40,Clouds
82070,112,1554861600,10,20,30,Clouds
82071,113,1554861600,40,0,40,Clouds
82072,114,1554861600,40,0,40,Clouds
82073,115,1554861600,3,27,30,Clouds
82074,2,1554865200,9,11,20,Clouds
82075,3,1554865200,13,7,20,Clouds
82076,4,1554865200,14,6,20,Clouds
82077,5,1554865200,26,14,40,Clouds
82078,6,1554865200,20,0,20,Clouds
82079,7,1554865200,20,9,29,Clouds
82080,8,1554865200,29,1,30,Clouds
82081,9,1554865200,24,0,24,Clouds
82082,10,1554865200,16,0,16,Clouds
82083,11,1554865200,30,0,30,Clouds
82084,12,1554865200,2,18,20,Clouds
82085,13,1554865200,30,0,30,Clouds
82086,14,1554865200,30,0,30,Clouds
82087,15,1554865200,6,10,16,Clouds
82088,16,1554865200,20,0,20,Clouds
82089,17,1554865200,17,3,20,Clouds
82090,18,1554865200,29,1,30,Clouds
82091,19,1554865200,30,0,30,Clouds
82092,21,1554865200,30,0,30,Clouds
82093,22,1554865200,20,0,20,Clouds
82094,23,1554865200,21,9,30,Clouds
82095,24,1554865200,18,2,20,Clouds
82096,25,1554865200,30,0,30,Clouds
82097,26,1554865200,19,1,20,Clouds
82098,27,1554865200,20,0,20,Clouds
82099,28,1554865200,7,23,30,Clouds
82100,29,1554865200,29,0,29,Clouds
82101,30,1554865200,18,2,20,Clouds
82102,31,1554865200,18,2,20,Clouds
82103,32,1554865200,30,0,30,Clouds
82104,33,1554865200,23,0,23,Clouds
82105,34,1554865200,6,24,30,Clouds
82106,35,1554865200,0,30,30,Clouds
82107,36,1554865200,40,0,40,Clouds
82108,37,1554865200,26,4,30,Clouds
82109,38,1554865200,40,0,40,Clouds
82110,39,1554865200,16,4,20,Clouds
82111,40,1554865200,20,1,21,Clouds
82112,41,1554865200,19,1,20,Clouds
82113,42,1554865200,0,30,30,Clouds
82114,43,1554865200,9,21,30,Clouds
82115,44,1554865200,0,30,30,Clouds
82116,45,1554865200,8,22,30,Clouds
82117,46,1554865200,20,0,20,Clouds
82118,47,1554865200,40,0,40,Clouds
82119,48,1554865200,40,0,40,Clouds
82120,49,1554865200,40,0,40,Clouds
82121,50,1554865200,0,40,40,Clouds
82122,51,1554865200,40,0,40,Clouds
82123,52,1554865200,32,0,32,Clouds
82124,53,1554865200,35,5,40,Clouds
82125,54,1554865200,33,0,33,Clouds
82126,55,1554865200,36,0,36,Clouds
82127,56,1554865200,40,0,40,Clouds
82128,57,1554865200,23,0,23,Clouds
82129,58,1554865200,40,0,40,Clouds
82130,59,1554865200,15,5,20,Clouds
82131,60,1554865200,0,30,30,Clouds
82132,61,1554865200,22,3,25,Clouds
82133,62,1554865200,40,0,40,Clouds
82134,63,1554865200,35,0,35,Clouds
82135,64,1554865200,40,0,40,Clouds
82136,65,1554865200,39,1,40,Clouds
82137,66,1554865200,26,14,40,Clouds
82138,67,1554865200,39,1,40,Clouds
82139,68,1554865200,38,2,40,Clouds
82140,69,1554865200,38,2,40,Clouds
82141,70,1554865200,20,8,28,Clouds
82142,71,1554865200,39,1,40,Clouds
82143,72,1554865200,4,27,31,Clouds
82144,73,1554865200,1,29,30,Clouds
82145,74,1554865200,13,17,30,Clouds
82146,75,1554865200,21,19,40,Clouds
82147,76,1554865200,0,38,38,Clouds
82148,77,1554865200,11,18,29,Clouds
82149,78,1554865200,8,32,40,Clouds
82150,79,1554865200,23,4,27,Clouds
82151,80,1554865200,1,39,40,Clouds
82152,81,1554865200,31,9,40,Clouds
82153,82,1554865200,2,20,22,Clouds
82154,83,1554865200,10,30,40,Clouds
82155,84,1554865200,2,28,30,Clouds
82156,85,1554865200,9,26,35,Clouds
82157,86,1554865200,7,31,38,Clouds
82158,87,1554865200,0,38,38,Clouds
82159,88,1554865200,0,30,30,Clouds
82160,89,1554865200,40,0,40,Clouds
82161,90,1554865200,40,0,40,Clouds
82162,91,1554865200,13,17,30,Clouds
82163,92,1554865200,5,35,40,Clouds
82164,93,1554865200,0,40,40,Clouds
82165,94,1554865200,0,40,40,Clouds
82166,95,1554865200,1,39,40,Clouds
82167,96,1554865200,11,19,30,Clouds
82168,97,1554865200,8,32,40,Clouds
82169,98,1554865200,40,0,40,Clouds
82170,99,1554865200,30,0,30,Clouds
82171,100,1554865200,2,23,25,Clouds
82172,101,1554865200,8,22,30,Clouds
82173,102,1554865200,34,6,40,Clouds
82174,103,1554865200,39,1,40,Clouds
82175,104,1554865200,40,0,40,Clouds
82176,105,1554865200,33,3,36,Clouds
82177,106,1554865200,14,26,40,Clouds
82178,107,1554865200,16,24,40,Clouds
82179,108,1554865200,23,17,40,Clouds
82180,109,1554865200,2,27,29,Clouds
82181,110,1554865200,30,10,40,Clouds
82182,111,1554865200,11,29,40,Clouds
82183,112,1554865200,10,20,30,Clouds
82184,113,1554865200,40,0,40,Clouds
82185,114,1554865200,40,0,40,Clouds
82186,115,1554865200,3,27,30,Clouds
82187,2,1554868800,9,11,20,Clouds
82188,3,1554868800,13,7,20,Clouds
82189,4,1554868800,14,6,20,Clouds
82190,5,1554868800,26,14,40,Clouds
82191,6,1554868800,20,0,20,Clouds
82192,7,1554868800,20,9,29,Clouds
82193,8,1554868800,29,1,30,Clouds
82194,9,1554868800,24,0,24,Clouds
82195,10,1554868800,16,0,16,Clouds
82196,11,1554868800,30,0,30,Clouds
82197,12,1554868800,2,18,20,Clouds
82198,13,1554868800,30,0,30,Clouds
82199,14,1554868800,30,0,30,Clouds
82200,15,1554868800,6,10,16,Clouds
82201,16,1554868800,20,0,20,Clouds
82202,17,1554868800,17,3,20,Clouds
82203,18,1554868800,29,1,30,Clouds
82204,19,1554868800,30,0,30,Clouds
82205,21,1554868800,30,0,30,Clouds
82206,22,1554868800,20,0,20,Clouds
82207,23,1554868800,21,9,30,Clouds
82208,24,1554868800,18,2,20,Clouds
82209,25,1554868800,30,0,30,Clouds
82210,26,1554868800,19,1,20,Clouds
82211,27,1554868800,20,0,20,Clouds
82212,28,1554868800,7,23,30,Clouds
82213,29,1554868800,29,0,29,Clouds
82214,30,1554868800,18,2,20,Clouds
82215,31,1554868800,18,2,20,Clouds
82216,32,1554868800,30,0,30,Clouds
82217,33,1554868800,23,0,23,Clouds
82218,34,1554868800,6,24,30,Clouds
82219,35,1554868800,0,30,30,Clouds
82220,36,1554868800,40,0,40,Clouds
82221,37,1554868800,26,4,30,Clouds
82222,38,1554868800,40,0,40,Clouds
82223,39,1554868800,16,4,20,Clouds
82224,40,1554868800,20,1,21,Clouds
82225,41,1554868800,19,1,20,Clouds
82226,42,1554868800,0,30,30,Clouds
82227,43,1554868800,9,21,30,Clouds
82228,44,1554868800,0,30,30,Clouds
82229,45,1554868800,8,22,30,Clouds
82230,46,1554868800,20,0,20,Clouds
82231,47,1554868800,40,0,40,Clouds
82232,48,1554868800,40,0,40,Clouds
82233,49,1554868800,40,0,40,Clouds
82234,50,1554868800,0,40,40,Clouds
82235,55,1554868800,36,0,36,Clouds
82236,58,1554868800,40,0,40,Clouds
82237,60,1554868800,0,30,30,Clouds
82238,61,1554868800,22,3,25,Clouds
82239,62,1554868800,40,0,40,Clouds
82240,63,1554868800,35,0,35,Clouds
82241,66,1554868800,26,14,40,Clouds
82242,67,1554868800,39,1,40,Clouds
82243,68,1554868800,38,2,40,Clouds
82244,69,1554868800,38,2,40,Clouds
82245,70,1554868800,20,8,28,Clouds
82246,71,1554868800,39,1,40,Clouds
82247,74,1554868800,13,17,30,Clouds
82248,77,1554868800,11,18,29,Clouds
82249,78,1554868800,8,32,40,Clouds
82250,79,1554868800,23,4,27,Clouds
82251,80,1554868800,1,39,40,Clouds
82252,81,1554868800,31,9,40,Clouds
82253,82,1554868800,2,20,22,Clouds
82254,83,1554868800,10,30,40,Clouds
82255,84,1554868800,2,28,30,Clouds
82256,85,1554868800,9,26,35,Clouds
82257,87,1554868800,0,38,38,Clouds
82258,88,1554868800,0,30,30,Clouds
82259,89,1554868800,40,0,40,Clouds
82260,91,1554868800,13,17,30,Clouds
82261,92,1554868800,5,35,40,Clouds
82262,93,1554868800,0,40,40,Clouds
82263,94,1554868800,0,40,40,Clouds
82264,95,1554868800,1,39,40,Clouds
82265,96,1554868800,11,19,30,Clouds
82266,97,1554868800,8,32,40,Clouds
82267,98,1554868800,40,0,40,Clouds
82268,99,1554868800,30,0,30,Clouds
82269,100,1554868800,2,23,25,Clouds
82270,101,1554868800,8,22,30,Clouds
82271,102,1554868800,34,6,40,Clouds
82272,103,1554868800,39,1,40,Clouds
82273,104,1554868800,40,0,40,Clouds
82274,105,1554868800,33,3,36,Clouds
82275,106,1554868800,14,26,40,Clouds
82276,107,1554868800,16,24,40,Clouds
82277,108,1554868800,23,17,40,Clouds
82278,109,1554868800,2,27,29,Clouds
82279,110,1554868800,30,10,40,Clouds
82280,111,1554868800,11,29,40,Clouds
82281,112,1554868800,10,20,30,Clouds
82282,113,1554868800,40,0,40,Clouds
82283,114,1554868800,40,0,40,Clouds
82284,115,1554868800,3,27,30,Clouds
82285,2,1554872400,9,11,20,Clouds
82286,3,1554872400,13,7,20,Clouds
82287,4,1554872400,14,6,20,Clouds
82288,5,1554872400,26,14,40,Clouds
82289,6,1554872400,20,0,20,Clouds
82290,7,1554872400,20,9,29,Clouds
82291,8,1554872400,29,1,30,Clouds
82292,9,1554872400,24,0,24,Clouds
82293,10,1554872400,16,0,16,Clouds
82294,11,1554872400,30,0,30,Clouds
82295,12,1554872400,2,18,20,Clouds
82296,13,1554872400,30,0,30,Clouds
82297,14,1554872400,30,0,30,Clouds
82298,15,1554872400,6,10,16,Clouds
82299,16,1554872400,20,0,20,Clouds
82300,17,1554872400,17,3,20,Clouds
82301,18,1554872400,29,1,30,Clouds
82302,19,1554872400,30,0,30,Clouds
82303,21,1554872400,30,0,30,Clouds
82304,22,1554872400,20,0,20,Clouds
82305,23,1554872400,21,9,30,Clouds
82306,24,1554872400,18,2,20,Clouds
82307,25,1554872400,30,0,30,Clouds
82308,26,1554872400,19,1,20,Clouds
82309,27,1554872400,20,0,20,Clouds
82310,28,1554872400,7,23,30,Clouds
82311,29,1554872400,29,0,29,Clouds
82312,30,1554872400,18,2,20,Clouds
82313,31,1554872400,18,2,20,Clouds
82314,32,1554872400,30,0,30,Clouds
82315,33,1554872400,23,0,23,Clouds
82316,34,1554872400,6,24,30,Clouds
82317,35,1554872400,0,30,30,Clouds
82318,36,1554872400,40,0,40,Clouds
82319,37,1554872400,26,4,30,Clouds
82320,38,1554872400,40,0,40,Clouds
82321,39,1554872400,16,4,20,Clouds
82322,40,1554872400,20,1,21,Clouds
82323,41,1554872400,19,1,20,Clouds
82324,42,1554872400,0,30,30,Clouds
82325,43,1554872400,9,21,30,Clouds
82326,44,1554872400,0,30,30,Clouds
82327,45,1554872400,8,22,30,Clouds
82328,46,1554872400,20,0,20,Clouds
82329,47,1554872400,40,0,40,Clouds
82330,48,1554872400,40,0,40,Clouds
82331,49,1554872400,40,0,40,Clouds
82332,55,1554872400,36,0,36,Clouds
82333,58,1554872400,40,0,40,Clouds
82334,60,1554872400,1,29,30,Clouds
82335,61,1554872400,22,3,25,Clouds
82336,62,1554872400,40,0,40,Clouds
82337,63,1554872400,35,0,35,Clouds
82338,66,1554872400,26,14,40,Clouds
82339,67,1554872400,39,1,40,Clouds
82340,68,1554872400,38,2,40,Clouds
82341,69,1554872400,38,2,40,Clouds
82342,70,1554872400,20,8,28,Clouds
82343,71,1554872400,39,1,40,Clouds
82344,74,1554872400,13,17,30,Clouds
82345,77,1554872400,11,18,29,Clouds
82346,78,1554872400,8,32,40,Clouds
82347,79,1554872400,23,4,27,Clouds
82348,80,1554872400,1,39,40,Clouds
82349,81,1554872400,31,9,40,Clouds
82350,82,1554872400,2,20,22,Clouds
82351,83,1554872400,10,30,40,Clouds
82352,84,1554872400,2,28,30,Clouds
82353,85,1554872400,9,26,35,Clouds
82354,87,1554872400,0,38,38,Clouds
82355,88,1554872400,0,30,30,Clouds
82356,89,1554872400,40,0,40,Clouds
82357,91,1554872400,13,17,30,Clouds
82358,92,1554872400,5,35,40,Clouds
82359,93,1554872400,0,40,40,Clouds
82360,94,1554872400,0,40,40,Clouds
82361,95,1554872400,1,39,40,Clouds
82362,96,1554872400,11,19,30,Clouds
82363,97,1554872400,8,32,40,Clouds
82364,98,1554872400,40,0,40,Clouds
82365,99,1554872400,30,0,30,Clouds
82366,100,1554872400,2,23,25,Clouds
82367,104,1554872400,40,0,40,Clouds
82368,105,1554872400,33,3,36,Clouds
82369,106,1554872400,14,26,40,Clouds
82370,107,1554872400,16,24,40,Clouds
82371,108,1554872400,23,17,40,Clouds
82372,109,1554872400,2,27,29,Clouds
82373,110,1554872400,30,10,40,Clouds
82374,111,1554872400,11,29,40,Clouds
82375,112,1554872400,10,20,30,Clouds
82376,113,1554872400,40,0,40,Clouds
82377,114,1554872400,40,0,40,Clouds
82378,115,1554872400,3,27,30,Clouds
82379,2,1554876000,9,11,20,Clouds
82380,3,1554876000,17,3,20,Clouds
82381,4,1554876000,15,5,20,Clouds
82382,5,1554876000,10,30,40,Clouds
82383,6,1554876000,20,0,20,Clouds
82384,7,1554876000,21,8,29,Clouds
82385,8,1554876000,24,6,30,Clouds
82386,9,1554876000,19,5,24,Clouds
82387,10,1554876000,14,2,16,Clouds
82388,11,1554876000,29,1,30,Clouds
82389,12,1554876000,4,16,20,Clouds
82390,13,1554876000,30,0,30,Clouds
82391,14,1554876000,26,4,30,Clouds
82392,15,1554876000,8,8,16,Clouds
82393,16,1554876000,20,0,20,Clouds
82394,17,1554876000,17,3,20,Clouds
82395,18,1554876000,29,1,30,Clouds
82396,19,1554876000,30,0,30,Clouds
82397,21,1554876000,29,1,30,Clouds
82398,22,1554876000,19,1,20,Clouds
82399,23,1554876000,20,10,30,Clouds
82400,24,1554876000,18,2,20,Clouds
82401,25,1554876000,30,0,30,Clouds
82402,26,1554876000,19,1,20,Clouds
82403,27,1554876000,19,1,20,Clouds
82404,28,1554876000,2,28,30,Clouds
82405,29,1554876000,29,0,29,Clouds
82406,30,1554876000,17,3,20,Clouds
82407,31,1554876000,19,1,20,Clouds
82408,32,1554876000,27,3,30,Clouds
82409,33,1554876000,13,10,23,Clouds
82410,34,1554876000,11,19,30,Clouds
82411,35,1554876000,6,24,30,Clouds
82412,36,1554876000,38,2,40,Clouds
82413,37,1554876000,26,4,30,Clouds
82414,38,1554876000,40,0,40,Clouds
82415,39,1554876000,15,5,20,Clouds
82416,40,1554876000,20,1,21,Clouds
82417,41,1554876000,20,0,20,Clouds
82418,42,1554876000,2,28,30,Clouds
82419,43,1554876000,14,16,30,Clouds
82420,44,1554876000,8,22,30,Clouds
82421,45,1554876000,9,21,30,Clouds
82422,46,1554876000,19,1,20,Clouds
82423,47,1554876000,40,0,40,Clouds
82424,48,1554876000,39,1,40,Clouds
82425,49,1554876000,38,2,40,Clouds
82426,55,1554876000,36,0,36,Clouds
82427,58,1554876000,39,1,40,Clouds
82428,60,1554876000,4,26,30,Clouds
82429,61,1554876000,23,2,25,Clouds
82430,62,1554876000,38,2,40,Clouds
82431,63,1554876000,34,1,35,Clouds
82432,66,1554876000,36,4,40,Clouds
82433,67,1554876000,40,0,40,Clouds
82434,68,1554876000,35,5,40,Clouds
82435,69,1554876000,37,3,40,Clouds
82436,70,1554876000,15,13,28,Clouds
82437,71,1554876000,39,1,40,Clouds
82438,74,1554876000,14,16,30,Clouds
82439,77,1554876000,10,19,29,Clouds
82440,78,1554876000,9,31,40,Clouds
82441,79,1554876000,23,4,27,Clouds
82442,80,1554876000,3,37,40,Clouds
82443,81,1554876000,31,9,40,Clouds
82444,82,1554876000,2,20,22,Clouds
82445,83,1554876000,13,27,40,Clouds
82446,84,1554876000,2,28,30,Clouds
82447,85,1554876000,9,26,35,Clouds
82448,87,1554876000,1,37,38,Clouds
82449,88,1554876000,1,29,30,Clouds
82450,89,1554876000,40,0,40,Clouds
82451,91,1554876000,27,3,30,Clouds
82452,92,1554876000,8,32,40,Clouds
82453,93,1554876000,0,40,40,Clouds
82454,94,1554876000,0,40,40,Clouds
82455,95,1554876000,1,39,40,Clouds
82456,96,1554876000,11,19,30,Clouds
82457,97,1554876000,10,30,40,Clouds
82458,98,1554876000,40,0,40,Clouds
82459,99,1554876000,30,0,30,Clouds
82460,100,1554876000,0,25,25,Clouds
82461,104,1554876000,40,0,40,Clouds
82462,105,1554876000,34,2,36,Clouds
82463,106,1554876000,14,26,40,Clouds
82464,107,1554876000,21,19,40,Clouds
82465,108,1554876000,25,15,40,Clouds
82466,109,1554876000,8,21,29,Clouds
82467,110,1554876000,30,10,40,Clouds
82468,111,1554876000,3,37,40,Clouds
82469,112,1554876000,11,19,30,Clouds
82470,113,1554876000,40,0,40,Clouds
82471,114,1554876000,40,0,40,Clouds
82472,115,1554876000,5,25,30,Clouds
82473,2,1554879600,20,0,20,Clouds
82474,3,1554879600,19,1,20,Clouds
82475,4,1554879600,20,0,20,Clouds
82476,5,1554879600,27,13,40,Clouds
82477,6,1554879600,20,0,20,Clouds
82478,7,1554879600,29,0,29,Clouds
82479,8,1554879600,17,13,30,Clouds
82480,9,1554879600,24,0,24,Clouds
82481,10,1554879600,14,2,16,Clouds
82482,11,1554879600,28,2,30,Clouds
82483,12,1554879600,11,9,20,Clouds
82484,13,1554879600,30,0,30,Clouds
82485,14,1554879600,22,8,30,Clouds
82486,15,1554879600,14,2,16,Clouds
82487,16,1554879600,20,0,20,Clouds
82488,17,1554879600,20,0,20,Clouds
82489,18,1554879600,27,3,30,Clouds
82490,19,1554879600,22,8,30,Clouds
82491,21,1554879600,24,6,30,Clouds
82492,22,1554879600,18,2,20,Clouds
82493,23,1554879600,23,7,30,Clouds
82494,24,1554879600,18,2,20,Clouds
82495,25,1554879600,26,4,30,Clouds
82496,26,1554879600,18,2,20,Clouds
82497,27,1554879600,16,4,20,Clouds
82498,28,1554879600,12,18,30,Clouds
82499,29,1554879600,27,2,29,Clouds
82500,30,1554879600,17,3,20,Clouds
82501,31,1554879600,13,7,20,Clouds
82502,32,1554879600,25,5,30,Clouds
82503,33,1554879600,8,15,23,Clouds
82504,34,1554879600,15,15,30,Clouds
82505,35,1554879600,17,13,30,Clouds
82506,36,1554879600,35,5,40,Clouds
82507,37,1554879600,28,2,30,Clouds
82508,38,1554879600,37,3,40,Clouds
82509,39,1554879600,19,1,20,Clouds
82510,40,1554879600,17,4,21,Clouds
82511,41,1554879600,18,2,20,Clouds
82512,42,1554879600,14,16,30,Clouds
82513,43,1554879600,6,23,29,Clouds
82514,44,1554879600,16,14,30,Clouds
82515,45,1554879600,14,16,30,Clouds
82516,46,1554879600,16,4,20,Clouds
82517,47,1554879600,39,1,40,Clouds
82518,48,1554879600,37,3,40,Clouds
82519,49,1554879600,38,2,40,Clouds
82520,55,1554879600,33,3,36,Clouds
82521,58,1554879600,33,7,40,Clouds
82522,60,1554879600,19,11,30,Clouds
82523,61,1554879600,25,0,25,Clouds
82524,62,1554879600,30,10,40,Clouds
82525,63,1554879600,35,0,35,Clouds
82526,66,1554879600,24,16,40,Clouds
82527,67,1554879600,36,4,40,Clouds
82528,68,1554879600,24,16,40,Clouds
82529,69,1554879600,22,18,40,Clouds
82530,70,1554879600,23,5,28,Clouds
82531,71,1554879600,39,1,40,Clouds
82532,74,1554879600,21,9,30,Clouds
82533,77,1554879600,28,1,29,Clouds
82534,78,1554879600,12,28,40,Clouds
82535,79,1554879600,23,4,27,Clouds
82536,80,1554879600,6,34,40,Clouds
82537,81,1554879600,29,11,40,Clouds
82538,82,1554879600,5,17,22,Clouds
82539,83,1554879600,16,24,40,Clouds
82540,84,1554879600,0,30,30,Clouds
82541,85,1554879600,16,19,35,Clouds
82542,87,1554879600,4,34,38,Clouds
82543,88,1554879600,10,20,30,Clouds
82544,89,1554879600,40,0,40,Clouds
82545,91,1554879600,27,3,30,Clouds
82546,92,1554879600,4,36,40,Clouds
82547,93,1554879600,6,34,40,Clouds
82548,94,1554879600,2,38,40,Clouds
82549,95,1554879600,6,34,40,Clouds
82550,96,1554879600,12,18,30,Clouds
82551,97,1554879600,21,19,40,Clouds
82552,98,1554879600,39,1,40,Clouds
82553,99,1554879600,30,0,30,Clouds
82554,100,1554879600,9,16,25,Clouds
82555,104,1554879600,40,0,40,Clouds
82556,105,1554879600,34,2,36,Clouds
82557,106,1554879600,17,23,40,Clouds
82558,107,1554879600,24,16,40,Clouds
82559,108,1554879600,31,9,40,Clouds
82560,109,1554879600,11,18,29,Clouds
82561,110,1554879600,17,23,40,Clouds
82562,111,1554879600,13,27,40,Clouds
82563,112,1554879600,25,5,30,Clouds
82564,113,1554879600,37,3,40,Clouds
82565,114,1554879600,37,3,40,Clouds
82566,115,1554879600,5,25,30,Clouds
82567,2,1554883200,20,0,20,Clouds
82568,3,1554883200,19,1,20,Clouds
82569,4,1554883200,20,0,20,Clouds
82570,5,1554883200,40,0,40,Clouds
82571,6,1554883200,20,0,20,Clouds
82572,7,1554883200,29,0,29,Clouds
82573,8,1554883200,21,9,30,Clouds
82574,9,1554883200,22,2,24,Clouds
82575,10,1554883200,16,0,16,Clouds
82576,11,1554883200,17,13,30,Clouds
82577,12,1554883200,20,0,20,Clouds
82578,13,1554883200,23,7,30,Clouds
82579,14,1554883200,30,0,30,Clouds
82580,15,1554883200,16,0,16,Clouds
82581,16,1554883200,18,2,20,Clouds
82582,17,1554883200,20,0,20,Clouds
82583,18,1554883200,27,3,30,Clouds
82584,19,1554883200,12,18,30,Clouds
82585,21,1554883200,19,11,30,Clouds
82586,22,1554883200,17,3,20,Clouds
82587,23,1554883200,26,4,30,Clouds
82588,24,1554883200,19,1,20,Clouds
82589,25,1554883200,24,5,29,Clouds
82590,26,1554883200,17,3,20,Clouds
82591,27,1554883200,5,15,20,Clouds
82592,28,1554883200,25,5,30,Clouds
82593,29,1554883200,28,1,29,Clouds
82594,30,1554883200,19,0,19,Clouds
82595,31,1554883200,18,2,20,Clouds
82596,32,1554883200,26,4,30,Clouds
82597,33,1554883200,13,10,23,Clouds
82598,34,1554883200,26,4,30,Clouds
82599,35,1554883200,30,0,30,Clouds
82600,36,1554883200,29,11,40,Clouds
82601,37,1554883200,29,1,30,Clouds
82602,38,1554883200,38,2,40,Clouds
82603,39,1554883200,16,4,20,Clouds
82604,40,1554883200,14,7,21,Clouds
82605,41,1554883200,20,0,20,Clouds
82606,42,1554883200,30,0,30,Clouds
82607,43,1554883200,30,0,30,Clouds
82608,44,1554883200,30,0,30,Clouds
82609,45,1554883200,24,6,30,Clouds
82610,46,1554883200,19,1,20,Clouds
82611,47,1554883200,36,4,40,Clouds
82612,48,1554883200,39,1,40,Clouds
82613,49,1554883200,39,1,40,Clouds
82614,55,1554883200,30,6,36,Clouds
82615,58,1554883200,28,12,40,Clouds
82616,60,1554883200,14,16,30,Clouds
82617,61,1554883200,23,2,25,Clouds
82618,62,1554883200,40,0,40,Clouds
82619,63,1554883200,28,7,35,Clouds
82620,66,1554883200,2,37,39,Clouds
82621,67,1554883200,26,14,40,Clouds
82622,68,1554883200,23,17,40,Clouds
82623,69,1554883200,30,10,40,Clouds
82624,70,1554883200,18,10,28,Clouds
82625,71,1554883200,38,2,40,Clouds
82626,74,1554883200,27,3,30,Clouds
82627,77,1554883200,28,0,28,Clouds
82628,78,1554883200,19,21,40,Clouds
82629,79,1554883200,25,2,27,Clouds
82630,80,1554883200,15,25,40,Clouds
82631,81,1554883200,28,12,40,Clouds
82632,82,1554883200,8,14,22,Clouds
82633,83,1554883200,35,5,40,Clouds
82634,84,1554883200,14,16,30,Clouds
82635,85,1554883200,35,0,35,Clouds
82636,87,1554883200,18,20,38,Clouds
82637,88,1554883200,20,10,30,Clouds
82638,89,1554883200,35,5,40,Clouds
82639,91,1554883200,28,2,30,Clouds
82640,92,1554883200,39,1,40,Clouds
82641,93,1554883200,28,12,40,Clouds
82642,94,1554883200,7,33,40,Clouds
82643,95,1554883200,21,19,40,Clouds
82644,96,1554883200,19,11,30,Clouds
82645,97,1554883200,40,0,40,Clouds
82646,98,1554883200,37,3,40,Clouds
82647,99,1554883200,29,1,30,Clouds
82648,100,1554883200,18,7,25,Clouds
82649,104,1554883200,40,0,40,Clouds
82650,105,1554883200,34,2,36,Clouds
82651,106,1554883200,17,23,40,Clouds
82652,107,1554883200,40,0,40,Clouds
82653,108,1554883200,34,6,40,Clouds
82654,109,1554883200,15,14,29,Clouds
82655,110,1554883200,24,16,40,Clouds
82656,111,1554883200,28,12,40,Clouds
82657,112,1554883200,30,0,30,Clouds
82658,113,1554883200,33,7,40,Clouds
82659,114,1554883200,31,9,40,Clouds
82660,115,1554883200,20,10,30,Clouds
82661,2,1554886800,20,0,20,Clouds
82662,3,1554886800,16,4,20,Clouds
82663,4,1554886800,17,3,20,Clouds
82664,5,1554886800,40,0,40,Clouds
82665,6,1554886800,20,0,20,Clouds
82666,7,1554886800,29,0,29,Clouds
82667,8,1554886800,24,6,30,Clouds
82668,9,1554886800,23,1,24,Clouds
82669,10,1554886800,15,1,16,Clouds
82670,11,1554886800,4,26,30,Clouds
82671,12,1554886800,20,0,20,Clouds
82672,13,1554886800,21,9,30,Clouds
82673,14,1554886800,29,1,30,Clouds
82674,15,1554886800,16,0,16,Clouds
82675,16,1554886800,19,1,20,Clouds
82676,17,1554886800,18,2,20,Clouds
82677,18,1554886800,30,0,30,Clouds
82678,19,1554886800,12,18,30,Clouds
82679,21,1554886800,24,6,30,Clouds
82680,22,1554886800,18,2,20,Clouds
82681,23,1554886800,28,2,30,Clouds
82682,24,1554886800,20,0,20,Clouds
82683,25,1554886800,2,27,29,Clouds
82684,26,1554886800,17,3,20,Clouds
82685,27,1554886800,13,7,20,Clouds
82686,28,1554886800,30,0,30,Clouds
82687,29,1554886800,29,0,29,Clouds
82688,30,1554886800,19,0,19,Clouds
82689,31,1554886800,17,3,20,Clouds
82690,32,1554886800,26,4,30,Clouds
82691,33,1554886800,22,1,23,Clouds
82692,34,1554886800,30,0,30,Clouds
82693,35,1554886800,30,0,30,Clouds
82694,36,1554886800,35,5,40,Clouds
82695,37,1554886800,29,1,30,Clouds
82696,38,1554886800,40,0,40,Clouds
82697,39,1554886800,20,0,20,Clouds
82698,40,1554886800,21,0,21,Clouds
82699,41,1554886800,15,5,20,Clouds
82700,42,1554886800,29,1,30,Clouds
82701,43,1554886800,30,0,30,Clouds
82702,44,1554886800,30,0,30,Clouds
82703,45,1554886800,30,0,30,Clouds
82704,46,1554886800,20,0,20,Clouds
82705,47,1554886800,16,24,40,Clouds
82706,48,1554886800,34,6,40,Clouds
82707,49,1554886800,29,11,40,Clouds
82708,51,1554886800,40,0,40,Clouds
82709,52,1554886800,32,0,32,Clouds
82710,54,1554886800,33,0,33,Clouds
82711,55,1554886800,35,1,36,Clouds
82712,58,1554886800,3,34,37,Clouds
82713,60,1554886800,23,7,30,Clouds
82714,61,1554886800,24,1,25,Clouds
82715,62,1554886800,26,14,40,Clouds
82716,63,1554886800,4,31,35,Clouds
82717,64,1554886800,40,0,40,Clouds
82718,65,1554886800,39,1,40,Clouds
82719,66,1554886800,1,38,39,Clouds
82720,67,1554886800,21,19,40,Clouds
82721,68,1554886800,1,39,40,Clouds
82722,69,1554886800,25,15,40,Clouds
82723,70,1554886800,16,12,28,Clouds
82724,71,1554886800,39,1,40,Clouds
82725,72,1554886800,4,27,31,Clouds
82726,74,1554886800,30,0,30,Clouds
82727,75,1554886800,21,19,40,Clouds
82728,76,1554886800,0,38,38,Clouds
82729,77,1554886800,27,1,28,Clouds
82730,78,1554886800,40,0,40,Clouds
82731,79,1554886800,27,0,27,Clouds
82732,80,1554886800,39,1,40,Clouds
82733,81,1554886800,37,3,40,Clouds
82734,82,1554886800,22,0,22,Clouds
82735,83,1554886800,40,0,40,Clouds
82736,84,1554886800,30,0,30,Clouds
82737,85,1554886800,35,0,35,Clouds
82738,86,1554886800,7,31,38,Clouds
82739,87,1554886800,38,0,38,Clouds
82740,88,1554886800,29,1,30,Clouds
82741,89,1554886800,37,3,40,Clouds
82742,91,1554886800,28,2,30,Clouds
82743,92,1554886800,40,0,40,Clouds
82744,93,1554886800,40,0,40,Clouds
82745,94,1554886800,40,0,40,Clouds
82746,95,1554886800,40,0,40,Clouds
82747,96,1554886800,30,0,30,Clouds
82748,97,1554886800,40,0,40,Clouds
82749,98,1554886800,39,1,40,Clouds
82750,99,1554886800,15,15,30,Clouds
82751,100,1554886800,25,0,25,Clouds
82752,101,1554886800,8,22,30,Clouds
82753,104,1554886800,40,0,40,Clouds
82754,105,1554886800,36,0,36,Clouds
82755,106,1554886800,40,0,40,Clouds
82756,107,1554886800,40,0,40,Clouds
82757,108,1554886800,39,1,40,Clouds
82758,109,1554886800,29,0,29,Clouds
82759,110,1554886800,32,8,40,Clouds
82760,111,1554886800,40,0,40,Clouds
82761,112,1554886800,30,0,30,Clouds
82762,113,1554886800,32,8,40,Clouds
82763,114,1554886800,13,27,40,Clouds
82764,115,1554886800,30,0,30,Clouds
82765,2,1554890400,20,0,20,Clouds
82766,3,1554890400,20,0,20,Clouds
82767,4,1554890400,20,0,20,Clouds
82768,5,1554890400,38,2,40,Clouds
82769,6,1554890400,17,3,20,Clouds
82770,7,1554890400,29,0,29,Clouds
82771,8,1554890400,23,7,30,Clouds
82772,9,1554890400,17,7,24,Clouds
82773,10,1554890400,14,2,16,Clouds
82774,11,1554890400,1,29,30,Clouds
82775,12,1554890400,20,0,20,Clouds
82776,13,1554890400,20,10,30,Clouds
82777,14,1554890400,26,4,30,Clouds
82778,15,1554890400,16,0,16,Clouds
82779,16,1554890400,11,9,20,Clouds
82780,17,1554890400,19,1,20,Clouds
82781,18,1554890400,28,2,30,Clouds
82782,19,1554890400,14,16,30,Clouds
82783,21,1554890400,29,1,30,Clouds
82784,22,1554890400,19,0,19,Clouds
82785,23,1554890400,30,0,30,Clouds
82786,24,1554890400,20,0,20,Clouds
82787,25,1554890400,15,13,28,Clouds
82788,26,1554890400,7,13,20,Clouds
82789,27,1554890400,12,8,20,Clouds
82790,28,1554890400,30,0,30,Clouds
82791,29,1554890400,28,1,29,Clouds
82792,30,1554890400,19,0,19,Clouds
82793,31,1554890400,19,1,20,Clouds
82794,32,1554890400,22,8,30,Clouds
82795,33,1554890400,20,3,23,Clouds
82796,34,1554890400,29,1,30,Clouds
82797,35,1554890400,29,1,30,Clouds
82798,36,1554890400,24,16,40,Clouds
82799,37,1554890400,26,4,30,Clouds
82800,38,1554890400,36,4,40,Clouds
82801,39,1554890400,20,0,20,Clouds
82802,40,1554890400,17,4,21,Clouds
82803,41,1554890400,11,9,20,Clouds
82804,42,1554890400,30,0,30,Clouds
82805,43,1554890400,30,0,30,Clouds
82806,44,1554890400,30,0,30,Clouds
82807,45,1554890400,30,0,30,Clouds
82808,46,1554890400,20,0,20,Clouds
82809,47,1554890400,5,35,40,Clouds
82810,48,1554890400,29,11,40,Clouds
82811,49,1554890400,21,19,40,Clouds
82812,50,1554890400,0,40,40,Clouds
82813,51,1554890400,40,0,40,Clouds
82814,52,1554890400,32,0,32,Clouds
82815,53,1554890400,35,5,40,Clouds
82816,54,1554890400,0,33,33,Clouds
82817,55,1554890400,35,1,36,Clouds
82818,56,1554890400,40,0,40,Clouds
82819,57,1554890400,23,0,23,Clouds
82820,58,1554890400,1,36,37,Clouds
82821,59,1554890400,15,5,20,Clouds
82822,60,1554890400,30,0,30,Clouds
82823,61,1554890400,25,0,25,Clouds
82824,62,1554890400,16,24,40,Clouds
82825,63,1554890400,3,32,35,Clouds
82826,64,1554890400,0,40,40,Clouds
82827,65,1554890400,0,40,40,Clouds
82828,66,1554890400,15,24,39,Clouds
82829,67,1554890400,29,11,40,Clouds
82830,68,1554890400,22,18,40,Clouds
82831,69,1554890400,4,36,40,Clouds
82832,70,1554890400,19,9,28,Clouds
82833,71,1554890400,37,3,40,Clouds
82834,72,1554890400,0,31,31,Clouds
82835,73,1554890400,1,29,30,Clouds
82836,74,1554890400,30,0,30,Clouds
82837,75,1554890400,8,32,40,Clouds
82838,76,1554890400,0,38,38,Clouds
82839,77,1554890400,25,3,28,Clouds
82840,78,1554890400,40,0,40,Clouds
82841,79,1554890400,27,0,27,Clouds
82842,80,1554890400,40,0,40,Clouds
82843,81,1554890400,39,1,40,Clouds
82844,82,1554890400,22,0,22,Clouds
82845,83,1554890400,40,0,40,Clouds
82846,84,1554890400,30,0,30,Clouds
82847,85,1554890400,35,0,35,Clouds
82848,86,1554890400,0,38,38,Clouds
82849,87,1554890400,38,0,38,Clouds
82850,88,1554890400,29,1,30,Clouds
82851,89,1554890400,22,18,40,Clouds
82852,90,1554890400,0,40,40,Clouds
82853,91,1554890400,21,9,30,Clouds
82854,92,1554890400,40,0,40,Clouds
82855,93,1554890400,40,0,40,Clouds
82856,94,1554890400,40,0,40,Clouds
82857,95,1554890400,40,0,40,Clouds
82858,96,1554890400,30,0,30,Clouds
82859,97,1554890400,40,0,40,Clouds
82860,98,1554890400,36,4,40,Clouds
82861,99,1554890400,2,28,30,Clouds
82862,100,1554890400,25,0,25,Clouds
82863,101,1554890400,9,21,30,Clouds
82864,102,1554890400,34,6,40,Clouds
82865,103,1554890400,25,15,40,Clouds
82866,104,1554890400,40,0,40,Clouds
82867,105,1554890400,36,0,36,Clouds
82868,106,1554890400,40,0,40,Clouds
82869,107,1554890400,40,0,40,Clouds
82870,108,1554890400,40,0,40,Clouds
82871,109,1554890400,29,0,29,Clouds
82872,110,1554890400,37,3,40,Clouds
82873,111,1554890400,40,0,40,Clouds
82874,112,1554890400,29,1,30,Clouds
82875,113,1554890400,19,21,40,Clouds
82876,114,1554890400,1,39,40,Clouds
82877,115,1554890400,30,0,30,Clouds
82878,2,1554894000,16,4,20,Clouds
82879,3,1554894000,19,1,20,Clouds
82880,4,1554894000,20,0,20,Clouds
82881,5,1554894000,32,8,40,Clouds
82882,6,1554894000,19,1,20,Clouds
82883,7,1554894000,26,3,29,Clouds
82884,8,1554894000,28,2,30,Clouds
82885,9,1554894000,10,14,24,Clouds
82886,10,1554894000,16,0,16,Clouds
82887,11,1554894000,4,26,30,Clouds
82888,12,1554894000,20,0,20,Clouds
82889,13,1554894000,20,10,30,Clouds
82890,14,1554894000,25,5,30,Clouds
82891,15,1554894000,16,0,16,Clouds
82892,16,1554894000,15,4,19,Clouds
82893,17,1554894000,20,0,20,Clouds
82894,18,1554894000,28,2,30,Clouds
82895,19,1554894000,5,25,30,Clouds
82896,21,1554894000,23,7,30,Clouds
82897,22,1554894000,17,2,19,Clouds
82898,23,1554894000,29,1,30,Clouds
82899,24,1554894000,18,2,20,Clouds
82900,25,1554894000,15,13,28,Clouds
82901,26,1554894000,0,20,20,Clouds
82902,27,1554894000,9,11,20,Clouds
82903,28,1554894000,28,2,30,Clouds
82904,29,1554894000,26,3,29,Clouds
82905,30,1554894000,19,0,19,Clouds
82906,31,1554894000,20,0,20,Clouds
82907,32,1554894000,21,9,30,Clouds
82908,33,1554894000,17,6,23,Clouds
82909,34,1554894000,30,0,30,Clouds
82910,35,1554894000,29,1,30,Clouds
82911,36,1554894000,24,16,40,Clouds
82912,37,1554894000,21,9,30,Clouds
82913,38,1554894000,37,3,40,Clouds
82914,39,1554894000,19,1,20,Clouds
82915,40,1554894000,16,5,21,Clouds
82916,41,1554894000,13,7,20,Clouds
82917,42,1554894000,30,0,30,Clouds
82918,43,1554894000,30,0,30,Clouds
82919,44,1554894000,30,0,30,Clouds
82920,45,1554894000,30,0,30,Clouds
82921,46,1554894000,18,2,20,Clouds
82922,47,1554894000,4,36,40,Clouds
82923,48,1554894000,31,9,40,Clouds
82924,49,1554894000,23,17,40,Clouds
82925,50,1554894000,0,40,40,Clouds
82926,51,1554894000,1,39,40,Clouds
82927,52,1554894000,0,32,32,Clouds
82928,53,1554894000,6,34,40,Clouds
82929,54,1554894000,3,30,33,Clouds
82930,55,1554894000,36,0,36,Clouds
82931,56,1554894000,6,34,40,Clouds
82932,57,1554894000,0,23,23,Clouds
82933,58,1554894000,3,34,37,Clouds
82934,59,1554894000,0,20,20,Clouds
82935,60,1554894000,29,1,30,Clouds
82936,61,1554894000,22,3,25,Clouds
82937,62,1554894000,24,16,40,Clouds
82938,63,1554894000,7,28,35,Clouds
82939,64,1554894000,0,40,40,Clouds
82940,65,1554894000,1,38,39,Clouds
82941,66,1554894000,13,26,39,Clouds
82942,67,1554894000,33,7,40,Clouds
82943,68,1554894000,16,24,40,Clouds
82944,69,1554894000,3,37,40,Clouds
82945,70,1554894000,12,16,28,Clouds
82946,71,1554894000,38,2,40,Clouds
82947,72,1554894000,1,30,31,Clouds
82948,73,1554894000,1,29,30,Clouds
82949,74,1554894000,30,0,30,Clouds
82950,75,1554894000,12,28,40,Clouds
82951,76,1554894000,0,38,38,Clouds
82952,77,1554894000,26,2,28,Clouds
82953,78,1554894000,40,0,40,Clouds
82954,79,1554894000,13,14,27,Clouds
82955,80,1554894000,40,0,40,Clouds
82956,81,1554894000,40,0,40,Clouds
82957,82,1554894000,22,0,22,Clouds
82958,83,1554894000,38,2,40,Clouds
82959,84,1554894000,30,0,30,Clouds
82960,85,1554894000,34,1,35,Clouds
82961,86,1554894000,1,37,38,Clouds
82962,87,1554894000,38,0,38,Clouds
82963,88,1554894000,28,2,30,Clouds
82964,89,1554894000,19,21,40,Clouds
82965,90,1554894000,0,39,39,Clouds
82966,91,1554894000,25,4,29,Clouds
82967,92,1554894000,40,0,40,Clouds
82968,93,1554894000,40,0,40,Clouds
82969,94,1554894000,40,0,40,Clouds
82970,95,1554894000,40,0,40,Clouds
82971,96,1554894000,30,0,30,Clouds
82972,97,1554894000,40,0,40,Clouds
82973,98,1554894000,35,5,40,Clouds
82974,99,1554894000,10,20,30,Clouds
82975,100,1554894000,23,2,25,Clouds
82976,101,1554894000,12,18,30,Clouds
82977,102,1554894000,35,5,40,Clouds
82978,103,1554894000,25,15,40,Clouds
82979,104,1554894000,40,0,40,Clouds
82980,105,1554894000,36,0,36,Clouds
82981,106,1554894000,40,0,40,Clouds
82982,107,1554894000,40,0,40,Clouds
82983,108,1554894000,34,6,40,Clouds
82984,109,1554894000,28,1,29,Clouds
82985,110,1554894000,34,6,40,Clouds
82986,111,1554894000,40,0,40,Clouds
82987,112,1554894000,30,0,30,Clouds
82988,113,1554894000,17,23,40,Clouds
82989,114,1554894000,9,31,40,Clouds
82990,115,1554894000,25,5,30,Clouds
82991,2,1554897600,16,4,20,Clouds
82992,3,1554897600,17,3,20,Clouds
82993,4,1554897600,20,0,20,Clouds
82994,5,1554897600,39,1,40,Clouds
82995,6,1554897600,20,0,20,Clouds
82996,7,1554897600,26,3,29,Clouds
82997,8,1554897600,30,0,30,Clouds
82998,9,1554897600,8,15,23,Clouds
82999,10,1554897600,12,4,16,Clouds
83000,11,1554897600,6,24,30,Clouds
83001,12,1554897600,18,2,20,Clouds
83002,13,1554897600,18,12,30,Clouds
83003,14,1554897600,26,4,30,Clouds
83004,15,1554897600,14,2,16,Clouds
83005,16,1554897600,16,4,20,Clouds
83006,17,1554897600,19,1,20,Clouds
83007,18,1554897600,24,6,30,Clouds
83008,19,1554897600,5,25,30,Clouds
83009,21,1554897600,23,7,30,Clouds
83010,22,1554897600,16,4,20,Clouds
83011,23,1554897600,29,1,30,Clouds
83012,24,1554897600,20,0,20,Clouds
83013,25,1554897600,14,14,28,Clouds
83014,26,1554897600,1,19,20,Clouds
83015,27,1554897600,3,16,19,Clouds
83016,28,1554897600,19,11,30,Clouds
83017,29,1554897600,21,8,29,Clouds
83018,30,1554897600,16,3,19,Clouds
83019,31,1554897600,20,0,20,Clouds
83020,32,1554897600,16,14,30,Clouds
83021,33,1554897600,13,10,23,Clouds
83022,34,1554897600,30,0,30,Clouds
83023,35,1554897600,28,2,30,Clouds
83024,36,1554897600,27,13,40,Clouds
83025,37,1554897600,18,12,30,Clouds
83026,38,1554897600,35,5,40,Clouds
83027,39,1554897600,16,4,20,Clouds
83028,40,1554897600,16,5,21,Clouds
83029,41,1554897600,14,6,20,Clouds
83030,42,1554897600,28,2,30,Clouds
83031,43,1554897600,30,0,30,Clouds
83032,44,1554897600,30,0,30,Clouds
83033,45,1554897600,30,0,30,Clouds
83034,46,1554897600,18,2,20,Clouds
83035,47,1554897600,4,36,40,Clouds
83036,48,1554897600,29,11,40,Clouds
83037,49,1554897600,21,19,40,Clouds
83038,50,1554897600,2,38,40,Clouds
83039,51,1554897600,0,40,40,Clouds
83040,52,1554897600,1,31,32,Clouds
83041,53,1554897600,0,40,40,Clouds
83042,54,1554897600,3,30,33,Clouds
83043,55,1554897600,35,1,36,Clouds
83044,56,1554897600,8,32,40,Clouds
83045,57,1554897600,1,22,23,Clouds
83046,58,1554897600,3,34,37,Clouds
83047,59,1554897600,1,19,20,Clouds
83048,60,1554897600,30,0,30,Clouds
83049,61,1554897600,25,0,25,Clouds
83050,62,1554897600,23,17,40,Clouds
83051,63,1554897600,9,26,35,Clouds
83052,64,1554897600,0,40,40,Clouds
83053,65,1554897600,5,35,40,Clouds
83054,66,1554897600,13,27,40,Clouds
83055,67,1554897600,32,8,40,Clouds
83056,68,1554897600,10,30,40,Clouds
83057,69,1554897600,1,39,40,Clouds
83058,70,1554897600,14,14,28,Clouds
83059,71,1554897600,36,4,40,Clouds
83060,72,1554897600,3,28,31,Clouds
83061,73,1554897600,3,27,30,Clouds
83062,74,1554897600,30,0,30,Clouds
83063,75,1554897600,22,18,40,Clouds
83064,76,1554897600,1,37,38,Clouds
83065,77,1554897600,28,0,28,Clouds
83066,78,1554897600,38,2,40,Clouds
83067,79,1554897600,15,12,27,Clouds
83068,80,1554897600,40,0,40,Clouds
83069,81,1554897600,40,0,40,Clouds
83070,82,1554897600,20,2,22,Clouds
83071,83,1554897600,40,0,40,Clouds
83072,84,1554897600,30,0,30,Clouds
83073,85,1554897600,35,0,35,Clouds
83074,86,1554897600,28,10,38,Clouds
83075,87,1554897600,38,0,38,Clouds
83076,88,1554897600,30,0,30,Clouds
83077,89,1554897600,19,21,40,Clouds
83078,90,1554897600,1,38,39,Clouds
83079,91,1554897600,29,1,30,Clouds
83080,92,1554897600,38,2,40,Clouds
83081,93,1554897600,40,0,40,Clouds
83082,94,1554897600,40,0,40,Clouds
83083,95,1554897600,39,1,40,Clouds
83084,96,1554897600,30,0,30,Clouds
83085,97,1554897600,39,1,40,Clouds
83086,98,1554897600,34,6,40,Clouds
83087,99,1554897600,7,23,30,Clouds
83088,100,1554897600,24,1,25,Clouds
83089,101,1554897600,22,8,30,Clouds
83090,102,1554897600,28,12,40,Clouds
83091,103,1554897600,28,12,40,Clouds
83092,104,1554897600,40,0,40,Clouds
83093,105,1554897600,36,0,36,Clouds
83094,106,1554897600,40,0,40,Clouds
83095,107,1554897600,35,5,40,Clouds
83096,108,1554897600,36,4,40,Clouds
83097,109,1554897600,29,0,29,Clouds
83098,110,1554897600,33,7,40,Clouds
83099,111,1554897600,39,1,40,Clouds
83100,112,1554897600,30,0,30,Clouds
83101,113,1554897600,14,26,40,Clouds
83102,114,1554897600,5,35,40,Clouds
83103,115,1554897600,29,1,30,Clouds
83104,2,1554901200,20,0,20,Clouds
83105,3,1554901200,15,5,20,Clouds
83106,4,1554901200,19,1,20,Clouds
83107,5,1554901200,37,3,40,Clouds
83108,6,1554901200,16,4,20,Clouds
83109,7,1554901200,29,0,29,Clouds
83110,8,1554901200,28,2,30,Clouds
83111,9,1554901200,1,22,23,Clouds
83112,10,1554901200,12,4,16,Clouds
83113,11,1554901200,19,11,30,Clouds
83114,12,1554901200,19,1,20,Clouds
83115,13,1554901200,15,15,30,Clouds
83116,14,1554901200,30,0,30,Clouds
83117,15,1554901200,16,0,16,Clouds
83118,16,1554901200,17,3,20,Clouds
83119,17,1554901200,19,1,20,Clouds
83120,18,1554901200,22,8,30,Clouds
83121,19,1554901200,10,20,30,Clouds
83122,21,1554901200,5,25,30,Clouds
83123,22,1554901200,15,5,20,Clouds
83124,23,1554901200,23,7,30,Clouds
83125,24,1554901200,17,3,20,Clouds
83126,25,1554901200,15,15,30,Clouds
83127,26,1554901200,3,17,20,Clouds
83128,27,1554901200,0,19,19,Clouds
83129,28,1554901200,28,2,30,Clouds
83130,29,1554901200,21,8,29,Clouds
83131,30,1554901200,19,0,19,Clouds
83132,31,1554901200,8,12,20,Clouds
83133,32,1554901200,7,23,30,Clouds
83134,33,1554901200,16,7,23,Clouds
83135,34,1554901200,19,11,30,Clouds
83136,35,1554901200,29,1,30,Clouds
83137,36,1554901200,35,5,40,Clouds
83138,37,1554901200,15,15,30,Clouds
83139,38,1554901200,38,2,40,Clouds
83140,39,1554901200,18,2,20,Clouds
83141,40,1554901200,13,8,21,Clouds
83142,41,1554901200,19,1,20,Clouds
83143,42,1554901200,29,1,30,Clouds
83144,43,1554901200,29,1,30,Clouds
83145,44,1554901200,29,1,30,Clouds
83146,45,1554901200,30,0,30,Clouds
83147,46,1554901200,14,6,20,Clouds
83148,47,1554901200,16,24,40,Clouds
83149,48,1554901200,33,7,40,Clouds
83150,49,1554901200,16,24,40,Clouds
83151,50,1554901200,23,17,40,Clouds
83152,51,1554901200,17,23,40,Clouds
83153,52,1554901200,1,31,32,Clouds
83154,53,1554901200,1,39,40,Clouds
83155,54,1554901200,7,26,33,Clouds
83156,55,1554901200,35,1,36,Clouds
83157,56,1554901200,9,31,40,Clouds
83158,57,1554901200,1,22,23,Clouds
83159,58,1554901200,17,23,40,Clouds
83160,59,1554901200,13,7,20,Clouds
83161,60,1554901200,28,2,30,Clouds
83162,61,1554901200,25,0,25,Clouds
83163,62,1554901200,28,12,40,Clouds
83164,63,1554901200,11,24,35,Clouds
83165,64,1554901200,7,33,40,Clouds
83166,65,1554901200,14,26,40,Clouds
83167,66,1554901200,20,20,40,Clouds
83168,67,1554901200,30,10,40,Clouds
83169,68,1554901200,0,40,40,Clouds
83170,69,1554901200,1,39,40,Clouds
83171,70,1554901200,9,19,28,Clouds
83172,71,1554901200,33,7,40,Clouds
83173,72,1554901200,15,16,31,Clouds
83174,73,1554901200,8,22,30,Clouds
83175,74,1554901200,29,1,30,Clouds
83176,75,1554901200,28,12,40,Clouds
83177,76,1554901200,2,36,38,Clouds
83178,77,1554901200,24,4,28,Clouds
83179,78,1554901200,40,0,40,Clouds
83180,79,1554901200,19,8,27,Clouds
83181,80,1554901200,29,11,40,Clouds
83182,81,1554901200,40,0,40,Clouds
83183,82,1554901200,22,0,22,Clouds
83184,83,1554901200,40,0,40,Clouds
83185,84,1554901200,28,2,30,Clouds
83186,85,1554901200,35,0,35,Clouds
83187,86,1554901200,33,5,38,Clouds
83188,87,1554901200,38,0,38,Clouds
83189,88,1554901200,30,0,30,Clouds
83190,89,1554901200,19,21,40,Clouds
83191,90,1554901200,5,35,40,Clouds
83192,91,1554901200,27,3,30,Clouds
83193,92,1554901200,38,2,40,Clouds
83194,93,1554901200,40,0,40,Clouds
83195,94,1554901200,40,0,40,Clouds
83196,95,1554901200,40,0,40,Clouds
83197,96,1554901200,29,1,30,Clouds
83198,97,1554901200,40,0,40,Clouds
83199,98,1554901200,35,5,40,Clouds
83200,99,1554901200,11,19,30,Clouds
83201,100,1554901200,23,2,25,Clouds
83202,101,1554901200,23,7,30,Clouds
83203,102,1554901200,31,9,40,Clouds
83204,103,1554901200,34,6,40,Clouds
83205,104,1554901200,40,0,40,Clouds
83206,105,1554901200,36,0,36,Clouds
83207,106,1554901200,39,1,40,Clouds
83208,107,1554901200,36,4,40,Clouds
83209,108,1554901200,37,3,40,Clouds
83210,109,1554901200,29,0,29,Clouds
83211,110,1554901200,36,4,40,Clouds
83212,111,1554901200,40,0,40,Clouds
83213,112,1554901200,29,1,30,Clouds
83214,113,1554901200,15,25,40,Clouds
83215,114,1554901200,18,22,40,Clouds
83216,115,1554901200,25,5,30,Clouds
83217,2,1554904800,19,1,20,Clouds
83218,3,1554904800,6,14,20,Clouds
83219,4,1554904800,15,5,20,Clouds
83220,5,1554904800,27,13,40,Clouds
83221,6,1554904800,18,2,20,Clouds
83222,7,1554904800,25,4,29,Clouds
83223,8,1554904800,23,7,30,Clouds
83224,9,1554904800,1,23,24,Clouds
83225,10,1554904800,15,1,16,Clouds
83226,11,1554904800,21,9,30,Clouds
83227,12,1554904800,19,1,20,Clouds
83228,13,1554904800,16,14,30,Clouds
83229,14,1554904800,19,11,30,Clouds
83230,15,1554904800,16,0,16,Clouds
83231,16,1554904800,18,2,20,Clouds
83232,17,1554904800,14,6,20,Clouds
83233,18,1554904800,20,10,30,Clouds
83234,19,1554904800,1,29,30,Clouds
83235,21,1554904800,1,29,30,Clouds
83236,22,1554904800,14,6,20,Clouds
83237,23,1554904800,23,7,30,Clouds
83238,24,1554904800,14,6,20,Clouds
83239,25,1554904800,16,14,30,Clouds
83240,26,1554904800,4,16,20,Clouds
83241,27,1554904800,10,9,19,Clouds
83242,28,1554904800,30,0,30,Clouds
83243,29,1554904800,19,10,29,Clouds
83244,30,1554904800,18,1,19,Clouds
83245,31,1554904800,11,9,20,Clouds
83246,32,1554904800,14,16,30,Clouds
83247,33,1554904800,20,3,23,Clouds
83248,34,1554904800,28,2,30,Clouds
83249,35,1554904800,27,3,30,Clouds
83250,36,1554904800,7,33,40,Clouds
83251,37,1554904800,15,15,30,Clouds
83252,38,1554904800,25,15,40,Clouds
83253,39,1554904800,18,2,20,Clouds
83254,40,1554904800,16,5,21,Clouds
83255,41,1554904800,17,3,20,Clouds
83256,42,1554904800,29,1,30,Clouds
83257,43,1554904800,28,2,30,Clouds
83258,44,1554904800,30,0,30,Clouds
83259,45,1554904800,29,1,30,Clouds
83260,46,1554904800,13,7,20,Clouds
83261,47,1554904800,12,28,40,Clouds
83262,48,1554904800,28,12,40,Clouds
83263,49,1554904800,16,24,40,Clouds
83264,50,1554904800,32,8,40,Clouds
83265,51,1554904800,14,26,40,Clouds
83266,52,1554904800,1,31,32,Clouds
83267,53,1554904800,1,39,40,Clouds
83268,54,1554904800,9,24,33,Clouds
83269,55,1554904800,36,0,36,Clouds
83270,56,1554904800,13,27,40,Clouds
83271,57,1554904800,0,22,22,Clouds
83272,58,1554904800,7,33,40,Clouds
83273,59,1554904800,20,0,20,Clouds
83274,60,1554904800,27,3,30,Clouds
83275,61,1554904800,25,0,25,Clouds
83276,62,1554904800,26,14,40,Clouds
83277,63,1554904800,5,30,35,Clouds
83278,64,1554904800,2,38,40,Clouds
83279,65,1554904800,16,24,40,Clouds
83280,66,1554904800,22,18,40,Clouds
83281,67,1554904800,32,8,40,Clouds
83282,68,1554904800,15,25,40,Clouds
83283,69,1554904800,1,39,40,Clouds
83284,70,1554904800,14,14,28,Clouds
83285,71,1554904800,40,0,40,Clouds
83286,72,1554904800,11,20,31,Clouds
83287,73,1554904800,9,21,30,Clouds
83288,74,1554904800,12,18,30,Clouds
83289,75,1554904800,31,9,40,Clouds
83290,76,1554904800,18,20,38,Clouds
83291,77,1554904800,23,5,28,Clouds
83292,78,1554904800,37,3,40,Clouds
83293,79,1554904800,22,5,27,Clouds
83294,80,1554904800,25,15,40,Clouds
83295,81,1554904800,27,13,40,Clouds
83296,82,1554904800,22,0,22,Clouds
83297,83,1554904800,40,0,40,Clouds
83298,84,1554904800,30,0,30,Clouds
83299,85,1554904800,35,0,35,Clouds
83300,86,1554904800,32,6,38,Clouds
83301,87,1554904800,37,1,38,Clouds
83302,88,1554904800,29,1,30,Clouds
83303,89,1554904800,23,17,40,Clouds
83304,90,1554904800,7,33,40,Clouds
83305,91,1554904800,24,6,30,Clouds
83306,92,1554904800,36,4,40,Clouds
83307,93,1554904800,40,0,40,Clouds
83308,94,1554904800,40,0,40,Clouds
83309,95,1554904800,37,3,40,Clouds
83310,96,1554904800,30,0,30,Clouds
83311,97,1554904800,30,10,40,Clouds
83312,98,1554904800,35,5,40,Clouds
83313,99,1554904800,9,21,30,Clouds
83314,100,1554904800,22,3,25,Clouds
83315,101,1554904800,25,5,30,Clouds
83316,102,1554904800,36,4,40,Clouds
83317,103,1554904800,31,9,40,Clouds
83318,104,1554904800,40,0,40,Clouds
83319,105,1554904800,36,0,36,Clouds
83320,106,1554904800,40,0,40,Clouds
83321,107,1554904800,37,3,40,Clouds
83322,108,1554904800,40,0,40,Clouds
83323,109,1554904800,29,0,29,Clouds
83324,110,1554904800,40,0,40,Clouds
83325,111,1554904800,40,0,40,Clouds
83326,112,1554904800,30,0,30,Clouds
83327,113,1554904800,16,24,40,Clouds
83328,114,1554904800,13,27,40,Clouds
83329,115,1554904800,29,1,30,Clouds
83330,2,1554908400,20,0,20,Clouds
83331,3,1554908400,8,12,20,Clouds
83332,4,1554908400,17,3,20,Clouds
83333,5,1554908400,28,12,40,Clouds
83334,6,1554908400,18,2,20,Clouds
83335,7,1554908400,28,1,29,Clouds
83336,8,1554908400,21,9,30,Clouds
83337,9,1554908400,6,18,24,Clouds
83338,10,1554908400,12,4,16,Clouds
83339,11,1554908400,23,7,30,Clouds
83340,12,1554908400,19,1,20,Clouds
83341,13,1554908400,18,12,30,Clouds
83342,14,1554908400,16,14,30,Clouds
83343,15,1554908400,16,0,16,Clouds
83344,16,1554908400,15,5,20,Clouds
83345,17,1554908400,13,7,20,Clouds
83346,18,1554908400,27,3,30,Clouds
83347,19,1554908400,0,30,30,Clouds
83348,21,1554908400,2,28,30,Clouds
83349,22,1554908400,13,7,20,Clouds
83350,23,1554908400,14,16,30,Clouds
83351,24,1554908400,17,3,20,Clouds
83352,25,1554908400,16,14,30,Clouds
83353,26,1554908400,6,14,20,Clouds
83354,27,1554908400,11,8,19,Clouds
83355,28,1554908400,15,15,30,Clouds
83356,29,1554908400,19,10,29,Clouds
83357,30,1554908400,19,0,19,Clouds
83358,31,1554908400,16,4,20,Clouds
83359,32,1554908400,16,14,30,Clouds
83360,33,1554908400,19,4,23,Clouds
83361,34,1554908400,24,6,30,Clouds
83362,35,1554908400,24,6,30,Clouds
83363,36,1554908400,9,31,40,Clouds
83364,37,1554908400,16,14,30,Clouds
83365,38,1554908400,25,15,40,Clouds
83366,39,1554908400,15,5,20,Clouds
83367,40,1554908400,18,3,21,Clouds
83368,41,1554908400,14,6,20,Clouds
83369,42,1554908400,30,0,30,Clouds
83370,43,1554908400,28,2,30,Clouds
83371,44,1554908400,27,3,30,Clouds
83372,45,1554908400,29,1,30,Clouds
83373,46,1554908400,10,10,20,Clouds
83374,47,1554908400,8,32,40,Clouds
83375,48,1554908400,24,16,40,Clouds
83376,49,1554908400,12,28,40,Clouds
83377,50,1554908400,32,8,40,Clouds
83378,51,1554908400,9,31,40,Clouds
83379,52,1554908400,2,30,32,Clouds
83380,53,1554908400,1,39,40,Clouds
83381,54,1554908400,10,23,33,Clouds
83382,55,1554908400,34,2,36,Clouds
83383,56,1554908400,5,35,40,Clouds
83384,57,1554908400,3,20,23,Clouds
83385,58,1554908400,10,30,40,Clouds
83386,59,1554908400,19,1,20,Clouds
83387,60,1554908400,24,6,30,Clouds
83388,61,1554908400,13,12,25,Clouds
83389,62,1554908400,30,10,40,Clouds
83390,63,1554908400,5,30,35,Clouds
83391,64,1554908400,20,20,40,Clouds
83392,65,1554908400,11,29,40,Clouds
83393,66,1554908400,20,20,40,Clouds
83394,67,1554908400,28,12,40,Clouds
83395,68,1554908400,13,27,40,Clouds
83396,69,1554908400,3,37,40,Clouds
83397,70,1554908400,14,14,28,Clouds
83398,71,1554908400,37,3,40,Clouds
83399,72,1554908400,14,17,31,Clouds
83400,73,1554908400,8,22,30,Clouds
83401,74,1554908400,11,19,30,Clouds
83402,75,1554908400,27,13,40,Clouds
83403,76,1554908400,20,18,38,Clouds
83404,77,1554908400,27,1,28,Clouds
83405,78,1554908400,37,3,40,Clouds
83406,79,1554908400,23,4,27,Clouds
83407,80,1554908400,28,12,40,Clouds
83408,81,1554908400,30,10,40,Clouds
83409,82,1554908400,22,0,22,Clouds
83410,83,1554908400,30,10,40,Clouds
83411,84,1554908400,29,1,30,Clouds
83412,85,1554908400,34,1,35,Clouds
83413,86,1554908400,35,3,38,Clouds
83414,87,1554908400,33,5,38,Clouds
83415,88,1554908400,30,0,30,Clouds
83416,89,1554908400,25,15,40,Clouds
83417,90,1554908400,6,34,40,Clouds
83418,91,1554908400,20,10,30,Clouds
83419,92,1554908400,37,3,40,Clouds
83420,93,1554908400,40,0,40,Clouds
83421,94,1554908400,39,1,40,Clouds
83422,95,1554908400,40,0,40,Clouds
83423,96,1554908400,30,0,30,Clouds
83424,97,1554908400,24,16,40,Clouds
83425,98,1554908400,38,2,40,Clouds
83426,99,1554908400,9,21,30,Clouds
83427,100,1554908400,19,6,25,Clouds
83428,101,1554908400,23,7,30,Clouds
83429,102,1554908400,38,2,40,Clouds
83430,103,1554908400,33,7,40,Clouds
83431,104,1554908400,38,2,40,Clouds
83432,105,1554908400,34,2,36,Clouds
83433,106,1554908400,39,1,40,Clouds
83434,107,1554908400,40,0,40,Clouds
83435,108,1554908400,40,0,40,Clouds
83436,109,1554908400,28,1,29,Clouds
83437,110,1554908400,40,0,40,Clouds
83438,111,1554908400,40,0,40,Clouds
83439,112,1554908400,30,0,30,Clouds
83440,113,1554908400,17,23,40,Clouds
83441,114,1554908400,14,26,40,Clouds
83442,115,1554908400,29,1,30,Clouds
83443,2,1554912000,17,3,20,Clouds
83444,3,1554912000,13,7,20,Clouds
83445,4,1554912000,18,2,20,Clouds
83446,5,1554912000,28,12,40,Clouds
83447,6,1554912000,17,3,20,Clouds
83448,7,1554912000,11,18,29,Clouds
83449,8,1554912000,16,14,30,Clouds
83450,9,1554912000,17,7,24,Clouds
83451,10,1554912000,15,1,16,Clouds
83452,11,1554912000,16,14,30,Clouds
83453,12,1554912000,20,0,20,Clouds
83454,13,1554912000,25,5,30,Clouds
83455,14,1554912000,24,6,30,Clouds
83456,15,1554912000,16,0,16,Clouds
83457,16,1554912000,14,6,20,Clouds
83458,17,1554912000,15,5,20,Clouds
83459,18,1554912000,25,5,30,Clouds
83460,19,1554912000,2,28,30,Clouds
83461,21,1554912000,3,27,30,Clouds
83462,22,1554912000,16,4,20,Clouds
83463,23,1554912000,24,6,30,Clouds
83464,24,1554912000,15,5,20,Clouds
83465,25,1554912000,21,9,30,Clouds
83466,26,1554912000,6,14,20,Clouds
83467,27,1554912000,12,7,19,Clouds
83468,28,1554912000,24,6,30,Clouds
83469,29,1554912000,20,9,29,Clouds
83470,30,1554912000,20,0,20,Clouds
83471,31,1554912000,10,10,20,Clouds
83472,32,1554912000,12,18,30,Clouds
83473,33,1554912000,10,13,23,Clouds
83474,34,1554912000,15,15,30,Clouds
83475,35,1554912000,30,0,30,Clouds
83476,36,1554912000,5,35,40,Clouds
83477,37,1554912000,19,11,30,Clouds
83478,38,1554912000,21,19,40,Clouds
83479,39,1554912000,16,4,20,Clouds
83480,40,1554912000,14,7,21,Clouds
83481,41,1554912000,12,8,20,Clouds
83482,42,1554912000,25,5,30,Clouds
83483,43,1554912000,28,2,30,Clouds
83484,44,1554912000,29,1,30,Clouds
83485,45,1554912000,20,10,30,Clouds
83486,46,1554912000,10,10,20,Clouds
83487,47,1554912000,8,32,40,Clouds
83488,48,1554912000,23,17,40,Clouds
83489,49,1554912000,12,28,40,Clouds
83490,50,1554912000,35,5,40,Clouds
83491,51,1554912000,19,21,40,Clouds
83492,52,1554912000,3,29,32,Clouds
83493,53,1554912000,3,37,40,Clouds
83494,54,1554912000,17,16,33,Clouds
83495,55,1554912000,36,0,36,Clouds
83496,56,1554912000,6,34,40,Clouds
83497,57,1554912000,4,19,23,Clouds
83498,58,1554912000,21,19,40,Clouds
83499,59,1554912000,17,3,20,Clouds
83500,60,1554912000,20,10,30,Clouds
83501,61,1554912000,19,6,25,Clouds
83502,62,1554912000,35,5,40,Clouds
83503,63,1554912000,4,31,35,Clouds
83504,64,1554912000,22,18,40,Clouds
83505,65,1554912000,16,24,40,Clouds
83506,66,1554912000,26,14,40,Clouds
83507,67,1554912000,26,14,40,Clouds
83508,68,1554912000,14,26,40,Clouds
83509,69,1554912000,11,29,40,Clouds
83510,70,1554912000,15,13,28,Clouds
83511,71,1554912000,38,2,40,Clouds
83512,72,1554912000,11,20,31,Clouds
83513,73,1554912000,6,24,30,Clouds
83514,74,1554912000,9,21,30,Clouds
83515,75,1554912000,23,17,40,Clouds
83516,76,1554912000,1,37,38,Clouds
83517,77,1554912000,13,16,29,Clouds
83518,78,1554912000,35,5,40,Clouds
83519,79,1554912000,24,3,27,Clouds
83520,80,1554912000,29,11,40,Clouds
83521,81,1554912000,30,10,40,Clouds
83522,82,1554912000,22,0,22,Clouds
83523,83,1554912000,32,8,40,Clouds
83524,84,1554912000,27,3,30,Clouds
83525,85,1554912000,34,1,35,Clouds
83526,86,1554912000,36,2,38,Clouds
83527,87,1554912000,35,3,38,Clouds
83528,88,1554912000,30,0,30,Clouds
83529,89,1554912000,26,14,40,Clouds
83530,90,1554912000,12,28,40,Clouds
83531,91,1554912000,22,8,30,Clouds
83532,92,1554912000,37,3,40,Clouds
83533,93,1554912000,38,2,40,Clouds
83534,94,1554912000,38,2,40,Clouds
83535,95,1554912000,40,0,40,Clouds
83536,96,1554912000,29,1,30,Clouds
83537,97,1554912000,24,16,40,Clouds
83538,98,1554912000,37,3,40,Clouds
83539,99,1554912000,9,21,30,Clouds
83540,100,1554912000,14,11,25,Clouds
83541,101,1554912000,21,9,30,Clouds
83542,102,1554912000,40,0,40,Clouds
83543,103,1554912000,34,6,40,Clouds
83544,104,1554912000,39,1,40,Clouds
83545,105,1554912000,34,2,36,Clouds
83546,106,1554912000,40,0,40,Clouds
83547,107,1554912000,39,1,40,Clouds
83548,108,1554912000,40,0,40,Clouds
83549,109,1554912000,25,4,29,Clouds
83550,110,1554912000,39,1,40,Clouds
83551,111,1554912000,40,0,40,Clouds
83552,112,1554912000,23,7,30,Clouds
83553,113,1554912000,19,21,40,Clouds
83554,114,1554912000,19,21,40,Clouds
83555,115,1554912000,23,7,30,Clouds
83556,2,1554915600,18,2,20,Clouds
83557,3,1554915600,20,0,20,Clouds
83558,4,1554915600,17,3,20,Clouds
83559,5,1554915600,23,17,40,Clouds
83560,6,1554915600,19,1,20,Clouds
83561,7,1554915600,15,14,29,Clouds
83562,8,1554915600,12,17,29,Clouds
83563,9,1554915600,23,1,24,Clouds
83564,10,1554915600,15,1,16,Clouds
83565,11,1554915600,30,0,30,Clouds
83566,12,1554915600,14,6,20,Clouds
83567,13,1554915600,30,0,30,Clouds
83568,14,1554915600,26,4,30,Clouds
83569,15,1554915600,15,1,16,Clouds
83570,16,1554915600,13,7,20,Clouds
83571,17,1554915600,20,0,20,Clouds
83572,18,1554915600,26,4,30,Clouds
83573,19,1554915600,27,3,30,Clouds
83574,21,1554915600,3,27,30,Clouds
83575,22,1554915600,9,11,20,Clouds
83576,23,1554915600,9,21,30,Clouds
83577,24,1554915600,12,8,20,Clouds
83578,25,1554915600,30,0,30,Clouds
83579,26,1554915600,3,17,20,Clouds
83580,27,1554915600,17,2,19,Clouds
83581,28,1554915600,19,11,30,Clouds
83582,29,1554915600,29,0,29,Clouds
83583,30,1554915600,20,0,20,Clouds
83584,31,1554915600,15,5,20,Clouds
83585,32,1554915600,13,17,30,Clouds
83586,33,1554915600,1,22,23,Clouds
83587,34,1554915600,12,18,30,Clouds
83588,35,1554915600,23,7,30,Clouds
83589,36,1554915600,18,22,40,Clouds
83590,37,1554915600,26,4,30,Clouds
83591,38,1554915600,10,29,39,Clouds
83592,39,1554915600,20,0,20,Clouds
83593,40,1554915600,20,1,21,Clouds
83594,41,1554915600,12,8,20,Clouds
83595,42,1554915600,22,8,30,Clouds
83596,43,1554915600,18,12,30,Clouds
83597,44,1554915600,22,8,30,Clouds
83598,45,1554915600,22,7,29,Clouds
83599,46,1554915600,9,11,20,Clouds
83600,47,1554915600,22,18,40,Clouds
83601,48,1554915600,20,20,40,Clouds
83602,49,1554915600,20,20,40,Clouds
83603,50,1554915600,34,6,40,Clouds
83604,51,1554915600,21,19,40,Clouds
83605,52,1554915600,5,27,32,Clouds
83606,53,1554915600,11,29,40,Clouds
83607,54,1554915600,33,0,33,Clouds
83608,55,1554915600,36,0,36,Clouds
83609,56,1554915600,12,28,40,Clouds
83610,57,1554915600,11,12,23,Clouds
83611,58,1554915600,35,5,40,Clouds
83612,59,1554915600,20,0,20,Clouds
83613,60,1554915600,14,16,30,Clouds
83614,61,1554915600,24,1,25,Clouds
83615,62,1554915600,40,0,40,Clouds
83616,63,1554915600,4,31,35,Clouds
83617,64,1554915600,22,18,40,Clouds
83618,65,1554915600,29,11,40,Clouds
83619,66,1554915600,40,0,40,Clouds
83620,67,1554915600,25,15,40,Clouds
83621,68,1554915600,25,15,40,Clouds
83622,69,1554915600,17,23,40,Clouds
83623,70,1554915600,12,16,28,Clouds
83624,71,1554915600,40,0,40,Clouds
83625,72,1554915600,10,21,31,Clouds
83626,73,1554915600,11,19,30,Clouds
83627,74,1554915600,6,24,30,Clouds
83628,75,1554915600,19,21,40,Clouds
83629,76,1554915600,4,34,38,Clouds
83630,77,1554915600,17,12,29,Clouds
83631,78,1554915600,35,5,40,Clouds
83632,79,1554915600,27,0,27,Clouds
83633,80,1554915600,18,22,40,Clouds
83634,81,1554915600,31,9,40,Clouds
83635,82,1554915600,22,0,22,Clouds
83636,83,1554915600,26,14,40,Clouds
83637,84,1554915600,24,6,30,Clouds
83638,85,1554915600,32,3,35,Clouds
83639,86,1554915600,24,14,38,Clouds
83640,87,1554915600,37,1,38,Clouds
83641,88,1554915600,21,9,30,Clouds
83642,89,1554915600,40,0,40,Clouds
83643,90,1554915600,40,0,40,Clouds
83644,91,1554915600,29,1,30,Clouds
83645,92,1554915600,26,14,40,Clouds
83646,93,1554915600,9,31,40,Clouds
83647,94,1554915600,38,2,40,Clouds
83648,95,1554915600,34,6,40,Clouds
83649,96,1554915600,29,1,30,Clouds
83650,97,1554915600,31,9,40,Clouds
83651,98,1554915600,40,0,40,Clouds
83652,99,1554915600,14,16,30,Clouds
83653,100,1554915600,0,25,25,Clouds
83654,101,1554915600,14,16,30,Clouds
83655,102,1554915600,38,2,40,Clouds
83656,103,1554915600,40,0,40,Clouds
83657,104,1554915600,39,1,40,Clouds
83658,105,1554915600,36,0,36,Clouds
83659,106,1554915600,40,0,40,Clouds
83660,107,1554915600,36,4,40,Clouds
83661,108,1554915600,39,1,40,Clouds
83662,109,1554915600,23,6,29,Clouds
83663,110,1554915600,40,0,40,Clouds
83664,111,1554915600,38,2,40,Clouds
83665,112,1554915600,25,5,30,Clouds
83666,113,1554915600,22,18,40,Clouds
83667,114,1554915600,40,0,40,Clouds
83668,115,1554915600,22,8,30,Clouds
83669,2,1554919200,16,4,20,Clouds
83670,3,1554919200,18,2,20,Clouds
83671,4,1554919200,18,2,20,Clouds
83672,5,1554919200,29,11,40,Clouds
83673,6,1554919200,19,1,20,Clouds
83674,7,1554919200,11,18,29,Clouds
83675,8,1554919200,25,5,30,Clouds
83676,9,1554919200,12,12,24,Clouds
83677,10,1554919200,10,6,16,Clouds
83678,11,1554919200,30,0,30,Clouds
83679,12,1554919200,18,2,20,Clouds
83680,13,1554919200,29,1,30,Clouds
83681,14,1554919200,19,11,30,Clouds
83682,15,1554919200,14,2,16,Clouds
83683,16,1554919200,6,14,20,Clouds
83684,17,1554919200,20,0,20,Clouds
83685,18,1554919200,27,3,30,Clouds
83686,19,1554919200,29,1,30,Clouds
83687,21,1554919200,5,25,30,Clouds
83688,22,1554919200,4,16,20,Clouds
83689,23,1554919200,0,30,30,Clouds
83690,24,1554919200,7,13,20,Clouds
83691,25,1554919200,30,0,30,Clouds
83692,26,1554919200,20,0,20,Clouds
83693,27,1554919200,18,1,19,Clouds
83694,28,1554919200,15,15,30,Clouds
83695,29,1554919200,27,2,29,Clouds
83696,30,1554919200,19,1,20,Clouds
83697,31,1554919200,18,2,20,Clouds
83698,32,1554919200,2,28,30,Clouds
83699,33,1554919200,1,22,23,Clouds
83700,34,1554919200,16,14,30,Clouds
83701,35,1554919200,28,2,30,Clouds
83702,36,1554919200,40,0,40,Clouds
83703,37,1554919200,30,0,30,Clouds
83704,38,1554919200,11,29,40,Clouds
83705,39,1554919200,15,5,20,Clouds
83706,40,1554919200,16,5,21,Clouds
83707,41,1554919200,20,0,20,Clouds
83708,42,1554919200,14,16,30,Clouds
83709,43,1554919200,7,23,30,Clouds
83710,44,1554919200,16,14,30,Clouds
83711,45,1554919200,15,15,30,Clouds
83712,46,1554919200,13,7,20,Clouds
83713,47,1554919200,40,0,40,Clouds
83714,48,1554919200,40,0,40,Clouds
83715,49,1554919200,38,2,40,Clouds
83716,50,1554919200,26,14,40,Clouds
83717,51,1554919200,22,18,40,Clouds
83718,52,1554919200,18,14,32,Clouds
83719,53,1554919200,31,9,40,Clouds
83720,54,1554919200,33,0,33,Clouds
83721,55,1554919200,36,0,36,Clouds
83722,56,1554919200,39,1,40,Clouds
83723,57,1554919200,23,0,23,Clouds
83724,58,1554919200,40,0,40,Clouds
83725,59,1554919200,15,5,20,Clouds
83726,60,1554919200,2,28,30,Clouds
83727,61,1554919200,19,6,25,Clouds
83728,62,1554919200,38,2,40,Clouds
83729,63,1554919200,35,0,35,Clouds
83730,64,1554919200,30,10,40,Clouds
83731,65,1554919200,38,2,40,Clouds
83732,66,1554919200,40,0,40,Clouds
83733,67,1554919200,40,0,40,Clouds
83734,68,1554919200,40,0,40,Clouds
83735,69,1554919200,40,0,40,Clouds
83736,70,1554919200,28,0,28,Clouds
83737,71,1554919200,40,0,40,Clouds
83738,72,1554919200,18,13,31,Clouds
83739,73,1554919200,17,13,30,Clouds
83740,74,1554919200,10,20,30,Clouds
83741,75,1554919200,8,32,40,Clouds
83742,76,1554919200,1,37,38,Clouds
83743,77,1554919200,29,0,29,Clouds
83744,78,1554919200,30,10,40,Clouds
83745,79,1554919200,27,0,27,Clouds
83746,80,1554919200,20,20,40,Clouds
83747,81,1554919200,15,25,40,Clouds
83748,82,1554919200,17,5,22,Clouds
83749,83,1554919200,16,24,40,Clouds
83750,84,1554919200,14,16,30,Clouds
83751,85,1554919200,30,5,35,Clouds
83752,86,1554919200,5,33,38,Clouds
83753,87,1554919200,31,7,38,Clouds
83754,88,1554919200,17,13,30,Clouds
83755,89,1554919200,40,0,40,Clouds
83756,90,1554919200,38,2,40,Clouds
83757,91,1554919200,19,11,30,Clouds
83758,92,1554919200,1,39,40,Clouds
83759,93,1554919200,0,40,40,Clouds
83760,94,1554919200,4,36,40,Clouds
83761,95,1554919200,24,16,40,Clouds
83762,96,1554919200,21,9,30,Clouds
83763,97,1554919200,16,24,40,Clouds
83764,98,1554919200,39,1,40,Clouds
83765,99,1554919200,30,0,30,Clouds
83766,100,1554919200,3,22,25,Clouds
83767,101,1554919200,12,18,30,Clouds
83768,102,1554919200,37,3,40,Clouds
83769,103,1554919200,40,0,40,Clouds
83770,104,1554919200,40,0,40,Clouds
83771,105,1554919200,35,1,36,Clouds
83772,106,1554919200,38,2,40,Clouds
83773,107,1554919200,30,10,40,Clouds
83774,108,1554919200,29,11,40,Clouds
83775,109,1554919200,26,3,29,Clouds
83776,110,1554919200,37,3,40,Clouds
83777,111,1554919200,34,6,40,Clouds
83778,112,1554919200,26,4,30,Clouds
83779,113,1554919200,39,1,40,Clouds
83780,114,1554919200,40,0,40,Clouds
83781,115,1554919200,15,15,30,Clouds
83782,2,1554922800,10,10,20,Clouds
83783,3,1554922800,20,0,20,Clouds
83784,4,1554922800,17,3,20,Clouds
83785,5,1554922800,35,5,40,Clouds
83786,6,1554922800,13,7,20,Clouds
83787,7,1554922800,15,14,29,Clouds
83788,8,1554922800,30,0,30,Clouds
83789,9,1554922800,3,21,24,Clouds
83790,10,1554922800,4,12,16,Clouds
83791,11,1554922800,30,0,30,Clouds
83792,12,1554922800,9,11,20,Clouds
83793,13,1554922800,30,0,30,Clouds
83794,14,1554922800,8,22,30,Clouds
83795,15,1554922800,16,0,16,Clouds
83796,16,1554922800,20,0,20,Clouds
83797,17,1554922800,20,0,20,Clouds
83798,18,1554922800,27,3,30,Clouds
83799,19,1554922800,29,1,30,Clouds
83800,21,1554922800,28,2,30,Clouds
83801,22,1554922800,1,19,20,Clouds
83802,23,1554922800,9,21,30,Clouds
83803,24,1554922800,9,11,20,Clouds
83804,25,1554922800,30,0,30,Clouds
83805,26,1554922800,20,0,20,Clouds
83806,27,1554922800,19,0,19,Clouds
83807,28,1554922800,14,16,30,Clouds
83808,29,1554922800,26,3,29,Clouds
83809,30,1554922800,20,0,20,Clouds
83810,31,1554922800,19,1,20,Clouds
83811,32,1554922800,19,11,30,Clouds
83812,33,1554922800,5,18,23,Clouds
83813,34,1554922800,22,8,30,Clouds
83814,35,1554922800,21,9,30,Clouds
83815,36,1554922800,40,0,40,Clouds
83816,37,1554922800,24,6,30,Clouds
83817,38,1554922800,18,22,40,Clouds
83818,39,1554922800,19,1,20,Clouds
83819,40,1554922800,19,2,21,Clouds
83820,41,1554922800,20,0,20,Clouds
83821,42,1554922800,13,17,30,Clouds
83822,43,1554922800,1,29,30,Clouds
83823,44,1554922800,12,18,30,Clouds
83824,45,1554922800,10,20,30,Clouds
83825,46,1554922800,16,4,20,Clouds
83826,47,1554922800,40,0,40,Clouds
83827,48,1554922800,39,1,40,Clouds
83828,49,1554922800,40,0,40,Clouds
83829,50,1554922800,15,25,40,Clouds
83830,51,1554922800,24,16,40,Clouds
83831,52,1554922800,26,6,32,Clouds
83832,53,1554922800,40,0,40,Clouds
83833,54,1554922800,33,0,33,Clouds
83834,55,1554922800,35,1,36,Clouds
83835,56,1554922800,40,0,40,Clouds
83836,57,1554922800,21,2,23,Clouds
83837,58,1554922800,40,0,40,Clouds
83838,59,1554922800,17,3,20,Clouds
83839,60,1554922800,1,29,30,Clouds
83840,61,1554922800,23,2,25,Clouds
83841,62,1554922800,39,1,40,Clouds
83842,63,1554922800,34,1,35,Clouds
83843,64,1554922800,40,0,40,Clouds
83844,65,1554922800,40,0,40,Clouds
83845,66,1554922800,40,0,40,Clouds
83846,67,1554922800,32,8,40,Clouds
83847,68,1554922800,40,0,40,Clouds
83848,69,1554922800,40,0,40,Clouds
83849,70,1554922800,25,3,28,Clouds
83850,71,1554922800,37,3,40,Clouds
83851,72,1554922800,7,24,31,Clouds
83852,73,1554922800,20,10,30,Clouds
83853,74,1554922800,12,18,30,Clouds
83854,75,1554922800,0,40,40,Clouds
83855,76,1554922800,0,38,38,Clouds
83856,77,1554922800,28,1,29,Clouds
83857,78,1554922800,29,10,39,Clouds
83858,79,1554922800,27,0,27,Clouds
83859,80,1554922800,18,22,40,Clouds
83860,81,1554922800,16,24,40,Clouds
83861,82,1554922800,6,16,22,Clouds
83862,83,1554922800,11,29,40,Clouds
83863,84,1554922800,8,22,30,Clouds
83864,85,1554922800,22,13,35,Clouds
83865,86,1554922800,8,30,38,Clouds
83866,87,1554922800,11,27,38,Clouds
83867,88,1554922800,12,18,30,Clouds
83868,89,1554922800,33,7,40,Clouds
83869,90,1554922800,40,0,40,Clouds
83870,91,1554922800,25,5,30,Clouds
83871,92,1554922800,9,31,40,Clouds
83872,93,1554922800,0,40,40,Clouds
83873,94,1554922800,0,40,40,Clouds
83874,95,1554922800,10,30,40,Clouds
83875,96,1554922800,18,12,30,Clouds
83876,97,1554922800,9,31,40,Clouds
83877,98,1554922800,40,0,40,Clouds
83878,99,1554922800,30,0,30,Clouds
83879,100,1554922800,21,4,25,Clouds
83880,101,1554922800,10,20,30,Clouds
83881,102,1554922800,34,6,40,Clouds
83882,103,1554922800,29,11,40,Clouds
83883,104,1554922800,33,7,40,Clouds
83884,105,1554922800,33,3,36,Clouds
83885,106,1554922800,31,9,40,Clouds
83886,107,1554922800,33,7,40,Clouds
83887,108,1554922800,29,11,40,Clouds
83888,109,1554922800,26,3,29,Clouds
83889,110,1554922800,36,4,40,Clouds
83890,111,1554922800,36,4,40,Clouds
83891,112,1554922800,21,9,30,Clouds
83892,113,1554922800,31,9,40,Clouds
83893,114,1554922800,40,0,40,Clouds
83894,115,1554922800,2,28,30,Clouds
83895,2,1554926400,15,5,20,Clouds
83896,3,1554926400,17,3,20,Clouds
83897,4,1554926400,18,2,20,Clouds
83898,5,1554926400,33,7,40,Clouds
83899,6,1554926400,13,7,20,Clouds
83900,7,1554926400,13,16,29,Clouds
83901,8,1554926400,29,1,30,Clouds
83902,9,1554926400,11,13,24,Clouds
83903,10,1554926400,2,14,16,Clouds
83904,11,1554926400,30,0,30,Clouds
83905,12,1554926400,9,11,20,Clouds
83906,13,1554926400,28,2,30,Clouds
83907,14,1554926400,13,17,30,Clouds
83908,15,1554926400,16,0,16,Clouds
83909,16,1554926400,20,0,20,Clouds
83910,17,1554926400,16,4,20,Clouds
83911,18,1554926400,28,2,30,Clouds
83912,19,1554926400,30,0,30,Clouds
83913,21,1554926400,30,0,30,Clouds
83914,22,1554926400,1,19,20,Clouds
83915,23,1554926400,10,20,30,Clouds
83916,24,1554926400,10,10,20,Clouds
83917,25,1554926400,29,1,30,Clouds
83918,26,1554926400,18,2,20,Clouds
83919,27,1554926400,19,0,19,Clouds
83920,28,1554926400,19,11,30,Clouds
83921,29,1554926400,19,10,29,Clouds
83922,30,1554926400,20,0,20,Clouds
83923,31,1554926400,18,2,20,Clouds
83924,32,1554926400,28,2,30,Clouds
83925,33,1554926400,5,18,23,Clouds
83926,34,1554926400,13,17,30,Clouds
83927,35,1554926400,19,11,30,Clouds
83928,36,1554926400,31,9,40,Clouds
83929,37,1554926400,20,10,30,Clouds
83930,38,1554926400,16,24,40,Clouds
83931,39,1554926400,16,4,20,Clouds
83932,40,1554926400,21,0,21,Clouds
83933,41,1554926400,19,1,20,Clouds
83934,42,1554926400,4,26,30,Clouds
83935,43,1554926400,19,11,30,Clouds
83936,44,1554926400,4,26,30,Clouds
83937,45,1554926400,9,21,30,Clouds
83938,46,1554926400,16,4,20,Clouds
83939,47,1554926400,40,0,40,Clouds
83940,48,1554926400,37,3,40,Clouds
83941,49,1554926400,39,1,40,Clouds
83942,50,1554926400,11,29,40,Clouds
83943,51,1554926400,27,13,40,Clouds
83944,52,1554926400,30,2,32,Clouds
83945,53,1554926400,40,0,40,Clouds
83946,54,1554926400,33,0,33,Clouds
83947,55,1554926400,36,0,36,Clouds
83948,56,1554926400,38,2,40,Clouds
83949,57,1554926400,23,0,23,Clouds
83950,58,1554926400,36,4,40,Clouds
83951,59,1554926400,20,0,20,Clouds
83952,60,1554926400,19,11,30,Clouds
83953,61,1554926400,24,1,25,Clouds
83954,62,1554926400,40,0,40,Clouds
83955,63,1554926400,35,0,35,Clouds
83956,64,1554926400,40,0,40,Clouds
83957,65,1554926400,40,0,40,Clouds
83958,66,1554926400,40,0,40,Clouds
83959,67,1554926400,33,7,40,Clouds
83960,68,1554926400,38,2,40,Clouds
83961,69,1554926400,39,1,40,Clouds
83962,70,1554926400,25,3,28,Clouds
83963,71,1554926400,34,6,40,Clouds
83964,72,1554926400,2,29,31,Clouds
83965,73,1554926400,18,12,30,Clouds
83966,74,1554926400,7,23,30,Clouds
83967,75,1554926400,0,40,40,Clouds
83968,76,1554926400,4,34,38,Clouds
83969,77,1554926400,28,1,29,Clouds
83970,78,1554926400,27,13,40,Clouds
83971,79,1554926400,24,3,27,Clouds
83972,80,1554926400,20,20,40,Clouds
83973,81,1554926400,14,26,40,Clouds
83974,82,1554926400,4,18,22,Clouds
83975,83,1554926400,4,36,40,Clouds
83976,84,1554926400,2,28,30,Clouds
83977,85,1554926400,17,18,35,Clouds
83978,86,1554926400,1,36,37,Clouds
83979,87,1554926400,9,29,38,Clouds
83980,88,1554926400,12,18,30,Clouds
83981,89,1554926400,40,0,40,Clouds
83982,90,1554926400,38,2,40,Clouds
83983,91,1554926400,25,5,30,Clouds
83984,92,1554926400,5,35,40,Clouds
83985,93,1554926400,0,40,40,Clouds
83986,94,1554926400,0,40,40,Clouds
83987,95,1554926400,10,30,40,Clouds
83988,96,1554926400,14,16,30,Clouds
83989,97,1554926400,5,35,40,Clouds
83990,98,1554926400,40,0,40,Clouds
83991,99,1554926400,30,0,30,Clouds
83992,100,1554926400,20,5,25,Clouds
83993,101,1554926400,6,24,30,Clouds
83994,102,1554926400,19,21,40,Clouds
83995,103,1554926400,29,11,40,Clouds
83996,104,1554926400,33,7,40,Clouds
83997,105,1554926400,33,3,36,Clouds
83998,106,1554926400,29,11,40,Clouds
83999,107,1554926400,35,5,40,Clouds
84000,108,1554926400,29,11,40,Clouds
84001,109,1554926400,22,7,29,Clouds
84002,110,1554926400,34,6,40,Clouds
84003,111,1554926400,33,7,40,Clouds
84004,112,1554926400,9,21,30,Clouds
84005,113,1554926400,40,0,40,Clouds
84006,114,1554926400,40,0,40,Clouds
84007,115,1554926400,6,24,30,Clouds
84008,2,1554930000,14,6,20,Clouds
84009,3,1554930000,15,5,20,Clouds
84010,4,1554930000,16,4,20,Clouds
84011,5,1554930000,35,5,40,Clouds
84012,6,1554930000,13,7,20,Clouds
84013,7,1554930000,12,17,29,Clouds
84014,8,1554930000,30,0,30,Clouds
84015,9,1554930000,18,6,24,Clouds
84016,10,1554930000,3,13,16,Clouds
84017,11,1554930000,30,0,30,Clouds
84018,12,1554930000,12,8,20,Clouds
84019,13,1554930000,29,1,30,Clouds
84020,14,1554930000,19,11,30,Clouds
84021,15,1554930000,16,0,16,Clouds
84022,16,1554930000,19,1,20,Clouds
84023,17,1554930000,14,6,20,Clouds
84024,18,1554930000,26,4,30,Clouds
84025,19,1554930000,21,9,30,Clouds
84026,21,1554930000,28,2,30,Clouds
84027,22,1554930000,6,14,20,Clouds
84028,23,1554930000,7,23,30,Clouds
84029,24,1554930000,11,9,20,Clouds
84030,25,1554930000,28,2,30,Clouds
84031,26,1554930000,20,0,20,Clouds
84032,27,1554930000,18,1,19,Clouds
84033,28,1554930000,22,8,30,Clouds
84034,29,1554930000,16,13,29,Clouds
84035,30,1554930000,18,2,20,Clouds
84036,31,1554930000,16,4,20,Clouds
84037,32,1554930000,30,0,30,Clouds
84038,33,1554930000,14,9,23,Clouds
84039,34,1554930000,20,10,30,Clouds
84040,35,1554930000,13,17,30,Clouds
84041,36,1554930000,37,3,40,Clouds
84042,37,1554930000,26,4,30,Clouds
84043,38,1554930000,19,21,40,Clouds
84044,39,1554930000,17,3,20,Clouds
84045,40,1554930000,21,0,21,Clouds
84046,41,1554930000,20,0,20,Clouds
84047,42,1554930000,0,30,30,Clouds
84048,43,1554930000,17,13,30,Clouds
84049,44,1554930000,2,28,30,Clouds
84050,45,1554930000,8,22,30,Clouds
84051,46,1554930000,16,4,20,Clouds
84052,47,1554930000,40,0,40,Clouds
84053,48,1554930000,40,0,40,Clouds
84054,49,1554930000,36,4,40,Clouds
84055,50,1554930000,4,36,40,Clouds
84056,51,1554930000,26,14,40,Clouds
84057,52,1554930000,29,3,32,Clouds
84058,53,1554930000,40,0,40,Clouds
84059,54,1554930000,33,0,33,Clouds
84060,55,1554930000,36,0,36,Clouds
84061,56,1554930000,37,3,40,Clouds
84062,57,1554930000,22,1,23,Clouds
84063,58,1554930000,37,3,40,Clouds
84064,59,1554930000,20,0,20,Clouds
84065,60,1554930000,11,19,30,Clouds
84066,61,1554930000,23,2,25,Clouds
84067,62,1554930000,37,3,40,Clouds
84068,63,1554930000,35,0,35,Clouds
84069,64,1554930000,40,0,40,Clouds
84070,65,1554930000,40,0,40,Clouds
84071,66,1554930000,36,4,40,Clouds
84072,67,1554930000,32,8,40,Clouds
84073,68,1554930000,25,15,40,Clouds
84074,69,1554930000,34,6,40,Clouds
84075,70,1554930000,27,1,28,Clouds
84076,71,1554930000,37,3,40,Clouds
84077,72,1554930000,2,29,31,Clouds
84078,73,1554930000,15,15,30,Clouds
84079,74,1554930000,0,30,30,Clouds
84080,75,1554930000,0,40,40,Clouds
84081,76,1554930000,0,38,38,Clouds
84082,77,1554930000,28,1,29,Clouds
84083,78,1554930000,30,10,40,Clouds
84084,79,1554930000,25,2,27,Clouds
84085,80,1554930000,20,20,40,Clouds
84086,81,1554930000,16,24,40,Clouds
84087,82,1554930000,2,20,22,Clouds
84088,83,1554930000,0,40,40,Clouds
84089,84,1554930000,0,30,30,Clouds
84090,85,1554930000,9,26,35,Clouds
84091,86,1554930000,1,37,38,Clouds
84092,87,1554930000,4,34,38,Clouds
84093,88,1554930000,14,16,30,Clouds
84094,89,1554930000,40,0,40,Clouds
84095,90,1554930000,40,0,40,Clouds
84096,91,1554930000,29,1,30,Clouds
84097,92,1554930000,0,40,40,Clouds
84098,93,1554930000,0,40,40,Clouds
84099,94,1554930000,0,40,40,Clouds
84100,95,1554930000,4,36,40,Clouds
84101,96,1554930000,13,17,30,Clouds
84102,97,1554930000,4,36,40,Clouds
84103,98,1554930000,40,0,40,Clouds
84104,99,1554930000,29,1,30,Clouds
84105,100,1554930000,15,10,25,Clouds
84106,101,1554930000,2,28,30,Clouds
84107,102,1554930000,18,22,40,Clouds
84108,103,1554930000,28,12,40,Clouds
84109,104,1554930000,34,6,40,Clouds
84110,105,1554930000,33,3,36,Clouds
84111,106,1554930000,30,10,40,Clouds
84112,107,1554930000,31,9,40,Clouds
84113,108,1554930000,28,12,40,Clouds
84114,109,1554930000,21,8,29,Clouds
84115,110,1554930000,34,6,40,Clouds
84116,111,1554930000,27,13,40,Clouds
84117,112,1554930000,6,24,30,Clouds
84118,113,1554930000,40,0,40,Clouds
84119,114,1554930000,40,0,40,Clouds
84120,115,1554930000,12,18,30,Clouds
84121,2,1554933600,6,14,20,Clouds
84122,3,1554933600,9,11,20,Clouds
84123,4,1554933600,16,4,20,Clouds
84124,5,1554933600,40,0,40,Clouds
84125,6,1554933600,14,6,20,Clouds
84126,7,1554933600,13,16,29,Clouds
84127,8,1554933600,28,2,30,Clouds
84128,9,1554933600,12,12,24,Clouds
84129,10,1554933600,7,9,16,Clouds
84130,11,1554933600,29,1,30,Clouds
84131,12,1554933600,10,10,20,Clouds
84132,13,1554933600,29,1,30,Clouds
84133,14,1554933600,29,1,30,Clouds
84134,15,1554933600,15,1,16,Clouds
84135,16,1554933600,20,0,20,Clouds
84136,17,1554933600,18,2,20,Clouds
84137,18,1554933600,28,2,30,Clouds
84138,19,1554933600,30,0,30,Clouds
84139,21,1554933600,30,0,30,Clouds
84140,22,1554933600,20,0,20,Clouds
84141,23,1554933600,13,17,30,Clouds
84142,24,1554933600,13,7,20,Clouds
84143,25,1554933600,30,0,30,Clouds
84144,26,1554933600,20,0,20,Clouds
84145,27,1554933600,19,0,19,Clouds
84146,28,1554933600,22,8,30,Clouds
84147,29,1554933600,20,9,29,Clouds
84148,30,1554933600,19,1,20,Clouds
84149,31,1554933600,20,0,20,Clouds
84150,32,1554933600,30,0,30,Clouds
84151,33,1554933600,18,5,23,Clouds
84152,34,1554933600,15,15,30,Clouds
84153,35,1554933600,17,13,30,Clouds
84154,36,1554933600,40,0,40,Clouds
84155,37,1554933600,28,2,30,Clouds
84156,38,1554933600,19,21,40,Clouds
84157,39,1554933600,17,3,20,Clouds
84158,40,1554933600,21,0,21,Clouds
84159,41,1554933600,20,0,20,Clouds
84160,42,1554933600,0,30,30,Clouds
84161,43,1554933600,13,17,30,Clouds
84162,44,1554933600,3,27,30,Clouds
84163,45,1554933600,9,21,30,Clouds
84164,46,1554933600,13,7,20,Clouds
84165,47,1554933600,39,1,40,Clouds
84166,48,1554933600,40,0,40,Clouds
84167,49,1554933600,35,5,40,Clouds
84168,50,1554933600,1,39,40,Clouds
84169,51,1554933600,30,10,40,Clouds
84170,52,1554933600,32,0,32,Clouds
84171,53,1554933600,40,0,40,Clouds
84172,54,1554933600,32,1,33,Clouds
84173,55,1554933600,35,1,36,Clouds
84174,56,1554933600,40,0,40,Clouds
84175,57,1554933600,23,0,23,Clouds
84176,58,1554933600,38,2,40,Clouds
84177,59,1554933600,20,0,20,Clouds
84178,60,1554933600,5,25,30,Clouds
84179,61,1554933600,25,0,25,Clouds
84180,62,1554933600,39,1,40,Clouds
84181,63,1554933600,35,0,35,Clouds
84182,64,1554933600,38,2,40,Clouds
84183,65,1554933600,40,0,40,Clouds
84184,66,1554933600,40,0,40,Clouds
84185,67,1554933600,25,15,40,Clouds
84186,68,1554933600,33,7,40,Clouds
84187,69,1554933600,35,5,40,Clouds
84188,70,1554933600,20,8,28,Clouds
84189,71,1554933600,38,2,40,Clouds
84190,72,1554933600,1,30,31,Clouds
84191,73,1554933600,13,17,30,Clouds
84192,74,1554933600,1,29,30,Clouds
84193,75,1554933600,9,31,40,Clouds
84194,76,1554933600,1,37,38,Clouds
84195,77,1554933600,28,1,29,Clouds
84196,78,1554933600,32,8,40,Clouds
84197,79,1554933600,25,2,27,Clouds
84198,80,1554933600,19,21,40,Clouds
84199,81,1554933600,16,24,40,Clouds
84200,82,1554933600,0,22,22,Clouds
84201,83,1554933600,12,28,40,Clouds
84202,84,1554933600,0,30,30,Clouds
84203,85,1554933600,7,28,35,Clouds
84204,86,1554933600,0,38,38,Clouds
84205,87,1554933600,0,38,38,Clouds
84206,88,1554933600,7,23,30,Clouds
84207,89,1554933600,39,1,40,Clouds
84208,90,1554933600,39,1,40,Clouds
84209,91,1554933600,21,9,30,Clouds
84210,92,1554933600,0,40,40,Clouds
84211,93,1554933600,0,40,40,Clouds
84212,94,1554933600,0,40,40,Clouds
84213,95,1554933600,0,40,40,Clouds
84214,96,1554933600,13,17,30,Clouds
84215,97,1554933600,3,37,40,Clouds
84216,98,1554933600,40,0,40,Clouds
84217,99,1554933600,29,1,30,Clouds
84218,100,1554933600,6,19,25,Clouds
84219,101,1554933600,0,30,30,Clouds
84220,102,1554933600,15,25,40,Clouds
84221,103,1554933600,29,11,40,Clouds
84222,104,1554933600,34,6,40,Clouds
84223,105,1554933600,32,4,36,Clouds
84224,106,1554933600,27,13,40,Clouds
84225,107,1554933600,31,9,40,Clouds
84226,108,1554933600,26,14,40,Clouds
84227,109,1554933600,17,12,29,Clouds
84228,110,1554933600,33,7,40,Clouds
84229,111,1554933600,23,17,40,Clouds
84230,112,1554933600,0,30,30,Clouds
84231,113,1554933600,40,0,40,Clouds
84232,114,1554933600,40,0,40,Clouds
84233,115,1554933600,14,16,30,Clouds
84234,2,1554937200,3,17,20,Clouds
84235,3,1554937200,12,8,20,Clouds
84236,4,1554937200,11,9,20,Clouds
84237,5,1554937200,38,2,40,Clouds
84238,6,1554937200,17,3,20,Clouds
84239,7,1554937200,14,15,29,Clouds
84240,8,1554937200,29,1,30,Clouds
84241,9,1554937200,19,5,24,Clouds
84242,10,1554937200,14,2,16,Clouds
84243,11,1554937200,30,0,30,Clouds
84244,12,1554937200,7,13,20,Clouds
84245,13,1554937200,30,0,30,Clouds
84246,14,1554937200,13,17,30,Clouds
84247,15,1554937200,15,1,16,Clouds
84248,16,1554937200,20,0,20,Clouds
84249,17,1554937200,20,0,20,Clouds
84250,18,1554937200,29,1,30,Clouds
84251,19,1554937200,30,0,30,Clouds
84252,21,1554937200,30,0,30,Clouds
84253,22,1554937200,16,4,20,Clouds
84254,23,1554937200,15,15,30,Clouds
84255,24,1554937200,16,4,20,Clouds
84256,25,1554937200,30,0,30,Clouds
84257,26,1554937200,20,0,20,Clouds
84258,27,1554937200,19,0,19,Clouds
84259,28,1554937200,17,13,30,Clouds
84260,29,1554937200,24,5,29,Clouds
84261,30,1554937200,20,0,20,Clouds
84262,31,1554937200,13,7,20,Clouds
84263,32,1554937200,28,2,30,Clouds
84264,33,1554937200,23,0,23,Clouds
84265,34,1554937200,18,12,30,Clouds
84266,35,1554937200,13,17,30,Clouds
84267,36,1554937200,40,0,40,Clouds
84268,37,1554937200,30,0,30,Clouds
84269,38,1554937200,23,17,40,Clouds
84270,39,1554937200,18,2,20,Clouds
84271,40,1554937200,21,0,21,Clouds
84272,41,1554937200,20,0,20,Clouds
84273,42,1554937200,5,25,30,Clouds
84274,43,1554937200,6,24,30,Clouds
84275,44,1554937200,0,30,30,Clouds
84276,45,1554937200,8,22,30,Clouds
84277,46,1554937200,16,4,20,Clouds
84278,47,1554937200,38,2,40,Clouds
84279,48,1554937200,38,2,40,Clouds
84280,49,1554937200,40,0,40,Clouds
84281,50,1554937200,9,31,40,Clouds
84282,51,1554937200,40,0,40,Clouds
84283,52,1554937200,32,0,32,Clouds
84284,53,1554937200,40,0,40,Clouds
84285,54,1554937200,33,0,33,Clouds
84286,55,1554937200,36,0,36,Clouds
84287,56,1554937200,40,0,40,Clouds
84288,57,1554937200,23,0,23,Clouds
84289,58,1554937200,39,1,40,Clouds
84290,59,1554937200,20,0,20,Clouds
84291,60,1554937200,5,25,30,Clouds
84292,61,1554937200,25,0,25,Clouds
84293,62,1554937200,40,0,40,Clouds
84294,63,1554937200,35,0,35,Clouds
84295,64,1554937200,38,2,40,Clouds
84296,65,1554937200,39,1,40,Clouds
84297,66,1554937200,35,5,40,Clouds
84298,67,1554937200,23,17,40,Clouds
84299,68,1554937200,40,0,40,Clouds
84300,69,1554937200,40,0,40,Clouds
84301,70,1554937200,20,8,28,Clouds
84302,71,1554937200,37,3,40,Clouds
84303,72,1554937200,8,23,31,Clouds
84304,73,1554937200,12,18,30,Clouds
84305,74,1554937200,1,29,30,Clouds
84306,75,1554937200,6,34,40,Clouds
84307,76,1554937200,0,38,38,Clouds
84308,77,1554937200,29,0,29,Clouds
84309,78,1554937200,32,8,40,Clouds
84310,79,1554937200,22,5,27,Clouds
84311,80,1554937200,18,22,40,Clouds
84312,81,1554937200,15,25,40,Clouds
84313,82,1554937200,0,22,22,Clouds
84314,83,1554937200,8,32,40,Clouds
84315,84,1554937200,8,22,30,Clouds
84316,85,1554937200,2,33,35,Clouds
84317,86,1554937200,5,33,38,Clouds
84318,87,1554937200,0,38,38,Clouds
84319,88,1554937200,4,26,30,Clouds
84320,89,1554937200,40,0,40,Clouds
84321,90,1554937200,38,2,40,Clouds
84322,91,1554937200,20,10,30,Clouds
84323,92,1554937200,8,32,40,Clouds
84324,93,1554937200,0,40,40,Clouds
84325,94,1554937200,0,40,40,Clouds
84326,95,1554937200,11,29,40,Clouds
84327,96,1554937200,11,19,30,Clouds
84328,97,1554937200,0,40,40,Clouds
84329,98,1554937200,40,0,40,Clouds
84330,99,1554937200,30,0,30,Clouds
84331,100,1554937200,3,22,25,Clouds
84332,101,1554937200,1,29,30,Clouds
84333,102,1554937200,14,26,40,Clouds
84334,103,1554937200,29,11,40,Clouds
84335,104,1554937200,35,5,40,Clouds
84336,105,1554937200,32,4,36,Clouds
84337,106,1554937200,26,14,40,Clouds
84338,107,1554937200,26,14,40,Clouds
84339,108,1554937200,24,16,40,Clouds
84340,109,1554937200,18,11,29,Clouds
84341,110,1554937200,14,26,40,Clouds
84342,111,1554937200,12,28,40,Clouds
84343,112,1554937200,1,29,30,Clouds
84344,113,1554937200,40,0,40,Clouds
84345,114,1554937200,40,0,40,Clouds
84346,115,1554937200,8,22,30,Clouds
84347,2,1554940800,2,18,20,Clouds
84348,3,1554940800,13,7,20,Clouds
84349,4,1554940800,9,11,20,Clouds
84350,5,1554940800,37,3,40,Clouds
84351,6,1554940800,20,0,20,Clouds
84352,7,1554940800,16,13,29,Clouds
84353,8,1554940800,30,0,30,Clouds
84354,9,1554940800,24,0,24,Clouds
84355,10,1554940800,14,2,16,Clouds
84356,11,1554940800,30,0,30,Clouds
84357,12,1554940800,7,13,20,Clouds
84358,13,1554940800,30,0,30,Clouds
84359,14,1554940800,25,5,30,Clouds
84360,15,1554940800,15,1,16,Clouds
84361,16,1554940800,20,0,20,Clouds
84362,17,1554940800,20,0,20,Clouds
84363,18,1554940800,29,1,30,Clouds
84364,19,1554940800,30,0,30,Clouds
84365,21,1554940800,30,0,30,Clouds
84366,22,1554940800,17,3,20,Clouds
84367,23,1554940800,22,8,30,Clouds
84368,24,1554940800,16,4,20,Clouds
84369,25,1554940800,30,0,30,Clouds
84370,26,1554940800,20,0,20,Clouds
84371,27,1554940800,19,0,19,Clouds
84372,28,1554940800,15,15,30,Clouds
84373,29,1554940800,29,0,29,Clouds
84374,30,1554940800,12,8,20,Clouds
84375,31,1554940800,10,9,19,Clouds
84376,32,1554940800,30,0,30,Clouds
84377,33,1554940800,23,0,23,Clouds
84378,34,1554940800,12,18,30,Clouds
84379,35,1554940800,12,18,30,Clouds
84380,36,1554940800,40,0,40,Clouds
84381,37,1554940800,30,0,30,Clouds
84382,38,1554940800,26,14,40,Clouds
84383,39,1554940800,20,0,20,Clouds
84384,40,1554940800,18,3,21,Clouds
84385,41,1554940800,20,0,20,Clouds
84386,42,1554940800,0,30,30,Clouds
84387,43,1554940800,5,25,30,Clouds
84388,44,1554940800,0,30,30,Clouds
84389,45,1554940800,7,23,30,Clouds
84390,46,1554940800,20,0,20,Clouds
84391,47,1554940800,40,0,40,Clouds
84392,48,1554940800,40,0,40,Clouds
84393,49,1554940800,40,0,40,Clouds
84394,50,1554940800,3,37,40,Clouds
84395,51,1554940800,40,0,40,Clouds
84396,52,1554940800,32,0,32,Clouds
84397,53,1554940800,40,0,40,Clouds
84398,54,1554940800,33,0,33,Clouds
84399,55,1554940800,36,0,36,Clouds
84400,56,1554940800,40,0,40,Clouds
84401,57,1554940800,23,0,23,Clouds
84402,58,1554940800,40,0,40,Clouds
84403,59,1554940800,19,1,20,Clouds
84404,60,1554940800,10,20,30,Clouds
84405,61,1554940800,25,0,25,Clouds
84406,62,1554940800,40,0,40,Clouds
84407,63,1554940800,35,0,35,Clouds
84408,64,1554940800,39,1,40,Clouds
84409,65,1554940800,40,0,40,Clouds
84410,66,1554940800,32,8,40,Clouds
84411,67,1554940800,25,15,40,Clouds
84412,68,1554940800,40,0,40,Clouds
84413,69,1554940800,40,0,40,Clouds
84414,70,1554940800,22,6,28,Clouds
84415,71,1554940800,40,0,40,Clouds
84416,72,1554940800,12,19,31,Clouds
84417,73,1554940800,12,18,30,Clouds
84418,74,1554940800,8,22,30,Clouds
84419,75,1554940800,2,38,40,Clouds
84420,76,1554940800,0,38,38,Clouds
84421,77,1554940800,28,1,29,Clouds
84422,78,1554940800,29,11,40,Clouds
84423,79,1554940800,21,6,27,Clouds
84424,80,1554940800,14,26,40,Clouds
84425,81,1554940800,15,25,40,Clouds
84426,82,1554940800,0,22,22,Clouds
84427,83,1554940800,8,32,40,Clouds
84428,84,1554940800,5,25,30,Clouds
84429,85,1554940800,2,33,35,Clouds
84430,86,1554940800,2,36,38,Clouds
84431,87,1554940800,0,38,38,Clouds
84432,88,1554940800,4,26,30,Clouds
84433,89,1554940800,40,0,40,Clouds
84434,90,1554940800,37,3,40,Clouds
84435,91,1554940800,19,11,30,Clouds
84436,92,1554940800,8,32,40,Clouds
84437,93,1554940800,0,40,40,Clouds
84438,94,1554940800,0,40,40,Clouds
84439,95,1554940800,9,31,40,Clouds
84440,96,1554940800,11,19,30,Clouds
84441,97,1554940800,0,40,40,Clouds
84442,98,1554940800,40,0,40,Clouds
84443,99,1554940800,29,1,30,Clouds
84444,100,1554940800,3,22,25,Clouds
84445,101,1554940800,0,30,30,Clouds
84446,102,1554940800,13,27,40,Clouds
84447,103,1554940800,29,11,40,Clouds
84448,104,1554940800,36,4,40,Clouds
84449,105,1554940800,32,4,36,Clouds
84450,106,1554940800,26,14,40,Clouds
84451,107,1554940800,9,31,40,Clouds
84452,108,1554940800,23,17,40,Clouds
84453,109,1554940800,17,12,29,Clouds
84454,110,1554940800,15,25,40,Clouds
84455,111,1554940800,5,35,40,Clouds
84456,112,1554940800,10,20,30,Clouds
84457,113,1554940800,40,0,40,Clouds
84458,114,1554940800,40,0,40,Clouds
84459,115,1554940800,6,24,30,Clouds
84460,2,1554944400,1,19,20,Clouds
84461,3,1554944400,12,8,20,Clouds
84462,4,1554944400,9,11,20,Clouds
84463,5,1554944400,37,3,40,Clouds
84464,6,1554944400,20,0,20,Clouds
84465,7,1554944400,16,13,29,Clouds
84466,8,1554944400,30,0,30,Clouds
84467,9,1554944400,24,0,24,Clouds
84468,10,1554944400,16,0,16,Clouds
84469,11,1554944400,29,1,30,Clouds
84470,12,1554944400,7,13,20,Clouds
84471,13,1554944400,30,0,30,Clouds
84472,14,1554944400,30,0,30,Clouds
84473,15,1554944400,14,2,16,Clouds
84474,16,1554944400,20,0,20,Clouds
84475,17,1554944400,20,0,20,Clouds
84476,18,1554944400,29,1,30,Clouds
84477,19,1554944400,29,1,30,Clouds
84478,21,1554944400,30,0,30,Clouds
84479,22,1554944400,18,2,20,Clouds
84480,23,1554944400,24,6,30,Clouds
84481,24,1554944400,20,0,20,Clouds
84482,25,1554944400,30,0,30,Clouds
84483,26,1554944400,20,0,20,Clouds
84484,27,1554944400,19,0,19,Clouds
84485,28,1554944400,15,15,30,Clouds
84486,29,1554944400,29,0,29,Clouds
84487,30,1554944400,12,8,20,Clouds
84488,31,1554944400,11,8,19,Clouds
84489,32,1554944400,30,0,30,Clouds
84490,33,1554944400,23,0,23,Clouds
84491,34,1554944400,11,19,30,Clouds
84492,35,1554944400,11,19,30,Clouds
84493,36,1554944400,40,0,40,Clouds
84494,37,1554944400,30,0,30,Clouds
84495,38,1554944400,27,13,40,Clouds
84496,39,1554944400,19,1,20,Clouds
84497,40,1554944400,18,3,21,Clouds
84498,41,1554944400,20,0,20,Clouds
84499,42,1554944400,0,30,30,Clouds
84500,43,1554944400,4,26,30,Clouds
84501,44,1554944400,0,30,30,Clouds
84502,45,1554944400,7,23,30,Clouds
84503,46,1554944400,20,0,20,Clouds
84504,47,1554944400,40,0,40,Clouds
84505,48,1554944400,39,1,40,Clouds
84506,49,1554944400,40,0,40,Clouds
84507,50,1554944400,0,40,40,Clouds
84508,51,1554944400,40,0,40,Clouds
84509,52,1554944400,32,0,32,Clouds
84510,53,1554944400,40,0,40,Clouds
84511,54,1554944400,33,0,33,Clouds
84512,55,1554944400,36,0,36,Clouds
84513,56,1554944400,40,0,40,Clouds
84514,57,1554944400,23,0,23,Clouds
84515,58,1554944400,40,0,40,Clouds
84516,59,1554944400,18,2,20,Clouds
84517,60,1554944400,7,23,30,Clouds
84518,61,1554944400,25,0,25,Clouds
84519,62,1554944400,40,0,40,Clouds
84520,63,1554944400,35,0,35,Clouds
84521,64,1554944400,39,1,40,Clouds
84522,65,1554944400,40,0,40,Clouds
84523,66,1554944400,30,10,40,Clouds
84524,67,1554944400,24,16,40,Clouds
84525,68,1554944400,40,0,40,Clouds
84526,69,1554944400,38,2,40,Clouds
84527,70,1554944400,22,6,28,Clouds
84528,71,1554944400,40,0,40,Clouds
84529,72,1554944400,13,18,31,Clouds
84530,73,1554944400,12,18,30,Clouds
84531,74,1554944400,8,22,30,Clouds
84532,75,1554944400,2,38,40,Clouds
84533,76,1554944400,0,38,38,Clouds
84534,77,1554944400,29,0,29,Clouds
84535,78,1554944400,28,12,40,Clouds
84536,79,1554944400,21,6,27,Clouds
84537,80,1554944400,13,27,40,Clouds
84538,81,1554944400,15,25,40,Clouds
84539,82,1554944400,0,22,22,Clouds
84540,83,1554944400,6,34,40,Clouds
84541,84,1554944400,4,26,30,Clouds
84542,85,1554944400,0,35,35,Clouds
84543,86,1554944400,2,36,38,Clouds
84544,87,1554944400,0,38,38,Clouds
84545,88,1554944400,4,26,30,Clouds
84546,89,1554944400,40,0,40,Clouds
84547,90,1554944400,37,3,40,Clouds
84548,91,1554944400,19,11,30,Clouds
84549,92,1554944400,9,31,40,Clouds
84550,93,1554944400,0,40,40,Clouds
84551,94,1554944400,0,40,40,Clouds
84552,95,1554944400,9,31,40,Clouds
84553,96,1554944400,10,20,30,Clouds
84554,97,1554944400,0,40,40,Clouds
84555,98,1554944400,40,0,40,Clouds
84556,99,1554944400,30,0,30,Clouds
84557,100,1554944400,3,22,25,Clouds
84558,101,1554944400,0,30,30,Clouds
84559,102,1554944400,13,27,40,Clouds
84560,103,1554944400,28,12,40,Clouds
84561,104,1554944400,36,4,40,Clouds
84562,105,1554944400,32,4,36,Clouds
84563,106,1554944400,26,14,40,Clouds
84564,107,1554944400,9,31,40,Clouds
84565,108,1554944400,23,17,40,Clouds
84566,109,1554944400,17,12,29,Clouds
84567,110,1554944400,15,25,40,Clouds
84568,111,1554944400,4,36,40,Clouds
84569,112,1554944400,7,23,30,Clouds
84570,113,1554944400,40,0,40,Clouds
84571,114,1554944400,40,0,40,Clouds
84572,115,1554944400,6,24,30,Clouds
84573,2,1554948000,1,19,20,Clouds
84574,3,1554948000,12,8,20,Clouds
84575,4,1554948000,9,11,20,Clouds
84576,5,1554948000,37,3,40,Clouds
84577,6,1554948000,20,0,20,Clouds
84578,7,1554948000,16,13,29,Clouds
84579,8,1554948000,30,0,30,Clouds
84580,9,1554948000,24,0,24,Clouds
84581,10,1554948000,16,0,16,Clouds
84582,11,1554948000,29,1,30,Clouds
84583,12,1554948000,7,13,20,Clouds
84584,13,1554948000,30,0,30,Clouds
84585,14,1554948000,30,0,30,Clouds
84586,15,1554948000,14,2,16,Clouds
84587,16,1554948000,20,0,20,Clouds
84588,17,1554948000,20,0,20,Clouds
84589,18,1554948000,29,1,30,Clouds
84590,19,1554948000,29,1,30,Clouds
84591,21,1554948000,30,0,30,Clouds
84592,22,1554948000,18,2,20,Clouds
84593,23,1554948000,24,6,30,Clouds
84594,24,1554948000,20,0,20,Clouds
84595,25,1554948000,30,0,30,Clouds
84596,26,1554948000,20,0,20,Clouds
84597,27,1554948000,19,0,19,Clouds
84598,28,1554948000,15,15,30,Clouds
84599,29,1554948000,29,0,29,Clouds
84600,30,1554948000,12,8,20,Clouds
84601,31,1554948000,12,8,20,Clouds
84602,32,1554948000,30,0,30,Clouds
84603,33,1554948000,23,0,23,Clouds
84604,34,1554948000,10,20,30,Clouds
84605,35,1554948000,11,19,30,Clouds
84606,36,1554948000,40,0,40,Clouds
84607,37,1554948000,30,0,30,Clouds
84608,38,1554948000,27,13,40,Clouds
84609,39,1554948000,19,1,20,Clouds
84610,40,1554948000,18,3,21,Clouds
84611,41,1554948000,20,0,20,Clouds
84612,42,1554948000,0,30,30,Clouds
84613,43,1554948000,4,26,30,Clouds
84614,44,1554948000,0,30,30,Clouds
84615,45,1554948000,7,23,30,Clouds
84616,46,1554948000,20,0,20,Clouds
84617,47,1554948000,40,0,40,Clouds
84618,48,1554948000,39,1,40,Clouds
84619,49,1554948000,40,0,40,Clouds
84620,50,1554948000,0,40,40,Clouds
84621,51,1554948000,40,0,40,Clouds
84622,52,1554948000,32,0,32,Clouds
84623,53,1554948000,40,0,40,Clouds
84624,54,1554948000,33,0,33,Clouds
84625,55,1554948000,36,0,36,Clouds
84626,56,1554948000,40,0,40,Clouds
84627,57,1554948000,23,0,23,Clouds
84628,58,1554948000,40,0,40,Clouds
84629,59,1554948000,18,2,20,Clouds
84630,60,1554948000,7,23,30,Clouds
84631,61,1554948000,25,0,25,Clouds
84632,62,1554948000,40,0,40,Clouds
84633,63,1554948000,35,0,35,Clouds
84634,64,1554948000,39,1,40,Clouds
84635,65,1554948000,40,0,40,Clouds
84636,66,1554948000,30,10,40,Clouds
84637,67,1554948000,24,16,40,Clouds
84638,68,1554948000,40,0,40,Clouds
84639,69,1554948000,38,2,40,Clouds
84640,70,1554948000,22,6,28,Clouds
84641,71,1554948000,40,0,40,Clouds
84642,72,1554948000,13,18,31,Clouds
84643,73,1554948000,12,18,30,Clouds
84644,74,1554948000,8,22,30,Clouds
84645,75,1554948000,2,38,40,Clouds
84646,76,1554948000,0,38,38,Clouds
84647,77,1554948000,29,0,29,Clouds
84648,78,1554948000,28,12,40,Clouds
84649,79,1554948000,21,6,27,Clouds
84650,80,1554948000,13,27,40,Clouds
84651,81,1554948000,15,25,40,Clouds
84652,82,1554948000,0,22,22,Clouds
84653,83,1554948000,6,34,40,Clouds
84654,84,1554948000,4,26,30,Clouds
84655,85,1554948000,0,35,35,Clouds
84656,86,1554948000,2,36,38,Clouds
84657,87,1554948000,0,38,38,Clouds
84658,88,1554948000,4,26,30,Clouds
84659,89,1554948000,40,0,40,Clouds
84660,90,1554948000,37,3,40,Clouds
84661,91,1554948000,19,11,30,Clouds
84662,92,1554948000,9,31,40,Clouds
84663,93,1554948000,0,40,40,Clouds
84664,94,1554948000,0,40,40,Clouds
84665,95,1554948000,9,31,40,Clouds
84666,96,1554948000,10,20,30,Clouds
84667,97,1554948000,0,40,40,Clouds
84668,98,1554948000,40,0,40,Clouds
84669,99,1554948000,30,0,30,Clouds
84670,100,1554948000,3,22,25,Clouds
84671,101,1554948000,0,30,30,Clouds
84672,102,1554948000,13,27,40,Clouds
84673,103,1554948000,28,12,40,Clouds
84674,104,1554948000,36,4,40,Clouds
84675,105,1554948000,32,4,36,Clouds
84676,106,1554948000,26,14,40,Clouds
84677,107,1554948000,9,31,40,Clouds
84678,108,1554948000,23,17,40,Clouds
84679,109,1554948000,17,12,29,Clouds
84680,110,1554948000,15,25,40,Clouds
84681,111,1554948000,4,36,40,Clouds
84682,112,1554948000,7,23,30,Clouds
84683,113,1554948000,40,0,40,Clouds
84684,114,1554948000,40,0,40,Clouds
84685,115,1554948000,6,24,30,Clouds
84686,2,1554951600,1,19,20,Clouds
84687,3,1554951600,12,8,20,Clouds
84688,4,1554951600,9,11,20,Clouds
84689,5,1554951600,37,3,40,Clouds
84690,6,1554951600,20,0,20,Clouds
84691,7,1554951600,16,13,29,Clouds
84692,8,1554951600,30,0,30,Clouds
84693,9,1554951600,24,0,24,Clouds
84694,10,1554951600,16,0,16,Clouds
84695,11,1554951600,29,1,30,Clouds
84696,12,1554951600,7,13,20,Clouds
84697,13,1554951600,30,0,30,Clouds
84698,14,1554951600,30,0,30,Clouds
84699,15,1554951600,14,2,16,Clouds
84700,16,1554951600,20,0,20,Clouds
84701,17,1554951600,20,0,20,Clouds
84702,18,1554951600,29,1,30,Clouds
84703,19,1554951600,29,1,30,Clouds
84704,21,1554951600,30,0,30,Clouds
84705,22,1554951600,18,2,20,Clouds
84706,23,1554951600,24,6,30,Clouds
84707,24,1554951600,20,0,20,Clouds
84708,25,1554951600,30,0,30,Clouds
84709,26,1554951600,20,0,20,Clouds
84710,27,1554951600,19,0,19,Clouds
84711,28,1554951600,15,15,30,Clouds
84712,29,1554951600,29,0,29,Clouds
84713,30,1554951600,12,8,20,Clouds
84714,31,1554951600,12,8,20,Clouds
84715,32,1554951600,30,0,30,Clouds
84716,33,1554951600,23,0,23,Clouds
84717,34,1554951600,10,20,30,Clouds
84718,35,1554951600,11,19,30,Clouds
84719,36,1554951600,40,0,40,Clouds
84720,37,1554951600,30,0,30,Clouds
84721,38,1554951600,26,14,40,Clouds
84722,39,1554951600,19,1,20,Clouds
84723,40,1554951600,18,3,21,Clouds
84724,41,1554951600,20,0,20,Clouds
84725,42,1554951600,0,30,30,Clouds
84726,43,1554951600,4,26,30,Clouds
84727,44,1554951600,0,30,30,Clouds
84728,45,1554951600,7,23,30,Clouds
84729,46,1554951600,20,0,20,Clouds
84730,47,1554951600,40,0,40,Clouds
84731,48,1554951600,39,1,40,Clouds
84732,49,1554951600,40,0,40,Clouds
84733,50,1554951600,0,40,40,Clouds
84734,51,1554951600,40,0,40,Clouds
84735,52,1554951600,32,0,32,Clouds
84736,53,1554951600,40,0,40,Clouds
84737,54,1554951600,33,0,33,Clouds
84738,55,1554951600,36,0,36,Clouds
84739,56,1554951600,40,0,40,Clouds
84740,57,1554951600,23,0,23,Clouds
84741,58,1554951600,40,0,40,Clouds
84742,59,1554951600,18,2,20,Clouds
84743,60,1554951600,7,23,30,Clouds
84744,61,1554951600,25,0,25,Clouds
84745,62,1554951600,40,0,40,Clouds
84746,63,1554951600,35,0,35,Clouds
84747,64,1554951600,39,1,40,Clouds
84748,65,1554951600,40,0,40,Clouds
84749,66,1554951600,30,10,40,Clouds
84750,67,1554951600,24,16,40,Clouds
84751,68,1554951600,40,0,40,Clouds
84752,69,1554951600,38,2,40,Clouds
84753,70,1554951600,22,6,28,Clouds
84754,71,1554951600,40,0,40,Clouds
84755,72,1554951600,13,18,31,Clouds
84756,73,1554951600,12,18,30,Clouds
84757,74,1554951600,8,22,30,Clouds
84758,75,1554951600,2,38,40,Clouds
84759,76,1554951600,0,38,38,Clouds
84760,77,1554951600,29,0,29,Clouds
84761,78,1554951600,28,12,40,Clouds
84762,79,1554951600,21,6,27,Clouds
84763,80,1554951600,13,27,40,Clouds
84764,81,1554951600,15,25,40,Clouds
84765,82,1554951600,0,22,22,Clouds
84766,83,1554951600,6,34,40,Clouds
84767,84,1554951600,4,26,30,Clouds
84768,85,1554951600,0,35,35,Clouds
84769,86,1554951600,2,36,38,Clouds
84770,87,1554951600,0,38,38,Clouds
84771,88,1554951600,4,26,30,Clouds
84772,89,1554951600,40,0,40,Clouds
84773,90,1554951600,37,3,40,Clouds
84774,91,1554951600,19,11,30,Clouds
84775,92,1554951600,9,31,40,Clouds
84776,93,1554951600,0,40,40,Clouds
84777,94,1554951600,0,40,40,Clouds
84778,95,1554951600,9,31,40,Clouds
84779,96,1554951600,10,20,30,Clouds
84780,97,1554951600,0,40,40,Clouds
84781,98,1554951600,40,0,40,Clouds
84782,99,1554951600,30,0,30,Clouds
84783,100,1554951600,3,22,25,Clouds
84784,101,1554951600,0,30,30,Clouds
84785,102,1554951600,13,27,40,Clouds
84786,103,1554951600,28,12,40,Clouds
84787,104,1554951600,36,4,40,Clouds
84788,105,1554951600,32,4,36,Clouds
84789,106,1554951600,26,14,40,Clouds
84790,107,1554951600,9,31,40,Clouds
84791,108,1554951600,23,17,40,Clouds
84792,109,1554951600,17,12,29,Clouds
84793,110,1554951600,15,25,40,Clouds
84794,111,1554951600,4,36,40,Clouds
84795,112,1554951600,7,23,30,Clouds
84796,113,1554951600,40,0,40,Clouds
84797,114,1554951600,40,0,40,Clouds
84798,115,1554951600,6,24,30,Clouds
84799,2,1554955200,1,19,20,Clouds
84800,3,1554955200,12,8,20,Clouds
84801,4,1554955200,9,11,20,Clouds
84802,5,1554955200,37,3,40,Clouds
84803,6,1554955200,20,0,20,Clouds
84804,7,1554955200,16,13,29,Clouds
84805,8,1554955200,30,0,30,Clouds
84806,9,1554955200,24,0,24,Clouds
84807,10,1554955200,16,0,16,Clouds
84808,11,1554955200,29,1,30,Clouds
84809,12,1554955200,7,13,20,Clouds
84810,13,1554955200,30,0,30,Clouds
84811,14,1554955200,30,0,30,Clouds
84812,15,1554955200,14,2,16,Clouds
84813,16,1554955200,20,0,20,Clouds
84814,17,1554955200,20,0,20,Clouds
84815,18,1554955200,29,1,30,Clouds
84816,19,1554955200,29,1,30,Clouds
84817,21,1554955200,30,0,30,Clouds
84818,22,1554955200,18,2,20,Clouds
84819,23,1554955200,24,6,30,Clouds
84820,24,1554955200,20,0,20,Clouds
84821,25,1554955200,30,0,30,Clouds
84822,26,1554955200,20,0,20,Clouds
84823,27,1554955200,19,0,19,Clouds
84824,28,1554955200,15,15,30,Clouds
84825,29,1554955200,29,0,29,Clouds
84826,30,1554955200,12,8,20,Clouds
84827,31,1554955200,12,8,20,Clouds
84828,32,1554955200,30,0,30,Clouds
84829,33,1554955200,23,0,23,Clouds
84830,34,1554955200,10,20,30,Clouds
84831,35,1554955200,11,19,30,Clouds
84832,36,1554955200,40,0,40,Clouds
84833,37,1554955200,30,0,30,Clouds
84834,38,1554955200,26,14,40,Clouds
84835,39,1554955200,19,1,20,Clouds
84836,40,1554955200,18,3,21,Clouds
84837,41,1554955200,20,0,20,Clouds
84838,42,1554955200,0,30,30,Clouds
84839,43,1554955200,4,26,30,Clouds
84840,44,1554955200,0,30,30,Clouds
84841,45,1554955200,7,23,30,Clouds
84842,46,1554955200,20,0,20,Clouds
84843,47,1554955200,40,0,40,Clouds
84844,48,1554955200,39,1,40,Clouds
84845,49,1554955200,40,0,40,Clouds
84846,50,1554955200,0,40,40,Clouds
84847,51,1554955200,40,0,40,Clouds
84848,52,1554955200,32,0,32,Clouds
84849,53,1554955200,40,0,40,Clouds
84850,54,1554955200,33,0,33,Clouds
84851,55,1554955200,36,0,36,Clouds
84852,56,1554955200,40,0,40,Clouds
84853,57,1554955200,23,0,23,Clouds
84854,58,1554955200,40,0,40,Clouds
84855,59,1554955200,18,2,20,Clouds
84856,60,1554955200,7,23,30,Clouds
84857,61,1554955200,25,0,25,Clouds
84858,62,1554955200,40,0,40,Clouds
84859,63,1554955200,35,0,35,Clouds
84860,64,1554955200,39,1,40,Clouds
84861,65,1554955200,40,0,40,Clouds
84862,66,1554955200,30,10,40,Clouds
84863,67,1554955200,24,16,40,Clouds
84864,68,1554955200,40,0,40,Clouds
84865,69,1554955200,38,2,40,Clouds
84866,70,1554955200,22,6,28,Clouds
84867,71,1554955200,40,0,40,Clouds
84868,72,1554955200,13,18,31,Clouds
84869,73,1554955200,12,18,30,Clouds
84870,74,1554955200,8,22,30,Clouds
84871,75,1554955200,2,38,40,Clouds
84872,76,1554955200,0,38,38,Clouds
84873,77,1554955200,29,0,29,Clouds
84874,78,1554955200,28,12,40,Clouds
84875,79,1554955200,21,6,27,Clouds
84876,80,1554955200,13,27,40,Clouds
84877,81,1554955200,15,25,40,Clouds
84878,82,1554955200,0,22,22,Clouds
84879,83,1554955200,6,34,40,Clouds
84880,84,1554955200,4,26,30,Clouds
84881,85,1554955200,0,35,35,Clouds
84882,86,1554955200,2,36,38,Clouds
84883,87,1554955200,0,38,38,Clouds
84884,88,1554955200,4,26,30,Clouds
84885,89,1554955200,40,0,40,Clouds
84886,90,1554955200,37,3,40,Clouds
84887,91,1554955200,19,11,30,Clouds
84888,92,1554955200,9,31,40,Clouds
84889,93,1554955200,0,40,40,Clouds
84890,94,1554955200,0,40,40,Clouds
84891,95,1554955200,9,31,40,Clouds
84892,96,1554955200,10,20,30,Clouds
84893,97,1554955200,0,40,40,Clouds
84894,98,1554955200,40,0,40,Clouds
84895,99,1554955200,30,0,30,Clouds
84896,100,1554955200,3,22,25,Clouds
84897,101,1554955200,0,30,30,Clouds
84898,102,1554955200,13,27,40,Clouds
84899,103,1554955200,28,12,40,Clouds
84900,104,1554955200,36,4,40,Clouds
84901,105,1554955200,32,4,36,Clouds
84902,106,1554955200,26,14,40,Clouds
84903,107,1554955200,9,31,40,Clouds
84904,108,1554955200,23,17,40,Clouds
84905,109,1554955200,17,12,29,Clouds
84906,110,1554955200,15,25,40,Clouds
84907,111,1554955200,4,36,40,Clouds
84908,112,1554955200,7,23,30,Clouds
84909,113,1554955200,40,0,40,Clouds
84910,114,1554955200,40,0,40,Clouds
84911,115,1554955200,6,24,30,Clouds
84912,2,1554958800,1,19,20,Clouds
84913,3,1554958800,12,8,20,Clouds
84914,4,1554958800,9,11,20,Clouds
84915,5,1554958800,37,3,40,Clouds
84916,6,1554958800,20,0,20,Clouds
84917,7,1554958800,16,13,29,Clouds
84918,8,1554958800,30,0,30,Clouds
84919,9,1554958800,24,0,24,Clouds
84920,10,1554958800,16,0,16,Clouds
84921,11,1554958800,29,1,30,Clouds
84922,12,1554958800,7,13,20,Clouds
84923,13,1554958800,30,0,30,Clouds
84924,14,1554958800,30,0,30,Clouds
84925,15,1554958800,14,2,16,Clouds
84926,16,1554958800,20,0,20,Clouds
84927,17,1554958800,20,0,20,Clouds
84928,18,1554958800,29,1,30,Clouds
84929,19,1554958800,29,1,30,Clouds
84930,21,1554958800,30,0,30,Clouds
84931,22,1554958800,18,2,20,Clouds
84932,23,1554958800,24,6,30,Clouds
84933,24,1554958800,20,0,20,Clouds
84934,25,1554958800,30,0,30,Clouds
84935,26,1554958800,20,0,20,Clouds
84936,27,1554958800,19,0,19,Clouds
84937,28,1554958800,15,15,30,Clouds
84938,29,1554958800,29,0,29,Clouds
84939,30,1554958800,12,8,20,Clouds
84940,31,1554958800,12,8,20,Clouds
84941,32,1554958800,30,0,30,Clouds
84942,33,1554958800,23,0,23,Clouds
84943,34,1554958800,10,20,30,Clouds
84944,35,1554958800,11,19,30,Clouds
84945,36,1554958800,40,0,40,Clouds
84946,37,1554958800,30,0,30,Clouds
84947,38,1554958800,26,14,40,Clouds
84948,39,1554958800,19,1,20,Clouds
84949,40,1554958800,18,3,21,Clouds
84950,41,1554958800,20,0,20,Clouds
84951,42,1554958800,0,30,30,Clouds
84952,43,1554958800,4,26,30,Clouds
84953,44,1554958800,0,30,30,Clouds
84954,45,1554958800,7,23,30,Clouds
84955,46,1554958800,20,0,20,Clouds
84956,47,1554958800,40,0,40,Clouds
84957,48,1554958800,39,1,40,Clouds
84958,49,1554958800,40,0,40,Clouds
84959,50,1554958800,0,40,40,Clouds
84960,51,1554958800,40,0,40,Clouds
84961,52,1554958800,32,0,32,Clouds
84962,53,1554958800,40,0,40,Clouds
84963,54,1554958800,33,0,33,Clouds
84964,55,1554958800,36,0,36,Clouds
84965,56,1554958800,40,0,40,Clouds
84966,57,1554958800,23,0,23,Clouds
84967,58,1554958800,40,0,40,Clouds
84968,59,1554958800,18,2,20,Clouds
84969,60,1554958800,7,23,30,Clouds
84970,61,1554958800,25,0,25,Clouds
84971,62,1554958800,40,0,40,Clouds
84972,63,1554958800,35,0,35,Clouds
84973,64,1554958800,39,1,40,Clouds
84974,65,1554958800,40,0,40,Clouds
84975,66,1554958800,30,10,40,Clouds
84976,67,1554958800,24,16,40,Clouds
84977,68,1554958800,40,0,40,Clouds
84978,69,1554958800,38,2,40,Clouds
84979,70,1554958800,22,6,28,Clouds
84980,71,1554958800,40,0,40,Clouds
84981,72,1554958800,13,18,31,Clouds
84982,73,1554958800,12,18,30,Clouds
84983,74,1554958800,8,22,30,Clouds
84984,75,1554958800,2,38,40,Clouds
84985,76,1554958800,0,38,38,Clouds
84986,77,1554958800,29,0,29,Clouds
84987,78,1554958800,28,12,40,Clouds
84988,79,1554958800,21,6,27,Clouds
84989,80,1554958800,13,27,40,Clouds
84990,81,1554958800,15,25,40,Clouds
84991,82,1554958800,0,22,22,Clouds
84992,83,1554958800,6,34,40,Clouds
84993,84,1554958800,4,26,30,Clouds
84994,85,1554958800,0,35,35,Clouds
84995,86,1554958800,2,36,38,Clouds
84996,87,1554958800,0,38,38,Clouds
84997,88,1554958800,4,26,30,Clouds
84998,89,1554958800,40,0,40,Clouds
84999,90,1554958800,37,3,40,Clouds
85000,91,1554958800,19,11,30,Clouds
85001,92,1554958800,9,31,40,Clouds
85002,93,1554958800,0,40,40,Clouds
85003,94,1554958800,0,40,40,Clouds
85004,95,1554958800,9,31,40,Clouds
85005,96,1554958800,10,20,30,Clouds
85006,97,1554958800,0,40,40,Clouds
85007,98,1554958800,40,0,40,Clouds
85008,99,1554958800,30,0,30,Clouds
85009,100,1554958800,3,22,25,Clouds
85010,101,1554958800,0,30,30,Clouds
85011,102,1554958800,13,27,40,Clouds
85012,103,1554958800,28,12,40,Clouds
85013,104,1554958800,36,4,40,Clouds
85014,105,1554958800,32,4,36,Clouds
85015,106,1554958800,26,14,40,Clouds
85016,107,1554958800,9,31,40,Clouds
85017,108,1554958800,23,17,40,Clouds
85018,109,1554958800,17,12,29,Clouds
85019,110,1554958800,15,25,40,Clouds
85020,111,1554958800,4,36,40,Clouds
85021,112,1554958800,7,23,30,Clouds
85022,113,1554958800,40,0,40,Clouds
85023,114,1554958800,40,0,40,Clouds
85024,115,1554958800,6,24,30,Clouds
85025,2,1554962400,1,19,20,Clear
85026,3,1554962400,16,4,20,Clear
85027,4,1554962400,11,9,20,Clear
85028,5,1554962400,25,15,40,Clear
85029,6,1554962400,20,0,20,Clear
85030,7,1554962400,17,12,29,Clear
85031,8,1554962400,25,5,30,Clear
85032,9,1554962400,19,5,24,Clear
85033,10,1554962400,14,2,16,Clear
85034,11,1554962400,29,1,30,Clear
85035,12,1554962400,10,10,20,Clear
85036,13,1554962400,28,2,30,Clear
85037,14,1554962400,27,3,30,Clear
85038,15,1554962400,16,0,16,Clear
85039,16,1554962400,19,1,20,Clear
85040,17,1554962400,19,1,20,Clear
85041,18,1554962400,28,2,30,Clear
85042,19,1554962400,27,3,30,Clear
85043,21,1554962400,30,0,30,Clear
85044,22,1554962400,18,2,20,Clear
85045,23,1554962400,28,2,30,Clear
85046,24,1554962400,17,3,20,Clear
85047,25,1554962400,30,0,30,Clear
85048,26,1554962400,20,0,20,Clear
85049,27,1554962400,19,0,19,Clear
85050,28,1554962400,2,28,30,Clear
85051,29,1554962400,29,0,29,Clear
85052,30,1554962400,14,6,20,Clear
85053,31,1554962400,13,7,20,Clear
85054,32,1554962400,29,1,30,Clear
85055,33,1554962400,16,7,23,Clear
85056,34,1554962400,14,16,30,Clear
85057,35,1554962400,17,13,30,Clear
85058,36,1554962400,36,4,40,Clear
85059,37,1554962400,30,0,30,Clear
85060,38,1554962400,27,13,40,Clear
85061,39,1554962400,20,0,20,Clear
85062,40,1554962400,17,4,21,Clear
85063,41,1554962400,20,0,20,Clear
85064,42,1554962400,2,28,30,Clear
85065,43,1554962400,9,21,30,Clear
85066,44,1554962400,5,25,30,Clear
85067,45,1554962400,7,23,30,Clear
85068,46,1554962400,19,1,20,Clear
85069,47,1554962400,40,0,40,Clear
85070,48,1554962400,39,1,40,Clear
85071,49,1554962400,38,2,40,Clear
85072,50,1554962400,2,38,40,Clear
85073,51,1554962400,39,1,40,Clear
85074,52,1554962400,26,6,32,Clear
85075,53,1554962400,39,1,40,Clear
85076,54,1554962400,33,0,33,Clear
85077,55,1554962400,36,0,36,Clear
85078,56,1554962400,40,0,40,Clear
85079,57,1554962400,22,1,23,Clear
85080,58,1554962400,40,0,40,Clear
85081,59,1554962400,19,1,20,Clear
85082,60,1554962400,9,21,30,Clear
85083,61,1554962400,9,16,25,Clear
85084,62,1554962400,39,1,40,Clear
85085,63,1554962400,34,1,35,Clear
85086,64,1554962400,39,1,40,Clear
85087,65,1554962400,40,0,40,Clear
85088,66,1554962400,38,2,40,Clear
85089,67,1554962400,37,3,40,Clear
85090,68,1554962400,35,5,40,Clear
85091,69,1554962400,36,4,40,Clear
85092,70,1554962400,19,9,28,Clear
85093,71,1554962400,38,2,40,Clear
85094,72,1554962400,13,18,31,Clear
85095,73,1554962400,13,17,30,Clear
85096,74,1554962400,11,19,30,Clear
85097,75,1554962400,2,38,40,Clear
85098,76,1554962400,2,36,38,Clear
85099,77,1554962400,26,3,29,Clear
85100,78,1554962400,11,29,40,Clear
85101,79,1554962400,21,6,27,Clear
85102,80,1554962400,15,25,40,Clear
85103,81,1554962400,15,25,40,Clear
85104,82,1554962400,0,22,22,Clear
85105,83,1554962400,6,34,40,Clear
85106,84,1554962400,6,24,30,Clear
85107,85,1554962400,1,34,35,Clear
85108,86,1554962400,3,35,38,Clear
85109,87,1554962400,1,37,38,Clear
85110,88,1554962400,4,26,30,Clear
85111,89,1554962400,40,0,40,Clear
85112,90,1554962400,35,5,40,Clear
85113,91,1554962400,27,3,30,Clear
85114,92,1554962400,10,30,40,Clear
85115,93,1554962400,0,40,40,Clear
85116,94,1554962400,0,40,40,Clear
85117,95,1554962400,9,31,40,Clear
85118,96,1554962400,10,20,30,Clear
85119,97,1554962400,2,38,40,Clear
85120,98,1554962400,40,0,40,Clear
85121,99,1554962400,28,2,30,Clear
85122,100,1554962400,4,21,25,Clear
85123,101,1554962400,5,25,30,Clear
85124,102,1554962400,13,27,40,Clear
85125,103,1554962400,28,12,40,Clear
85126,104,1554962400,36,4,40,Clear
85127,105,1554962400,33,3,36,Clear
85128,106,1554962400,29,11,40,Clear
85129,107,1554962400,14,26,40,Clear
85130,108,1554962400,24,16,40,Clear
85131,109,1554962400,24,5,29,Clear
85132,110,1554962400,15,25,40,Clear
85133,111,1554962400,0,40,40,Clear
85134,112,1554962400,11,19,30,Clear
85135,113,1554962400,40,0,40,Clear
85136,114,1554962400,38,2,40,Clear
85137,115,1554962400,6,24,30,Clear
85138,2,1554966000,13,7,20,Clouds
85139,3,1554966000,20,0,20,Clouds
85140,4,1554966000,10,10,20,Clouds
85141,5,1554966000,28,12,40,Clouds
85142,6,1554966000,20,0,20,Clouds
85143,7,1554966000,20,9,29,Clouds
85144,8,1554966000,23,7,30,Clouds
85145,9,1554966000,17,7,24,Clouds
85146,10,1554966000,16,0,16,Clouds
85147,11,1554966000,30,0,30,Clouds
85148,12,1554966000,16,4,20,Clouds
85149,13,1554966000,29,1,30,Clouds
85150,14,1554966000,22,8,30,Clouds
85151,15,1554966000,15,1,16,Clouds
85152,16,1554966000,20,0,20,Clouds
85153,17,1554966000,19,1,20,Clouds
85154,18,1554966000,25,5,30,Clouds
85155,19,1554966000,24,6,30,Clouds
85156,21,1554966000,27,3,30,Clouds
85157,22,1554966000,18,2,20,Clouds
85158,23,1554966000,30,0,30,Clouds
85159,24,1554966000,17,3,20,Clouds
85160,25,1554966000,28,2,30,Clouds
85161,26,1554966000,20,0,20,Clouds
85162,27,1554966000,13,6,19,Clouds
85163,28,1554966000,9,21,30,Clouds
85164,29,1554966000,28,1,29,Clouds
85165,30,1554966000,13,7,20,Clouds
85166,31,1554966000,12,8,20,Clouds
85167,32,1554966000,26,4,30,Clouds
85168,33,1554966000,2,21,23,Clouds
85169,34,1554966000,20,10,30,Clouds
85170,35,1554966000,26,4,30,Clouds
85171,36,1554966000,35,5,40,Clouds
85172,37,1554966000,30,0,30,Clouds
85173,38,1554966000,33,7,40,Clouds
85174,39,1554966000,20,0,20,Clouds
85175,40,1554966000,11,10,21,Clouds
85176,41,1554966000,20,0,20,Clouds
85177,42,1554966000,2,28,30,Clouds
85178,43,1554966000,18,12,30,Clouds
85179,44,1554966000,17,13,30,Clouds
85180,45,1554966000,19,11,30,Clouds
85181,46,1554966000,15,5,20,Clouds
85182,47,1554966000,38,2,40,Clouds
85183,48,1554966000,39,1,40,Clouds
85184,49,1554966000,36,4,40,Clouds
85185,50,1554966000,6,34,40,Clouds
85186,51,1554966000,35,5,40,Clouds
85187,52,1554966000,28,4,32,Clouds
85188,53,1554966000,39,1,40,Clouds
85189,54,1554966000,31,2,33,Clouds
85190,55,1554966000,35,1,36,Clouds
85191,56,1554966000,40,0,40,Clouds
85192,57,1554966000,23,0,23,Clouds
85193,58,1554966000,40,0,40,Clouds
85194,59,1554966000,19,1,20,Clouds
85195,60,1554966000,7,23,30,Clouds
85196,61,1554966000,11,14,25,Clouds
85197,62,1554966000,32,8,40,Clouds
85198,63,1554966000,33,2,35,Clouds
85199,64,1554966000,38,2,40,Clouds
85200,65,1554966000,34,6,40,Clouds
85201,66,1554966000,26,14,40,Clouds
85202,67,1554966000,34,6,40,Clouds
85203,68,1554966000,27,13,40,Clouds
85204,69,1554966000,34,5,39,Clouds
85205,70,1554966000,4,24,28,Clouds
85206,71,1554966000,39,1,40,Clouds
85207,72,1554966000,18,13,31,Clouds
85208,73,1554966000,20,10,30,Clouds
85209,74,1554966000,14,16,30,Clouds
85210,75,1554966000,2,38,40,Clouds
85211,76,1554966000,8,30,38,Clouds
85212,77,1554966000,28,1,29,Clouds
85213,78,1554966000,11,29,40,Clouds
85214,79,1554966000,19,8,27,Clouds
85215,80,1554966000,20,20,40,Clouds
85216,81,1554966000,14,26,40,Clouds
85217,82,1554966000,3,19,22,Clouds
85218,83,1554966000,14,26,40,Clouds
85219,84,1554966000,5,25,30,Clouds
85220,85,1554966000,6,29,35,Clouds
85221,86,1554966000,1,37,38,Clouds
85222,87,1554966000,7,31,38,Clouds
85223,88,1554966000,10,20,30,Clouds
85224,89,1554966000,38,2,40,Clouds
85225,90,1554966000,32,8,40,Clouds
85226,91,1554966000,23,7,30,Clouds
85227,92,1554966000,1,39,40,Clouds
85228,93,1554966000,9,31,40,Clouds
85229,94,1554966000,1,39,40,Clouds
85230,95,1554966000,13,27,40,Clouds
85231,96,1554966000,11,19,30,Clouds
85232,97,1554966000,10,30,40,Clouds
85233,98,1554966000,40,0,40,Clouds
85234,99,1554966000,26,4,30,Clouds
85235,100,1554966000,7,18,25,Clouds
85236,101,1554966000,11,19,30,Clouds
85237,102,1554966000,15,25,40,Clouds
85238,103,1554966000,27,13,40,Clouds
85239,104,1554966000,36,4,40,Clouds
85240,105,1554966000,31,5,36,Clouds
85241,106,1554966000,32,8,40,Clouds
85242,107,1554966000,20,20,40,Clouds
85243,108,1554966000,29,11,40,Clouds
85244,109,1554966000,29,0,29,Clouds
85245,110,1554966000,19,21,40,Clouds
85246,111,1554966000,8,32,40,Clouds
85247,112,1554966000,26,4,30,Clouds
85248,113,1554966000,37,3,40,Clouds
85249,114,1554966000,33,6,39,Clouds
85250,115,1554966000,12,18,30,Clouds
85251,2,1554969600,20,0,20,Clear
85252,3,1554969600,19,1,20,Clear
85253,4,1554969600,9,11,20,Clear
85254,5,1554969600,40,0,40,Clear
85255,6,1554969600,18,2,20,Clear
85256,7,1554969600,29,0,29,Clear
85257,8,1554969600,30,0,30,Clear
85258,9,1554969600,19,5,24,Clear
85259,10,1554969600,14,2,16,Clear
85260,11,1554969600,20,10,30,Clear
85261,12,1554969600,20,0,20,Clear
85262,13,1554969600,25,5,30,Clear
85263,14,1554969600,18,12,30,Clear
85264,15,1554969600,16,0,16,Clear
85265,16,1554969600,20,0,20,Clear
85266,17,1554969600,15,5,20,Clear
85267,18,1554969600,29,1,30,Clear
85268,19,1554969600,25,5,30,Clear
85269,21,1554969600,24,6,30,Clear
85270,22,1554969600,18,2,20,Clear
85271,23,1554969600,25,5,30,Clear
85272,24,1554969600,20,0,20,Clear
85273,25,1554969600,12,17,29,Clear
85274,26,1554969600,15,5,20,Clear
85275,27,1554969600,10,9,19,Clear
85276,28,1554969600,22,8,30,Clear
85277,29,1554969600,28,1,29,Clear
85278,30,1554969600,13,7,20,Clear
85279,31,1554969600,13,7,20,Clear
85280,32,1554969600,26,4,30,Clear
85281,33,1554969600,0,23,23,Clear
85282,34,1554969600,29,1,30,Clear
85283,35,1554969600,26,4,30,Clear
85284,36,1554969600,35,5,40,Clear
85285,37,1554969600,30,0,30,Clear
85286,38,1554969600,32,8,40,Clear
85287,39,1554969600,18,2,20,Clear
85288,40,1554969600,0,21,21,Clear
85289,41,1554969600,20,0,20,Clear
85290,42,1554969600,21,9,30,Clear
85291,43,1554969600,30,0,30,Clear
85292,44,1554969600,28,2,30,Clear
85293,45,1554969600,25,5,30,Clear
85294,46,1554969600,19,1,20,Clear
85295,47,1554969600,33,7,40,Clear
85296,48,1554969600,37,3,40,Clear
85297,49,1554969600,36,4,40,Clear
85298,50,1554969600,19,21,40,Clear
85299,51,1554969600,32,8,40,Clear
85300,52,1554969600,12,20,32,Clear
85301,53,1554969600,35,5,40,Clear
85302,54,1554969600,24,9,33,Clear
85303,55,1554969600,28,8,36,Clear
85304,56,1554969600,26,14,40,Clear
85305,57,1554969600,13,10,23,Clear
85306,58,1554969600,20,20,40,Clear
85307,59,1554969600,19,1,20,Clear
85308,60,1554969600,25,5,30,Clear
85309,61,1554969600,14,11,25,Clear
85310,62,1554969600,33,7,40,Clear
85311,63,1554969600,23,12,35,Clear
85312,64,1554969600,32,6,38,Clear
85313,65,1554969600,36,4,40,Clear
85314,66,1554969600,3,37,40,Clear
85315,67,1554969600,23,17,40,Clear
85316,68,1554969600,12,28,40,Clear
85317,69,1554969600,25,13,38,Clear
85318,70,1554969600,5,23,28,Clear
85319,71,1554969600,39,1,40,Clear
85320,72,1554969600,30,1,31,Clear
85321,73,1554969600,28,2,30,Clear
85322,74,1554969600,30,0,30,Clear
85323,75,1554969600,12,28,40,Clear
85324,76,1554969600,15,23,38,Clear
85325,77,1554969600,26,3,29,Clear
85326,78,1554969600,11,29,40,Clear
85327,79,1554969600,18,9,27,Clear
85328,80,1554969600,27,13,40,Clear
85329,81,1554969600,14,26,40,Clear
85330,82,1554969600,9,13,22,Clear
85331,83,1554969600,23,17,40,Clear
85332,84,1554969600,11,19,30,Clear
85333,85,1554969600,28,7,35,Clear
85334,86,1554969600,29,9,38,Clear
85335,87,1554969600,19,19,38,Clear
85336,88,1554969600,17,13,30,Clear
85337,89,1554969600,36,4,40,Clear
85338,90,1554969600,5,34,39,Clear
85339,91,1554969600,24,6,30,Clear
85340,92,1554969600,22,18,40,Clear
85341,93,1554969600,18,22,40,Clear
85342,94,1554969600,7,33,40,Clear
85343,95,1554969600,31,9,40,Clear
85344,96,1554969600,17,13,30,Clear
85345,97,1554969600,26,14,40,Clear
85346,98,1554969600,37,3,40,Clear
85347,99,1554969600,27,3,30,Clear
85348,100,1554969600,25,0,25,Clear
85349,101,1554969600,22,8,30,Clear
85350,102,1554969600,22,18,40,Clear
85351,103,1554969600,27,13,40,Clear
85352,104,1554969600,34,6,40,Clear
85353,105,1554969600,31,5,36,Clear
85354,106,1554969600,38,2,40,Clear
85355,107,1554969600,36,4,40,Clear
85356,108,1554969600,32,8,40,Clear
85357,109,1554969600,28,1,29,Clear
85358,110,1554969600,25,15,40,Clear
85359,111,1554969600,22,18,40,Clear
85360,112,1554969600,28,2,30,Clear
85361,113,1554969600,29,11,40,Clear
85362,114,1554969600,38,1,39,Clear
85363,115,1554969600,10,20,30,Clear
85364,2,1554973200,20,0,20,Clear
85365,3,1554973200,11,9,20,Clear
85366,4,1554973200,14,6,20,Clear
85367,5,1554973200,40,0,40,Clear
85368,6,1554973200,19,1,20,Clear
85369,7,1554973200,29,0,29,Clear
85370,8,1554973200,19,11,30,Clear
85371,9,1554973200,12,12,24,Clear
85372,10,1554973200,10,6,16,Clear
85373,11,1554973200,1,29,30,Clear
85374,12,1554973200,20,0,20,Clear
85375,13,1554973200,15,15,30,Clear
85376,14,1554973200,24,6,30,Clear
85377,15,1554973200,16,0,16,Clear
85378,16,1554973200,18,1,19,Clear
85379,17,1554973200,14,6,20,Clear
85380,18,1554973200,30,0,30,Clear
85381,19,1554973200,1,29,30,Clear
85382,21,1554973200,7,23,30,Clear
85383,22,1554973200,17,3,20,Clear
85384,23,1554973200,11,19,30,Clear
85385,24,1554973200,20,0,20,Clear
85386,25,1554973200,0,29,29,Clear
85387,26,1554973200,6,13,19,Clear
85388,27,1554973200,7,12,19,Clear
85389,28,1554973200,29,1,30,Clear
85390,29,1554973200,27,2,29,Clear
85391,30,1554973200,14,6,20,Clear
85392,31,1554973200,13,7,20,Clear
85393,32,1554973200,18,12,30,Clear
85394,33,1554973200,0,23,23,Clear
85395,34,1554973200,30,0,30,Clear
85396,35,1554973200,25,5,30,Clear
85397,36,1554973200,8,32,40,Clear
85398,37,1554973200,24,6,30,Clear
85399,38,1554973200,39,1,40,Clear
85400,39,1554973200,20,0,20,Clear
85401,40,1554973200,0,21,21,Clear
85402,41,1554973200,20,0,20,Clear
85403,42,1554973200,30,0,30,Clear
85404,43,1554973200,30,0,30,Clear
85405,44,1554973200,30,0,30,Clear
85406,45,1554973200,30,0,30,Clear
85407,46,1554973200,20,0,20,Clear
85408,47,1554973200,13,27,40,Clear
85409,48,1554973200,20,20,40,Clear
85410,49,1554973200,17,23,40,Clear
85411,50,1554973200,39,1,40,Clear
85412,51,1554973200,32,8,40,Clear
85413,52,1554973200,22,10,32,Clear
85414,53,1554973200,16,24,40,Clear
85415,54,1554973200,29,4,33,Clear
85416,55,1554973200,19,17,36,Clear
85417,56,1554973200,10,30,40,Clear
85418,57,1554973200,0,23,23,Clear
85419,58,1554973200,10,30,40,Clear
85420,59,1554973200,20,0,20,Clear
85421,60,1554973200,29,1,30,Clear
85422,61,1554973200,23,2,25,Clear
85423,62,1554973200,18,22,40,Clear
85424,63,1554973200,0,35,35,Clear
85425,64,1554973200,21,17,38,Clear
85426,65,1554973200,25,15,40,Clear
85427,66,1554973200,1,39,40,Clear
85428,67,1554973200,11,29,40,Clear
85429,68,1554973200,12,28,40,Clear
85430,69,1554973200,0,38,38,Clear
85431,70,1554973200,14,13,27,Clear
85432,71,1554973200,37,3,40,Clear
85433,72,1554973200,29,2,31,Clear
85434,73,1554973200,30,0,30,Clear
85435,74,1554973200,28,2,30,Clear
85436,75,1554973200,34,6,40,Clear
85437,76,1554973200,32,6,38,Clear
85438,77,1554973200,16,13,29,Clear
85439,78,1554973200,40,0,40,Clear
85440,79,1554973200,23,4,27,Clear
85441,80,1554973200,38,2,40,Clear
85442,81,1554973200,27,13,40,Clear
85443,82,1554973200,22,0,22,Clear
85444,83,1554973200,40,0,40,Clear
85445,84,1554973200,30,0,30,Clear
85446,85,1554973200,35,0,35,Clear
85447,86,1554973200,37,1,38,Clear
85448,87,1554973200,38,0,38,Clear
85449,88,1554973200,30,0,30,Clear
85450,89,1554973200,29,11,40,Clear
85451,90,1554973200,14,23,37,Clear
85452,91,1554973200,27,3,30,Clear
85453,92,1554973200,40,0,40,Clear
85454,93,1554973200,40,0,40,Clear
85455,94,1554973200,37,3,40,Clear
85456,95,1554973200,40,0,40,Clear
85457,96,1554973200,30,0,30,Clear
85458,97,1554973200,40,0,40,Clear
85459,98,1554973200,35,5,40,Clear
85460,99,1554973200,17,13,30,Clear
85461,100,1554973200,22,3,25,Clear
85462,101,1554973200,30,0,30,Clear
85463,102,1554973200,37,3,40,Clear
85464,103,1554973200,32,8,40,Clear
85465,104,1554973200,40,0,40,Clear
85466,105,1554973200,36,0,36,Clear
85467,106,1554973200,40,0,40,Clear
85468,107,1554973200,39,1,40,Clear
85469,108,1554973200,40,0,40,Clear
85470,109,1554973200,29,0,29,Clear
85471,110,1554973200,30,10,40,Clear
85472,111,1554973200,39,1,40,Clear
85473,112,1554973200,29,1,30,Clear
85474,113,1554973200,9,30,39,Clear
85475,114,1554973200,10,29,39,Clear
85476,115,1554973200,28,2,30,Clear
85477,2,1554976800,19,1,20,Clouds
85478,3,1554976800,15,5,20,Clouds
85479,4,1554976800,16,4,20,Clouds
85480,5,1554976800,37,3,40,Clouds
85481,6,1554976800,17,3,20,Clouds
85482,7,1554976800,27,2,29,Clouds
85483,8,1554976800,20,10,30,Clouds
85484,9,1554976800,9,14,23,Clouds
85485,10,1554976800,9,7,16,Clouds
85486,11,1554976800,18,12,30,Clouds
85487,12,1554976800,20,0,20,Clouds
85488,13,1554976800,6,24,30,Clouds
85489,14,1554976800,21,9,30,Clouds
85490,15,1554976800,16,0,16,Clouds
85491,16,1554976800,12,7,19,Clouds
85492,17,1554976800,19,1,20,Clouds
85493,18,1554976800,27,3,30,Clouds
85494,19,1554976800,2,28,30,Clouds
85495,21,1554976800,0,30,30,Clouds
85496,22,1554976800,20,0,20,Clouds
85497,23,1554976800,8,22,30,Clouds
85498,24,1554976800,15,5,20,Clouds
85499,25,1554976800,0,29,29,Clouds
85500,26,1554976800,4,15,19,Clouds
85501,27,1554976800,0,19,19,Clouds
85502,28,1554976800,26,4,30,Clouds
85503,29,1554976800,17,12,29,Clouds
85504,30,1554976800,13,7,20,Clouds
85505,31,1554976800,19,1,20,Clouds
85506,32,1554976800,10,20,30,Clouds
85507,33,1554976800,0,22,22,Clouds
85508,34,1554976800,27,3,30,Clouds
85509,35,1554976800,30,0,30,Clouds
85510,36,1554976800,0,40,40,Clouds
85511,37,1554976800,17,13,30,Clouds
85512,38,1554976800,36,4,40,Clouds
85513,39,1554976800,14,6,20,Clouds
85514,40,1554976800,0,21,21,Clouds
85515,41,1554976800,11,9,20,Clouds
85516,42,1554976800,29,1,30,Clouds
85517,43,1554976800,30,0,30,Clouds
85518,44,1554976800,29,1,30,Clouds
85519,45,1554976800,26,4,30,Clouds
85520,46,1554976800,19,1,20,Clouds
85521,47,1554976800,5,35,40,Clouds
85522,48,1554976800,19,21,40,Clouds
85523,49,1554976800,20,20,40,Clouds
85524,50,1554976800,40,0,40,Clouds
85525,51,1554976800,24,15,39,Clouds
85526,52,1554976800,18,14,32,Clouds
85527,53,1554976800,6,34,40,Clouds
85528,54,1554976800,26,7,33,Clouds
85529,55,1554976800,16,20,36,Clouds
85530,56,1554976800,0,40,40,Clouds
85531,57,1554976800,0,23,23,Clouds
85532,58,1554976800,0,40,40,Clouds
85533,59,1554976800,20,0,20,Clouds
85534,60,1554976800,29,1,30,Clouds
85535,61,1554976800,24,1,25,Clouds
85536,62,1554976800,7,33,40,Clouds
85537,63,1554976800,0,35,35,Clouds
85538,64,1554976800,4,33,37,Clouds
85539,65,1554976800,10,30,40,Clouds
85540,66,1554976800,0,40,40,Clouds
85541,67,1554976800,13,27,40,Clouds
85542,68,1554976800,14,26,40,Clouds
85543,69,1554976800,0,38,38,Clouds
85544,70,1554976800,12,15,27,Clouds
85545,71,1554976800,40,0,40,Clouds
85546,72,1554976800,30,1,31,Clouds
85547,73,1554976800,30,0,30,Clouds
85548,74,1554976800,29,1,30,Clouds
85549,75,1554976800,38,2,40,Clouds
85550,76,1554976800,33,5,38,Clouds
85551,77,1554976800,18,11,29,Clouds
85552,78,1554976800,40,0,40,Clouds
85553,79,1554976800,19,8,27,Clouds
85554,80,1554976800,39,1,40,Clouds
85555,81,1554976800,30,10,40,Clouds
85556,82,1554976800,22,0,22,Clouds
85557,83,1554976800,40,0,40,Clouds
85558,84,1554976800,30,0,30,Clouds
85559,85,1554976800,35,0,35,Clouds
85560,86,1554976800,38,0,38,Clouds
85561,87,1554976800,38,0,38,Clouds
85562,88,1554976800,30,0,30,Clouds
85563,89,1554976800,19,21,40,Clouds
85564,90,1554976800,7,30,37,Clouds
85565,91,1554976800,24,6,30,Clouds
85566,92,1554976800,40,0,40,Clouds
85567,93,1554976800,40,0,40,Clouds
85568,94,1554976800,39,1,40,Clouds
85569,95,1554976800,39,1,40,Clouds
85570,96,1554976800,30,0,30,Clouds
85571,97,1554976800,40,0,40,Clouds
85572,98,1554976800,31,9,40,Clouds
85573,99,1554976800,20,10,30,Clouds
85574,100,1554976800,25,0,25,Clouds
85575,101,1554976800,30,0,30,Clouds
85576,102,1554976800,40,0,40,Clouds
85577,103,1554976800,33,7,40,Clouds
85578,104,1554976800,40,0,40,Clouds
85579,105,1554976800,36,0,36,Clouds
85580,106,1554976800,40,0,40,Clouds
85581,107,1554976800,37,3,40,Clouds
85582,108,1554976800,40,0,40,Clouds
85583,109,1554976800,29,0,29,Clouds
85584,110,1554976800,34,6,40,Clouds
85585,111,1554976800,40,0,40,Clouds
85586,112,1554976800,30,0,30,Clouds
85587,113,1554976800,0,39,39,Clouds
85588,114,1554976800,9,30,39,Clouds
85589,115,1554976800,30,0,30,Clouds
85590,2,1554980400,18,2,20,Clouds
85591,3,1554980400,18,2,20,Clouds
85592,4,1554980400,19,1,20,Clouds
85593,5,1554980400,14,26,40,Clouds
85594,6,1554980400,19,1,20,Clouds
85595,7,1554980400,29,0,29,Clouds
85596,8,1554980400,19,11,30,Clouds
85597,9,1554980400,0,23,23,Clouds
85598,10,1554980400,9,7,16,Clouds
85599,11,1554980400,19,11,30,Clouds
85600,12,1554980400,20,0,20,Clouds
85601,13,1554980400,8,22,30,Clouds
85602,14,1554980400,18,12,30,Clouds
85603,15,1554980400,16,0,16,Clouds
85604,16,1554980400,14,5,19,Clouds
85605,17,1554980400,20,0,20,Clouds
85606,18,1554980400,28,2,30,Clouds
85607,19,1554980400,1,29,30,Clouds
85608,21,1554980400,0,30,30,Clouds
85609,22,1554980400,16,4,20,Clouds
85610,23,1554980400,10,20,30,Clouds
85611,24,1554980400,20,0,20,Clouds
85612,25,1554980400,7,22,29,Clouds
85613,26,1554980400,1,18,19,Clouds
85614,27,1554980400,0,19,19,Clouds
85615,28,1554980400,30,0,30,Clouds
85616,29,1554980400,21,8,29,Clouds
85617,30,1554980400,20,0,20,Clouds
85618,31,1554980400,15,5,20,Clouds
85619,32,1554980400,6,24,30,Clouds
85620,33,1554980400,4,18,22,Clouds
85621,34,1554980400,28,2,30,Clouds
85622,35,1554980400,30,0,30,Clouds
85623,36,1554980400,0,40,40,Clouds
85624,37,1554980400,18,12,30,Clouds
85625,38,1554980400,37,2,39,Clouds
85626,39,1554980400,19,1,20,Clouds
85627,40,1554980400,0,21,21,Clouds
85628,41,1554980400,9,11,20,Clouds
85629,42,1554980400,29,1,30,Clouds
85630,43,1554980400,21,8,29,Clouds
85631,44,1554980400,30,0,30,Clouds
85632,45,1554980400,27,3,30,Clouds
85633,46,1554980400,16,4,20,Clouds
85634,47,1554980400,1,39,40,Clouds
85635,48,1554980400,19,21,40,Clouds
85636,49,1554980400,19,21,40,Clouds
85637,50,1554980400,39,1,40,Clouds
85638,51,1554980400,22,17,39,Clouds
85639,52,1554980400,18,14,32,Clouds
85640,53,1554980400,5,35,40,Clouds
85641,54,1554980400,27,6,33,Clouds
85642,55,1554980400,17,19,36,Clouds
85643,56,1554980400,12,28,40,Clouds
85644,57,1554980400,0,23,23,Clouds
85645,58,1554980400,15,25,40,Clouds
85646,59,1554980400,19,1,20,Clouds
85647,60,1554980400,30,0,30,Clouds
85648,61,1554980400,24,1,25,Clouds
85649,62,1554980400,5,35,40,Clouds
85650,63,1554980400,2,33,35,Clouds
85651,64,1554980400,6,31,37,Clouds
85652,65,1554980400,8,32,40,Clouds
85653,66,1554980400,6,34,40,Clouds
85654,67,1554980400,12,28,40,Clouds
85655,68,1554980400,9,31,40,Clouds
85656,69,1554980400,5,33,38,Clouds
85657,70,1554980400,8,19,27,Clouds
85658,71,1554980400,34,6,40,Clouds
85659,72,1554980400,30,1,31,Clouds
85660,73,1554980400,28,2,30,Clouds
85661,74,1554980400,29,1,30,Clouds
85662,75,1554980400,39,1,40,Clouds
85663,76,1554980400,34,4,38,Clouds
85664,77,1554980400,10,19,29,Clouds
85665,78,1554980400,33,7,40,Clouds
85666,79,1554980400,11,16,27,Clouds
85667,80,1554980400,40,0,40,Clouds
85668,81,1554980400,35,4,39,Clouds
85669,82,1554980400,22,0,22,Clouds
85670,83,1554980400,40,0,40,Clouds
85671,84,1554980400,30,0,30,Clouds
85672,85,1554980400,35,0,35,Clouds
85673,86,1554980400,38,0,38,Clouds
85674,87,1554980400,38,0,38,Clouds
85675,88,1554980400,27,3,30,Clouds
85676,89,1554980400,16,24,40,Clouds
85677,90,1554980400,3,34,37,Clouds
85678,91,1554980400,29,1,30,Clouds
85679,92,1554980400,40,0,40,Clouds
85680,93,1554980400,40,0,40,Clouds
85681,94,1554980400,39,1,40,Clouds
85682,95,1554980400,39,1,40,Clouds
85683,96,1554980400,30,0,30,Clouds
85684,97,1554980400,40,0,40,Clouds
85685,98,1554980400,16,24,40,Clouds
85686,99,1554980400,20,10,30,Clouds
85687,100,1554980400,25,0,25,Clouds
85688,101,1554980400,30,0,30,Clouds
85689,102,1554980400,34,6,40,Clouds
85690,103,1554980400,36,4,40,Clouds
85691,104,1554980400,40,0,40,Clouds
85692,105,1554980400,36,0,36,Clouds
85693,106,1554980400,40,0,40,Clouds
85694,107,1554980400,39,1,40,Clouds
85695,108,1554980400,40,0,40,Clouds
85696,109,1554980400,29,0,29,Clouds
85697,110,1554980400,37,3,40,Clouds
85698,111,1554980400,31,9,40,Clouds
85699,112,1554980400,30,0,30,Clouds
85700,113,1554980400,6,34,40,Clouds
85701,114,1554980400,5,35,40,Clouds
85702,115,1554980400,28,2,30,Clouds
85703,2,1554984000,19,1,20,Clouds
85704,3,1554984000,19,1,20,Clouds
85705,4,1554984000,20,0,20,Clouds
85706,5,1554984000,18,22,40,Clouds
85707,6,1554984000,20,0,20,Clouds
85708,7,1554984000,29,0,29,Clouds
85709,8,1554984000,21,9,30,Clouds
85710,9,1554984000,1,22,23,Clouds
85711,10,1554984000,5,11,16,Clouds
85712,11,1554984000,18,12,30,Clouds
85713,12,1554984000,20,0,20,Clouds
85714,13,1554984000,15,15,30,Clouds
85715,14,1554984000,16,14,30,Clouds
85716,15,1554984000,16,0,16,Clouds
85717,16,1554984000,14,5,19,Clouds
85718,17,1554984000,19,1,20,Clouds
85719,18,1554984000,23,7,30,Clouds
85720,19,1554984000,0,30,30,Clouds
85721,21,1554984000,5,25,30,Clouds
85722,22,1554984000,18,2,20,Clouds
85723,23,1554984000,8,22,30,Clouds
85724,24,1554984000,16,4,20,Clouds
85725,25,1554984000,6,23,29,Clouds
85726,26,1554984000,0,19,19,Clouds
85727,27,1554984000,0,19,19,Clouds
85728,28,1554984000,30,0,30,Clouds
85729,29,1554984000,21,8,29,Clouds
85730,30,1554984000,20,0,20,Clouds
85731,31,1554984000,16,4,20,Clouds
85732,32,1554984000,4,26,30,Clouds
85733,33,1554984000,0,22,22,Clouds
85734,34,1554984000,29,1,30,Clouds
85735,35,1554984000,29,1,30,Clouds
85736,36,1554984000,2,38,40,Clouds
85737,37,1554984000,20,10,30,Clouds
85738,38,1554984000,38,2,40,Clouds
85739,39,1554984000,20,0,20,Clouds
85740,40,1554984000,0,21,21,Clouds
85741,41,1554984000,12,8,20,Clouds
85742,42,1554984000,30,0,30,Clouds
85743,43,1554984000,26,4,30,Clouds
85744,44,1554984000,28,2,30,Clouds
85745,45,1554984000,27,3,30,Clouds
85746,46,1554984000,18,2,20,Clouds
85747,47,1554984000,1,39,40,Clouds
85748,48,1554984000,22,18,40,Clouds
85749,49,1554984000,22,18,40,Clouds
85750,50,1554984000,38,2,40,Clouds
85751,51,1554984000,25,15,40,Clouds
85752,52,1554984000,18,14,32,Clouds
85753,53,1554984000,3,37,40,Clouds
85754,54,1554984000,30,3,33,Clouds
85755,55,1554984000,22,14,36,Clouds
85756,56,1554984000,10,30,40,Clouds
85757,57,1554984000,0,23,23,Clouds
85758,58,1554984000,11,29,40,Clouds
85759,59,1554984000,20,0,20,Clouds
85760,60,1554984000,29,1,30,Clouds
85761,61,1554984000,25,0,25,Clouds
85762,62,1554984000,4,36,40,Clouds
85763,63,1554984000,5,30,35,Clouds
85764,64,1554984000,1,36,37,Clouds
85765,65,1554984000,11,29,40,Clouds
85766,66,1554984000,8,32,40,Clouds
85767,67,1554984000,12,28,40,Clouds
85768,68,1554984000,8,32,40,Clouds
85769,69,1554984000,2,36,38,Clouds
85770,70,1554984000,6,21,27,Clouds
85771,71,1554984000,36,4,40,Clouds
85772,72,1554984000,31,0,31,Clouds
85773,73,1554984000,28,2,30,Clouds
85774,74,1554984000,30,0,30,Clouds
85775,75,1554984000,39,1,40,Clouds
85776,76,1554984000,37,1,38,Clouds
85777,77,1554984000,1,28,29,Clouds
85778,78,1554984000,36,4,40,Clouds
85779,79,1554984000,14,13,27,Clouds
85780,80,1554984000,40,0,40,Clouds
85781,81,1554984000,40,0,40,Clouds
85782,82,1554984000,22,0,22,Clouds
85783,83,1554984000,40,0,40,Clouds
85784,84,1554984000,29,1,30,Clouds
85785,85,1554984000,35,0,35,Clouds
85786,86,1554984000,38,0,38,Clouds
85787,87,1554984000,38,0,38,Clouds
85788,88,1554984000,26,4,30,Clouds
85789,89,1554984000,11,29,40,Clouds
85790,90,1554984000,9,28,37,Clouds
85791,91,1554984000,27,3,30,Clouds
85792,92,1554984000,40,0,40,Clouds
85793,93,1554984000,40,0,40,Clouds
85794,94,1554984000,40,0,40,Clouds
85795,95,1554984000,39,1,40,Clouds
85796,96,1554984000,30,0,30,Clouds
85797,97,1554984000,40,0,40,Clouds
85798,98,1554984000,14,26,40,Clouds
85799,99,1554984000,19,11,30,Clouds
85800,100,1554984000,25,0,25,Clouds
85801,101,1554984000,29,1,30,Clouds
85802,102,1554984000,33,7,40,Clouds
85803,103,1554984000,40,0,40,Clouds
85804,104,1554984000,40,0,40,Clouds
85805,105,1554984000,36,0,36,Clouds
85806,106,1554984000,40,0,40,Clouds
85807,107,1554984000,37,3,40,Clouds
85808,108,1554984000,40,0,40,Clouds
85809,109,1554984000,29,0,29,Clouds
85810,110,1554984000,40,0,40,Clouds
85811,111,1554984000,40,0,40,Clouds
85812,112,1554984000,30,0,30,Clouds
85813,113,1554984000,4,36,40,Clouds
85814,114,1554984000,0,40,40,Clouds
85815,115,1554984000,30,0,30,Clouds
85816,2,1554987600,18,2,20,Clouds
85817,3,1554987600,17,3,20,Clouds
85818,4,1554987600,19,1,20,Clouds
85819,5,1554987600,14,26,40,Clouds
85820,6,1554987600,20,0,20,Clouds
85821,7,1554987600,29,0,29,Clouds
85822,8,1554987600,26,4,30,Clouds
85823,9,1554987600,0,23,23,Clouds
85824,10,1554987600,5,11,16,Clouds
85825,11,1554987600,30,0,30,Clouds
85826,12,1554987600,19,1,20,Clouds
85827,13,1554987600,18,12,30,Clouds
85828,14,1554987600,0,30,30,Clouds
85829,15,1554987600,15,1,16,Clouds
85830,16,1554987600,16,3,19,Clouds
85831,17,1554987600,18,2,20,Clouds
85832,18,1554987600,23,7,30,Clouds
85833,19,1554987600,12,18,30,Clouds
85834,21,1554987600,4,26,30,Clouds
85835,22,1554987600,16,4,20,Clouds
85836,23,1554987600,12,18,30,Clouds
85837,24,1554987600,20,0,20,Clouds
85838,25,1554987600,5,24,29,Clouds
85839,26,1554987600,8,12,20,Clouds
85840,27,1554987600,2,20,22,Clouds
85841,28,1554987600,29,1,30,Clouds
85842,29,1554987600,27,2,29,Clouds
85843,30,1554987600,20,0,20,Clouds
85844,31,1554987600,16,4,20,Clouds
85845,32,1554987600,13,17,30,Clouds
85846,33,1554987600,1,21,22,Clouds
85847,34,1554987600,28,2,30,Clouds
85848,35,1554987600,29,1,30,Clouds
85849,36,1554987600,12,28,40,Clouds
85850,37,1554987600,6,24,30,Clouds
85851,38,1554987600,36,4,40,Clouds
85852,39,1554987600,16,4,20,Clouds
85853,40,1554987600,0,21,21,Clouds
85854,41,1554987600,16,4,20,Clouds
85855,42,1554987600,28,2,30,Clouds
85856,43,1554987600,26,4,30,Clouds
85857,44,1554987600,29,1,30,Clouds
85858,45,1554987600,30,0,30,Clouds
85859,46,1554987600,15,5,20,Clouds
85860,47,1554987600,2,38,40,Clouds
85861,48,1554987600,15,25,40,Clouds
85862,49,1554987600,27,13,40,Clouds
85863,50,1554987600,40,0,40,Clouds
85864,51,1554987600,22,18,40,Clouds
85865,52,1554987600,16,16,32,Clouds
85866,53,1554987600,12,28,40,Clouds
85867,54,1554987600,30,3,33,Clouds
85868,55,1554987600,24,12,36,Clouds
85869,56,1554987600,27,13,40,Clouds
85870,57,1554987600,2,21,23,Clouds
85871,58,1554987600,19,21,40,Clouds
85872,59,1554987600,20,0,20,Clouds
85873,60,1554987600,30,0,30,Clouds
85874,61,1554987600,25,0,25,Clouds
85875,62,1554987600,6,34,40,Clouds
85876,63,1554987600,15,20,35,Clouds
85877,64,1554987600,7,33,40,Clouds
85878,65,1554987600,27,13,40,Clouds
85879,66,1554987600,8,32,40,Clouds
85880,67,1554987600,18,22,40,Clouds
85881,68,1554987600,13,27,40,Clouds
85882,69,1554987600,0,38,38,Clouds
85883,70,1554987600,10,17,27,Clouds
85884,71,1554987600,33,7,40,Clouds
85885,72,1554987600,29,2,31,Clouds
85886,73,1554987600,28,2,30,Clouds
85887,74,1554987600,26,4,30,Clouds
85888,75,1554987600,37,3,40,Clouds
85889,76,1554987600,38,0,38,Clouds
85890,77,1554987600,6,23,29,Clouds
85891,78,1554987600,39,1,40,Clouds
85892,79,1554987600,17,10,27,Clouds
85893,80,1554987600,32,8,40,Clouds
85894,81,1554987600,40,0,40,Clouds
85895,82,1554987600,21,1,22,Clouds
85896,83,1554987600,40,0,40,Clouds
85897,84,1554987600,30,0,30,Clouds
85898,85,1554987600,35,0,35,Clouds
85899,86,1554987600,38,0,38,Clouds
85900,87,1554987600,38,0,38,Clouds
85901,88,1554987600,25,5,30,Clouds
85902,89,1554987600,13,27,40,Clouds
85903,90,1554987600,15,22,37,Clouds
85904,91,1554987600,22,8,30,Clouds
85905,92,1554987600,40,0,40,Clouds
85906,93,1554987600,40,0,40,Clouds
85907,94,1554987600,40,0,40,Clouds
85908,95,1554987600,39,1,40,Clouds
85909,96,1554987600,25,5,30,Clouds
85910,97,1554987600,34,6,40,Clouds
85911,98,1554987600,6,34,40,Clouds
85912,99,1554987600,18,12,30,Clouds
85913,100,1554987600,19,6,25,Clouds
85914,101,1554987600,27,3,30,Clouds
85915,102,1554987600,40,0,40,Clouds
85916,103,1554987600,40,0,40,Clouds
85917,104,1554987600,40,0,40,Clouds
85918,105,1554987600,35,1,36,Clouds
85919,106,1554987600,40,0,40,Clouds
85920,107,1554987600,39,1,40,Clouds
85921,108,1554987600,40,0,40,Clouds
85922,109,1554987600,29,0,29,Clouds
85923,110,1554987600,39,1,40,Clouds
85924,111,1554987600,40,0,40,Clouds
85925,112,1554987600,30,0,30,Clouds
85926,113,1554987600,5,35,40,Clouds
85927,114,1554987600,6,34,40,Clouds
85928,115,1554987600,27,3,30,Clouds
85929,2,1554991200,19,1,20,Clouds
85930,3,1554991200,8,12,20,Clouds
85931,4,1554991200,19,1,20,Clouds
85932,5,1554991200,16,24,40,Clouds
85933,6,1554991200,14,6,20,Clouds
85934,7,1554991200,29,0,29,Clouds
85935,8,1554991200,28,2,30,Clouds
85936,9,1554991200,15,9,24,Clouds
85937,10,1554991200,0,16,16,Clouds
85938,11,1554991200,27,3,30,Clouds
85939,12,1554991200,20,0,20,Clouds
85940,13,1554991200,22,8,30,Clouds
85941,14,1554991200,10,20,30,Clouds
85942,15,1554991200,16,0,16,Clouds
85943,16,1554991200,16,3,19,Clouds
85944,17,1554991200,16,4,20,Clouds
85945,18,1554991200,28,2,30,Clouds
85946,19,1554991200,6,23,29,Clouds
85947,21,1554991200,16,14,30,Clouds
85948,22,1554991200,12,8,20,Clouds
85949,23,1554991200,7,23,30,Clouds
85950,24,1554991200,17,3,20,Clouds
85951,25,1554991200,7,23,30,Clouds
85952,26,1554991200,10,10,20,Clouds
85953,27,1554991200,5,17,22,Clouds
85954,28,1554991200,21,9,30,Clouds
85955,29,1554991200,22,7,29,Clouds
85956,30,1554991200,20,0,20,Clouds
85957,31,1554991200,10,10,20,Clouds
85958,32,1554991200,16,14,30,Clouds
85959,33,1554991200,5,18,23,Clouds
85960,34,1554991200,30,0,30,Clouds
85961,35,1554991200,29,1,30,Clouds
85962,36,1554991200,8,32,40,Clouds
85963,37,1554991200,1,29,30,Clouds
85964,38,1554991200,30,10,40,Clouds
85965,39,1554991200,18,2,20,Clouds
85966,40,1554991200,0,21,21,Clouds
85967,41,1554991200,14,6,20,Clouds
85968,42,1554991200,26,4,30,Clouds
85969,43,1554991200,28,2,30,Clouds
85970,44,1554991200,30,0,30,Clouds
85971,45,1554991200,27,3,30,Clouds
85972,46,1554991200,15,5,20,Clouds
85973,47,1554991200,10,30,40,Clouds
85974,48,1554991200,16,24,40,Clouds
85975,49,1554991200,16,24,40,Clouds
85976,50,1554991200,37,3,40,Clouds
85977,51,1554991200,21,19,40,Clouds
85978,52,1554991200,9,23,32,Clouds
85979,53,1554991200,11,29,40,Clouds
85980,54,1554991200,29,4,33,Clouds
85981,55,1554991200,28,8,36,Clouds
85982,56,1554991200,25,15,40,Clouds
85983,57,1554991200,4,19,23,Clouds
85984,58,1554991200,20,20,40,Clouds
85985,59,1554991200,18,2,20,Clouds
85986,60,1554991200,26,4,30,Clouds
85987,61,1554991200,25,0,25,Clouds
85988,62,1554991200,6,34,40,Clouds
85989,63,1554991200,9,26,35,Clouds
85990,64,1554991200,7,33,40,Clouds
85991,65,1554991200,24,16,40,Clouds
85992,66,1554991200,9,31,40,Clouds
85993,67,1554991200,15,25,40,Clouds
85994,68,1554991200,2,38,40,Clouds
85995,69,1554991200,7,31,38,Clouds
85996,70,1554991200,8,19,27,Clouds
85997,71,1554991200,33,7,40,Clouds
85998,72,1554991200,29,2,31,Clouds
85999,73,1554991200,26,4,30,Clouds
86000,74,1554991200,28,2,30,Clouds
86001,75,1554991200,40,0,40,Clouds
86002,76,1554991200,38,0,38,Clouds
86003,77,1554991200,7,22,29,Clouds
86004,78,1554991200,38,2,40,Clouds
86005,79,1554991200,24,3,27,Clouds
86006,80,1554991200,38,2,40,Clouds
86007,81,1554991200,39,1,40,Clouds
86008,82,1554991200,21,1,22,Clouds
86009,83,1554991200,35,5,40,Clouds
86010,84,1554991200,27,3,30,Clouds
86011,85,1554991200,35,0,35,Clouds
86012,86,1554991200,35,3,38,Clouds
86013,87,1554991200,36,2,38,Clouds
86014,88,1554991200,25,5,30,Clouds
86015,89,1554991200,18,22,40,Clouds
86016,90,1554991200,10,27,37,Clouds
86017,91,1554991200,19,11,30,Clouds
86018,92,1554991200,39,1,40,Clouds
86019,93,1554991200,40,0,40,Clouds
86020,94,1554991200,39,1,40,Clouds
86021,95,1554991200,38,2,40,Clouds
86022,96,1554991200,25,5,30,Clouds
86023,97,1554991200,34,6,40,Clouds
86024,98,1554991200,7,33,40,Clouds
86025,99,1554991200,19,11,30,Clouds
86026,100,1554991200,23,2,25,Clouds
86027,101,1554991200,30,0,30,Clouds
86028,102,1554991200,40,0,40,Clouds
86029,103,1554991200,40,0,40,Clouds
86030,104,1554991200,32,8,40,Clouds
86031,105,1554991200,36,0,36,Clouds
86032,106,1554991200,40,0,40,Clouds
86033,107,1554991200,37,3,40,Clouds
86034,108,1554991200,35,5,40,Clouds
86035,109,1554991200,29,0,29,Clouds
86036,110,1554991200,38,2,40,Clouds
86037,111,1554991200,40,0,40,Clouds
86038,112,1554991200,29,1,30,Clouds
86039,113,1554991200,3,37,40,Clouds
86040,114,1554991200,2,38,40,Clouds
86041,115,1554991200,28,2,30,Clouds
86042,2,1554994800,19,1,20,Clouds
86043,3,1554994800,6,14,20,Clouds
86044,4,1554994800,17,3,20,Clouds
86045,5,1554994800,23,17,40,Clouds
86046,6,1554994800,11,9,20,Clouds
86047,7,1554994800,29,0,29,Clouds
86048,8,1554994800,19,10,29,Clouds
86049,9,1554994800,5,19,24,Clouds
86050,10,1554994800,0,16,16,Clouds
86051,11,1554994800,23,7,30,Clouds
86052,12,1554994800,19,1,20,Clouds
86053,13,1554994800,19,11,30,Clouds
86054,14,1554994800,16,14,30,Clouds
86055,15,1554994800,14,2,16,Clouds
86056,16,1554994800,8,12,20,Clouds
86057,17,1554994800,15,5,20,Clouds
86058,18,1554994800,30,0,30,Clouds
86059,19,1554994800,5,24,29,Clouds
86060,21,1554994800,16,14,30,Clouds
86061,22,1554994800,20,0,20,Clouds
86062,23,1554994800,5,25,30,Clouds
86063,24,1554994800,18,2,20,Clouds
86064,25,1554994800,6,24,30,Clouds
86065,26,1554994800,13,7,20,Clouds
86066,27,1554994800,4,16,20,Clouds
86067,28,1554994800,20,10,30,Clouds
86068,29,1554994800,26,3,29,Clouds
86069,30,1554994800,20,0,20,Clouds
86070,31,1554994800,20,0,20,Clouds
86071,32,1554994800,23,7,30,Clouds
86072,33,1554994800,11,12,23,Clouds
86073,34,1554994800,30,0,30,Clouds
86074,35,1554994800,27,3,30,Clouds
86075,36,1554994800,0,40,40,Clouds
86076,37,1554994800,1,29,30,Clouds
86077,38,1554994800,28,12,40,Clouds
86078,39,1554994800,18,2,20,Clouds
86079,40,1554994800,0,21,21,Clouds
86080,41,1554994800,14,6,20,Clouds
86081,42,1554994800,28,2,30,Clouds
86082,43,1554994800,26,4,30,Clouds
86083,44,1554994800,30,0,30,Clouds
86084,45,1554994800,25,5,30,Clouds
86085,46,1554994800,12,8,20,Clouds
86086,47,1554994800,13,27,40,Clouds
86087,48,1554994800,10,30,40,Clouds
86088,49,1554994800,18,22,40,Clouds
86089,50,1554994800,40,0,40,Clouds
86090,51,1554994800,20,20,40,Clouds
86091,52,1554994800,7,25,32,Clouds
86092,53,1554994800,10,30,40,Clouds
86093,54,1554994800,31,2,33,Clouds
86094,55,1554994800,26,10,36,Clouds
86095,56,1554994800,19,21,40,Clouds
86096,57,1554994800,5,18,23,Clouds
86097,58,1554994800,20,20,40,Clouds
86098,59,1554994800,20,0,20,Clouds
86099,60,1554994800,27,3,30,Clouds
86100,61,1554994800,21,4,25,Clouds
86101,62,1554994800,8,32,40,Clouds
86102,63,1554994800,9,26,35,Clouds
86103,64,1554994800,20,20,40,Clouds
86104,65,1554994800,26,14,40,Clouds
86105,66,1554994800,9,31,40,Clouds
86106,67,1554994800,8,32,40,Clouds
86107,68,1554994800,3,37,40,Clouds
86108,69,1554994800,15,25,40,Clouds
86109,70,1554994800,12,16,28,Clouds
86110,71,1554994800,32,8,40,Clouds
86111,72,1554994800,28,3,31,Clouds
86112,73,1554994800,26,4,30,Clouds
86113,74,1554994800,28,2,30,Clouds
86114,75,1554994800,38,2,40,Clouds
86115,76,1554994800,19,19,38,Clouds
86116,77,1554994800,5,24,29,Clouds
86117,78,1554994800,37,3,40,Clouds
86118,79,1554994800,25,2,27,Clouds
86119,80,1554994800,38,2,40,Clouds
86120,81,1554994800,38,2,40,Clouds
86121,82,1554994800,22,0,22,Clouds
86122,83,1554994800,35,5,40,Clouds
86123,84,1554994800,26,4,30,Clouds
86124,85,1554994800,35,0,35,Clouds
86125,86,1554994800,38,0,38,Clouds
86126,87,1554994800,36,2,38,Clouds
86127,88,1554994800,26,4,30,Clouds
86128,89,1554994800,16,24,40,Clouds
86129,90,1554994800,12,28,40,Clouds
86130,91,1554994800,14,16,30,Clouds
86131,92,1554994800,40,0,40,Clouds
86132,93,1554994800,40,0,40,Clouds
86133,94,1554994800,39,1,40,Clouds
86134,95,1554994800,39,1,40,Clouds
86135,96,1554994800,26,4,30,Clouds
86136,97,1554994800,37,3,40,Clouds
86137,98,1554994800,11,29,40,Clouds
86138,99,1554994800,20,10,30,Clouds
86139,100,1554994800,21,4,25,Clouds
86140,101,1554994800,28,2,30,Clouds
86141,102,1554994800,39,1,40,Clouds
86142,103,1554994800,40,0,40,Clouds
86143,104,1554994800,38,2,40,Clouds
86144,105,1554994800,36,0,36,Clouds
86145,106,1554994800,40,0,40,Clouds
86146,107,1554994800,39,1,40,Clouds
86147,108,1554994800,35,5,40,Clouds
86148,109,1554994800,26,3,29,Clouds
86149,110,1554994800,34,6,40,Clouds
86150,111,1554994800,31,9,40,Clouds
86151,112,1554994800,28,2,30,Clouds
86152,113,1554994800,4,36,40,Clouds
86153,114,1554994800,2,38,40,Clouds
86154,115,1554994800,25,5,30,Clouds
86155,2,1554998400,20,0,20,Clouds
86156,3,1554998400,11,9,20,Clouds
86157,4,1554998400,20,0,20,Clouds
86158,5,1554998400,20,20,40,Clouds
86159,6,1554998400,9,11,20,Clouds
86160,7,1554998400,29,0,29,Clouds
86161,8,1554998400,14,15,29,Clouds
86162,9,1554998400,1,23,24,Clouds
86163,10,1554998400,6,10,16,Clouds
86164,11,1554998400,30,0,30,Clouds
86165,12,1554998400,16,4,20,Clouds
86166,13,1554998400,20,10,30,Clouds
86167,14,1554998400,28,2,30,Clouds
86168,15,1554998400,16,0,16,Clouds
86169,16,1554998400,20,0,20,Clouds
86170,17,1554998400,19,1,20,Clouds
86171,18,1554998400,27,3,30,Clouds
86172,19,1554998400,8,21,29,Clouds
86173,21,1554998400,18,12,30,Clouds
86174,22,1554998400,17,3,20,Clouds
86175,23,1554998400,24,5,29,Clouds
86176,24,1554998400,17,3,20,Clouds
86177,25,1554998400,7,23,30,Clouds
86178,26,1554998400,8,12,20,Clouds
86179,27,1554998400,3,17,20,Clouds
86180,28,1554998400,26,4,30,Clouds
86181,29,1554998400,27,2,29,Clouds
86182,30,1554998400,20,0,20,Clouds
86183,31,1554998400,18,2,20,Clouds
86184,32,1554998400,17,13,30,Clouds
86185,33,1554998400,5,18,23,Clouds
86186,34,1554998400,28,2,30,Clouds
86187,35,1554998400,29,1,30,Clouds
86188,36,1554998400,2,38,40,Clouds
86189,37,1554998400,7,23,30,Clouds
86190,38,1554998400,17,23,40,Clouds
86191,39,1554998400,20,0,20,Clouds
86192,40,1554998400,0,21,21,Clouds
86193,41,1554998400,16,4,20,Clouds
86194,42,1554998400,29,1,30,Clouds
86195,43,1554998400,21,9,30,Clouds
86196,44,1554998400,26,4,30,Clouds
86197,45,1554998400,24,6,30,Clouds
86198,46,1554998400,9,11,20,Clouds
86199,47,1554998400,15,25,40,Clouds
86200,48,1554998400,9,29,38,Clouds
86201,49,1554998400,18,22,40,Clouds
86202,50,1554998400,38,2,40,Clouds
86203,51,1554998400,21,19,40,Clouds
86204,52,1554998400,7,25,32,Clouds
86205,53,1554998400,11,29,40,Clouds
86206,54,1554998400,33,0,33,Clouds
86207,55,1554998400,31,5,36,Clouds
86208,56,1554998400,8,32,40,Clouds
86209,57,1554998400,1,22,23,Clouds
86210,58,1554998400,8,32,40,Clouds
86211,59,1554998400,20,0,20,Clouds
86212,60,1554998400,26,4,30,Clouds
86213,61,1554998400,20,5,25,Clouds
86214,62,1554998400,12,28,40,Clouds
86215,63,1554998400,10,25,35,Clouds
86216,64,1554998400,20,20,40,Clouds
86217,65,1554998400,28,11,39,Clouds
86218,66,1554998400,17,20,37,Clouds
86219,67,1554998400,5,33,38,Clouds
86220,68,1554998400,5,35,40,Clouds
86221,69,1554998400,19,21,40,Clouds
86222,70,1554998400,6,22,28,Clouds
86223,71,1554998400,40,0,40,Clouds
86224,72,1554998400,9,22,31,Clouds
86225,73,1554998400,28,2,30,Clouds
86226,74,1554998400,25,5,30,Clouds
86227,75,1554998400,36,4,40,Clouds
86228,76,1554998400,10,28,38,Clouds
86229,77,1554998400,13,16,29,Clouds
86230,78,1554998400,34,6,40,Clouds
86231,79,1554998400,24,3,27,Clouds
86232,80,1554998400,24,16,40,Clouds
86233,81,1554998400,38,2,40,Clouds
86234,82,1554998400,22,0,22,Clouds
86235,83,1554998400,38,2,40,Clouds
86236,84,1554998400,23,7,30,Clouds
86237,85,1554998400,31,4,35,Clouds
86238,86,1554998400,32,6,38,Clouds
86239,87,1554998400,36,2,38,Clouds
86240,88,1554998400,28,2,30,Clouds
86241,89,1554998400,19,21,40,Clouds
86242,90,1554998400,23,17,40,Clouds
86243,91,1554998400,18,12,30,Clouds
86244,92,1554998400,38,2,40,Clouds
86245,93,1554998400,40,0,40,Clouds
86246,94,1554998400,39,1,40,Clouds
86247,95,1554998400,37,3,40,Clouds
86248,96,1554998400,24,6,30,Clouds
86249,97,1554998400,31,9,40,Clouds
86250,98,1554998400,15,25,40,Clouds
86251,99,1554998400,20,10,30,Clouds
86252,100,1554998400,8,17,25,Clouds
86253,101,1554998400,29,1,30,Clouds
86254,102,1554998400,39,1,40,Clouds
86255,103,1554998400,40,0,40,Clouds
86256,104,1554998400,38,2,40,Clouds
86257,105,1554998400,35,1,36,Clouds
86258,106,1554998400,40,0,40,Clouds
86259,107,1554998400,39,1,40,Clouds
86260,108,1554998400,37,3,40,Clouds
86261,109,1554998400,25,4,29,Clouds
86262,110,1554998400,37,3,40,Clouds
86263,111,1554998400,34,6,40,Clouds
86264,112,1554998400,27,3,30,Clouds
86265,113,1554998400,8,32,40,Clouds
86266,114,1554998400,14,26,40,Clouds
86267,115,1554998400,24,6,30,Clouds
86268,2,1555002000,20,0,20,Clouds
86269,3,1555002000,20,0,20,Clouds
86270,4,1555002000,18,2,20,Clouds
86271,5,1555002000,25,15,40,Clouds
86272,6,1555002000,12,8,20,Clouds
86273,7,1555002000,28,1,29,Clouds
86274,8,1555002000,17,13,30,Clouds
86275,9,1555002000,13,11,24,Clouds
86276,10,1555002000,4,12,16,Clouds
86277,11,1555002000,30,0,30,Clouds
86278,12,1555002000,19,1,20,Clouds
86279,13,1555002000,26,4,30,Clouds
86280,14,1555002000,16,14,30,Clouds
86281,15,1555002000,15,1,16,Clouds
86282,16,1555002000,16,4,20,Clouds
86283,17,1555002000,19,1,20,Clouds
86284,18,1555002000,29,1,30,Clouds
86285,19,1555002000,19,10,29,Clouds
86286,21,1555002000,20,10,30,Clouds
86287,22,1555002000,20,0,20,Clouds
86288,23,1555002000,10,20,30,Clouds
86289,24,1555002000,19,1,20,Clouds
86290,25,1555002000,11,19,30,Clouds
86291,26,1555002000,9,11,20,Clouds
86292,27,1555002000,10,10,20,Clouds
86293,28,1555002000,25,5,30,Clouds
86294,29,1555002000,26,3,29,Clouds
86295,30,1555002000,20,0,20,Clouds
86296,31,1555002000,20,0,20,Clouds
86297,32,1555002000,15,15,30,Clouds
86298,33,1555002000,7,16,23,Clouds
86299,34,1555002000,21,9,30,Clouds
86300,35,1555002000,28,2,30,Clouds
86301,36,1555002000,19,21,40,Clouds
86302,37,1555002000,18,12,30,Clouds
86303,38,1555002000,15,25,40,Clouds
86304,39,1555002000,13,7,20,Clouds
86305,40,1555002000,0,21,21,Clouds
86306,41,1555002000,20,0,20,Clouds
86307,42,1555002000,23,7,30,Clouds
86308,43,1555002000,15,15,30,Clouds
86309,44,1555002000,20,10,30,Clouds
86310,45,1555002000,20,10,30,Clouds
86311,46,1555002000,8,12,20,Clouds
86312,47,1555002000,31,9,40,Clouds
86313,48,1555002000,6,34,40,Clouds
86314,49,1555002000,16,24,40,Clouds
86315,50,1555002000,36,4,40,Clouds
86316,51,1555002000,23,17,40,Clouds
86317,52,1555002000,9,23,32,Clouds
86318,53,1555002000,21,19,40,Clouds
86319,54,1555002000,33,0,33,Clouds
86320,55,1555002000,36,0,36,Clouds
86321,56,1555002000,34,6,40,Clouds
86322,57,1555002000,4,19,23,Clouds
86323,58,1555002000,35,5,40,Clouds
86324,59,1555002000,20,0,20,Clouds
86325,60,1555002000,23,7,30,Clouds
86326,61,1555002000,25,0,25,Clouds
86327,62,1555002000,29,11,40,Clouds
86328,63,1555002000,11,24,35,Clouds
86329,64,1555002000,23,17,40,Clouds
86330,65,1555002000,39,1,40,Clouds
86331,66,1555002000,38,2,40,Clouds
86332,67,1555002000,11,29,40,Clouds
86333,68,1555002000,13,27,40,Clouds
86334,69,1555002000,18,22,40,Clouds
86335,70,1555002000,8,20,28,Clouds
86336,71,1555002000,40,0,40,Clouds
86337,72,1555002000,11,20,31,Clouds
86338,73,1555002000,26,4,30,Clouds
86339,74,1555002000,6,24,30,Clouds
86340,75,1555002000,35,5,40,Clouds
86341,76,1555002000,12,26,38,Clouds
86342,77,1555002000,14,15,29,Clouds
86343,78,1555002000,31,9,40,Clouds
86344,79,1555002000,26,1,27,Clouds
86345,80,1555002000,30,10,40,Clouds
86346,81,1555002000,23,17,40,Clouds
86347,82,1555002000,20,2,22,Clouds
86348,83,1555002000,31,9,40,Clouds
86349,84,1555002000,23,7,30,Clouds
86350,85,1555002000,30,5,35,Clouds
86351,86,1555002000,22,16,38,Clouds
86352,87,1555002000,38,0,38,Clouds
86353,88,1555002000,27,3,30,Clouds
86354,89,1555002000,33,7,40,Clouds
86355,90,1555002000,34,6,40,Clouds
86356,91,1555002000,23,7,30,Clouds
86357,92,1555002000,33,7,40,Clouds
86358,93,1555002000,29,11,40,Clouds
86359,94,1555002000,40,0,40,Clouds
86360,95,1555002000,38,2,40,Clouds
86361,96,1555002000,23,7,30,Clouds
86362,97,1555002000,31,9,40,Clouds
86363,98,1555002000,15,25,40,Clouds
86364,99,1555002000,17,13,30,Clouds
86365,100,1555002000,0,25,25,Clouds
86366,101,1555002000,30,0,30,Clouds
86367,102,1555002000,39,1,40,Clouds
86368,103,1555002000,40,0,40,Clouds
86369,104,1555002000,40,0,40,Clouds
86370,105,1555002000,36,0,36,Clouds
86371,106,1555002000,38,2,40,Clouds
86372,107,1555002000,37,3,40,Clouds
86373,108,1555002000,38,2,40,Clouds
86374,109,1555002000,20,9,29,Clouds
86375,110,1555002000,40,0,40,Clouds
86376,111,1555002000,37,3,40,Clouds
86377,112,1555002000,28,2,30,Clouds
86378,113,1555002000,5,35,40,Clouds
86379,114,1555002000,40,0,40,Clouds
86380,115,1555002000,19,11,30,Clouds
86381,2,1555005600,20,0,20,Clouds
86382,3,1555005600,18,2,20,Clouds
86383,4,1555005600,20,0,20,Clouds
86384,5,1555005600,21,19,40,Clouds
86385,6,1555005600,12,8,20,Clouds
86386,7,1555005600,27,2,29,Clouds
86387,8,1555005600,21,9,30,Clouds
86388,9,1555005600,13,11,24,Clouds
86389,10,1555005600,1,15,16,Clouds
86390,11,1555005600,30,0,30,Clouds
86391,12,1555005600,14,6,20,Clouds
86392,13,1555005600,29,1,30,Clouds
86393,14,1555005600,7,23,30,Clouds
86394,15,1555005600,16,0,16,Clouds
86395,16,1555005600,12,8,20,Clouds
86396,17,1555005600,20,0,20,Clouds
86397,18,1555005600,25,5,30,Clouds
86398,19,1555005600,28,1,29,Clouds
86399,21,1555005600,19,11,30,Clouds
86400,22,1555005600,8,12,20,Clouds
86401,23,1555005600,7,23,30,Clouds
86402,24,1555005600,9,11,20,Clouds
86403,25,1555005600,30,0,30,Clouds
86404,26,1555005600,9,11,20,Clouds
86405,27,1555005600,11,9,20,Clouds
86406,28,1555005600,26,4,30,Clouds
86407,29,1555005600,28,1,29,Clouds
86408,30,1555005600,20,0,20,Clouds
86409,31,1555005600,20,0,20,Clouds
86410,32,1555005600,2,28,30,Clouds
86411,33,1555005600,0,23,23,Clouds
86412,34,1555005600,0,30,30,Clouds
86413,35,1555005600,25,5,30,Clouds
86414,36,1555005600,36,4,40,Clouds
86415,37,1555005600,30,0,30,Clouds
86416,38,1555005600,13,27,40,Clouds
86417,39,1555005600,20,0,20,Clouds
86418,40,1555005600,0,21,21,Clouds
86419,41,1555005600,20,0,20,Clouds
86420,42,1555005600,12,18,30,Clouds
86421,43,1555005600,20,10,30,Clouds
86422,44,1555005600,15,15,30,Clouds
86423,45,1555005600,15,15,30,Clouds
86424,46,1555005600,12,8,20,Clouds
86425,47,1555005600,40,0,40,Clouds
86426,48,1555005600,25,15,40,Clouds
86427,49,1555005600,37,3,40,Clouds
86428,50,1555005600,31,9,40,Clouds
86429,51,1555005600,23,17,40,Clouds
86430,52,1555005600,23,9,32,Clouds
86431,53,1555005600,40,0,40,Clouds
86432,54,1555005600,33,0,33,Clouds
86433,55,1555005600,36,0,36,Clouds
86434,56,1555005600,30,10,40,Clouds
86435,57,1555005600,23,0,23,Clouds
86436,58,1555005600,40,0,40,Clouds
86437,59,1555005600,20,0,20,Clouds
86438,60,1555005600,1,29,30,Clouds
86439,61,1555005600,25,0,25,Clouds
86440,62,1555005600,40,0,40,Clouds
86441,63,1555005600,17,18,35,Clouds
86442,64,1555005600,24,16,40,Clouds
86443,65,1555005600,40,0,40,Clouds
86444,66,1555005600,39,1,40,Clouds
86445,67,1555005600,17,23,40,Clouds
86446,68,1555005600,38,2,40,Clouds
86447,69,1555005600,40,0,40,Clouds
86448,70,1555005600,22,6,28,Clouds
86449,71,1555005600,37,3,40,Clouds
86450,72,1555005600,21,10,31,Clouds
86451,73,1555005600,30,0,30,Clouds
86452,74,1555005600,3,27,30,Clouds
86453,75,1555005600,24,16,40,Clouds
86454,76,1555005600,8,30,38,Clouds
86455,77,1555005600,18,11,29,Clouds
86456,78,1555005600,26,14,40,Clouds
86457,79,1555005600,25,2,27,Clouds
86458,80,1555005600,29,11,40,Clouds
86459,81,1555005600,26,14,40,Clouds
86460,82,1555005600,13,9,22,Clouds
86461,83,1555005600,14,26,40,Clouds
86462,84,1555005600,20,10,30,Clouds
86463,85,1555005600,26,9,35,Clouds
86464,86,1555005600,11,27,38,Clouds
86465,87,1555005600,33,5,38,Clouds
86466,88,1555005600,25,5,30,Clouds
86467,89,1555005600,40,0,40,Clouds
86468,90,1555005600,40,0,40,Clouds
86469,91,1555005600,23,7,30,Clouds
86470,92,1555005600,10,30,40,Clouds
86471,93,1555005600,0,40,40,Clouds
86472,94,1555005600,7,33,40,Clouds
86473,95,1555005600,35,5,40,Clouds
86474,96,1555005600,18,12,30,Clouds
86475,97,1555005600,25,15,40,Clouds
86476,98,1555005600,18,22,40,Clouds
86477,99,1555005600,29,1,30,Clouds
86478,100,1555005600,0,25,25,Clouds
86479,101,1555005600,24,6,30,Clouds
86480,102,1555005600,39,1,40,Clouds
86481,103,1555005600,32,8,40,Clouds
86482,104,1555005600,31,9,40,Clouds
86483,105,1555005600,36,0,36,Clouds
86484,106,1555005600,35,5,40,Clouds
86485,107,1555005600,34,6,40,Clouds
86486,108,1555005600,34,6,40,Clouds
86487,109,1555005600,16,13,29,Clouds
86488,110,1555005600,39,1,40,Clouds
86489,111,1555005600,31,9,40,Clouds
86490,112,1555005600,24,6,30,Clouds
86491,113,1555005600,40,0,40,Clouds
86492,114,1555005600,39,1,40,Clouds
86493,115,1555005600,18,12,30,Clouds
86494,2,1555009200,18,2,20,Clouds
86495,3,1555009200,19,1,20,Clouds
86496,4,1555009200,19,1,20,Clouds
86497,5,1555009200,37,3,40,Clouds
86498,6,1555009200,12,8,20,Clouds
86499,7,1555009200,26,3,29,Clouds
86500,8,1555009200,25,5,30,Clouds
86501,9,1555009200,7,17,24,Clouds
86502,10,1555009200,0,16,16,Clouds
86503,11,1555009200,30,0,30,Clouds
86504,12,1555009200,11,9,20,Clouds
86505,13,1555009200,28,2,30,Clouds
86506,14,1555009200,2,28,30,Clouds
86507,15,1555009200,16,0,16,Clouds
86508,16,1555009200,20,0,20,Clouds
86509,17,1555009200,19,1,20,Clouds
86510,18,1555009200,18,12,30,Clouds
86511,19,1555009200,30,0,30,Clouds
86512,21,1555009200,13,17,30,Clouds
86513,22,1555009200,0,20,20,Clouds
86514,23,1555009200,12,18,30,Clouds
86515,24,1555009200,8,12,20,Clouds
86516,25,1555009200,30,0,30,Clouds
86517,26,1555009200,20,0,20,Clouds
86518,27,1555009200,19,1,20,Clouds
86519,28,1555009200,28,2,30,Clouds
86520,29,1555009200,24,5,29,Clouds
86521,30,1555009200,20,0,20,Clouds
86522,31,1555009200,18,2,20,Clouds
86523,32,1555009200,2,28,30,Clouds
86524,33,1555009200,0,23,23,Clouds
86525,34,1555009200,10,20,30,Clouds
86526,35,1555009200,26,4,30,Clouds
86527,36,1555009200,38,2,40,Clouds
86528,37,1555009200,29,1,30,Clouds
86529,38,1555009200,27,13,40,Clouds
86530,39,1555009200,18,2,20,Clouds
86531,40,1555009200,0,21,21,Clouds
86532,41,1555009200,20,0,20,Clouds
86533,42,1555009200,2,28,30,Clouds
86534,43,1555009200,15,15,30,Clouds
86535,44,1555009200,4,26,30,Clouds
86536,45,1555009200,7,23,30,Clouds
86537,46,1555009200,9,11,20,Clouds
86538,47,1555009200,40,0,40,Clouds
86539,48,1555009200,36,4,40,Clouds
86540,49,1555009200,40,0,40,Clouds
86541,50,1555009200,25,15,40,Clouds
86542,51,1555009200,29,11,40,Clouds
86543,52,1555009200,32,0,32,Clouds
86544,53,1555009200,40,0,40,Clouds
86545,54,1555009200,32,1,33,Clouds
86546,55,1555009200,35,1,36,Clouds
86547,56,1555009200,33,7,40,Clouds
86548,57,1555009200,23,0,23,Clouds
86549,58,1555009200,35,5,40,Clouds
86550,59,1555009200,20,0,20,Clouds
86551,60,1555009200,0,30,30,Clouds
86552,61,1555009200,23,2,25,Clouds
86553,62,1555009200,40,0,40,Clouds
86554,63,1555009200,30,5,35,Clouds
86555,64,1555009200,27,13,40,Clouds
86556,65,1555009200,40,0,40,Clouds
86557,66,1555009200,34,6,40,Clouds
86558,67,1555009200,24,16,40,Clouds
86559,68,1555009200,38,2,40,Clouds
86560,69,1555009200,39,1,40,Clouds
86561,70,1555009200,25,3,28,Clouds
86562,71,1555009200,32,8,40,Clouds
86563,72,1555009200,27,4,31,Clouds
86564,73,1555009200,26,4,30,Clouds
86565,74,1555009200,0,30,30,Clouds
86566,75,1555009200,19,21,40,Clouds
86567,76,1555009200,8,30,38,Clouds
86568,77,1555009200,18,11,29,Clouds
86569,78,1555009200,21,19,40,Clouds
86570,79,1555009200,24,3,27,Clouds
86571,80,1555009200,10,30,40,Clouds
86572,81,1555009200,28,12,40,Clouds
86573,82,1555009200,9,13,22,Clouds
86574,83,1555009200,2,38,40,Clouds
86575,84,1555009200,14,16,30,Clouds
86576,85,1555009200,21,14,35,Clouds
86577,86,1555009200,1,37,38,Clouds
86578,87,1555009200,27,11,38,Clouds
86579,88,1555009200,24,6,30,Clouds
86580,89,1555009200,40,0,40,Clouds
86581,90,1555009200,40,0,40,Clouds
86582,91,1555009200,25,5,30,Clouds
86583,92,1555009200,2,38,40,Clouds
86584,93,1555009200,0,40,40,Clouds
86585,94,1555009200,0,40,40,Clouds
86586,95,1555009200,19,21,40,Clouds
86587,96,1555009200,12,18,30,Clouds
86588,97,1555009200,14,26,40,Clouds
86589,98,1555009200,26,14,40,Clouds
86590,99,1555009200,29,1,30,Clouds
86591,100,1555009200,14,11,25,Clouds
86592,101,1555009200,26,4,30,Clouds
86593,102,1555009200,35,5,40,Clouds
86594,103,1555009200,33,7,40,Clouds
86595,104,1555009200,31,9,40,Clouds
86596,105,1555009200,34,2,36,Clouds
86597,106,1555009200,31,9,40,Clouds
86598,107,1555009200,31,9,40,Clouds
86599,108,1555009200,35,5,40,Clouds
86600,109,1555009200,24,5,29,Clouds
86601,110,1555009200,39,1,40,Clouds
86602,111,1555009200,33,7,40,Clouds
86603,112,1555009200,16,14,30,Clouds
86604,113,1555009200,40,0,40,Clouds
86605,114,1555009200,40,0,40,Clouds
86606,115,1555009200,7,23,30,Clouds
86607,2,1555012800,16,4,20,Clouds
86608,3,1555012800,20,0,20,Clouds
86609,4,1555012800,20,0,20,Clouds
86610,5,1555012800,40,0,40,Clouds
86611,6,1555012800,6,14,20,Clouds
86612,7,1555012800,23,6,29,Clouds
86613,8,1555012800,29,1,30,Clouds
86614,9,1555012800,10,14,24,Clouds
86615,10,1555012800,1,15,16,Clouds
86616,11,1555012800,30,0,30,Clouds
86617,12,1555012800,7,13,20,Clouds
86618,13,1555012800,28,2,30,Clouds
86619,14,1555012800,0,30,30,Clouds
86620,15,1555012800,14,2,16,Clouds
86621,16,1555012800,20,0,20,Clouds
86622,17,1555012800,20,0,20,Clouds
86623,18,1555012800,27,3,30,Clouds
86624,19,1555012800,14,16,30,Clouds
86625,21,1555012800,9,21,30,Clouds
86626,22,1555012800,7,13,20,Clouds
86627,23,1555012800,13,17,30,Clouds
86628,24,1555012800,8,12,20,Clouds
86629,25,1555012800,30,0,30,Clouds
86630,26,1555012800,20,0,20,Clouds
86631,27,1555012800,19,1,20,Clouds
86632,28,1555012800,25,5,30,Clouds
86633,29,1555012800,21,8,29,Clouds
86634,30,1555012800,19,1,20,Clouds
86635,31,1555012800,20,0,20,Clouds
86636,32,1555012800,11,19,30,Clouds
86637,33,1555012800,1,22,23,Clouds
86638,34,1555012800,9,21,30,Clouds
86639,35,1555012800,21,9,30,Clouds
86640,36,1555012800,31,9,40,Clouds
86641,37,1555012800,24,6,30,Clouds
86642,38,1555012800,31,9,40,Clouds
86643,39,1555012800,17,3,20,Clouds
86644,40,1555012800,0,21,21,Clouds
86645,41,1555012800,20,0,20,Clouds
86646,42,1555012800,1,29,30,Clouds
86647,43,1555012800,12,18,30,Clouds
86648,44,1555012800,0,30,30,Clouds
86649,45,1555012800,5,25,30,Clouds
86650,46,1555012800,8,12,20,Clouds
86651,47,1555012800,40,0,40,Clouds
86652,48,1555012800,40,0,40,Clouds
86653,49,1555012800,38,2,40,Clouds
86654,50,1555012800,23,17,40,Clouds
86655,51,1555012800,35,5,40,Clouds
86656,52,1555012800,29,3,32,Clouds
86657,53,1555012800,40,0,40,Clouds
86658,54,1555012800,32,1,33,Clouds
86659,55,1555012800,35,1,36,Clouds
86660,56,1555012800,34,6,40,Clouds
86661,57,1555012800,21,2,23,Clouds
86662,58,1555012800,40,0,40,Clouds
86663,59,1555012800,20,0,20,Clouds
86664,60,1555012800,0,30,30,Clouds
86665,61,1555012800,20,5,25,Clouds
86666,62,1555012800,39,1,40,Clouds
86667,63,1555012800,35,0,35,Clouds
86668,64,1555012800,35,5,40,Clouds
86669,65,1555012800,40,0,40,Clouds
86670,66,1555012800,38,2,40,Clouds
86671,67,1555012800,24,16,40,Clouds
86672,68,1555012800,40,0,40,Clouds
86673,69,1555012800,38,2,40,Clouds
86674,70,1555012800,26,2,28,Clouds
86675,71,1555012800,31,9,40,Clouds
86676,72,1555012800,23,8,31,Clouds
86677,73,1555012800,27,3,30,Clouds
86678,74,1555012800,5,25,30,Clouds
86679,75,1555012800,21,19,40,Clouds
86680,76,1555012800,7,31,38,Clouds
86681,77,1555012800,27,2,29,Clouds
86682,78,1555012800,21,19,40,Clouds
86683,79,1555012800,22,5,27,Clouds
86684,80,1555012800,13,27,40,Clouds
86685,81,1555012800,28,12,40,Clouds
86686,82,1555012800,9,13,22,Clouds
86687,83,1555012800,0,40,40,Clouds
86688,84,1555012800,12,18,30,Clouds
86689,85,1555012800,13,22,35,Clouds
86690,86,1555012800,24,14,38,Clouds
86691,87,1555012800,19,19,38,Clouds
86692,88,1555012800,17,13,30,Clouds
86693,89,1555012800,40,0,40,Clouds
86694,90,1555012800,40,0,40,Clouds
86695,91,1555012800,25,5,30,Clouds
86696,92,1555012800,20,20,40,Clouds
86697,93,1555012800,0,40,40,Clouds
86698,94,1555012800,0,40,40,Clouds
86699,95,1555012800,20,20,40,Clouds
86700,96,1555012800,6,24,30,Clouds
86701,97,1555012800,1,39,40,Clouds
86702,98,1555012800,33,7,40,Clouds
86703,99,1555012800,29,1,30,Clouds
86704,100,1555012800,8,17,25,Clouds
86705,101,1555012800,20,10,30,Clouds
86706,102,1555012800,27,13,40,Clouds
86707,103,1555012800,28,12,40,Clouds
86708,104,1555012800,31,9,40,Clouds
86709,105,1555012800,33,3,36,Clouds
86710,106,1555012800,12,28,40,Clouds
86711,107,1555012800,32,8,40,Clouds
86712,108,1555012800,37,3,40,Clouds
86713,109,1555012800,22,7,29,Clouds
86714,110,1555012800,38,2,40,Clouds
86715,111,1555012800,31,9,40,Clouds
86716,112,1555012800,7,23,30,Clouds
86717,113,1555012800,40,0,40,Clouds
86718,114,1555012800,39,1,40,Clouds
86719,115,1555012800,3,27,30,Clouds
86720,2,1555020000,9,11,20,Clouds
86721,3,1555020000,18,2,20,Clouds
86722,4,1555020000,18,2,20,Clouds
86723,5,1555020000,34,6,40,Clouds
86724,6,1555020000,5,15,20,Clouds
86725,7,1555020000,22,7,29,Clouds
86726,8,1555020000,28,2,30,Clouds
86727,9,1555020000,7,15,22,Clouds
86728,10,1555020000,1,15,16,Clouds
86729,11,1555020000,30,0,30,Clouds
86730,12,1555020000,7,13,20,Clouds
86731,13,1555020000,29,0,29,Clouds
86732,14,1555020000,3,27,30,Clouds
86733,15,1555020000,14,2,16,Clouds
86734,16,1555020000,20,0,20,Clouds
86735,17,1555020000,19,1,20,Clouds
86736,18,1555020000,25,5,30,Clouds
86737,19,1555020000,19,11,30,Clouds
86738,21,1555020000,23,7,30,Clouds
86739,22,1555020000,20,0,20,Clouds
86740,23,1555020000,13,17,30,Clouds
86741,24,1555020000,17,3,20,Clouds
86742,25,1555020000,27,3,30,Clouds
86743,26,1555020000,18,2,20,Clouds
86744,27,1555020000,20,0,20,Clouds
86745,28,1555020000,16,14,30,Clouds
86746,29,1555020000,24,5,29,Clouds
86747,30,1555020000,20,0,20,Clouds
86748,31,1555020000,20,0,20,Clouds
86749,32,1555020000,25,5,30,Clouds
86750,33,1555020000,20,3,23,Clouds
86751,34,1555020000,2,28,30,Clouds
86752,35,1555020000,24,6,30,Clouds
86753,36,1555020000,35,5,40,Clouds
86754,37,1555020000,29,1,30,Clouds
86755,38,1555020000,37,3,40,Clouds
86756,39,1555020000,18,2,20,Clouds
86757,40,1555020000,0,21,21,Clouds
86758,41,1555020000,15,5,20,Clouds
86759,42,1555020000,3,27,30,Clouds
86760,43,1555020000,8,21,29,Clouds
86761,44,1555020000,0,30,30,Clouds
86762,45,1555020000,5,25,30,Clouds
86763,46,1555020000,13,7,20,Clouds
86764,47,1555020000,40,0,40,Clouds
86765,48,1555020000,39,1,40,Clouds
86766,49,1555020000,38,2,40,Clouds
86767,50,1555020000,4,36,40,Clouds
86768,51,1555020000,40,0,40,Clouds
86769,52,1555020000,32,0,32,Clouds
86770,53,1555020000,40,0,40,Clouds
86771,54,1555020000,33,0,33,Clouds
86772,55,1555020000,36,0,36,Clouds
86773,56,1555020000,37,3,40,Clouds
86774,57,1555020000,23,0,23,Clouds
86775,58,1555020000,40,0,40,Clouds
86776,59,1555020000,19,1,20,Clouds
86777,60,1555020000,8,22,30,Clouds
86778,61,1555020000,19,6,25,Clouds
86779,62,1555020000,40,0,40,Clouds
86780,63,1555020000,34,1,35,Clouds
86781,64,1555020000,38,2,40,Clouds
86782,65,1555020000,40,0,40,Clouds
86783,66,1555020000,37,3,40,Clouds
86784,67,1555020000,15,25,40,Clouds
86785,68,1555020000,37,3,40,Clouds
86786,69,1555020000,34,6,40,Clouds
86787,70,1555020000,26,2,28,Clouds
86788,71,1555020000,37,3,40,Clouds
86789,72,1555020000,21,10,31,Clouds
86790,73,1555020000,27,3,30,Clouds
86791,74,1555020000,1,29,30,Clouds
86792,75,1555020000,23,17,40,Clouds
86793,76,1555020000,3,35,38,Clouds
86794,77,1555020000,29,0,29,Clouds
86795,78,1555020000,12,28,40,Clouds
86796,79,1555020000,25,2,27,Clouds
86797,80,1555020000,11,29,40,Clouds
86798,81,1555020000,31,9,40,Clouds
86799,82,1555020000,6,16,22,Clouds
86800,83,1555020000,8,32,40,Clouds
86801,84,1555020000,3,27,30,Clouds
86802,85,1555020000,7,28,35,Clouds
86803,86,1555020000,21,17,38,Clouds
86804,87,1555020000,14,24,38,Clouds
86805,88,1555020000,12,18,30,Clouds
86806,89,1555020000,35,5,40,Clouds
86807,90,1555020000,39,1,40,Clouds
86808,91,1555020000,27,3,30,Clouds
86809,92,1555020000,16,24,40,Clouds
86810,93,1555020000,0,40,40,Clouds
86811,94,1555020000,1,39,40,Clouds
86812,95,1555020000,13,27,40,Clouds
86813,96,1555020000,0,30,30,Clouds
86814,97,1555020000,1,39,40,Clouds
86815,98,1555020000,40,0,40,Clouds
86816,99,1555020000,30,0,30,Clouds
86817,100,1555020000,2,23,25,Clouds
86818,101,1555020000,14,16,30,Clouds
86819,102,1555020000,24,16,40,Clouds
86820,103,1555020000,21,19,40,Clouds
86821,104,1555020000,30,10,40,Clouds
86822,105,1555020000,32,4,36,Clouds
86823,106,1555020000,11,29,40,Clouds
86824,107,1555020000,30,10,40,Clouds
86825,108,1555020000,30,10,40,Clouds
86826,109,1555020000,14,15,29,Clouds
86827,110,1555020000,21,19,40,Clouds
86828,111,1555020000,16,24,40,Clouds
86829,112,1555020000,0,30,30,Clouds
86830,113,1555020000,40,0,40,Clouds
86831,114,1555020000,39,1,40,Clouds
86832,115,1555020000,6,24,30,Clouds
86833,2,1555023600,11,9,20,Clouds
86834,3,1555023600,13,7,20,Clouds
86835,4,1555023600,15,5,20,Clouds
86836,5,1555023600,33,7,40,Clouds
86837,6,1555023600,11,9,20,Clouds
86838,7,1555023600,22,7,29,Clouds
86839,8,1555023600,30,0,30,Clouds
86840,9,1555023600,21,2,23,Clouds
86841,10,1555023600,3,13,16,Clouds
86842,11,1555023600,30,0,30,Clouds
86843,12,1555023600,6,14,20,Clouds
86844,13,1555023600,30,0,30,Clouds
86845,14,1555023600,9,21,30,Clouds
86846,15,1555023600,14,2,16,Clouds
86847,16,1555023600,19,1,20,Clouds
86848,17,1555023600,20,0,20,Clouds
86849,18,1555023600,30,0,30,Clouds
86850,19,1555023600,26,4,30,Clouds
86851,21,1555023600,28,2,30,Clouds
86852,22,1555023600,17,3,20,Clouds
86853,23,1555023600,21,9,30,Clouds
86854,24,1555023600,17,3,20,Clouds
86855,25,1555023600,30,0,30,Clouds
86856,26,1555023600,17,3,20,Clouds
86857,27,1555023600,20,0,20,Clouds
86858,28,1555023600,15,15,30,Clouds
86859,29,1555023600,29,0,29,Clouds
86860,30,1555023600,20,0,20,Clouds
86861,31,1555023600,18,2,20,Clouds
86862,32,1555023600,29,1,30,Clouds
86863,33,1555023600,21,2,23,Clouds
86864,34,1555023600,14,16,30,Clouds
86865,35,1555023600,16,14,30,Clouds
86866,36,1555023600,36,4,40,Clouds
86867,37,1555023600,25,5,30,Clouds
86868,38,1555023600,36,4,40,Clouds
86869,39,1555023600,15,4,19,Clouds
86870,40,1555023600,0,21,21,Clouds
86871,41,1555023600,16,4,20,Clouds
86872,42,1555023600,4,26,30,Clouds
86873,43,1555023600,1,28,29,Clouds
86874,44,1555023600,0,30,30,Clouds
86875,45,1555023600,2,28,30,Clouds
86876,46,1555023600,14,6,20,Clouds
86877,47,1555023600,40,0,40,Clouds
86878,48,1555023600,40,0,40,Clouds
86879,49,1555023600,40,0,40,Clouds
86880,50,1555023600,5,35,40,Clouds
86881,51,1555023600,40,0,40,Clouds
86882,52,1555023600,32,0,32,Clouds
86883,53,1555023600,40,0,40,Clouds
86884,54,1555023600,33,0,33,Clouds
86885,55,1555023600,36,0,36,Clouds
86886,56,1555023600,40,0,40,Clouds
86887,57,1555023600,20,3,23,Clouds
86888,58,1555023600,36,4,40,Clouds
86889,59,1555023600,18,2,20,Clouds
86890,60,1555023600,8,22,30,Clouds
86891,61,1555023600,20,5,25,Clouds
86892,62,1555023600,40,0,40,Clouds
86893,63,1555023600,35,0,35,Clouds
86894,64,1555023600,37,3,40,Clouds
86895,65,1555023600,38,2,40,Clouds
86896,66,1555023600,33,7,40,Clouds
86897,67,1555023600,14,26,40,Clouds
86898,68,1555023600,39,1,40,Clouds
86899,69,1555023600,36,4,40,Clouds
86900,70,1555023600,25,3,28,Clouds
86901,71,1555023600,33,7,40,Clouds
86902,72,1555023600,15,16,31,Clouds
86903,73,1555023600,6,24,30,Clouds
86904,74,1555023600,4,26,30,Clouds
86905,75,1555023600,21,19,40,Clouds
86906,76,1555023600,4,34,38,Clouds
86907,77,1555023600,26,3,29,Clouds
86908,78,1555023600,10,30,40,Clouds
86909,79,1555023600,25,2,27,Clouds
86910,80,1555023600,11,29,40,Clouds
86911,81,1555023600,33,7,40,Clouds
86912,82,1555023600,4,18,22,Clouds
86913,83,1555023600,8,32,40,Clouds
86914,84,1555023600,9,21,30,Clouds
86915,85,1555023600,3,32,35,Clouds
86916,86,1555023600,21,17,38,Clouds
86917,87,1555023600,13,25,38,Clouds
86918,88,1555023600,15,15,30,Clouds
86919,89,1555023600,36,4,40,Clouds
86920,90,1555023600,37,3,40,Clouds
86921,91,1555023600,28,2,30,Clouds
86922,92,1555023600,15,25,40,Clouds
86923,93,1555023600,0,40,40,Clouds
86924,94,1555023600,1,39,40,Clouds
86925,95,1555023600,11,29,40,Clouds
86926,96,1555023600,0,30,30,Clouds
86927,97,1555023600,7,33,40,Clouds
86928,98,1555023600,40,0,40,Clouds
86929,99,1555023600,30,0,30,Clouds
86930,100,1555023600,2,23,25,Clouds
86931,101,1555023600,14,16,30,Clouds
86932,102,1555023600,20,20,40,Clouds
86933,103,1555023600,21,19,40,Clouds
86934,104,1555023600,30,10,40,Clouds
86935,105,1555023600,32,4,36,Clouds
86936,106,1555023600,7,33,40,Clouds
86937,107,1555023600,28,12,40,Clouds
86938,108,1555023600,28,12,40,Clouds
86939,109,1555023600,12,17,29,Clouds
86940,110,1555023600,11,29,40,Clouds
86941,111,1555023600,10,30,40,Clouds
86942,112,1555023600,1,29,30,Clouds
86943,113,1555023600,40,0,40,Clouds
86944,114,1555023600,40,0,40,Clouds
86945,115,1555023600,8,22,30,Clouds
86946,2,1555027200,6,14,20,Clouds
86947,3,1555027200,15,5,20,Clouds
86948,4,1555027200,13,7,20,Clouds
86949,5,1555027200,32,8,40,Clouds
86950,6,1555027200,15,5,20,Clouds
86951,7,1555027200,23,6,29,Clouds
86952,8,1555027200,30,0,30,Clouds
86953,9,1555027200,24,0,24,Clouds
86954,10,1555027200,10,6,16,Clouds
86955,11,1555027200,30,0,30,Clouds
86956,12,1555027200,5,15,20,Clouds
86957,13,1555027200,30,0,30,Clouds
86958,14,1555027200,21,9,30,Clouds
86959,15,1555027200,15,1,16,Clouds
86960,16,1555027200,20,0,20,Clouds
86961,17,1555027200,20,0,20,Clouds
86962,18,1555027200,29,1,30,Clouds
86963,19,1555027200,29,1,30,Clouds
86964,21,1555027200,30,0,30,Clouds
86965,22,1555027200,16,4,20,Clouds
86966,23,1555027200,26,4,30,Clouds
86967,24,1555027200,20,0,20,Clouds
86968,25,1555027200,30,0,30,Clouds
86969,26,1555027200,20,0,20,Clouds
86970,27,1555027200,20,0,20,Clouds
86971,28,1555027200,14,16,30,Clouds
86972,29,1555027200,28,1,29,Clouds
86973,30,1555027200,19,1,20,Clouds
86974,31,1555027200,17,3,20,Clouds
86975,32,1555027200,28,2,30,Clouds
86976,33,1555027200,23,0,23,Clouds
86977,34,1555027200,3,27,30,Clouds
86978,35,1555027200,14,16,30,Clouds
86979,36,1555027200,40,0,40,Clouds
86980,37,1555027200,30,0,30,Clouds
86981,38,1555027200,38,2,40,Clouds
86982,39,1555027200,20,0,20,Clouds
86983,40,1555027200,0,21,21,Clouds
86984,41,1555027200,15,5,20,Clouds
86985,42,1555027200,0,30,30,Clouds
86986,43,1555027200,0,30,30,Clouds
86987,44,1555027200,0,30,30,Clouds
86988,45,1555027200,3,27,30,Clouds
86989,46,1555027200,18,2,20,Clouds
86990,47,1555027200,40,0,40,Clouds
86991,48,1555027200,38,2,40,Clouds
86992,49,1555027200,38,2,40,Clouds
86993,50,1555027200,3,37,40,Clouds
86994,51,1555027200,40,0,40,Clouds
86995,52,1555027200,32,0,32,Clouds
86996,53,1555027200,30,10,40,Clouds
86997,54,1555027200,33,0,33,Clouds
86998,55,1555027200,36,0,36,Clouds
86999,56,1555027200,40,0,40,Clouds
87000,57,1555027200,20,3,23,Clouds
87001,58,1555027200,35,5,40,Clouds
87002,59,1555027200,16,4,20,Clouds
87003,60,1555027200,3,27,30,Clouds
87004,61,1555027200,18,7,25,Clouds
87005,62,1555027200,39,1,40,Clouds
87006,63,1555027200,35,0,35,Clouds
87007,64,1555027200,38,2,40,Clouds
87008,65,1555027200,40,0,40,Clouds
87009,66,1555027200,27,13,40,Clouds
87010,67,1555027200,31,9,40,Clouds
87011,68,1555027200,39,1,40,Clouds
87012,69,1555027200,39,1,40,Clouds
87013,70,1555027200,26,2,28,Clouds
87014,71,1555027200,36,4,40,Clouds
87015,72,1555027200,13,18,31,Clouds
87016,73,1555027200,5,25,30,Clouds
87017,74,1555027200,4,26,30,Clouds
87018,75,1555027200,17,23,40,Clouds
87019,76,1555027200,1,37,38,Clouds
87020,77,1555027200,28,1,29,Clouds
87021,78,1555027200,10,30,40,Clouds
87022,79,1555027200,25,2,27,Clouds
87023,80,1555027200,9,31,40,Clouds
87024,81,1555027200,33,7,40,Clouds
87025,82,1555027200,4,18,22,Clouds
87026,83,1555027200,9,31,40,Clouds
87027,84,1555027200,8,22,30,Clouds
87028,85,1555027200,10,25,35,Clouds
87029,86,1555027200,24,14,38,Clouds
87030,87,1555027200,12,26,38,Clouds
87031,88,1555027200,13,17,30,Clouds
87032,89,1555027200,40,0,40,Clouds
87033,90,1555027200,37,3,40,Clouds
87034,91,1555027200,27,3,30,Clouds
87035,92,1555027200,14,26,40,Clouds
87036,93,1555027200,0,40,40,Clouds
87037,94,1555027200,1,39,40,Clouds
87038,95,1555027200,10,30,40,Clouds
87039,96,1555027200,1,29,30,Clouds
87040,97,1555027200,5,35,40,Clouds
87041,98,1555027200,40,0,40,Clouds
87042,99,1555027200,30,0,30,Clouds
87043,100,1555027200,2,23,25,Clouds
87044,101,1555027200,11,19,30,Clouds
87045,102,1555027200,18,22,40,Clouds
87046,103,1555027200,21,19,40,Clouds
87047,104,1555027200,31,9,40,Clouds
87048,105,1555027200,32,4,36,Clouds
87049,106,1555027200,6,34,40,Clouds
87050,107,1555027200,27,13,40,Clouds
87051,108,1555027200,28,12,40,Clouds
87052,109,1555027200,11,18,29,Clouds
87053,110,1555027200,11,29,40,Clouds
87054,111,1555027200,4,36,40,Clouds
87055,112,1555027200,7,23,30,Clouds
87056,113,1555027200,40,0,40,Clouds
87057,114,1555027200,40,0,40,Clouds
87058,115,1555027200,4,26,30,Clouds
87059,2,1555030800,6,14,20,Clouds
87060,3,1555030800,13,7,20,Clouds
87061,4,1555030800,13,7,20,Clouds
87062,5,1555030800,35,5,40,Clouds
87063,6,1555030800,15,5,20,Clouds
87064,7,1555030800,24,5,29,Clouds
87065,8,1555030800,30,0,30,Clouds
87066,9,1555030800,21,3,24,Clouds
87067,10,1555030800,10,6,16,Clouds
87068,11,1555030800,30,0,30,Clouds
87069,12,1555030800,5,15,20,Clouds
87070,13,1555030800,30,0,30,Clouds
87071,14,1555030800,25,5,30,Clouds
87072,15,1555030800,15,1,16,Clouds
87073,16,1555030800,20,0,20,Clouds
87074,17,1555030800,20,0,20,Clouds
87075,18,1555030800,27,3,30,Clouds
87076,19,1555030800,29,1,30,Clouds
87077,21,1555030800,30,0,30,Clouds
87078,22,1555030800,17,3,20,Clouds
87079,23,1555030800,27,3,30,Clouds
87080,24,1555030800,20,0,20,Clouds
87081,25,1555030800,30,0,30,Clouds
87082,26,1555030800,20,0,20,Clouds
87083,27,1555030800,20,0,20,Clouds
87084,28,1555030800,12,18,30,Clouds
87085,29,1555030800,28,1,29,Clouds
87086,30,1555030800,19,1,20,Clouds
87087,31,1555030800,18,2,20,Clouds
87088,32,1555030800,29,1,30,Clouds
87089,33,1555030800,22,1,23,Clouds
87090,34,1555030800,6,24,30,Clouds
87091,35,1555030800,14,16,30,Clouds
87092,36,1555030800,40,0,40,Clouds
87093,37,1555030800,30,0,30,Clouds
87094,38,1555030800,39,1,40,Clouds
87095,39,1555030800,19,1,20,Clouds
87096,40,1555030800,0,21,21,Clouds
87097,41,1555030800,15,5,20,Clouds
87098,42,1555030800,0,30,30,Clouds
87099,43,1555030800,0,30,30,Clouds
87100,44,1555030800,0,30,30,Clouds
87101,45,1555030800,4,26,30,Clouds
87102,46,1555030800,18,2,20,Clouds
87103,47,1555030800,40,0,40,Clouds
87104,48,1555030800,37,3,40,Clouds
87105,49,1555030800,36,4,40,Clouds
87106,50,1555030800,4,36,40,Clouds
87107,51,1555030800,40,0,40,Clouds
87108,52,1555030800,32,0,32,Clouds
87109,53,1555030800,32,8,40,Clouds
87110,54,1555030800,33,0,33,Clouds
87111,55,1555030800,36,0,36,Clouds
87112,56,1555030800,40,0,40,Clouds
87113,57,1555030800,20,3,23,Clouds
87114,58,1555030800,35,5,40,Clouds
87115,59,1555030800,15,5,20,Clouds
87116,60,1555030800,2,28,30,Clouds
87117,61,1555030800,18,7,25,Clouds
87118,62,1555030800,39,1,40,Clouds
87119,63,1555030800,35,0,35,Clouds
87120,64,1555030800,38,2,40,Clouds
87121,65,1555030800,40,0,40,Clouds
87122,66,1555030800,27,13,40,Clouds
87123,67,1555030800,31,9,40,Clouds
87124,68,1555030800,39,1,40,Clouds
87125,69,1555030800,39,1,40,Clouds
87126,70,1555030800,27,1,28,Clouds
87127,71,1555030800,38,2,40,Clouds
87128,72,1555030800,13,18,31,Clouds
87129,73,1555030800,5,25,30,Clouds
87130,74,1555030800,3,27,30,Clouds
87131,75,1555030800,16,24,40,Clouds
87132,76,1555030800,1,37,38,Clouds
87133,77,1555030800,29,0,29,Clouds
87134,78,1555030800,10,30,40,Clouds
87135,79,1555030800,26,1,27,Clouds
87136,80,1555030800,9,31,40,Clouds
87137,81,1555030800,34,6,40,Clouds
87138,82,1555030800,3,19,22,Clouds
87139,83,1555030800,8,32,40,Clouds
87140,84,1555030800,8,22,30,Clouds
87141,85,1555030800,9,26,35,Clouds
87142,86,1555030800,24,14,38,Clouds
87143,87,1555030800,12,26,38,Clouds
87144,88,1555030800,13,17,30,Clouds
87145,89,1555030800,40,0,40,Clouds
87146,90,1555030800,38,2,40,Clouds
87147,91,1555030800,23,7,30,Clouds
87148,92,1555030800,15,25,40,Clouds
87149,93,1555030800,0,40,40,Clouds
87150,94,1555030800,1,39,40,Clouds
87151,95,1555030800,11,29,40,Clouds
87152,96,1555030800,1,29,30,Clouds
87153,97,1555030800,4,36,40,Clouds
87154,98,1555030800,40,0,40,Clouds
87155,99,1555030800,29,1,30,Clouds
87156,100,1555030800,2,23,25,Clouds
87157,101,1555030800,10,20,30,Clouds
87158,102,1555030800,18,22,40,Clouds
87159,103,1555030800,21,19,40,Clouds
87160,104,1555030800,31,9,40,Clouds
87161,105,1555030800,31,5,36,Clouds
87162,106,1555030800,6,34,40,Clouds
87163,107,1555030800,26,14,40,Clouds
87164,108,1555030800,28,12,40,Clouds
87165,109,1555030800,9,20,29,Clouds
87166,110,1555030800,10,30,40,Clouds
87167,111,1555030800,2,38,40,Clouds
87168,112,1555030800,7,23,30,Clouds
87169,113,1555030800,40,0,40,Clouds
87170,114,1555030800,40,0,40,Clouds
87171,115,1555030800,5,25,30,Clouds
87172,2,1555034400,6,14,20,Clouds
87173,3,1555034400,13,7,20,Clouds
87174,4,1555034400,13,7,20,Clouds
87175,5,1555034400,35,5,40,Clouds
87176,6,1555034400,15,5,20,Clouds
87177,7,1555034400,24,5,29,Clouds
87178,8,1555034400,30,0,30,Clouds
87179,9,1555034400,21,3,24,Clouds
87180,10,1555034400,10,6,16,Clouds
87181,11,1555034400,30,0,30,Clouds
87182,12,1555034400,5,15,20,Clouds
87183,13,1555034400,30,0,30,Clouds
87184,14,1555034400,25,5,30,Clouds
87185,15,1555034400,15,1,16,Clouds
87186,16,1555034400,20,0,20,Clouds
87187,17,1555034400,20,0,20,Clouds
87188,18,1555034400,27,3,30,Clouds
87189,19,1555034400,29,1,30,Clouds
87190,21,1555034400,30,0,30,Clouds
87191,22,1555034400,17,3,20,Clouds
87192,23,1555034400,27,3,30,Clouds
87193,24,1555034400,20,0,20,Clouds
87194,25,1555034400,30,0,30,Clouds
87195,26,1555034400,20,0,20,Clouds
87196,27,1555034400,20,0,20,Clouds
87197,28,1555034400,12,18,30,Clouds
87198,29,1555034400,28,1,29,Clouds
87199,30,1555034400,19,1,20,Clouds
87200,31,1555034400,18,2,20,Clouds
87201,32,1555034400,29,1,30,Clouds
87202,33,1555034400,22,1,23,Clouds
87203,34,1555034400,5,25,30,Clouds
87204,35,1555034400,14,16,30,Clouds
87205,36,1555034400,40,0,40,Clouds
87206,37,1555034400,30,0,30,Clouds
87207,38,1555034400,38,2,40,Clouds
87208,39,1555034400,19,1,20,Clouds
87209,40,1555034400,0,21,21,Clouds
87210,41,1555034400,15,5,20,Clouds
87211,42,1555034400,0,30,30,Clouds
87212,43,1555034400,0,30,30,Clouds
87213,44,1555034400,0,30,30,Clouds
87214,45,1555034400,4,26,30,Clouds
87215,46,1555034400,18,2,20,Clouds
87216,47,1555034400,40,0,40,Clouds
87217,48,1555034400,37,3,40,Clouds
87218,49,1555034400,36,4,40,Clouds
87219,50,1555034400,4,36,40,Clouds
87220,51,1555034400,40,0,40,Clouds
87221,52,1555034400,32,0,32,Clouds
87222,53,1555034400,32,8,40,Clouds
87223,54,1555034400,33,0,33,Clouds
87224,55,1555034400,36,0,36,Clouds
87225,56,1555034400,40,0,40,Clouds
87226,57,1555034400,20,3,23,Clouds
87227,58,1555034400,35,5,40,Clouds
87228,59,1555034400,15,5,20,Clouds
87229,60,1555034400,2,28,30,Clouds
87230,61,1555034400,18,7,25,Clouds
87231,62,1555034400,39,1,40,Clouds
87232,63,1555034400,35,0,35,Clouds
87233,64,1555034400,38,2,40,Clouds
87234,65,1555034400,40,0,40,Clouds
87235,66,1555034400,27,13,40,Clouds
87236,67,1555034400,31,9,40,Clouds
87237,68,1555034400,39,1,40,Clouds
87238,69,1555034400,39,1,40,Clouds
87239,70,1555034400,27,1,28,Clouds
87240,71,1555034400,37,3,40,Clouds
87241,72,1555034400,13,18,31,Clouds
87242,73,1555034400,5,25,30,Clouds
87243,74,1555034400,3,27,30,Clouds
87244,75,1555034400,16,24,40,Clouds
87245,76,1555034400,1,37,38,Clouds
87246,77,1555034400,29,0,29,Clouds
87247,78,1555034400,10,30,40,Clouds
87248,79,1555034400,26,1,27,Clouds
87249,80,1555034400,9,31,40,Clouds
87250,81,1555034400,34,6,40,Clouds
87251,82,1555034400,3,19,22,Clouds
87252,83,1555034400,8,32,40,Clouds
87253,84,1555034400,8,22,30,Clouds
87254,85,1555034400,9,26,35,Clouds
87255,86,1555034400,24,14,38,Clouds
87256,87,1555034400,12,26,38,Clouds
87257,88,1555034400,13,17,30,Clouds
87258,89,1555034400,40,0,40,Clouds
87259,90,1555034400,38,2,40,Clouds
87260,91,1555034400,23,7,30,Clouds
87261,92,1555034400,15,25,40,Clouds
87262,93,1555034400,0,40,40,Clouds
87263,94,1555034400,1,39,40,Clouds
87264,95,1555034400,11,29,40,Clouds
87265,96,1555034400,1,29,30,Clouds
87266,97,1555034400,4,36,40,Clouds
87267,98,1555034400,40,0,40,Clouds
87268,99,1555034400,29,1,30,Clouds
87269,100,1555034400,2,23,25,Clouds
87270,101,1555034400,10,20,30,Clouds
87271,102,1555034400,18,22,40,Clouds
87272,103,1555034400,21,19,40,Clouds
87273,104,1555034400,31,9,40,Clouds
87274,105,1555034400,31,5,36,Clouds
87275,106,1555034400,6,34,40,Clouds
87276,107,1555034400,26,14,40,Clouds
87277,108,1555034400,28,12,40,Clouds
87278,109,1555034400,9,20,29,Clouds
87279,110,1555034400,10,30,40,Clouds
87280,111,1555034400,2,38,40,Clouds
87281,112,1555034400,7,23,30,Clouds
87282,113,1555034400,40,0,40,Clouds
87283,114,1555034400,40,0,40,Clouds
87284,115,1555034400,5,25,30,Clouds
87285,2,1555038000,6,14,20,Clouds
87286,3,1555038000,13,7,20,Clouds
87287,4,1555038000,13,7,20,Clouds
87288,5,1555038000,35,5,40,Clouds
87289,6,1555038000,15,5,20,Clouds
87290,7,1555038000,24,5,29,Clouds
87291,8,1555038000,30,0,30,Clouds
87292,9,1555038000,21,3,24,Clouds
87293,10,1555038000,10,6,16,Clouds
87294,11,1555038000,30,0,30,Clouds
87295,12,1555038000,5,15,20,Clouds
87296,13,1555038000,29,0,29,Clouds
87297,14,1555038000,25,5,30,Clouds
87298,15,1555038000,15,1,16,Clouds
87299,16,1555038000,20,0,20,Clouds
87300,17,1555038000,20,0,20,Clouds
87301,18,1555038000,27,3,30,Clouds
87302,19,1555038000,29,1,30,Clouds
87303,21,1555038000,30,0,30,Clouds
87304,22,1555038000,17,3,20,Clouds
87305,23,1555038000,27,3,30,Clouds
87306,24,1555038000,20,0,20,Clouds
87307,25,1555038000,30,0,30,Clouds
87308,26,1555038000,20,0,20,Clouds
87309,27,1555038000,20,0,20,Clouds
87310,28,1555038000,12,18,30,Clouds
87311,29,1555038000,28,1,29,Clouds
87312,30,1555038000,19,1,20,Clouds
87313,31,1555038000,18,2,20,Clouds
87314,32,1555038000,29,1,30,Clouds
87315,33,1555038000,22,1,23,Clouds
87316,34,1555038000,5,25,30,Clouds
87317,35,1555038000,14,16,30,Clouds
87318,36,1555038000,40,0,40,Clouds
87319,37,1555038000,30,0,30,Clouds
87320,38,1555038000,38,2,40,Clouds
87321,39,1555038000,19,1,20,Clouds
87322,40,1555038000,0,21,21,Clouds
87323,41,1555038000,15,5,20,Clouds
87324,42,1555038000,0,30,30,Clouds
87325,43,1555038000,0,30,30,Clouds
87326,44,1555038000,0,30,30,Clouds
87327,45,1555038000,4,26,30,Clouds
87328,46,1555038000,18,2,20,Clouds
87329,47,1555038000,40,0,40,Clouds
87330,48,1555038000,37,3,40,Clouds
87331,49,1555038000,36,4,40,Clouds
87332,50,1555038000,4,36,40,Clouds
87333,51,1555038000,40,0,40,Clouds
87334,52,1555038000,32,0,32,Clouds
87335,53,1555038000,32,8,40,Clouds
87336,54,1555038000,33,0,33,Clouds
87337,55,1555038000,36,0,36,Clouds
87338,56,1555038000,40,0,40,Clouds
87339,57,1555038000,20,3,23,Clouds
87340,58,1555038000,35,5,40,Clouds
87341,59,1555038000,15,5,20,Clouds
87342,60,1555038000,2,28,30,Clouds
87343,61,1555038000,18,7,25,Clouds
87344,62,1555038000,39,1,40,Clouds
87345,63,1555038000,35,0,35,Clouds
87346,64,1555038000,38,2,40,Clouds
87347,65,1555038000,40,0,40,Clouds
87348,66,1555038000,27,13,40,Clouds
87349,67,1555038000,31,9,40,Clouds
87350,68,1555038000,39,1,40,Clouds
87351,69,1555038000,39,1,40,Clouds
87352,70,1555038000,27,1,28,Clouds
87353,71,1555038000,37,3,40,Clouds
87354,72,1555038000,13,18,31,Clouds
87355,73,1555038000,5,25,30,Clouds
87356,74,1555038000,3,27,30,Clouds
87357,75,1555038000,16,24,40,Clouds
87358,76,1555038000,1,37,38,Clouds
87359,77,1555038000,29,0,29,Clouds
87360,78,1555038000,10,30,40,Clouds
87361,79,1555038000,26,1,27,Clouds
87362,80,1555038000,9,31,40,Clouds
87363,81,1555038000,34,6,40,Clouds
87364,82,1555038000,3,19,22,Clouds
87365,83,1555038000,8,32,40,Clouds
87366,84,1555038000,8,22,30,Clouds
87367,85,1555038000,9,26,35,Clouds
87368,86,1555038000,24,14,38,Clouds
87369,87,1555038000,12,26,38,Clouds
87370,88,1555038000,13,17,30,Clouds
87371,89,1555038000,40,0,40,Clouds
87372,90,1555038000,38,2,40,Clouds
87373,91,1555038000,23,7,30,Clouds
87374,92,1555038000,15,25,40,Clouds
87375,93,1555038000,0,40,40,Clouds
87376,94,1555038000,1,39,40,Clouds
87377,95,1555038000,11,29,40,Clouds
87378,96,1555038000,1,29,30,Clouds
87379,97,1555038000,4,36,40,Clouds
87380,98,1555038000,40,0,40,Clouds
87381,99,1555038000,29,1,30,Clouds
87382,100,1555038000,2,23,25,Clouds
87383,101,1555038000,10,20,30,Clouds
87384,102,1555038000,18,22,40,Clouds
87385,103,1555038000,21,19,40,Clouds
87386,104,1555038000,31,9,40,Clouds
87387,105,1555038000,31,5,36,Clouds
87388,106,1555038000,6,34,40,Clouds
87389,107,1555038000,26,14,40,Clouds
87390,108,1555038000,28,12,40,Clouds
87391,109,1555038000,9,20,29,Clouds
87392,110,1555038000,10,30,40,Clouds
87393,111,1555038000,2,38,40,Clouds
87394,112,1555038000,7,23,30,Clouds
87395,113,1555038000,40,0,40,Clouds
87396,114,1555038000,40,0,40,Clouds
87397,115,1555038000,5,25,30,Clouds
87398,2,1555041600,6,14,20,Clouds
87399,3,1555041600,13,7,20,Clouds
87400,4,1555041600,13,7,20,Clouds
87401,5,1555041600,35,5,40,Clouds
87402,6,1555041600,15,5,20,Clouds
87403,7,1555041600,24,5,29,Clouds
87404,8,1555041600,30,0,30,Clouds
87405,9,1555041600,21,3,24,Clouds
87406,10,1555041600,10,6,16,Clouds
87407,11,1555041600,30,0,30,Clouds
87408,12,1555041600,5,15,20,Clouds
87409,13,1555041600,30,0,30,Clouds
87410,14,1555041600,25,5,30,Clouds
87411,15,1555041600,15,1,16,Clouds
87412,16,1555041600,20,0,20,Clouds
87413,17,1555041600,20,0,20,Clouds
87414,18,1555041600,27,3,30,Clouds
87415,19,1555041600,29,1,30,Clouds
87416,21,1555041600,30,0,30,Clouds
87417,22,1555041600,17,3,20,Clouds
87418,23,1555041600,27,3,30,Clouds
87419,24,1555041600,20,0,20,Clouds
87420,25,1555041600,30,0,30,Clouds
87421,26,1555041600,20,0,20,Clouds
87422,27,1555041600,20,0,20,Clouds
87423,28,1555041600,12,18,30,Clouds
87424,29,1555041600,28,1,29,Clouds
87425,30,1555041600,19,1,20,Clouds
87426,31,1555041600,18,2,20,Clouds
87427,32,1555041600,29,1,30,Clouds
87428,33,1555041600,22,1,23,Clouds
87429,34,1555041600,5,25,30,Clouds
87430,35,1555041600,14,16,30,Clouds
87431,36,1555041600,40,0,40,Clouds
87432,37,1555041600,30,0,30,Clouds
87433,38,1555041600,38,2,40,Clouds
87434,39,1555041600,19,1,20,Clouds
87435,40,1555041600,0,21,21,Clouds
87436,41,1555041600,15,5,20,Clouds
87437,42,1555041600,0,30,30,Clouds
87438,43,1555041600,0,30,30,Clouds
87439,44,1555041600,0,30,30,Clouds
87440,45,1555041600,4,26,30,Clouds
87441,46,1555041600,18,2,20,Clouds
87442,47,1555041600,40,0,40,Clouds
87443,48,1555041600,37,3,40,Clouds
87444,49,1555041600,36,4,40,Clouds
87445,50,1555041600,4,36,40,Clouds
87446,51,1555041600,40,0,40,Clouds
87447,52,1555041600,32,0,32,Clouds
87448,53,1555041600,32,8,40,Clouds
87449,54,1555041600,33,0,33,Clouds
87450,55,1555041600,36,0,36,Clouds
87451,56,1555041600,40,0,40,Clouds
87452,57,1555041600,20,3,23,Clouds
87453,58,1555041600,35,5,40,Clouds
87454,59,1555041600,15,5,20,Clouds
87455,60,1555041600,2,28,30,Clouds
87456,61,1555041600,18,7,25,Clouds
87457,62,1555041600,39,1,40,Clouds
87458,63,1555041600,35,0,35,Clouds
87459,64,1555041600,38,2,40,Clouds
87460,65,1555041600,40,0,40,Clouds
87461,66,1555041600,27,13,40,Clouds
87462,67,1555041600,31,9,40,Clouds
87463,68,1555041600,39,1,40,Clouds
87464,69,1555041600,39,1,40,Clouds
87465,70,1555041600,27,1,28,Clouds
87466,71,1555041600,37,3,40,Clouds
87467,72,1555041600,13,18,31,Clouds
87468,73,1555041600,5,25,30,Clouds
87469,74,1555041600,3,27,30,Clouds
87470,75,1555041600,16,24,40,Clouds
87471,76,1555041600,1,37,38,Clouds
87472,77,1555041600,29,0,29,Clouds
87473,78,1555041600,10,30,40,Clouds
87474,79,1555041600,26,1,27,Clouds
87475,80,1555041600,9,31,40,Clouds
87476,81,1555041600,34,6,40,Clouds
87477,82,1555041600,3,19,22,Clouds
87478,83,1555041600,8,32,40,Clouds
87479,84,1555041600,8,22,30,Clouds
87480,85,1555041600,9,26,35,Clouds
87481,86,1555041600,24,14,38,Clouds
87482,87,1555041600,12,26,38,Clouds
87483,88,1555041600,13,17,30,Clouds
87484,89,1555041600,40,0,40,Clouds
87485,90,1555041600,38,2,40,Clouds
87486,91,1555041600,23,7,30,Clouds
87487,92,1555041600,15,25,40,Clouds
87488,93,1555041600,0,40,40,Clouds
87489,94,1555041600,1,39,40,Clouds
87490,95,1555041600,11,29,40,Clouds
87491,96,1555041600,1,29,30,Clouds
87492,97,1555041600,4,36,40,Clouds
87493,98,1555041600,40,0,40,Clouds
87494,99,1555041600,29,1,30,Clouds
87495,100,1555041600,2,23,25,Clouds
87496,101,1555041600,10,20,30,Clouds
87497,102,1555041600,18,22,40,Clouds
87498,103,1555041600,21,19,40,Clouds
87499,104,1555041600,31,9,40,Clouds
87500,105,1555041600,31,5,36,Clouds
87501,106,1555041600,6,34,40,Clouds
87502,107,1555041600,26,14,40,Clouds
87503,108,1555041600,28,12,40,Clouds
87504,109,1555041600,9,20,29,Clouds
87505,110,1555041600,10,30,40,Clouds
87506,111,1555041600,2,38,40,Clouds
87507,112,1555041600,7,23,30,Clouds
87508,113,1555041600,40,0,40,Clouds
87509,114,1555041600,40,0,40,Clouds
87510,115,1555041600,5,25,30,Clouds
87511,2,1555045200,6,14,20,Clouds
87512,3,1555045200,13,7,20,Clouds
87513,4,1555045200,13,7,20,Clouds
87514,5,1555045200,35,5,40,Clouds
87515,6,1555045200,15,5,20,Clouds
87516,7,1555045200,24,5,29,Clouds
87517,8,1555045200,30,0,30,Clouds
87518,9,1555045200,21,3,24,Clouds
87519,10,1555045200,10,6,16,Clouds
87520,11,1555045200,30,0,30,Clouds
87521,12,1555045200,5,15,20,Clouds
87522,13,1555045200,30,0,30,Clouds
87523,14,1555045200,25,5,30,Clouds
87524,15,1555045200,15,1,16,Clouds
87525,16,1555045200,20,0,20,Clouds
87526,17,1555045200,20,0,20,Clouds
87527,18,1555045200,27,3,30,Clouds
87528,19,1555045200,29,1,30,Clouds
87529,21,1555045200,30,0,30,Clouds
87530,22,1555045200,17,3,20,Clouds
87531,23,1555045200,27,3,30,Clouds
87532,24,1555045200,20,0,20,Clouds
87533,25,1555045200,30,0,30,Clouds
87534,26,1555045200,20,0,20,Clouds
87535,27,1555045200,20,0,20,Clouds
87536,28,1555045200,12,18,30,Clouds
87537,29,1555045200,28,1,29,Clouds
87538,30,1555045200,19,1,20,Clouds
87539,31,1555045200,18,2,20,Clouds
87540,32,1555045200,29,1,30,Clouds
87541,33,1555045200,22,1,23,Clouds
87542,34,1555045200,5,25,30,Clouds
87543,35,1555045200,14,16,30,Clouds
87544,36,1555045200,40,0,40,Clouds
87545,37,1555045200,30,0,30,Clouds
87546,38,1555045200,38,2,40,Clouds
87547,39,1555045200,19,1,20,Clouds
87548,40,1555045200,0,21,21,Clouds
87549,41,1555045200,15,5,20,Clouds
87550,42,1555045200,0,30,30,Clouds
87551,43,1555045200,0,30,30,Clouds
87552,44,1555045200,0,30,30,Clouds
87553,45,1555045200,4,26,30,Clouds
87554,46,1555045200,18,2,20,Clouds
87555,47,1555045200,40,0,40,Clouds
87556,48,1555045200,37,3,40,Clouds
87557,49,1555045200,36,4,40,Clouds
87558,50,1555045200,4,36,40,Clouds
87559,51,1555045200,40,0,40,Clouds
87560,52,1555045200,32,0,32,Clouds
87561,53,1555045200,32,8,40,Clouds
87562,54,1555045200,33,0,33,Clouds
87563,55,1555045200,36,0,36,Clouds
87564,56,1555045200,40,0,40,Clouds
87565,57,1555045200,20,3,23,Clouds
87566,58,1555045200,35,5,40,Clouds
87567,59,1555045200,15,5,20,Clouds
87568,60,1555045200,2,28,30,Clouds
87569,61,1555045200,18,7,25,Clouds
87570,62,1555045200,39,1,40,Clouds
87571,63,1555045200,35,0,35,Clouds
87572,64,1555045200,38,2,40,Clouds
87573,65,1555045200,40,0,40,Clouds
87574,66,1555045200,27,13,40,Clouds
87575,67,1555045200,31,9,40,Clouds
87576,68,1555045200,39,1,40,Clouds
87577,69,1555045200,39,1,40,Clouds
87578,70,1555045200,27,1,28,Clouds
87579,71,1555045200,37,3,40,Clouds
87580,72,1555045200,13,18,31,Clouds
87581,73,1555045200,5,25,30,Clouds
87582,74,1555045200,3,27,30,Clouds
87583,75,1555045200,16,24,40,Clouds
87584,76,1555045200,1,37,38,Clouds
87585,77,1555045200,29,0,29,Clouds
87586,78,1555045200,10,30,40,Clouds
87587,79,1555045200,26,1,27,Clouds
87588,80,1555045200,9,31,40,Clouds
87589,81,1555045200,34,6,40,Clouds
87590,82,1555045200,3,19,22,Clouds
87591,83,1555045200,8,32,40,Clouds
87592,84,1555045200,8,22,30,Clouds
87593,85,1555045200,9,26,35,Clouds
87594,86,1555045200,24,14,38,Clouds
87595,87,1555045200,12,26,38,Clouds
87596,88,1555045200,13,17,30,Clouds
87597,89,1555045200,40,0,40,Clouds
87598,90,1555045200,38,2,40,Clouds
87599,91,1555045200,23,7,30,Clouds
87600,92,1555045200,15,25,40,Clouds
87601,93,1555045200,0,40,40,Clouds
87602,94,1555045200,1,39,40,Clouds
87603,95,1555045200,11,29,40,Clouds
87604,96,1555045200,1,29,30,Clouds
87605,97,1555045200,4,36,40,Clouds
87606,98,1555045200,40,0,40,Clouds
87607,99,1555045200,29,1,30,Clouds
87608,100,1555045200,2,23,25,Clouds
87609,101,1555045200,10,20,30,Clouds
87610,102,1555045200,18,22,40,Clouds
87611,103,1555045200,21,19,40,Clouds
87612,104,1555045200,31,9,40,Clouds
87613,105,1555045200,31,5,36,Clouds
87614,106,1555045200,6,34,40,Clouds
87615,107,1555045200,26,14,40,Clouds
87616,108,1555045200,28,12,40,Clouds
87617,109,1555045200,9,20,29,Clouds
87618,110,1555045200,10,30,40,Clouds
87619,111,1555045200,2,38,40,Clouds
87620,112,1555045200,7,23,30,Clouds
87621,113,1555045200,40,0,40,Clouds
87622,114,1555045200,40,0,40,Clouds
87623,115,1555045200,5,25,30,Clouds
87624,2,1555048800,6,14,20,Clouds
87625,3,1555048800,20,0,20,Clouds
87626,4,1555048800,14,6,20,Clouds
87627,5,1555048800,18,22,40,Clouds
87628,6,1555048800,13,7,20,Clouds
87629,7,1555048800,25,4,29,Clouds
87630,8,1555048800,25,5,30,Clouds
87631,9,1555048800,19,5,24,Clouds
87632,10,1555048800,8,8,16,Clouds
87633,11,1555048800,30,0,30,Clouds
87634,12,1555048800,8,12,20,Clouds
87635,13,1555048800,27,0,27,Clouds
87636,14,1555048800,27,3,30,Clouds
87637,15,1555048800,16,0,16,Clouds
87638,16,1555048800,20,0,20,Clouds
87639,17,1555048800,18,2,20,Clouds
87640,18,1555048800,13,17,30,Clouds
87641,19,1555048800,27,3,30,Clouds
87642,21,1555048800,30,0,30,Clouds
87643,22,1555048800,18,2,20,Clouds
87644,23,1555048800,26,4,30,Clouds
87645,24,1555048800,20,0,20,Clouds
87646,25,1555048800,30,0,30,Clouds
87647,26,1555048800,20,0,20,Clouds
87648,27,1555048800,20,0,20,Clouds
87649,28,1555048800,12,18,30,Clouds
87650,29,1555048800,27,2,29,Clouds
87651,30,1555048800,18,2,20,Clouds
87652,31,1555048800,17,3,20,Clouds
87653,32,1555048800,28,2,30,Clouds
87654,33,1555048800,14,9,23,Clouds
87655,34,1555048800,6,24,30,Clouds
87656,35,1555048800,19,11,30,Clouds
87657,36,1555048800,37,3,40,Clouds
87658,37,1555048800,30,0,30,Clouds
87659,38,1555048800,40,0,40,Clouds
87660,39,1555048800,20,0,20,Clouds
87661,40,1555048800,1,20,21,Clouds
87662,41,1555048800,15,5,20,Clouds
87663,42,1555048800,1,29,30,Clouds
87664,43,1555048800,6,24,30,Clouds
87665,44,1555048800,7,23,30,Clouds
87666,45,1555048800,4,26,30,Clouds
87667,46,1555048800,20,0,20,Clouds
87668,47,1555048800,40,0,40,Clouds
87669,48,1555048800,38,2,40,Clouds
87670,49,1555048800,33,7,40,Clouds
87671,50,1555048800,8,32,40,Clouds
87672,51,1555048800,40,0,40,Clouds
87673,52,1555048800,31,1,32,Clouds
87674,53,1555048800,38,2,40,Clouds
87675,54,1555048800,32,1,33,Clouds
87676,55,1555048800,36,0,36,Clouds
87677,56,1555048800,40,0,40,Clouds
87678,57,1555048800,20,3,23,Clouds
87679,58,1555048800,40,0,40,Clouds
87680,59,1555048800,17,3,20,Clouds
87681,60,1555048800,3,27,30,Clouds
87682,61,1555048800,20,5,25,Clouds
87683,62,1555048800,38,2,40,Clouds
87684,63,1555048800,34,1,35,Clouds
87685,64,1555048800,39,1,40,Clouds
87686,65,1555048800,40,0,40,Clouds
87687,66,1555048800,37,3,40,Clouds
87688,67,1555048800,37,3,40,Clouds
87689,68,1555048800,38,2,40,Clouds
87690,69,1555048800,35,5,40,Clouds
87691,70,1555048800,27,1,28,Clouds
87692,71,1555048800,35,5,40,Clouds
87693,72,1555048800,13,18,31,Clouds
87694,73,1555048800,7,23,30,Clouds
87695,74,1555048800,7,23,30,Clouds
87696,75,1555048800,18,22,40,Clouds
87697,76,1555048800,2,36,38,Clouds
87698,77,1555048800,27,2,29,Clouds
87699,78,1555048800,11,29,40,Clouds
87700,79,1555048800,26,1,27,Clouds
87701,80,1555048800,13,27,40,Clouds
87702,81,1555048800,34,6,40,Clouds
87703,82,1555048800,3,19,22,Clouds
87704,83,1555048800,10,30,40,Clouds
87705,84,1555048800,11,19,30,Clouds
87706,85,1555048800,10,25,35,Clouds
87707,86,1555048800,5,33,38,Clouds
87708,87,1555048800,14,24,38,Clouds
87709,88,1555048800,13,17,30,Clouds
87710,89,1555048800,40,0,40,Clouds
87711,90,1555048800,40,0,40,Clouds
87712,91,1555048800,24,6,30,Clouds
87713,92,1555048800,2,38,40,Clouds
87714,93,1555048800,0,40,40,Clouds
87715,94,1555048800,1,39,40,Clouds
87716,95,1555048800,11,29,40,Clouds
87717,96,1555048800,1,29,30,Clouds
87718,97,1555048800,7,33,40,Clouds
87719,98,1555048800,40,0,40,Clouds
87720,99,1555048800,26,4,30,Clouds
87721,100,1555048800,1,24,25,Clouds
87722,101,1555048800,14,16,30,Clouds
87723,102,1555048800,18,22,40,Clouds
87724,103,1555048800,21,19,40,Clouds
87725,104,1555048800,32,8,40,Clouds
87726,105,1555048800,32,4,36,Clouds
87727,106,1555048800,6,34,40,Clouds
87728,107,1555048800,31,9,40,Clouds
87729,108,1555048800,28,12,40,Clouds
87730,109,1555048800,14,15,29,Clouds
87731,110,1555048800,10,30,40,Clouds
87732,111,1555048800,4,36,40,Clouds
87733,112,1555048800,8,22,30,Clouds
87734,113,1555048800,39,1,40,Clouds
87735,114,1555048800,39,1,40,Clouds
87736,115,1555048800,7,23,30,Clouds
87737,2,1555052400,15,5,20,Clouds
87738,3,1555052400,20,0,20,Clouds
87739,4,1555052400,11,8,19,Clouds
87740,5,1555052400,10,30,40,Clouds
87741,6,1555052400,18,2,20,Clouds
87742,7,1555052400,28,1,29,Clouds
87743,8,1555052400,30,0,30,Clouds
87744,9,1555052400,19,5,24,Clouds
87745,10,1555052400,13,3,16,Clouds
87746,11,1555052400,27,3,30,Clouds
87747,12,1555052400,13,7,20,Clouds
87748,13,1555052400,24,2,26,Clouds
87749,14,1555052400,21,9,30,Clouds
87750,15,1555052400,16,0,16,Clouds
87751,16,1555052400,19,1,20,Clouds
87752,17,1555052400,17,3,20,Clouds
87753,18,1555052400,12,18,30,Clouds
87754,19,1555052400,18,12,30,Clouds
87755,21,1555052400,22,8,30,Clouds
87756,22,1555052400,18,2,20,Clouds
87757,23,1555052400,30,0,30,Clouds
87758,24,1555052400,19,1,20,Clouds
87759,25,1555052400,26,4,30,Clouds
87760,26,1555052400,16,4,20,Clouds
87761,27,1555052400,17,3,20,Clouds
87762,28,1555052400,22,8,30,Clouds
87763,29,1555052400,26,3,29,Clouds
87764,30,1555052400,17,3,20,Clouds
87765,31,1555052400,19,1,20,Clouds
87766,32,1555052400,26,4,30,Clouds
87767,33,1555052400,5,18,23,Clouds
87768,34,1555052400,25,5,30,Clouds
87769,35,1555052400,27,3,30,Clouds
87770,36,1555052400,32,8,40,Clouds
87771,37,1555052400,29,1,30,Clouds
87772,38,1555052400,36,4,40,Clouds
87773,39,1555052400,17,3,20,Clouds
87774,40,1555052400,0,21,21,Clouds
87775,41,1555052400,20,0,20,Clouds
87776,42,1555052400,2,28,30,Clouds
87777,43,1555052400,20,10,30,Clouds
87778,44,1555052400,21,9,30,Clouds
87779,45,1555052400,6,24,30,Clouds
87780,46,1555052400,18,2,20,Clouds
87781,47,1555052400,37,3,40,Clouds
87782,48,1555052400,39,1,40,Clouds
87783,49,1555052400,34,6,40,Clouds
87784,50,1555052400,10,30,40,Clouds
87785,51,1555052400,37,3,40,Clouds
87786,52,1555052400,27,5,32,Clouds
87787,53,1555052400,37,3,40,Clouds
87788,54,1555052400,32,1,33,Clouds
87789,55,1555052400,32,4,36,Clouds
87790,56,1555052400,39,1,40,Clouds
87791,57,1555052400,23,0,23,Clouds
87792,58,1555052400,28,12,40,Clouds
87793,59,1555052400,20,0,20,Clouds
87794,60,1555052400,20,10,30,Clouds
87795,61,1555052400,24,1,25,Clouds
87796,62,1555052400,30,9,39,Clouds
87797,63,1555052400,35,0,35,Clouds
87798,64,1555052400,33,7,40,Clouds
87799,65,1555052400,36,4,40,Clouds
87800,66,1555052400,22,18,40,Clouds
87801,67,1555052400,30,10,40,Clouds
87802,68,1555052400,38,2,40,Clouds
87803,69,1555052400,30,10,40,Clouds
87804,70,1555052400,13,15,28,Clouds
87805,71,1555052400,36,4,40,Clouds
87806,72,1555052400,18,13,31,Clouds
87807,73,1555052400,15,15,30,Clouds
87808,74,1555052400,11,19,30,Clouds
87809,75,1555052400,19,21,40,Clouds
87810,76,1555052400,8,30,38,Clouds
87811,77,1555052400,26,3,29,Clouds
87812,78,1555052400,11,29,40,Clouds
87813,79,1555052400,7,20,27,Clouds
87814,80,1555052400,17,23,40,Clouds
87815,81,1555052400,34,6,40,Clouds
87816,82,1555052400,8,14,22,Clouds
87817,83,1555052400,14,26,40,Clouds
87818,84,1555052400,10,20,30,Clouds
87819,85,1555052400,19,16,35,Clouds
87820,86,1555052400,8,30,38,Clouds
87821,87,1555052400,14,24,38,Clouds
87822,88,1555052400,23,7,30,Clouds
87823,89,1555052400,39,1,40,Clouds
87824,90,1555052400,32,8,40,Clouds
87825,91,1555052400,26,4,30,Clouds
87826,92,1555052400,1,39,40,Clouds
87827,93,1555052400,8,32,40,Clouds
87828,94,1555052400,0,40,40,Clouds
87829,95,1555052400,15,25,40,Clouds
87830,96,1555052400,2,28,30,Clouds
87831,97,1555052400,14,26,40,Clouds
87832,98,1555052400,39,1,40,Clouds
87833,99,1555052400,26,4,30,Clouds
87834,100,1555052400,9,16,25,Clouds
87835,101,1555052400,21,9,30,Clouds
87836,102,1555052400,22,18,40,Clouds
87837,103,1555052400,20,20,40,Clouds
87838,104,1555052400,26,14,40,Clouds
87839,105,1555052400,19,17,36,Clouds
87840,106,1555052400,9,31,40,Clouds
87841,107,1555052400,35,5,40,Clouds
87842,108,1555052400,36,4,40,Clouds
87843,109,1555052400,20,9,29,Clouds
87844,110,1555052400,12,28,40,Clouds
87845,111,1555052400,12,28,40,Clouds
87846,112,1555052400,21,9,30,Clouds
87847,113,1555052400,36,4,40,Clouds
87848,114,1555052400,33,7,40,Clouds
87849,115,1555052400,9,21,30,Clouds
87850,2,1555056000,20,0,20,Clouds
87851,3,1555056000,18,2,20,Clouds
87852,4,1555056000,9,10,19,Clouds
87853,5,1555056000,36,4,40,Clouds
87854,6,1555056000,20,0,20,Clouds
87855,7,1555056000,27,2,29,Clouds
87856,8,1555056000,28,2,30,Clouds
87857,9,1555056000,16,8,24,Clouds
87858,10,1555056000,13,3,16,Clouds
87859,11,1555056000,22,8,30,Clouds
87860,12,1555056000,20,0,20,Clouds
87861,13,1555056000,17,5,22,Clouds
87862,14,1555056000,25,5,30,Clouds
87863,15,1555056000,16,0,16,Clouds
87864,16,1555056000,17,3,20,Clouds
87865,17,1555056000,15,5,20,Clouds
87866,18,1555056000,18,12,30,Clouds
87867,19,1555056000,19,11,30,Clouds
87868,21,1555056000,17,13,30,Clouds
87869,22,1555056000,16,3,19,Clouds
87870,23,1555056000,24,6,30,Clouds
87871,24,1555056000,20,0,20,Clouds
87872,25,1555056000,23,7,30,Clouds
87873,26,1555056000,14,6,20,Clouds
87874,27,1555056000,4,14,18,Clouds
87875,28,1555056000,14,16,30,Clouds
87876,29,1555056000,28,1,29,Clouds
87877,30,1555056000,15,5,20,Clouds
87878,31,1555056000,18,2,20,Clouds
87879,32,1555056000,24,6,30,Clouds
87880,33,1555056000,7,16,23,Clouds
87881,34,1555056000,30,0,30,Clouds
87882,35,1555056000,30,0,30,Clouds
87883,36,1555056000,26,13,39,Clouds
87884,37,1555056000,28,2,30,Clouds
87885,38,1555056000,32,8,40,Clouds
87886,39,1555056000,19,1,20,Clouds
87887,40,1555056000,1,19,20,Clouds
87888,41,1555056000,19,1,20,Clouds
87889,42,1555056000,21,9,30,Clouds
87890,43,1555056000,30,0,30,Clouds
87891,44,1555056000,6,24,30,Clouds
87892,45,1555056000,14,16,30,Clouds
87893,46,1555056000,15,5,20,Clouds
87894,47,1555056000,32,8,40,Clouds
87895,48,1555056000,40,0,40,Clouds
87896,49,1555056000,40,0,40,Clouds
87897,50,1555056000,30,10,40,Clouds
87898,51,1555056000,30,10,40,Clouds
87899,52,1555056000,15,17,32,Clouds
87900,53,1555056000,30,10,40,Clouds
87901,54,1555056000,29,4,33,Clouds
87902,55,1555056000,28,8,36,Clouds
87903,56,1555056000,25,15,40,Clouds
87904,57,1555056000,19,4,23,Clouds
87905,58,1555056000,22,18,40,Clouds
87906,59,1555056000,20,0,20,Clouds
87907,60,1555056000,29,1,30,Clouds
87908,61,1555056000,21,4,25,Clouds
87909,62,1555056000,23,16,39,Clouds
87910,63,1555056000,29,6,35,Clouds
87911,64,1555056000,28,12,40,Clouds
87912,65,1555056000,33,7,40,Clouds
87913,66,1555056000,7,33,40,Clouds
87914,67,1555056000,21,18,39,Clouds
87915,68,1555056000,24,15,39,Clouds
87916,69,1555056000,19,21,40,Clouds
87917,70,1555056000,3,25,28,Clouds
87918,71,1555056000,38,2,40,Clouds
87919,72,1555056000,31,0,31,Clouds
87920,73,1555056000,26,4,30,Clouds
87921,74,1555056000,16,14,30,Clouds
87922,75,1555056000,29,11,40,Clouds
87923,76,1555056000,15,23,38,Clouds
87924,77,1555056000,27,2,29,Clouds
87925,78,1555056000,13,27,40,Clouds
87926,79,1555056000,8,19,27,Clouds
87927,80,1555056000,22,18,40,Clouds
87928,81,1555056000,31,9,40,Clouds
87929,82,1555056000,10,12,22,Clouds
87930,83,1555056000,28,12,40,Clouds
87931,84,1555056000,23,7,30,Clouds
87932,85,1555056000,35,0,35,Clouds
87933,86,1555056000,26,12,38,Clouds
87934,87,1555056000,22,16,38,Clouds
87935,88,1555056000,27,3,30,Clouds
87936,89,1555056000,34,6,40,Clouds
87937,90,1555056000,20,20,40,Clouds
87938,91,1555056000,23,7,30,Clouds
87939,92,1555056000,7,33,40,Clouds
87940,93,1555056000,29,11,40,Clouds
87941,94,1555056000,7,33,40,Clouds
87942,95,1555056000,30,10,40,Clouds
87943,96,1555056000,7,23,30,Clouds
87944,97,1555056000,35,5,40,Clouds
87945,98,1555056000,36,4,40,Clouds
87946,99,1555056000,25,5,30,Clouds
87947,100,1555056000,25,0,25,Clouds
87948,101,1555056000,29,1,30,Clouds
87949,102,1555056000,27,13,40,Clouds
87950,103,1555056000,19,21,40,Clouds
87951,104,1555056000,25,15,40,Clouds
87952,105,1555056000,18,18,36,Clouds
87953,106,1555056000,19,21,40,Clouds
87954,107,1555056000,40,0,40,Clouds
87955,108,1555056000,38,2,40,Clouds
87956,109,1555056000,24,5,29,Clouds
87957,110,1555056000,17,23,40,Clouds
87958,111,1555056000,29,11,40,Clouds
87959,112,1555056000,30,0,30,Clouds
87960,113,1555056000,33,7,40,Clouds
87961,114,1555056000,37,3,40,Clouds
87962,115,1555056000,19,11,30,Clouds
87963,2,1555059600,20,0,20,Clouds
87964,3,1555059600,12,8,20,Clouds
87965,4,1555059600,19,1,20,Clouds
87966,5,1555059600,40,0,40,Clouds
87967,6,1555059600,20,0,20,Clouds
87968,7,1555059600,29,0,29,Clouds
87969,8,1555059600,7,23,30,Clouds
87970,9,1555059600,24,0,24,Clouds
87971,10,1555059600,8,6,14,Clouds
87972,11,1555059600,1,29,30,Clouds
87973,12,1555059600,20,0,20,Clouds
87974,13,1555059600,4,18,22,Clouds
87975,14,1555059600,17,13,30,Clouds
87976,15,1555059600,13,3,16,Clouds
87977,16,1555059600,14,5,19,Clouds
87978,17,1555059600,20,0,20,Clouds
87979,18,1555059600,30,0,30,Clouds
87980,19,1555059600,0,30,30,Clouds
87981,21,1555059600,2,28,30,Clouds
87982,22,1555059600,14,5,19,Clouds
87983,23,1555059600,21,9,30,Clouds
87984,24,1555059600,19,1,20,Clouds
87985,25,1555059600,10,20,30,Clouds
87986,26,1555059600,3,17,20,Clouds
87987,27,1555059600,1,17,18,Clouds
87988,28,1555059600,30,0,30,Clouds
87989,29,1555059600,25,4,29,Clouds
87990,30,1555059600,20,0,20,Clouds
87991,31,1555059600,15,5,20,Clouds
87992,32,1555059600,23,7,30,Clouds
87993,33,1555059600,7,16,23,Clouds
87994,34,1555059600,30,0,30,Clouds
87995,35,1555059600,27,3,30,Clouds
87996,36,1555059600,11,28,39,Clouds
87997,37,1555059600,25,5,30,Clouds
87998,38,1555059600,31,9,40,Clouds
87999,39,1555059600,18,2,20,Clouds
88000,40,1555059600,9,12,21,Clouds
88001,41,1555059600,16,4,20,Clouds
88002,42,1555059600,27,3,30,Clouds
88003,43,1555059600,30,0,30,Clouds
88004,44,1555059600,30,0,30,Clouds
88005,45,1555059600,28,2,30,Clouds
88006,46,1555059600,19,1,20,Clouds
88007,47,1555059600,18,22,40,Clouds
88008,48,1555059600,31,9,40,Clouds
88009,49,1555059600,12,27,39,Clouds
88010,50,1555059600,40,0,40,Clouds
88011,51,1555059600,26,14,40,Clouds
88012,52,1555059600,8,24,32,Clouds
88013,53,1555059600,20,20,40,Clouds
88014,54,1555059600,26,7,33,Clouds
88015,55,1555059600,21,15,36,Clouds
88016,56,1555059600,3,37,40,Clouds
88017,57,1555059600,1,22,23,Clouds
88018,58,1555059600,0,38,38,Clouds
88019,59,1555059600,20,0,20,Clouds
88020,60,1555059600,30,0,30,Clouds
88021,61,1555059600,24,1,25,Clouds
88022,62,1555059600,3,35,38,Clouds
88023,63,1555059600,1,34,35,Clouds
88024,64,1555059600,13,27,40,Clouds
88025,65,1555059600,31,9,40,Clouds
88026,66,1555059600,6,34,40,Clouds
88027,67,1555059600,23,16,39,Clouds
88028,68,1555059600,9,30,39,Clouds
88029,69,1555059600,0,40,40,Clouds
88030,70,1555059600,1,27,28,Clouds
88031,71,1555059600,35,5,40,Clouds
88032,72,1555059600,29,2,31,Clouds
88033,73,1555059600,29,1,30,Clouds
88034,74,1555059600,27,3,30,Clouds
88035,75,1555059600,39,1,40,Clouds
88036,76,1555059600,34,4,38,Clouds
88037,77,1555059600,29,0,29,Clouds
88038,78,1555059600,40,0,40,Clouds
88039,79,1555059600,27,0,27,Clouds
88040,80,1555059600,39,1,40,Clouds
88041,81,1555059600,40,0,40,Clouds
88042,82,1555059600,22,0,22,Clouds
88043,83,1555059600,40,0,40,Clouds
88044,84,1555059600,30,0,30,Clouds
88045,85,1555059600,35,0,35,Clouds
88046,86,1555059600,38,0,38,Clouds
88047,87,1555059600,38,0,38,Clouds
88048,88,1555059600,30,0,30,Clouds
88049,89,1555059600,33,7,40,Clouds
88050,90,1555059600,11,29,40,Clouds
88051,91,1555059600,25,4,29,Clouds
88052,92,1555059600,39,1,40,Clouds
88053,93,1555059600,40,0,40,Clouds
88054,94,1555059600,39,1,40,Clouds
88055,95,1555059600,39,1,40,Clouds
88056,96,1555059600,28,2,30,Clouds
88057,97,1555059600,39,1,40,Clouds
88058,98,1555059600,35,5,40,Clouds
88059,99,1555059600,16,14,30,Clouds
88060,100,1555059600,25,0,25,Clouds
88061,101,1555059600,30,0,30,Clouds
88062,102,1555059600,40,0,40,Clouds
88063,103,1555059600,21,19,40,Clouds
88064,104,1555059600,25,15,40,Clouds
88065,105,1555059600,23,13,36,Clouds
88066,106,1555059600,40,0,40,Clouds
88067,107,1555059600,40,0,40,Clouds
88068,108,1555059600,40,0,40,Clouds
88069,109,1555059600,29,0,29,Clouds
88070,110,1555059600,26,14,40,Clouds
88071,111,1555059600,40,0,40,Clouds
88072,112,1555059600,30,0,30,Clouds
88073,113,1555059600,27,13,40,Clouds
88074,114,1555059600,18,22,40,Clouds
88075,115,1555059600,20,10,30,Clouds
88076,2,1555063200,20,0,20,Clouds
88077,3,1555063200,18,2,20,Clouds
88078,4,1555063200,17,3,20,Clouds
88079,5,1555063200,32,8,40,Clouds
88080,6,1555063200,18,2,20,Clouds
88081,7,1555063200,29,0,29,Clouds
88082,8,1555063200,3,27,30,Clouds
88083,9,1555063200,13,11,24,Clouds
88084,10,1555063200,9,5,14,Clouds
88085,11,1555063200,11,19,30,Clouds
88086,12,1555063200,20,0,20,Clouds
88087,13,1555063200,8,21,29,Clouds
88088,14,1555063200,19,11,30,Clouds
88089,15,1555063200,16,0,16,Clouds
88090,16,1555063200,15,4,19,Clouds
88091,17,1555063200,20,0,20,Clouds
88092,18,1555063200,29,1,30,Clouds
88093,19,1555063200,4,26,30,Clouds
88094,21,1555063200,1,29,30,Clouds
88095,22,1555063200,14,5,19,Clouds
88096,23,1555063200,17,13,30,Clouds
88097,24,1555063200,16,4,20,Clouds
88098,25,1555063200,0,30,30,Clouds
88099,26,1555063200,2,18,20,Clouds
88100,27,1555063200,0,18,18,Clouds
88101,28,1555063200,19,11,30,Clouds
88102,29,1555063200,18,11,29,Clouds
88103,30,1555063200,20,0,20,Clouds
88104,31,1555063200,16,4,20,Clouds
88105,32,1555063200,17,13,30,Clouds
88106,33,1555063200,6,16,22,Clouds
88107,34,1555063200,19,11,30,Clouds
88108,35,1555063200,29,1,30,Clouds
88109,36,1555063200,4,35,39,Clouds
88110,37,1555063200,22,8,30,Clouds
88111,38,1555063200,32,8,40,Clouds
88112,39,1555063200,14,6,20,Clouds
88113,40,1555063200,2,19,21,Clouds
88114,41,1555063200,16,4,20,Clouds
88115,42,1555063200,30,0,30,Clouds
88116,43,1555063200,23,7,30,Clouds
88117,44,1555063200,30,0,30,Clouds
88118,45,1555063200,29,1,30,Clouds
88119,46,1555063200,19,1,20,Clouds
88120,47,1555063200,2,38,40,Clouds
88121,48,1555063200,17,23,40,Clouds
88122,49,1555063200,8,31,39,Clouds
88123,50,1555063200,40,0,40,Clouds
88124,51,1555063200,19,21,40,Clouds
88125,52,1555063200,1,31,32,Clouds
88126,53,1555063200,13,27,40,Clouds
88127,54,1555063200,23,10,33,Clouds
88128,55,1555063200,16,20,36,Clouds
88129,56,1555063200,4,36,40,Clouds
88130,57,1555063200,0,23,23,Clouds
88131,58,1555063200,0,38,38,Clouds
88132,59,1555063200,20,0,20,Clouds
88133,60,1555063200,28,2,30,Clouds
88134,61,1555063200,24,1,25,Clouds
88135,62,1555063200,4,34,38,Clouds
88136,63,1555063200,10,25,35,Clouds
88137,64,1555063200,1,39,40,Clouds
88138,65,1555063200,12,28,40,Clouds
88139,66,1555063200,5,35,40,Clouds
88140,67,1555063200,30,9,39,Clouds
88141,68,1555063200,2,37,39,Clouds
88142,69,1555063200,1,39,40,Clouds
88143,70,1555063200,1,27,28,Clouds
88144,71,1555063200,31,9,40,Clouds
88145,72,1555063200,31,0,31,Clouds
88146,73,1555063200,30,0,30,Clouds
88147,74,1555063200,30,0,30,Clouds
88148,75,1555063200,40,0,40,Clouds
88149,76,1555063200,37,1,38,Clouds
88150,77,1555063200,26,3,29,Clouds
88151,78,1555063200,40,0,40,Clouds
88152,79,1555063200,26,1,27,Clouds
88153,80,1555063200,40,0,40,Clouds
88154,81,1555063200,40,0,40,Clouds
88155,82,1555063200,22,0,22,Clouds
88156,83,1555063200,40,0,40,Clouds
88157,84,1555063200,30,0,30,Clouds
88158,85,1555063200,29,6,35,Clouds
88159,86,1555063200,35,3,38,Clouds
88160,87,1555063200,38,0,38,Clouds
88161,88,1555063200,30,0,30,Clouds
88162,89,1555063200,28,12,40,Clouds
88163,90,1555063200,4,36,40,Clouds
88164,91,1555063200,16,13,29,Clouds
88165,92,1555063200,40,0,40,Clouds
88166,93,1555063200,40,0,40,Clouds
88167,94,1555063200,38,2,40,Clouds
88168,95,1555063200,40,0,40,Clouds
88169,96,1555063200,29,1,30,Clouds
88170,97,1555063200,40,0,40,Clouds
88171,98,1555063200,24,16,40,Clouds
88172,99,1555063200,15,15,30,Clouds
88173,100,1555063200,21,4,25,Clouds
88174,101,1555063200,30,0,30,Clouds
88175,102,1555063200,40,0,40,Clouds
88176,103,1555063200,18,22,40,Clouds
88177,104,1555063200,24,16,40,Clouds
88178,105,1555063200,30,6,36,Clouds
88179,106,1555063200,40,0,40,Clouds
88180,107,1555063200,40,0,40,Clouds
88181,108,1555063200,40,0,40,Clouds
88182,109,1555063200,28,1,29,Clouds
88183,110,1555063200,31,9,40,Clouds
88184,111,1555063200,40,0,40,Clouds
88185,112,1555063200,30,0,30,Clouds
88186,113,1555063200,13,27,40,Clouds
88187,114,1555063200,0,40,40,Clouds
88188,115,1555063200,29,1,30,Clouds
88189,2,1555066800,20,0,20,Clouds
88190,3,1555066800,14,6,20,Clouds
88191,4,1555066800,18,2,20,Clouds
88192,5,1555066800,36,4,40,Clouds
88193,6,1555066800,16,4,20,Clouds
88194,7,1555066800,28,1,29,Clouds
88195,8,1555066800,12,18,30,Clouds
88196,9,1555066800,11,13,24,Clouds
88197,10,1555066800,14,2,16,Clouds
88198,11,1555066800,8,22,30,Clouds
88199,12,1555066800,12,8,20,Clouds
88200,13,1555066800,11,18,29,Clouds
88201,14,1555066800,15,15,30,Clouds
88202,15,1555066800,15,1,16,Clouds
88203,16,1555066800,13,6,19,Clouds
88204,17,1555066800,15,5,20,Clouds
88205,18,1555066800,30,0,30,Clouds
88206,19,1555066800,2,28,30,Clouds
88207,21,1555066800,0,30,30,Clouds
88208,22,1555066800,10,9,19,Clouds
88209,23,1555066800,17,13,30,Clouds
88210,24,1555066800,20,0,20,Clouds
88211,25,1555066800,7,23,30,Clouds
88212,26,1555066800,2,18,20,Clouds
88213,27,1555066800,4,16,20,Clouds
88214,28,1555066800,29,1,30,Clouds
88215,29,1555066800,20,9,29,Clouds
88216,30,1555066800,20,0,20,Clouds
88217,31,1555066800,16,4,20,Clouds
88218,32,1555066800,11,19,30,Clouds
88219,33,1555066800,12,11,23,Clouds
88220,34,1555066800,28,2,30,Clouds
88221,35,1555066800,28,2,30,Clouds
88222,36,1555066800,3,37,40,Clouds
88223,37,1555066800,18,12,30,Clouds
88224,38,1555066800,28,12,40,Clouds
88225,39,1555066800,17,3,20,Clouds
88226,40,1555066800,1,20,21,Clouds
88227,41,1555066800,17,3,20,Clouds
88228,42,1555066800,30,0,30,Clouds
88229,43,1555066800,27,3,30,Clouds
88230,44,1555066800,30,0,30,Clouds
88231,45,1555066800,30,0,30,Clouds
88232,46,1555066800,19,1,20,Clouds
88233,47,1555066800,0,40,40,Clouds
88234,48,1555066800,11,29,40,Clouds
88235,49,1555066800,11,28,39,Clouds
88236,50,1555066800,40,0,40,Clouds
88237,51,1555066800,19,21,40,Clouds
88238,52,1555066800,1,31,32,Clouds
88239,53,1555066800,13,27,40,Clouds
88240,54,1555066800,22,11,33,Clouds
88241,55,1555066800,15,21,36,Clouds
88242,56,1555066800,2,38,40,Clouds
88243,57,1555066800,1,22,23,Clouds
88244,58,1555066800,14,24,38,Clouds
88245,59,1555066800,19,1,20,Clouds
88246,60,1555066800,30,0,30,Clouds
88247,61,1555066800,25,0,25,Clouds
88248,62,1555066800,3,35,38,Clouds
88249,63,1555066800,13,22,35,Clouds
88250,64,1555066800,3,37,40,Clouds
88251,65,1555066800,12,28,40,Clouds
88252,66,1555066800,7,33,40,Clouds
88253,67,1555066800,31,8,39,Clouds
88254,68,1555066800,8,31,39,Clouds
88255,69,1555066800,0,40,40,Clouds
88256,70,1555066800,2,26,28,Clouds
88257,71,1555066800,35,5,40,Clouds
88258,72,1555066800,31,0,31,Clouds
88259,73,1555066800,30,0,30,Clouds
88260,74,1555066800,30,0,30,Clouds
88261,75,1555066800,40,0,40,Clouds
88262,76,1555066800,38,0,38,Clouds
88263,77,1555066800,29,0,29,Clouds
88264,78,1555066800,39,1,40,Clouds
88265,79,1555066800,23,4,27,Clouds
88266,80,1555066800,34,6,40,Clouds
88267,81,1555066800,40,0,40,Clouds
88268,82,1555066800,22,0,22,Clouds
88269,83,1555066800,40,0,40,Clouds
88270,84,1555066800,30,0,30,Clouds
88271,85,1555066800,35,0,35,Clouds
88272,86,1555066800,37,1,38,Clouds
88273,87,1555066800,38,0,38,Clouds
88274,88,1555066800,30,0,30,Clouds
88275,89,1555066800,25,15,40,Clouds
88276,90,1555066800,7,33,40,Clouds
88277,91,1555066800,18,11,29,Clouds
88278,92,1555066800,40,0,40,Clouds
88279,93,1555066800,40,0,40,Clouds
88280,94,1555066800,39,1,40,Clouds
88281,95,1555066800,39,1,40,Clouds
88282,96,1555066800,30,0,30,Clouds
88283,97,1555066800,38,2,40,Clouds
88284,98,1555066800,19,21,40,Clouds
88285,99,1555066800,9,21,30,Clouds
88286,100,1555066800,23,2,25,Clouds
88287,101,1555066800,29,1,30,Clouds
88288,102,1555066800,39,1,40,Clouds
88289,103,1555066800,19,21,40,Clouds
88290,104,1555066800,25,15,40,Clouds
88291,105,1555066800,32,4,36,Clouds
88292,106,1555066800,40,0,40,Clouds
88293,107,1555066800,40,0,40,Clouds
88294,108,1555066800,40,0,40,Clouds
88295,109,1555066800,29,0,29,Clouds
88296,110,1555066800,37,3,40,Clouds
88297,111,1555066800,39,1,40,Clouds
88298,112,1555066800,30,0,30,Clouds
88299,113,1555066800,12,28,40,Clouds
88300,114,1555066800,1,39,40,Clouds
88301,115,1555066800,29,1,30,Clouds
88302,2,1555070400,20,0,20,Clouds
88303,3,1555070400,15,5,20,Clouds
88304,4,1555070400,18,2,20,Clouds
88305,5,1555070400,39,1,40,Clouds
88306,6,1555070400,17,3,20,Clouds
88307,7,1555070400,27,2,29,Clouds
88308,8,1555070400,17,13,30,Clouds
88309,9,1555070400,6,18,24,Clouds
88310,10,1555070400,9,7,16,Clouds
88311,11,1555070400,10,20,30,Clouds
88312,12,1555070400,16,4,20,Clouds
88313,13,1555070400,13,17,30,Clouds
88314,14,1555070400,7,23,30,Clouds
88315,15,1555070400,16,0,16,Clouds
88316,16,1555070400,14,5,19,Clouds
88317,17,1555070400,10,10,20,Clouds
88318,18,1555070400,29,1,30,Clouds
88319,19,1555070400,0,30,30,Clouds
88320,21,1555070400,1,29,30,Clouds
88321,22,1555070400,9,10,19,Clouds
88322,23,1555070400,15,15,30,Clouds
88323,24,1555070400,19,1,20,Clouds
88324,25,1555070400,11,19,30,Clouds
88325,26,1555070400,0,20,20,Clouds
88326,27,1555070400,0,20,20,Clouds
88327,28,1555070400,22,8,30,Clouds
88328,29,1555070400,21,8,29,Clouds
88329,30,1555070400,18,2,20,Clouds
88330,31,1555070400,14,6,20,Clouds
88331,32,1555070400,7,23,30,Clouds
88332,33,1555070400,12,11,23,Clouds
88333,34,1555070400,28,2,30,Clouds
88334,35,1555070400,28,2,30,Clouds
88335,36,1555070400,0,40,40,Clouds
88336,37,1555070400,23,7,30,Clouds
88337,38,1555070400,29,11,40,Clouds
88338,39,1555070400,20,0,20,Clouds
88339,40,1555070400,7,14,21,Clouds
88340,41,1555070400,16,4,20,Clouds
88341,42,1555070400,30,0,30,Clouds
88342,43,1555070400,28,2,30,Clouds
88343,44,1555070400,29,1,30,Clouds
88344,45,1555070400,27,3,30,Clouds
88345,46,1555070400,20,0,20,Clouds
88346,47,1555070400,2,38,40,Clouds
88347,48,1555070400,7,33,40,Clouds
88348,49,1555070400,23,16,39,Clouds
88349,50,1555070400,40,0,40,Clouds
88350,51,1555070400,17,23,40,Clouds
88351,52,1555070400,6,26,32,Clouds
88352,53,1555070400,11,29,40,Clouds
88353,54,1555070400,23,10,33,Clouds
88354,55,1555070400,15,21,36,Clouds
88355,56,1555070400,0,40,40,Clouds
88356,57,1555070400,2,21,23,Clouds
88357,58,1555070400,19,21,40,Clouds
88358,59,1555070400,20,0,20,Clouds
88359,60,1555070400,27,3,30,Clouds
88360,61,1555070400,25,0,25,Clouds
88361,62,1555070400,2,38,40,Clouds
88362,63,1555070400,10,25,35,Clouds
88363,64,1555070400,1,39,40,Clouds
88364,65,1555070400,11,29,40,Clouds
88365,66,1555070400,11,29,40,Clouds
88366,67,1555070400,33,6,39,Clouds
88367,68,1555070400,12,28,40,Clouds
88368,69,1555070400,0,40,40,Clouds
88369,70,1555070400,4,24,28,Clouds
88370,71,1555070400,39,1,40,Clouds
88371,72,1555070400,30,1,31,Clouds
88372,73,1555070400,30,0,30,Clouds
88373,74,1555070400,30,0,30,Clouds
88374,75,1555070400,40,0,40,Clouds
88375,76,1555070400,37,1,38,Clouds
88376,77,1555070400,29,0,29,Clouds
88377,78,1555070400,40,0,40,Clouds
88378,79,1555070400,26,1,27,Clouds
88379,80,1555070400,39,1,40,Clouds
88380,81,1555070400,40,0,40,Clouds
88381,82,1555070400,22,0,22,Clouds
88382,83,1555070400,40,0,40,Clouds
88383,84,1555070400,30,0,30,Clouds
88384,85,1555070400,35,0,35,Clouds
88385,86,1555070400,38,0,38,Clouds
88386,87,1555070400,38,0,38,Clouds
88387,88,1555070400,30,0,30,Clouds
88388,89,1555070400,23,17,40,Clouds
88389,90,1555070400,10,30,40,Clouds
88390,91,1555070400,16,14,30,Clouds
88391,92,1555070400,39,1,40,Clouds
88392,93,1555070400,40,0,40,Clouds
88393,94,1555070400,39,1,40,Clouds
88394,95,1555070400,38,2,40,Clouds
88395,96,1555070400,30,0,30,Clouds
88396,97,1555070400,40,0,40,Clouds
88397,98,1555070400,21,19,40,Clouds
88398,99,1555070400,9,21,30,Clouds
88399,100,1555070400,23,2,25,Clouds
88400,101,1555070400,30,0,30,Clouds
88401,102,1555070400,40,0,40,Clouds
88402,103,1555070400,18,22,40,Clouds
88403,104,1555070400,25,15,40,Clouds
88404,105,1555070400,32,4,36,Clouds
88405,106,1555070400,40,0,40,Clouds
88406,107,1555070400,25,15,40,Clouds
88407,108,1555070400,40,0,40,Clouds
88408,109,1555070400,29,0,29,Clouds
88409,110,1555070400,40,0,40,Clouds
88410,111,1555070400,33,7,40,Clouds
88411,112,1555070400,27,3,30,Clouds
88412,113,1555070400,11,29,40,Clouds
88413,114,1555070400,5,35,40,Clouds
88414,115,1555070400,26,4,30,Clouds
88415,2,1555074000,20,0,20,Clouds
88416,3,1555074000,18,2,20,Clouds
88417,4,1555074000,20,0,20,Clouds
88418,5,1555074000,28,12,40,Clouds
88419,6,1555074000,20,0,20,Clouds
88420,7,1555074000,13,16,29,Clouds
88421,8,1555074000,24,6,30,Clouds
88422,9,1555074000,4,20,24,Clouds
88423,10,1555074000,6,10,16,Clouds
88424,11,1555074000,18,12,30,Clouds
88425,12,1555074000,17,3,20,Clouds
88426,13,1555074000,19,11,30,Clouds
88427,14,1555074000,2,28,30,Clouds
88428,15,1555074000,14,2,16,Clouds
88429,16,1555074000,12,8,20,Clouds
88430,17,1555074000,14,6,20,Clouds
88431,18,1555074000,23,7,30,Clouds
88432,19,1555074000,13,17,30,Clouds
88433,21,1555074000,13,17,30,Clouds
88434,22,1555074000,5,15,20,Clouds
88435,23,1555074000,16,14,30,Clouds
88436,24,1555074000,20,0,20,Clouds
88437,25,1555074000,12,18,30,Clouds
88438,26,1555074000,1,19,20,Clouds
88439,27,1555074000,2,18,20,Clouds
88440,28,1555074000,30,0,30,Clouds
88441,29,1555074000,18,11,29,Clouds
88442,30,1555074000,19,1,20,Clouds
88443,31,1555074000,11,9,20,Clouds
88444,32,1555074000,10,20,30,Clouds
88445,33,1555074000,8,15,23,Clouds
88446,34,1555074000,30,0,30,Clouds
88447,35,1555074000,30,0,30,Clouds
88448,36,1555074000,11,29,40,Clouds
88449,37,1555074000,27,3,30,Clouds
88450,38,1555074000,28,12,40,Clouds
88451,39,1555074000,20,0,20,Clouds
88452,40,1555074000,10,11,21,Clouds
88453,41,1555074000,20,0,20,Clouds
88454,42,1555074000,30,0,30,Clouds
88455,43,1555074000,30,0,30,Clouds
88456,44,1555074000,30,0,30,Clouds
88457,45,1555074000,29,1,30,Clouds
88458,46,1555074000,13,7,20,Clouds
88459,47,1555074000,12,28,40,Clouds
88460,48,1555074000,7,33,40,Clouds
88461,49,1555074000,26,14,40,Clouds
88462,50,1555074000,39,1,40,Clouds
88463,51,1555074000,8,32,40,Clouds
88464,52,1555074000,4,28,32,Clouds
88465,53,1555074000,6,34,40,Clouds
88466,54,1555074000,24,9,33,Clouds
88467,55,1555074000,20,16,36,Clouds
88468,56,1555074000,9,31,40,Clouds
88469,57,1555074000,2,21,23,Clouds
88470,58,1555074000,22,18,40,Clouds
88471,59,1555074000,20,0,20,Clouds
88472,60,1555074000,29,1,30,Clouds
88473,61,1555074000,24,1,25,Clouds
88474,62,1555074000,14,26,40,Clouds
88475,63,1555074000,9,26,35,Clouds
88476,64,1555074000,1,39,40,Clouds
88477,65,1555074000,26,14,40,Clouds
88478,66,1555074000,19,21,40,Clouds
88479,67,1555074000,36,4,40,Clouds
88480,68,1555074000,14,26,40,Clouds
88481,69,1555074000,4,36,40,Clouds
88482,70,1555074000,2,26,28,Clouds
88483,71,1555074000,36,4,40,Clouds
88484,72,1555074000,30,1,31,Clouds
88485,73,1555074000,25,5,30,Clouds
88486,74,1555074000,30,0,30,Clouds
88487,75,1555074000,37,3,40,Clouds
88488,76,1555074000,37,1,38,Clouds
88489,77,1555074000,28,1,29,Clouds
88490,78,1555074000,40,0,40,Clouds
88491,79,1555074000,27,0,27,Clouds
88492,80,1555074000,37,3,40,Clouds
88493,81,1555074000,25,15,40,Clouds
88494,82,1555074000,22,0,22,Clouds
88495,83,1555074000,40,0,40,Clouds
88496,84,1555074000,30,0,30,Clouds
88497,85,1555074000,34,1,35,Clouds
88498,86,1555074000,36,2,38,Clouds
88499,87,1555074000,38,0,38,Clouds
88500,88,1555074000,30,0,30,Clouds
88501,89,1555074000,25,15,40,Clouds
88502,90,1555074000,17,23,40,Clouds
88503,91,1555074000,17,13,30,Clouds
88504,92,1555074000,37,3,40,Clouds
88505,93,1555074000,40,0,40,Clouds
88506,94,1555074000,40,0,40,Clouds
88507,95,1555074000,39,1,40,Clouds
88508,96,1555074000,30,0,30,Clouds
88509,97,1555074000,39,1,40,Clouds
88510,98,1555074000,16,24,40,Clouds
88511,99,1555074000,11,19,30,Clouds
88512,100,1555074000,22,3,25,Clouds
88513,101,1555074000,29,1,30,Clouds
88514,102,1555074000,40,0,40,Clouds
88515,103,1555074000,20,20,40,Clouds
88516,104,1555074000,25,15,40,Clouds
88517,105,1555074000,33,3,36,Clouds
88518,106,1555074000,40,0,40,Clouds
88519,107,1555074000,32,8,40,Clouds
88520,108,1555074000,40,0,40,Clouds
88521,109,1555074000,29,0,29,Clouds
88522,110,1555074000,40,0,40,Clouds
88523,111,1555074000,40,0,40,Clouds
88524,112,1555074000,26,4,30,Clouds
88525,113,1555074000,7,33,40,Clouds
88526,114,1555074000,11,29,40,Clouds
88527,115,1555074000,24,6,30,Clouds
88528,2,1555077600,20,0,20,Clouds
88529,3,1555077600,13,7,20,Clouds
88530,4,1555077600,20,0,20,Clouds
88531,5,1555077600,34,6,40,Clouds
88532,6,1555077600,17,3,20,Clouds
88533,7,1555077600,22,7,29,Clouds
88534,8,1555077600,15,15,30,Clouds
88535,9,1555077600,13,11,24,Clouds
88536,10,1555077600,0,16,16,Clouds
88537,11,1555077600,26,4,30,Clouds
88538,12,1555077600,17,3,20,Clouds
88539,13,1555077600,23,7,30,Clouds
88540,14,1555077600,0,30,30,Clouds
88541,15,1555077600,8,8,16,Clouds
88542,16,1555077600,13,7,20,Clouds
88543,17,1555077600,14,6,20,Clouds
88544,18,1555077600,25,5,30,Clouds
88545,19,1555077600,5,25,30,Clouds
88546,21,1555077600,14,16,30,Clouds
88547,22,1555077600,4,16,20,Clouds
88548,23,1555077600,16,14,30,Clouds
88549,24,1555077600,18,2,20,Clouds
88550,25,1555077600,9,21,30,Clouds
88551,26,1555077600,0,20,20,Clouds
88552,27,1555077600,4,16,20,Clouds
88553,28,1555077600,30,0,30,Clouds
88554,29,1555077600,14,15,29,Clouds
88555,30,1555077600,19,1,20,Clouds
88556,31,1555077600,8,12,20,Clouds
88557,32,1555077600,10,20,30,Clouds
88558,33,1555077600,18,5,23,Clouds
88559,34,1555077600,28,2,30,Clouds
88560,35,1555077600,24,6,30,Clouds
88561,36,1555077600,5,35,40,Clouds
88562,37,1555077600,25,5,30,Clouds
88563,38,1555077600,13,27,40,Clouds
88564,39,1555077600,18,2,20,Clouds
88565,40,1555077600,5,16,21,Clouds
88566,41,1555077600,18,2,20,Clouds
88567,42,1555077600,29,1,30,Clouds
88568,43,1555077600,26,4,30,Clouds
88569,44,1555077600,30,0,30,Clouds
88570,45,1555077600,27,3,30,Clouds
88571,46,1555077600,11,9,20,Clouds
88572,47,1555077600,8,32,40,Clouds
88573,48,1555077600,11,29,40,Clouds
88574,49,1555077600,19,21,40,Clouds
88575,50,1555077600,39,1,40,Clouds
88576,51,1555077600,10,30,40,Clouds
88577,52,1555077600,4,28,32,Clouds
88578,53,1555077600,7,33,40,Clouds
88579,54,1555077600,23,10,33,Clouds
88580,55,1555077600,21,15,36,Clouds
88581,56,1555077600,15,25,40,Clouds
88582,57,1555077600,1,22,23,Clouds
88583,58,1555077600,17,23,40,Clouds
88584,59,1555077600,9,11,20,Clouds
88585,60,1555077600,29,1,30,Clouds
88586,61,1555077600,19,6,25,Clouds
88587,62,1555077600,12,28,40,Clouds
88588,63,1555077600,5,30,35,Clouds
88589,64,1555077600,5,35,40,Clouds
88590,65,1555077600,22,18,40,Clouds
88591,66,1555077600,16,24,40,Clouds
88592,67,1555077600,34,6,40,Clouds
88593,68,1555077600,15,25,40,Clouds
88594,69,1555077600,5,35,40,Clouds
88595,70,1555077600,4,24,28,Clouds
88596,71,1555077600,37,3,40,Clouds
88597,72,1555077600,30,1,31,Clouds
88598,73,1555077600,28,2,30,Clouds
88599,74,1555077600,28,2,30,Clouds
88600,75,1555077600,38,2,40,Clouds
88601,76,1555077600,38,0,38,Clouds
88602,77,1555077600,24,5,29,Clouds
88603,78,1555077600,38,2,40,Clouds
88604,79,1555077600,27,0,27,Clouds
88605,80,1555077600,38,2,40,Clouds
88606,81,1555077600,30,10,40,Clouds
88607,82,1555077600,22,0,22,Clouds
88608,83,1555077600,40,0,40,Clouds
88609,84,1555077600,30,0,30,Clouds
88610,85,1555077600,34,1,35,Clouds
88611,86,1555077600,36,2,38,Clouds
88612,87,1555077600,37,1,38,Clouds
88613,88,1555077600,30,0,30,Clouds
88614,89,1555077600,29,11,40,Clouds
88615,90,1555077600,18,22,40,Clouds
88616,91,1555077600,22,8,30,Clouds
88617,92,1555077600,39,1,40,Clouds
88618,93,1555077600,40,0,40,Clouds
88619,94,1555077600,40,0,40,Clouds
88620,95,1555077600,37,3,40,Clouds
88621,96,1555077600,29,1,30,Clouds
88622,97,1555077600,38,2,40,Clouds
88623,98,1555077600,15,25,40,Clouds
88624,99,1555077600,12,18,30,Clouds
88625,100,1555077600,20,5,25,Clouds
88626,101,1555077600,29,1,30,Clouds
88627,102,1555077600,36,4,40,Clouds
88628,103,1555077600,21,19,40,Clouds
88629,104,1555077600,25,15,40,Clouds
88630,105,1555077600,32,4,36,Clouds
88631,106,1555077600,39,1,40,Clouds
88632,107,1555077600,40,0,40,Clouds
88633,108,1555077600,40,0,40,Clouds
88634,109,1555077600,29,0,29,Clouds
88635,110,1555077600,35,5,40,Clouds
88636,111,1555077600,32,8,40,Clouds
88637,112,1555077600,24,6,30,Clouds
88638,113,1555077600,10,30,40,Clouds
88639,114,1555077600,9,31,40,Clouds
88640,115,1555077600,28,2,30,Clouds
88641,2,1555081200,20,0,20,Clouds
88642,3,1555081200,11,9,20,Clouds
88643,4,1555081200,20,0,20,Clouds
88644,5,1555081200,37,3,40,Clouds
88645,6,1555081200,17,3,20,Clouds
88646,7,1555081200,27,2,29,Clouds
88647,8,1555081200,8,22,30,Clouds
88648,9,1555081200,16,8,24,Clouds
88649,10,1555081200,5,11,16,Clouds
88650,11,1555081200,26,4,30,Clouds
88651,12,1555081200,17,3,20,Clouds
88652,13,1555081200,22,8,30,Clouds
88653,14,1555081200,1,29,30,Clouds
88654,15,1555081200,11,5,16,Clouds
88655,16,1555081200,19,1,20,Clouds
88656,17,1555081200,15,5,20,Clouds
88657,18,1555081200,28,1,29,Clouds
88658,19,1555081200,4,26,30,Clouds
88659,21,1555081200,14,16,30,Clouds
88660,22,1555081200,16,4,20,Clouds
88661,23,1555081200,14,16,30,Clouds
88662,24,1555081200,14,6,20,Clouds
88663,25,1555081200,10,20,30,Clouds
88664,26,1555081200,0,20,20,Clouds
88665,27,1555081200,2,18,20,Clouds
88666,28,1555081200,30,0,30,Clouds
88667,29,1555081200,11,18,29,Clouds
88668,30,1555081200,20,0,20,Clouds
88669,31,1555081200,6,14,20,Clouds
88670,32,1555081200,20,10,30,Clouds
88671,33,1555081200,12,11,23,Clouds
88672,34,1555081200,27,3,30,Clouds
88673,35,1555081200,27,3,30,Clouds
88674,36,1555081200,5,35,40,Clouds
88675,37,1555081200,25,5,30,Clouds
88676,38,1555081200,17,23,40,Clouds
88677,39,1555081200,10,10,20,Clouds
88678,40,1555081200,10,11,21,Clouds
88679,41,1555081200,12,8,20,Clouds
88680,42,1555081200,23,7,30,Clouds
88681,43,1555081200,27,3,30,Clouds
88682,44,1555081200,28,2,30,Clouds
88683,45,1555081200,26,4,30,Clouds
88684,46,1555081200,15,5,20,Clouds
88685,47,1555081200,10,30,40,Clouds
88686,48,1555081200,15,25,40,Clouds
88687,49,1555081200,18,22,40,Clouds
88688,50,1555081200,37,3,40,Clouds
88689,51,1555081200,9,31,40,Clouds
88690,52,1555081200,0,32,32,Clouds
88691,53,1555081200,8,32,40,Clouds
88692,54,1555081200,22,11,33,Clouds
88693,55,1555081200,24,12,36,Clouds
88694,56,1555081200,4,36,40,Clouds
88695,57,1555081200,0,23,23,Clouds
88696,58,1555081200,17,23,40,Clouds
88697,59,1555081200,18,2,20,Clouds
88698,60,1555081200,29,1,30,Clouds
88699,61,1555081200,23,2,25,Clouds
88700,62,1555081200,11,29,40,Clouds
88701,63,1555081200,0,35,35,Clouds
88702,64,1555081200,10,30,40,Clouds
88703,65,1555081200,19,21,40,Clouds
88704,66,1555081200,15,25,40,Clouds
88705,67,1555081200,31,9,40,Clouds
88706,68,1555081200,19,21,40,Clouds
88707,69,1555081200,8,32,40,Clouds
88708,70,1555081200,5,23,28,Clouds
88709,71,1555081200,35,5,40,Clouds
88710,72,1555081200,6,25,31,Clouds
88711,73,1555081200,29,1,30,Clouds
88712,74,1555081200,30,0,30,Clouds
88713,75,1555081200,40,0,40,Clouds
88714,76,1555081200,37,1,38,Clouds
88715,77,1555081200,26,3,29,Clouds
88716,78,1555081200,39,1,40,Clouds
88717,79,1555081200,25,2,27,Clouds
88718,80,1555081200,40,0,40,Clouds
88719,81,1555081200,30,10,40,Clouds
88720,82,1555081200,21,1,22,Clouds
88721,83,1555081200,39,1,40,Clouds
88722,84,1555081200,28,2,30,Clouds
88723,85,1555081200,33,2,35,Clouds
88724,86,1555081200,36,2,38,Clouds
88725,87,1555081200,38,0,38,Clouds
88726,88,1555081200,30,0,30,Clouds
88727,89,1555081200,33,7,40,Clouds
88728,90,1555081200,21,19,40,Clouds
88729,91,1555081200,24,6,30,Clouds
88730,92,1555081200,36,4,40,Clouds
88731,93,1555081200,39,1,40,Clouds
88732,94,1555081200,38,2,40,Clouds
88733,95,1555081200,40,0,40,Clouds
88734,96,1555081200,28,2,30,Clouds
88735,97,1555081200,35,5,40,Clouds
88736,98,1555081200,17,23,40,Clouds
88737,99,1555081200,11,19,30,Clouds
88738,100,1555081200,10,15,25,Clouds
88739,101,1555081200,30,0,30,Clouds
88740,102,1555081200,38,2,40,Clouds
88741,103,1555081200,22,18,40,Clouds
88742,104,1555081200,24,16,40,Clouds
88743,105,1555081200,32,4,36,Clouds
88744,106,1555081200,37,3,40,Clouds
88745,107,1555081200,37,3,40,Clouds
88746,108,1555081200,39,1,40,Clouds
88747,109,1555081200,26,3,29,Clouds
88748,110,1555081200,33,7,40,Clouds
88749,111,1555081200,36,4,40,Clouds
88750,112,1555081200,24,6,30,Clouds
88751,113,1555081200,10,30,40,Clouds
88752,114,1555081200,19,21,40,Clouds
88753,115,1555081200,26,4,30,Clouds
88754,2,1555084800,19,1,20,Clouds
88755,3,1555084800,15,5,20,Clouds
88756,4,1555084800,20,0,20,Clouds
88757,5,1555084800,35,5,40,Clouds
88758,6,1555084800,13,7,20,Clouds
88759,7,1555084800,25,4,29,Clouds
88760,8,1555084800,3,27,30,Clouds
88761,9,1555084800,13,11,24,Clouds
88762,10,1555084800,1,15,16,Clouds
88763,11,1555084800,17,13,30,Clouds
88764,12,1555084800,20,0,20,Clouds
88765,13,1555084800,21,9,30,Clouds
88766,14,1555084800,21,9,30,Clouds
88767,15,1555084800,13,3,16,Clouds
88768,16,1555084800,18,2,20,Clouds
88769,17,1555084800,19,1,20,Clouds
88770,18,1555084800,28,1,29,Clouds
88771,19,1555084800,11,19,30,Clouds
88772,21,1555084800,17,13,30,Clouds
88773,22,1555084800,15,5,20,Clouds
88774,23,1555084800,6,24,30,Clouds
88775,24,1555084800,14,6,20,Clouds
88776,25,1555084800,15,15,30,Clouds
88777,26,1555084800,2,18,20,Clouds
88778,27,1555084800,11,9,20,Clouds
88779,28,1555084800,30,0,30,Clouds
88780,29,1555084800,16,13,29,Clouds
88781,30,1555084800,19,1,20,Clouds
88782,31,1555084800,9,11,20,Clouds
88783,32,1555084800,18,12,30,Clouds
88784,33,1555084800,1,22,23,Clouds
88785,34,1555084800,21,9,30,Clouds
88786,35,1555084800,28,2,30,Clouds
88787,36,1555084800,5,35,40,Clouds
88788,37,1555084800,24,6,30,Clouds
88789,38,1555084800,20,20,40,Clouds
88790,39,1555084800,6,14,20,Clouds
88791,40,1555084800,9,12,21,Clouds
88792,41,1555084800,15,5,20,Clouds
88793,42,1555084800,26,4,30,Clouds
88794,43,1555084800,21,9,30,Clouds
88795,44,1555084800,28,2,30,Clouds
88796,45,1555084800,23,7,30,Clouds
88797,46,1555084800,13,7,20,Clouds
88798,47,1555084800,14,26,40,Clouds
88799,48,1555084800,5,35,40,Clouds
88800,49,1555084800,27,13,40,Clouds
88801,50,1555084800,33,7,40,Clouds
88802,51,1555084800,9,31,40,Clouds
88803,52,1555084800,23,9,32,Clouds
88804,53,1555084800,7,33,40,Clouds
88805,54,1555084800,26,7,33,Clouds
88806,55,1555084800,27,9,36,Clouds
88807,56,1555084800,5,35,40,Clouds
88808,57,1555084800,3,20,23,Clouds
88809,58,1555084800,4,36,40,Clouds
88810,59,1555084800,20,0,20,Clouds
88811,60,1555084800,18,12,30,Clouds
88812,61,1555084800,22,3,25,Clouds
88813,62,1555084800,16,24,40,Clouds
88814,63,1555084800,4,31,35,Clouds
88815,64,1555084800,11,29,40,Clouds
88816,65,1555084800,21,19,40,Clouds
88817,66,1555084800,26,14,40,Clouds
88818,67,1555084800,25,15,40,Clouds
88819,68,1555084800,17,23,40,Clouds
88820,69,1555084800,6,34,40,Clouds
88821,70,1555084800,5,23,28,Clouds
88822,71,1555084800,36,4,40,Clouds
88823,72,1555084800,6,25,31,Clouds
88824,73,1555084800,26,4,30,Clouds
88825,74,1555084800,27,3,30,Clouds
88826,75,1555084800,39,1,40,Clouds
88827,76,1555084800,38,0,38,Clouds
88828,77,1555084800,26,3,29,Clouds
88829,78,1555084800,39,1,40,Clouds
88830,79,1555084800,27,0,27,Clouds
88831,80,1555084800,27,13,40,Clouds
88832,81,1555084800,33,7,40,Clouds
88833,82,1555084800,21,1,22,Clouds
88834,83,1555084800,39,1,40,Clouds
88835,84,1555084800,30,0,30,Clouds
88836,85,1555084800,35,0,35,Clouds
88837,86,1555084800,34,4,38,Clouds
88838,87,1555084800,38,0,38,Clouds
88839,88,1555084800,30,0,30,Clouds
88840,89,1555084800,33,7,40,Clouds
88841,90,1555084800,23,17,40,Clouds
88842,91,1555084800,30,0,30,Clouds
88843,92,1555084800,30,10,40,Clouds
88844,93,1555084800,36,4,40,Clouds
88845,94,1555084800,38,2,40,Clouds
88846,95,1555084800,40,0,40,Clouds
88847,96,1555084800,28,2,30,Clouds
88848,97,1555084800,35,5,40,Clouds
88849,98,1555084800,22,18,40,Clouds
88850,99,1555084800,12,18,30,Clouds
88851,100,1555084800,11,14,25,Clouds
88852,101,1555084800,30,0,30,Clouds
88853,102,1555084800,39,1,40,Clouds
88854,103,1555084800,26,14,40,Clouds
88855,104,1555084800,24,16,40,Clouds
88856,105,1555084800,33,3,36,Clouds
88857,106,1555084800,37,3,40,Clouds
88858,107,1555084800,37,3,40,Clouds
88859,108,1555084800,38,2,40,Clouds
88860,109,1555084800,25,4,29,Clouds
88861,110,1555084800,36,4,40,Clouds
88862,111,1555084800,37,3,40,Clouds
88863,112,1555084800,27,3,30,Clouds
88864,113,1555084800,17,23,40,Clouds
88865,114,1555084800,22,18,40,Clouds
88866,115,1555084800,23,7,30,Clouds
88867,2,1555088400,20,0,20,Clouds
88868,3,1555088400,20,0,20,Clouds
88869,4,1555088400,19,1,20,Clouds
88870,5,1555088400,26,14,40,Clouds
88871,6,1555088400,15,5,20,Clouds
88872,7,1555088400,25,4,29,Clouds
88873,8,1555088400,2,28,30,Clouds
88874,9,1555088400,0,24,24,Clouds
88875,10,1555088400,2,14,16,Clouds
88876,11,1555088400,30,0,30,Clouds
88877,12,1555088400,16,4,20,Clouds
88878,13,1555088400,30,0,30,Clouds
88879,14,1555088400,17,13,30,Clouds
88880,15,1555088400,16,0,16,Clouds
88881,16,1555088400,8,12,20,Clouds
88882,17,1555088400,20,0,20,Clouds
88883,18,1555088400,28,1,29,Clouds
88884,19,1555088400,28,2,30,Clouds
88885,21,1555088400,17,13,30,Clouds
88886,22,1555088400,8,12,20,Clouds
88887,23,1555088400,0,30,30,Clouds
88888,24,1555088400,6,14,20,Clouds
88889,25,1555088400,27,3,30,Clouds
88890,26,1555088400,3,17,20,Clouds
88891,27,1555088400,17,3,20,Clouds
88892,28,1555088400,29,1,30,Clouds
88893,29,1555088400,16,13,29,Clouds
88894,30,1555088400,20,0,20,Clouds
88895,31,1555088400,13,7,20,Clouds
88896,32,1555088400,4,26,30,Clouds
88897,33,1555088400,4,19,23,Clouds
88898,34,1555088400,19,11,30,Clouds
88899,35,1555088400,30,0,30,Clouds
88900,36,1555088400,15,25,40,Clouds
88901,37,1555088400,29,1,30,Clouds
88902,38,1555088400,4,36,40,Clouds
88903,39,1555088400,20,0,20,Clouds
88904,40,1555088400,21,0,21,Clouds
88905,41,1555088400,20,0,20,Clouds
88906,42,1555088400,18,12,30,Clouds
88907,43,1555088400,18,12,30,Clouds
88908,44,1555088400,28,2,30,Clouds
88909,45,1555088400,19,11,30,Clouds
88910,46,1555088400,15,5,20,Clouds
88911,47,1555088400,37,3,40,Clouds
88912,48,1555088400,8,32,40,Clouds
88913,49,1555088400,20,20,40,Clouds
88914,50,1555088400,30,10,40,Clouds
88915,51,1555088400,11,29,40,Clouds
88916,52,1555088400,32,0,32,Clouds
88917,53,1555088400,21,19,40,Clouds
88918,54,1555088400,33,0,33,Clouds
88919,55,1555088400,36,0,36,Clouds
88920,56,1555088400,18,22,40,Clouds
88921,57,1555088400,11,12,23,Clouds
88922,58,1555088400,28,12,40,Clouds
88923,59,1555088400,20,0,20,Clouds
88924,60,1555088400,20,10,30,Clouds
88925,61,1555088400,25,0,25,Clouds
88926,62,1555088400,27,13,40,Clouds
88927,63,1555088400,6,29,35,Clouds
88928,64,1555088400,8,32,40,Clouds
88929,65,1555088400,39,1,40,Clouds
88930,66,1555088400,40,0,40,Clouds
88931,67,1555088400,26,14,40,Clouds
88932,68,1555088400,35,5,40,Clouds
88933,69,1555088400,8,32,40,Clouds
88934,70,1555088400,6,22,28,Clouds
88935,71,1555088400,37,3,40,Clouds
88936,72,1555088400,10,21,31,Clouds
88937,73,1555088400,30,0,30,Clouds
88938,74,1555088400,6,24,30,Clouds
88939,75,1555088400,30,10,40,Clouds
88940,76,1555088400,36,2,38,Clouds
88941,77,1555088400,29,0,29,Clouds
88942,78,1555088400,38,2,40,Clouds
88943,79,1555088400,24,3,27,Clouds
88944,80,1555088400,24,16,40,Clouds
88945,81,1555088400,35,5,40,Clouds
88946,82,1555088400,20,2,22,Clouds
88947,83,1555088400,33,7,40,Clouds
88948,84,1555088400,28,2,30,Clouds
88949,85,1555088400,33,2,35,Clouds
88950,86,1555088400,30,8,38,Clouds
88951,87,1555088400,32,6,38,Clouds
88952,88,1555088400,28,2,30,Clouds
88953,89,1555088400,40,0,40,Clouds
88954,90,1555088400,40,0,40,Clouds
88955,91,1555088400,28,2,30,Clouds
88956,92,1555088400,17,23,40,Clouds
88957,93,1555088400,11,29,40,Clouds
88958,94,1555088400,37,3,40,Clouds
88959,95,1555088400,35,5,40,Clouds
88960,96,1555088400,28,2,30,Clouds
88961,97,1555088400,34,6,40,Clouds
88962,98,1555088400,24,16,40,Clouds
88963,99,1555088400,15,15,30,Clouds
88964,100,1555088400,0,25,25,Clouds
88965,101,1555088400,27,3,30,Clouds
88966,102,1555088400,39,1,40,Clouds
88967,103,1555088400,31,9,40,Clouds
88968,104,1555088400,25,15,40,Clouds
88969,105,1555088400,25,11,36,Clouds
88970,106,1555088400,28,12,40,Clouds
88971,107,1555088400,34,6,40,Clouds
88972,108,1555088400,38,2,40,Clouds
88973,109,1555088400,24,5,29,Clouds
88974,110,1555088400,35,5,40,Clouds
88975,111,1555088400,36,4,40,Clouds
88976,112,1555088400,23,7,30,Clouds
88977,113,1555088400,22,18,40,Clouds
88978,114,1555088400,40,0,40,Clouds
88979,115,1555088400,22,8,30,Clouds
88980,2,1555092000,17,3,20,Clouds
88981,3,1555092000,20,0,20,Clouds
88982,4,1555092000,20,0,20,Clouds
88983,5,1555092000,25,15,40,Clouds
88984,6,1555092000,16,4,20,Clouds
88985,7,1555092000,29,0,29,Clouds
88986,8,1555092000,6,23,29,Clouds
88987,9,1555092000,6,18,24,Clouds
88988,10,1555092000,1,15,16,Clouds
88989,11,1555092000,19,11,30,Clouds
88990,12,1555092000,18,2,20,Clouds
88991,13,1555092000,29,1,30,Clouds
88992,14,1555092000,14,16,30,Clouds
88993,15,1555092000,16,0,16,Clouds
88994,16,1555092000,1,19,20,Clouds
88995,17,1555092000,17,3,20,Clouds
88996,18,1555092000,22,7,29,Clouds
88997,19,1555092000,30,0,30,Clouds
88998,21,1555092000,19,11,30,Clouds
88999,22,1555092000,5,15,20,Clouds
89000,23,1555092000,1,29,30,Clouds
89001,24,1555092000,2,18,20,Clouds
89002,25,1555092000,29,1,30,Clouds
89003,26,1555092000,5,14,19,Clouds
89004,27,1555092000,18,2,20,Clouds
89005,28,1555092000,27,3,30,Clouds
89006,29,1555092000,18,11,29,Clouds
89007,30,1555092000,20,0,20,Clouds
89008,31,1555092000,9,11,20,Clouds
89009,32,1555092000,0,30,30,Clouds
89010,33,1555092000,0,23,23,Clouds
89011,34,1555092000,13,17,30,Clouds
89012,35,1555092000,20,10,30,Clouds
89013,36,1555092000,40,0,40,Clouds
89014,37,1555092000,30,0,30,Clouds
89015,38,1555092000,11,29,40,Clouds
89016,39,1555092000,20,0,20,Clouds
89017,40,1555092000,14,7,21,Clouds
89018,41,1555092000,18,2,20,Clouds
89019,42,1555092000,9,21,30,Clouds
89020,43,1555092000,9,21,30,Clouds
89021,44,1555092000,25,5,30,Clouds
89022,45,1555092000,17,13,30,Clouds
89023,46,1555092000,7,13,20,Clouds
89024,47,1555092000,40,0,40,Clouds
89025,48,1555092000,14,26,40,Clouds
89026,49,1555092000,33,7,40,Clouds
89027,50,1555092000,25,15,40,Clouds
89028,51,1555092000,15,25,40,Clouds
89029,52,1555092000,27,5,32,Clouds
89030,53,1555092000,40,0,40,Clouds
89031,54,1555092000,33,0,33,Clouds
89032,55,1555092000,36,0,36,Clouds
89033,56,1555092000,40,0,40,Clouds
89034,57,1555092000,16,7,23,Clouds
89035,58,1555092000,39,1,40,Clouds
89036,59,1555092000,20,0,20,Clouds
89037,60,1555092000,16,14,30,Clouds
89038,61,1555092000,22,3,25,Clouds
89039,62,1555092000,38,2,40,Clouds
89040,63,1555092000,20,15,35,Clouds
89041,64,1555092000,10,30,40,Clouds
89042,65,1555092000,40,0,40,Clouds
89043,66,1555092000,39,1,40,Clouds
89044,67,1555092000,38,2,40,Clouds
89045,68,1555092000,40,0,40,Clouds
89046,69,1555092000,36,4,40,Clouds
89047,70,1555092000,21,7,28,Clouds
89048,71,1555092000,38,2,40,Clouds
89049,72,1555092000,14,17,31,Clouds
89050,73,1555092000,27,3,30,Clouds
89051,74,1555092000,9,21,30,Clouds
89052,75,1555092000,24,16,40,Clouds
89053,76,1555092000,15,23,38,Clouds
89054,77,1555092000,27,2,29,Clouds
89055,78,1555092000,31,9,40,Clouds
89056,79,1555092000,27,0,27,Clouds
89057,80,1555092000,20,20,40,Clouds
89058,81,1555092000,37,3,40,Clouds
89059,82,1555092000,17,5,22,Clouds
89060,83,1555092000,25,15,40,Clouds
89061,84,1555092000,27,3,30,Clouds
89062,85,1555092000,27,8,35,Clouds
89063,86,1555092000,8,30,38,Clouds
89064,87,1555092000,26,12,38,Clouds
89065,88,1555092000,21,9,30,Clouds
89066,89,1555092000,40,0,40,Clouds
89067,90,1555092000,40,0,40,Clouds
89068,91,1555092000,25,5,30,Clouds
89069,92,1555092000,1,39,40,Clouds
89070,93,1555092000,0,40,40,Clouds
89071,94,1555092000,11,29,40,Clouds
89072,95,1555092000,27,13,40,Clouds
89073,96,1555092000,27,3,30,Clouds
89074,97,1555092000,23,17,40,Clouds
89075,98,1555092000,34,6,40,Clouds
89076,99,1555092000,29,1,30,Clouds
89077,100,1555092000,1,24,25,Clouds
89078,101,1555092000,27,3,30,Clouds
89079,102,1555092000,33,7,40,Clouds
89080,103,1555092000,34,6,40,Clouds
89081,104,1555092000,25,15,40,Clouds
89082,105,1555092000,28,8,36,Clouds
89083,106,1555092000,27,13,40,Clouds
89084,107,1555092000,35,5,40,Clouds
89085,108,1555092000,33,7,40,Clouds
89086,109,1555092000,21,8,29,Clouds
89087,110,1555092000,30,10,40,Clouds
89088,111,1555092000,36,4,40,Clouds
89089,112,1555092000,22,8,30,Clouds
89090,113,1555092000,40,0,40,Clouds
89091,114,1555092000,40,0,40,Clouds
89092,115,1555092000,14,16,30,Clouds
89093,2,1555095600,16,4,20,Clouds
89094,3,1555095600,18,2,20,Clouds
89095,4,1555095600,18,2,20,Clouds
89096,5,1555095600,18,22,40,Clouds
89097,6,1555095600,18,2,20,Clouds
89098,7,1555095600,27,2,29,Clouds
89099,8,1555095600,13,17,30,Clouds
89100,9,1555095600,10,14,24,Clouds
89101,10,1555095600,0,16,16,Clouds
89102,11,1555095600,25,5,30,Clouds
89103,12,1555095600,16,4,20,Clouds
89104,13,1555095600,30,0,30,Clouds
89105,14,1555095600,5,25,30,Clouds
89106,15,1555095600,13,3,16,Clouds
89107,16,1555095600,5,15,20,Clouds
89108,17,1555095600,11,9,20,Clouds
89109,18,1555095600,21,8,29,Clouds
89110,19,1555095600,30,0,30,Clouds
89111,21,1555095600,15,15,30,Clouds
89112,22,1555095600,1,19,20,Clouds
89113,23,1555095600,2,28,30,Clouds
89114,24,1555095600,1,19,20,Clouds
89115,25,1555095600,28,2,30,Clouds
89116,26,1555095600,18,1,19,Clouds
89117,27,1555095600,12,8,20,Clouds
89118,28,1555095600,26,4,30,Clouds
89119,29,1555095600,18,11,29,Clouds
89120,30,1555095600,18,2,20,Clouds
89121,31,1555095600,8,12,20,Clouds
89122,32,1555095600,0,30,30,Clouds
89123,33,1555095600,1,22,23,Clouds
89124,34,1555095600,17,13,30,Clouds
89125,35,1555095600,21,9,30,Clouds
89126,36,1555095600,38,2,40,Clouds
89127,37,1555095600,28,2,30,Clouds
89128,38,1555095600,17,23,40,Clouds
89129,39,1555095600,20,0,20,Clouds
89130,40,1555095600,21,0,21,Clouds
89131,41,1555095600,18,2,20,Clouds
89132,42,1555095600,1,29,30,Clouds
89133,43,1555095600,23,7,30,Clouds
89134,44,1555095600,22,8,30,Clouds
89135,45,1555095600,13,17,30,Clouds
89136,46,1555095600,12,8,20,Clouds
89137,47,1555095600,40,0,40,Clouds
89138,48,1555095600,27,13,40,Clouds
89139,49,1555095600,38,2,40,Clouds
89140,50,1555095600,24,16,40,Clouds
89141,51,1555095600,16,24,40,Clouds
89142,52,1555095600,28,4,32,Clouds
89143,53,1555095600,40,0,40,Clouds
89144,54,1555095600,33,0,33,Clouds
89145,55,1555095600,35,1,36,Clouds
89146,56,1555095600,16,24,40,Clouds
89147,57,1555095600,22,1,23,Clouds
89148,58,1555095600,39,1,40,Clouds
89149,59,1555095600,19,1,20,Clouds
89150,60,1555095600,13,17,30,Clouds
89151,61,1555095600,20,5,25,Clouds
89152,62,1555095600,40,0,40,Clouds
89153,63,1555095600,23,12,35,Clouds
89154,64,1555095600,20,20,40,Clouds
89155,65,1555095600,40,0,40,Clouds
89156,66,1555095600,40,0,40,Clouds
89157,67,1555095600,37,3,40,Clouds
89158,68,1555095600,38,2,40,Clouds
89159,69,1555095600,40,0,40,Clouds
89160,70,1555095600,24,4,28,Clouds
89161,71,1555095600,38,2,40,Clouds
89162,72,1555095600,16,15,31,Clouds
89163,73,1555095600,27,3,30,Clouds
89164,74,1555095600,9,21,30,Clouds
89165,75,1555095600,19,21,40,Clouds
89166,76,1555095600,15,23,38,Clouds
89167,77,1555095600,25,4,29,Clouds
89168,78,1555095600,29,11,40,Clouds
89169,79,1555095600,25,2,27,Clouds
89170,80,1555095600,22,18,40,Clouds
89171,81,1555095600,20,20,40,Clouds
89172,82,1555095600,10,12,22,Clouds
89173,83,1555095600,19,21,40,Clouds
89174,84,1555095600,22,8,30,Clouds
89175,85,1555095600,22,13,35,Clouds
89176,86,1555095600,0,38,38,Clouds
89177,87,1555095600,23,15,38,Clouds
89178,88,1555095600,14,16,30,Clouds
89179,89,1555095600,40,0,40,Clouds
89180,90,1555095600,40,0,40,Clouds
89181,91,1555095600,1,29,30,Clouds
89182,92,1555095600,0,40,40,Clouds
89183,93,1555095600,0,40,40,Clouds
89184,94,1555095600,11,29,40,Clouds
89185,95,1555095600,18,22,40,Clouds
89186,96,1555095600,24,6,30,Clouds
89187,97,1555095600,18,22,40,Clouds
89188,98,1555095600,39,1,40,Clouds
89189,99,1555095600,30,0,30,Clouds
89190,100,1555095600,14,11,25,Clouds
89191,101,1555095600,24,6,30,Clouds
89192,102,1555095600,33,7,40,Clouds
89193,103,1555095600,36,4,40,Clouds
89194,104,1555095600,25,15,40,Clouds
89195,105,1555095600,27,9,36,Clouds
89196,106,1555095600,25,15,40,Clouds
89197,107,1555095600,32,8,40,Clouds
89198,108,1555095600,33,7,40,Clouds
89199,109,1555095600,20,9,29,Clouds
89200,110,1555095600,28,12,40,Clouds
89201,111,1555095600,37,3,40,Clouds
89202,112,1555095600,25,5,30,Clouds
89203,113,1555095600,40,0,40,Clouds
89204,114,1555095600,40,0,40,Clouds
89205,115,1555095600,6,24,30,Clouds
89206,2,1555099200,12,8,20,Clouds
89207,3,1555099200,17,3,20,Clouds
89208,4,1555099200,15,5,20,Clouds
89209,5,1555099200,7,33,40,Clouds
89210,6,1555099200,13,7,20,Clouds
89211,7,1555099200,26,3,29,Clouds
89212,8,1555099200,18,11,29,Clouds
89213,9,1555099200,2,22,24,Clouds
89214,10,1555099200,9,7,16,Clouds
89215,11,1555099200,30,0,30,Clouds
89216,12,1555099200,17,3,20,Clouds
89217,13,1555099200,29,1,30,Clouds
89218,14,1555099200,1,29,30,Clouds
89219,15,1555099200,15,1,16,Clouds
89220,16,1555099200,4,16,20,Clouds
89221,17,1555099200,11,9,20,Clouds
89222,18,1555099200,21,8,29,Clouds
89223,19,1555099200,28,2,30,Clouds
89224,21,1555099200,17,13,30,Clouds
89225,22,1555099200,2,18,20,Clouds
89226,23,1555099200,1,29,30,Clouds
89227,24,1555099200,3,17,20,Clouds
89228,25,1555099200,27,3,30,Clouds
89229,26,1555099200,17,2,19,Clouds
89230,27,1555099200,9,11,20,Clouds
89231,28,1555099200,26,4,30,Clouds
89232,29,1555099200,16,13,29,Clouds
89233,30,1555099200,19,1,20,Clouds
89234,31,1555099200,9,11,20,Clouds
89235,32,1555099200,19,11,30,Clouds
89236,33,1555099200,2,21,23,Clouds
89237,34,1555099200,7,23,30,Clouds
89238,35,1555099200,16,14,30,Clouds
89239,36,1555099200,36,4,40,Clouds
89240,37,1555099200,20,10,30,Clouds
89241,38,1555099200,22,18,40,Clouds
89242,39,1555099200,19,1,20,Clouds
89243,40,1555099200,18,3,21,Clouds
89244,41,1555099200,18,2,20,Clouds
89245,42,1555099200,0,30,30,Clouds
89246,43,1555099200,25,5,30,Clouds
89247,44,1555099200,14,16,30,Clouds
89248,45,1555099200,12,18,30,Clouds
89249,46,1555099200,12,8,20,Clouds
89250,47,1555099200,39,1,40,Clouds
89251,48,1555099200,33,7,40,Clouds
89252,49,1555099200,40,0,40,Clouds
89253,50,1555099200,18,22,40,Clouds
89254,51,1555099200,20,20,40,Clouds
89255,52,1555099200,32,0,32,Clouds
89256,53,1555099200,39,1,40,Clouds
89257,54,1555099200,33,0,33,Clouds
89258,55,1555099200,36,0,36,Clouds
89259,56,1555099200,27,13,40,Clouds
89260,57,1555099200,23,0,23,Clouds
89261,58,1555099200,38,2,40,Clouds
89262,59,1555099200,19,1,20,Clouds
89263,60,1555099200,3,27,30,Clouds
89264,61,1555099200,2,23,25,Clouds
89265,62,1555099200,40,0,40,Clouds
89266,63,1555099200,30,5,35,Clouds
89267,64,1555099200,25,15,40,Clouds
89268,65,1555099200,39,1,40,Clouds
89269,66,1555099200,39,1,40,Clouds
89270,67,1555099200,40,0,40,Clouds
89271,68,1555099200,40,0,40,Clouds
89272,69,1555099200,38,2,40,Clouds
89273,70,1555099200,28,0,28,Clouds
89274,71,1555099200,39,1,40,Clouds
89275,72,1555099200,15,16,31,Clouds
89276,73,1555099200,25,5,30,Clouds
89277,74,1555099200,8,22,30,Clouds
89278,75,1555099200,20,20,40,Clouds
89279,76,1555099200,18,20,38,Clouds
89280,77,1555099200,24,5,29,Clouds
89281,78,1555099200,28,12,40,Clouds
89282,79,1555099200,25,2,27,Clouds
89283,80,1555099200,21,19,40,Clouds
89284,81,1555099200,19,21,40,Clouds
89285,82,1555099200,10,12,22,Clouds
89286,83,1555099200,15,25,40,Clouds
89287,84,1555099200,21,9,30,Clouds
89288,85,1555099200,18,17,35,Clouds
89289,86,1555099200,2,36,38,Clouds
89290,87,1555099200,24,14,38,Clouds
89291,88,1555099200,14,16,30,Clouds
89292,89,1555099200,40,0,40,Clouds
89293,90,1555099200,40,0,40,Clouds
89294,91,1555099200,3,27,30,Clouds
89295,92,1555099200,0,40,40,Clouds
89296,93,1555099200,0,40,40,Clouds
89297,94,1555099200,11,29,40,Clouds
89298,95,1555099200,21,19,40,Clouds
89299,96,1555099200,21,9,30,Clouds
89300,97,1555099200,17,23,40,Clouds
89301,98,1555099200,39,1,40,Clouds
89302,99,1555099200,30,0,30,Clouds
89303,100,1555099200,7,18,25,Clouds
89304,101,1555099200,23,7,30,Clouds
89305,102,1555099200,31,9,40,Clouds
89306,103,1555099200,38,2,40,Clouds
89307,104,1555099200,25,15,40,Clouds
89308,105,1555099200,26,10,36,Clouds
89309,106,1555099200,20,20,40,Clouds
89310,107,1555099200,34,6,40,Clouds
89311,108,1555099200,38,2,40,Clouds
89312,109,1555099200,20,9,29,Clouds
89313,110,1555099200,27,13,40,Clouds
89314,111,1555099200,36,4,40,Clouds
89315,112,1555099200,21,9,30,Clouds
89316,113,1555099200,40,0,40,Clouds
89317,114,1555099200,40,0,40,Clouds
89318,115,1555099200,1,29,30,Clouds
89319,2,1555102800,13,7,20,Clouds
89320,3,1555102800,17,3,20,Clouds
89321,4,1555102800,15,5,20,Clouds
89322,5,1555102800,7,33,40,Clouds
89323,6,1555102800,13,7,20,Clouds
89324,7,1555102800,24,5,29,Clouds
89325,8,1555102800,23,7,30,Clouds
89326,9,1555102800,1,23,24,Clouds
89327,10,1555102800,2,14,16,Clouds
89328,11,1555102800,30,0,30,Clouds
89329,12,1555102800,16,4,20,Clouds
89330,13,1555102800,30,0,30,Clouds
89331,14,1555102800,0,30,30,Clouds
89332,15,1555102800,16,0,16,Clouds
89333,16,1555102800,3,17,20,Clouds
89334,17,1555102800,11,9,20,Clouds
89335,18,1555102800,14,15,29,Clouds
89336,19,1555102800,29,1,30,Clouds
89337,21,1555102800,17,13,30,Clouds
89338,22,1555102800,6,14,20,Clouds
89339,23,1555102800,0,30,30,Clouds
89340,24,1555102800,4,16,20,Clouds
89341,25,1555102800,30,0,30,Clouds
89342,26,1555102800,18,1,19,Clouds
89343,27,1555102800,10,10,20,Clouds
89344,28,1555102800,26,4,30,Clouds
89345,29,1555102800,13,16,29,Clouds
89346,30,1555102800,18,2,20,Clouds
89347,31,1555102800,20,0,20,Clouds
89348,32,1555102800,19,11,30,Clouds
89349,33,1555102800,2,21,23,Clouds
89350,34,1555102800,0,30,30,Clouds
89351,35,1555102800,9,21,30,Clouds
89352,36,1555102800,37,3,40,Clouds
89353,37,1555102800,22,8,30,Clouds
89354,38,1555102800,27,13,40,Clouds
89355,39,1555102800,18,2,20,Clouds
89356,40,1555102800,19,2,21,Clouds
89357,41,1555102800,20,0,20,Clouds
89358,42,1555102800,0,30,30,Clouds
89359,43,1555102800,22,8,30,Clouds
89360,44,1555102800,14,16,30,Clouds
89361,45,1555102800,11,19,30,Clouds
89362,46,1555102800,13,7,20,Clouds
89363,47,1555102800,40,0,40,Clouds
89364,48,1555102800,38,2,40,Clouds
89365,49,1555102800,40,0,40,Clouds
89366,50,1555102800,11,29,40,Clouds
89367,51,1555102800,19,21,40,Clouds
89368,52,1555102800,29,3,32,Clouds
89369,53,1555102800,39,1,40,Clouds
89370,54,1555102800,30,3,33,Clouds
89371,55,1555102800,35,1,36,Clouds
89372,56,1555102800,32,8,40,Clouds
89373,57,1555102800,23,0,23,Clouds
89374,58,1555102800,40,0,40,Clouds
89375,59,1555102800,19,1,20,Clouds
89376,60,1555102800,1,29,30,Clouds
89377,61,1555102800,6,19,25,Clouds
89378,62,1555102800,40,0,40,Clouds
89379,63,1555102800,35,0,35,Clouds
89380,64,1555102800,29,11,40,Clouds
89381,65,1555102800,40,0,40,Clouds
89382,66,1555102800,39,1,40,Clouds
89383,67,1555102800,39,1,40,Clouds
89384,68,1555102800,37,3,40,Clouds
89385,69,1555102800,36,4,40,Clouds
89386,70,1555102800,27,1,28,Clouds
89387,71,1555102800,40,0,40,Clouds
89388,72,1555102800,17,14,31,Clouds
89389,73,1555102800,25,5,30,Clouds
89390,74,1555102800,7,23,30,Clouds
89391,75,1555102800,20,20,40,Clouds
89392,76,1555102800,17,21,38,Clouds
89393,77,1555102800,24,5,29,Clouds
89394,78,1555102800,29,11,40,Clouds
89395,79,1555102800,26,1,27,Clouds
89396,80,1555102800,24,16,40,Clouds
89397,81,1555102800,21,19,40,Clouds
89398,82,1555102800,11,11,22,Clouds
89399,83,1555102800,10,30,40,Clouds
89400,84,1555102800,18,12,30,Clouds
89401,85,1555102800,19,16,35,Clouds
89402,86,1555102800,3,35,38,Clouds
89403,87,1555102800,24,14,38,Clouds
89404,88,1555102800,11,19,30,Clouds
89405,89,1555102800,39,1,40,Clouds
89406,90,1555102800,40,0,40,Clouds
89407,91,1555102800,3,27,30,Clouds
89408,92,1555102800,0,40,40,Clouds
89409,93,1555102800,0,40,40,Clouds
89410,94,1555102800,11,29,40,Clouds
89411,95,1555102800,20,20,40,Clouds
89412,96,1555102800,20,10,30,Clouds
89413,97,1555102800,16,24,40,Clouds
89414,98,1555102800,38,2,40,Clouds
89415,99,1555102800,30,0,30,Clouds
89416,100,1555102800,0,25,25,Clouds
89417,101,1555102800,25,5,30,Clouds
89418,102,1555102800,31,9,40,Clouds
89419,103,1555102800,39,1,40,Clouds
89420,104,1555102800,25,15,40,Clouds
89421,105,1555102800,26,10,36,Clouds
89422,106,1555102800,19,21,40,Clouds
89423,107,1555102800,32,8,40,Clouds
89424,108,1555102800,35,5,40,Clouds
89425,109,1555102800,20,9,29,Clouds
89426,110,1555102800,30,10,40,Clouds
89427,111,1555102800,40,0,40,Clouds
89428,112,1555102800,11,19,30,Clouds
89429,113,1555102800,39,1,40,Clouds
89430,114,1555102800,40,0,40,Clouds
89431,115,1555102800,3,27,30,Clouds
89432,2,1555106400,12,8,20,Clouds
89433,3,1555106400,18,2,20,Clouds
89434,4,1555106400,19,1,20,Clouds
89435,5,1555106400,24,16,40,Clouds
89436,6,1555106400,10,10,20,Clouds
89437,7,1555106400,8,21,29,Clouds
89438,8,1555106400,27,3,30,Clouds
89439,9,1555106400,3,21,24,Clouds
89440,10,1555106400,0,16,16,Clouds
89441,11,1555106400,30,0,30,Clouds
89442,12,1555106400,17,3,20,Clouds
89443,13,1555106400,30,0,30,Clouds
89444,14,1555106400,0,30,30,Clouds
89445,15,1555106400,15,1,16,Clouds
89446,16,1555106400,4,16,20,Clouds
89447,17,1555106400,12,8,20,Clouds
89448,18,1555106400,12,17,29,Clouds
89449,19,1555106400,22,8,30,Clouds
89450,21,1555106400,18,12,30,Clouds
89451,22,1555106400,8,12,20,Clouds
89452,23,1555106400,3,27,30,Clouds
89453,24,1555106400,0,20,20,Clouds
89454,25,1555106400,21,9,30,Clouds
89455,26,1555106400,19,1,20,Clouds
89456,27,1555106400,16,4,20,Clouds
89457,28,1555106400,25,5,30,Clouds
89458,29,1555106400,6,23,29,Clouds
89459,30,1555106400,17,3,20,Clouds
89460,31,1555106400,17,3,20,Clouds
89461,32,1555106400,14,16,30,Clouds
89462,33,1555106400,0,23,23,Clouds
89463,34,1555106400,20,10,30,Clouds
89464,35,1555106400,13,17,30,Clouds
89465,36,1555106400,38,2,40,Clouds
89466,37,1555106400,24,6,30,Clouds
89467,38,1555106400,34,6,40,Clouds
89468,39,1555106400,20,0,20,Clouds
89469,40,1555106400,18,3,21,Clouds
89470,41,1555106400,20,0,20,Clouds
89471,42,1555106400,2,28,30,Clouds
89472,43,1555106400,21,9,30,Clouds
89473,44,1555106400,13,17,30,Clouds
89474,45,1555106400,9,21,30,Clouds
89475,46,1555106400,15,5,20,Clouds
89476,47,1555106400,40,0,40,Clouds
89477,48,1555106400,40,0,40,Clouds
89478,49,1555106400,39,1,40,Clouds
89479,50,1555106400,6,34,40,Clouds
89480,51,1555106400,29,11,40,Clouds
89481,52,1555106400,28,4,32,Clouds
89482,53,1555106400,40,0,40,Clouds
89483,54,1555106400,29,4,33,Clouds
89484,55,1555106400,36,0,36,Clouds
89485,56,1555106400,35,5,40,Clouds
89486,57,1555106400,23,0,23,Clouds
89487,58,1555106400,39,1,40,Clouds
89488,59,1555106400,17,3,20,Clouds
89489,60,1555106400,4,26,30,Clouds
89490,61,1555106400,9,16,25,Clouds
89491,62,1555106400,38,2,40,Clouds
89492,63,1555106400,35,0,35,Clouds
89493,64,1555106400,34,6,40,Clouds
89494,65,1555106400,40,0,40,Clouds
89495,66,1555106400,37,3,40,Clouds
89496,67,1555106400,33,7,40,Clouds
89497,68,1555106400,39,1,40,Clouds
89498,69,1555106400,33,7,40,Clouds
89499,70,1555106400,27,1,28,Clouds
89500,71,1555106400,40,0,40,Clouds
89501,72,1555106400,13,18,31,Clouds
89502,73,1555106400,23,7,30,Clouds
89503,74,1555106400,7,23,30,Clouds
89504,75,1555106400,21,19,40,Clouds
89505,76,1555106400,14,24,38,Clouds
89506,77,1555106400,21,8,29,Clouds
89507,78,1555106400,29,11,40,Clouds
89508,79,1555106400,26,1,27,Clouds
89509,80,1555106400,22,18,40,Clouds
89510,81,1555106400,21,19,40,Clouds
89511,82,1555106400,12,10,22,Clouds
89512,83,1555106400,7,33,40,Clouds
89513,84,1555106400,15,15,30,Clouds
89514,85,1555106400,19,16,35,Clouds
89515,86,1555106400,1,37,38,Clouds
89516,87,1555106400,22,16,38,Clouds
89517,88,1555106400,6,24,30,Clouds
89518,89,1555106400,40,0,40,Clouds
89519,90,1555106400,40,0,40,Clouds
89520,91,1555106400,5,25,30,Clouds
89521,92,1555106400,1,39,40,Clouds
89522,93,1555106400,0,40,40,Clouds
89523,94,1555106400,11,29,40,Clouds
89524,95,1555106400,15,25,40,Clouds
89525,96,1555106400,19,11,30,Clouds
89526,97,1555106400,17,23,40,Clouds
89527,98,1555106400,39,1,40,Clouds
89528,99,1555106400,29,1,30,Clouds
89529,100,1555106400,1,24,25,Clouds
89530,101,1555106400,23,7,30,Clouds
89531,102,1555106400,31,9,40,Clouds
89532,103,1555106400,38,2,40,Clouds
89533,104,1555106400,25,15,40,Clouds
89534,105,1555106400,26,10,36,Clouds
89535,106,1555106400,19,21,40,Clouds
89536,107,1555106400,28,12,40,Clouds
89537,108,1555106400,35,5,40,Clouds
89538,109,1555106400,20,9,29,Clouds
89539,110,1555106400,30,10,40,Clouds
89540,111,1555106400,38,2,40,Clouds
89541,112,1555106400,6,24,30,Clouds
89542,113,1555106400,40,0,40,Clouds
89543,114,1555106400,40,0,40,Clouds
89544,115,1555106400,2,28,30,Clouds
89545,2,1555110000,9,11,20,Clouds
89546,3,1555110000,17,3,20,Clouds
89547,4,1555110000,19,1,20,Clouds
89548,5,1555110000,28,12,40,Clouds
89549,6,1555110000,9,11,20,Clouds
89550,7,1555110000,10,19,29,Clouds
89551,8,1555110000,29,1,30,Clouds
89552,9,1555110000,9,15,24,Clouds
89553,10,1555110000,0,16,16,Clouds
89554,11,1555110000,30,0,30,Clouds
89555,12,1555110000,17,3,20,Clouds
89556,13,1555110000,30,0,30,Clouds
89557,14,1555110000,0,30,30,Clouds
89558,15,1555110000,15,1,16,Clouds
89559,16,1555110000,7,13,20,Clouds
89560,17,1555110000,10,10,20,Clouds
89561,18,1555110000,21,9,30,Clouds
89562,19,1555110000,28,2,30,Clouds
89563,21,1555110000,20,10,30,Clouds
89564,22,1555110000,8,12,20,Clouds
89565,23,1555110000,6,24,30,Clouds
89566,24,1555110000,3,17,20,Clouds
89567,25,1555110000,21,9,30,Clouds
89568,26,1555110000,20,0,20,Clouds
89569,27,1555110000,18,2,20,Clouds
89570,28,1555110000,24,6,30,Clouds
89571,29,1555110000,8,21,29,Clouds
89572,30,1555110000,18,2,20,Clouds
89573,31,1555110000,16,4,20,Clouds
89574,32,1555110000,16,14,30,Clouds
89575,33,1555110000,6,17,23,Clouds
89576,34,1555110000,22,8,30,Clouds
89577,35,1555110000,19,11,30,Clouds
89578,36,1555110000,40,0,40,Clouds
89579,37,1555110000,26,4,30,Clouds
89580,38,1555110000,31,9,40,Clouds
89581,39,1555110000,20,0,20,Clouds
89582,40,1555110000,17,4,21,Clouds
89583,41,1555110000,20,0,20,Clouds
89584,42,1555110000,0,30,30,Clouds
89585,43,1555110000,16,14,30,Clouds
89586,44,1555110000,12,18,30,Clouds
89587,45,1555110000,9,21,30,Clouds
89588,46,1555110000,17,3,20,Clouds
89589,47,1555110000,39,1,40,Clouds
89590,48,1555110000,38,2,40,Clouds
89591,49,1555110000,40,0,40,Clouds
89592,50,1555110000,1,39,40,Clouds
89593,51,1555110000,31,9,40,Clouds
89594,52,1555110000,28,4,32,Clouds
89595,53,1555110000,40,0,40,Clouds
89596,54,1555110000,26,7,33,Clouds
89597,55,1555110000,35,1,36,Clouds
89598,56,1555110000,36,4,40,Clouds
89599,57,1555110000,23,0,23,Clouds
89600,58,1555110000,38,2,40,Clouds
89601,59,1555110000,16,4,20,Clouds
89602,60,1555110000,0,30,30,Clouds
89603,61,1555110000,9,16,25,Clouds
89604,62,1555110000,38,2,40,Clouds
89605,63,1555110000,34,1,35,Clouds
89606,64,1555110000,39,1,40,Clouds
89607,65,1555110000,39,1,40,Clouds
89608,66,1555110000,35,5,40,Clouds
89609,67,1555110000,29,11,40,Clouds
89610,68,1555110000,40,0,40,Clouds
89611,69,1555110000,36,4,40,Clouds
89612,70,1555110000,28,0,28,Clouds
89613,71,1555110000,35,5,40,Clouds
89614,72,1555110000,12,19,31,Clouds
89615,73,1555110000,23,7,30,Clouds
89616,74,1555110000,6,24,30,Clouds
89617,75,1555110000,20,20,40,Clouds
89618,76,1555110000,13,25,38,Clouds
89619,77,1555110000,23,6,29,Clouds
89620,78,1555110000,29,11,40,Clouds
89621,79,1555110000,26,1,27,Clouds
89622,80,1555110000,23,17,40,Clouds
89623,81,1555110000,25,15,40,Clouds
89624,82,1555110000,12,10,22,Clouds
89625,83,1555110000,9,31,40,Clouds
89626,84,1555110000,13,17,30,Clouds
89627,85,1555110000,14,21,35,Clouds
89628,86,1555110000,2,36,38,Clouds
89629,87,1555110000,20,18,38,Clouds
89630,88,1555110000,5,25,30,Clouds
89631,89,1555110000,40,0,40,Clouds
89632,90,1555110000,38,2,40,Clouds
89633,91,1555110000,7,23,30,Clouds
89634,92,1555110000,2,38,40,Clouds
89635,93,1555110000,0,40,40,Clouds
89636,94,1555110000,11,29,40,Clouds
89637,95,1555110000,14,26,40,Clouds
89638,96,1555110000,17,13,30,Clouds
89639,97,1555110000,17,23,40,Clouds
89640,98,1555110000,39,1,40,Clouds
89641,99,1555110000,29,1,30,Clouds
89642,100,1555110000,0,25,25,Clouds
89643,101,1555110000,22,8,30,Clouds
89644,102,1555110000,16,24,40,Clouds
89645,103,1555110000,38,2,40,Clouds
89646,104,1555110000,25,15,40,Clouds
89647,105,1555110000,26,10,36,Clouds
89648,106,1555110000,17,23,40,Clouds
89649,107,1555110000,28,12,40,Clouds
89650,108,1555110000,36,4,40,Clouds
89651,109,1555110000,15,14,29,Clouds
89652,110,1555110000,31,9,40,Clouds
89653,111,1555110000,34,6,40,Clouds
89654,112,1555110000,2,28,30,Clouds
89655,113,1555110000,38,2,40,Clouds
89656,114,1555110000,40,0,40,Clouds
89657,115,1555110000,1,29,30,Clouds
89658,2,1555113600,5,15,20,Clouds
89659,3,1555113600,14,6,20,Clouds
89660,4,1555113600,18,2,20,Clouds
89661,5,1555113600,36,4,40,Clouds
89662,6,1555113600,14,6,20,Clouds
89663,7,1555113600,14,15,29,Clouds
89664,8,1555113600,30,0,30,Clouds
89665,9,1555113600,21,3,24,Clouds
89666,10,1555113600,8,8,16,Clouds
89667,11,1555113600,30,0,30,Clouds
89668,12,1555113600,13,7,20,Clouds
89669,13,1555113600,30,0,30,Clouds
89670,14,1555113600,10,20,30,Clouds
89671,15,1555113600,13,3,16,Clouds
89672,16,1555113600,9,11,20,Clouds
89673,17,1555113600,11,9,20,Clouds
89674,18,1555113600,23,7,30,Clouds
89675,19,1555113600,30,0,30,Clouds
89676,21,1555113600,23,7,30,Clouds
89677,22,1555113600,12,8,20,Clouds
89678,23,1555113600,9,21,30,Clouds
89679,24,1555113600,0,20,20,Clouds
89680,25,1555113600,23,7,30,Clouds
89681,26,1555113600,20,0,20,Clouds
89682,27,1555113600,20,0,20,Clouds
89683,28,1555113600,24,6,30,Clouds
89684,29,1555113600,11,18,29,Clouds
89685,30,1555113600,18,2,20,Clouds
89686,31,1555113600,18,2,20,Clouds
89687,32,1555113600,18,12,30,Clouds
89688,33,1555113600,4,19,23,Clouds
89689,34,1555113600,13,17,30,Clouds
89690,35,1555113600,19,11,30,Clouds
89691,36,1555113600,40,0,40,Clouds
89692,37,1555113600,30,0,30,Clouds
89693,38,1555113600,36,4,40,Clouds
89694,39,1555113600,19,1,20,Clouds
89695,40,1555113600,20,1,21,Clouds
89696,41,1555113600,19,1,20,Clouds
89697,42,1555113600,1,29,30,Clouds
89698,43,1555113600,14,15,29,Clouds
89699,44,1555113600,4,26,30,Clouds
89700,45,1555113600,8,22,30,Clouds
89701,46,1555113600,16,4,20,Clouds
89702,47,1555113600,40,0,40,Clouds
89703,48,1555113600,40,0,40,Clouds
89704,49,1555113600,39,1,40,Clouds
89705,50,1555113600,2,38,40,Clouds
89706,51,1555113600,31,9,40,Clouds
89707,52,1555113600,29,3,32,Clouds
89708,53,1555113600,40,0,40,Clouds
89709,54,1555113600,28,5,33,Clouds
89710,55,1555113600,35,1,36,Clouds
89711,56,1555113600,34,6,40,Clouds
89712,57,1555113600,22,1,23,Clouds
89713,58,1555113600,36,4,40,Clouds
89714,59,1555113600,13,7,20,Clouds
89715,60,1555113600,0,30,30,Clouds
89716,61,1555113600,10,15,25,Clouds
89717,62,1555113600,40,0,40,Clouds
89718,63,1555113600,35,0,35,Clouds
89719,64,1555113600,39,1,40,Clouds
89720,65,1555113600,39,1,40,Clouds
89721,66,1555113600,32,8,40,Clouds
89722,67,1555113600,30,10,40,Clouds
89723,68,1555113600,37,3,40,Clouds
89724,69,1555113600,39,1,40,Clouds
89725,70,1555113600,23,5,28,Clouds
89726,71,1555113600,33,7,40,Clouds
89727,72,1555113600,13,18,31,Clouds
89728,73,1555113600,20,10,30,Clouds
89729,74,1555113600,7,23,30,Clouds
89730,75,1555113600,17,23,40,Clouds
89731,76,1555113600,13,25,38,Clouds
89732,77,1555113600,24,5,29,Clouds
89733,78,1555113600,29,11,40,Clouds
89734,79,1555113600,26,1,27,Clouds
89735,80,1555113600,22,18,40,Clouds
89736,81,1555113600,25,15,40,Clouds
89737,82,1555113600,10,12,22,Clouds
89738,83,1555113600,11,29,40,Clouds
89739,84,1555113600,12,18,30,Clouds
89740,85,1555113600,14,21,35,Clouds
89741,86,1555113600,0,38,38,Clouds
89742,87,1555113600,14,24,38,Clouds
89743,88,1555113600,1,29,30,Clouds
89744,89,1555113600,40,0,40,Clouds
89745,90,1555113600,37,3,40,Clouds
89746,91,1555113600,5,25,30,Clouds
89747,92,1555113600,1,39,40,Clouds
89748,93,1555113600,0,40,40,Clouds
89749,94,1555113600,11,29,40,Clouds
89750,95,1555113600,7,33,40,Clouds
89751,96,1555113600,16,14,30,Clouds
89752,97,1555113600,15,25,40,Clouds
89753,98,1555113600,39,1,40,Clouds
89754,99,1555113600,29,1,30,Clouds
89755,100,1555113600,0,25,25,Clouds
89756,101,1555113600,19,11,30,Clouds
89757,102,1555113600,15,25,40,Clouds
89758,103,1555113600,38,2,40,Clouds
89759,104,1555113600,26,14,40,Clouds
89760,105,1555113600,26,10,36,Clouds
89761,106,1555113600,16,24,40,Clouds
89762,107,1555113600,29,11,40,Clouds
89763,108,1555113600,36,4,40,Clouds
89764,109,1555113600,8,21,29,Clouds
89765,110,1555113600,30,10,40,Clouds
89766,111,1555113600,29,11,40,Clouds
89767,112,1555113600,1,29,30,Clouds
89768,113,1555113600,39,1,40,Clouds
89769,114,1555113600,40,0,40,Clouds
89770,115,1555113600,0,30,30,Clouds
89771,2,1555117200,5,15,20,Clouds
89772,3,1555117200,14,6,20,Clouds
89773,4,1555117200,18,2,20,Clouds
89774,5,1555117200,38,2,40,Clouds
89775,6,1555117200,17,3,20,Clouds
89776,7,1555117200,16,13,29,Clouds
89777,8,1555117200,29,1,30,Clouds
89778,9,1555117200,24,0,24,Clouds
89779,10,1555117200,7,9,16,Clouds
89780,11,1555117200,30,0,30,Clouds
89781,12,1555117200,14,6,20,Clouds
89782,13,1555117200,30,0,30,Clouds
89783,14,1555117200,16,14,30,Clouds
89784,15,1555117200,13,3,16,Clouds
89785,16,1555117200,7,13,20,Clouds
89786,17,1555117200,12,8,20,Clouds
89787,18,1555117200,22,8,30,Clouds
89788,19,1555117200,27,3,30,Clouds
89789,21,1555117200,24,6,30,Clouds
89790,22,1555117200,12,8,20,Clouds
89791,23,1555117200,10,20,30,Clouds
89792,24,1555117200,0,20,20,Clouds
89793,25,1555117200,25,5,30,Clouds
89794,26,1555117200,20,0,20,Clouds
89795,27,1555117200,20,0,20,Clouds
89796,28,1555117200,23,7,30,Clouds
89797,29,1555117200,12,17,29,Clouds
89798,30,1555117200,18,2,20,Clouds
89799,31,1555117200,18,2,20,Clouds
89800,32,1555117200,18,12,30,Clouds
89801,33,1555117200,3,20,23,Clouds
89802,34,1555117200,16,14,30,Clouds
89803,35,1555117200,12,18,30,Clouds
89804,36,1555117200,40,0,40,Clouds
89805,37,1555117200,30,0,30,Clouds
89806,38,1555117200,37,3,40,Clouds
89807,39,1555117200,19,1,20,Clouds
89808,40,1555117200,20,1,21,Clouds
89809,41,1555117200,18,2,20,Clouds
89810,42,1555117200,0,30,30,Clouds
89811,43,1555117200,15,15,30,Clouds
89812,44,1555117200,0,30,30,Clouds
89813,45,1555117200,8,22,30,Clouds
89814,46,1555117200,18,2,20,Clouds
89815,47,1555117200,40,0,40,Clouds
89816,48,1555117200,39,1,40,Clouds
89817,49,1555117200,37,3,40,Clouds
89818,50,1555117200,0,40,40,Clouds
89819,51,1555117200,32,8,40,Clouds
89820,52,1555117200,32,0,32,Clouds
89821,53,1555117200,40,0,40,Clouds
89822,54,1555117200,31,2,33,Clouds
89823,55,1555117200,35,1,36,Clouds
89824,56,1555117200,37,3,40,Clouds
89825,57,1555117200,22,1,23,Clouds
89826,58,1555117200,35,5,40,Clouds
89827,59,1555117200,11,9,20,Clouds
89828,60,1555117200,0,30,30,Clouds
89829,61,1555117200,10,15,25,Clouds
89830,62,1555117200,40,0,40,Clouds
89831,63,1555117200,34,1,35,Clouds
89832,64,1555117200,39,1,40,Clouds
89833,65,1555117200,37,3,40,Clouds
89834,66,1555117200,29,11,40,Clouds
89835,67,1555117200,30,10,40,Clouds
89836,68,1555117200,39,1,40,Clouds
89837,69,1555117200,40,0,40,Clouds
89838,70,1555117200,19,9,28,Clouds
89839,71,1555117200,35,5,40,Clouds
89840,72,1555117200,14,17,31,Clouds
89841,73,1555117200,18,12,30,Clouds
89842,74,1555117200,6,24,30,Clouds
89843,75,1555117200,16,24,40,Clouds
89844,76,1555117200,12,26,38,Clouds
89845,77,1555117200,28,1,29,Clouds
89846,78,1555117200,23,17,40,Clouds
89847,79,1555117200,26,1,27,Clouds
89848,80,1555117200,20,20,40,Clouds
89849,81,1555117200,25,15,40,Clouds
89850,82,1555117200,10,12,22,Clouds
89851,83,1555117200,11,29,40,Clouds
89852,84,1555117200,10,20,30,Clouds
89853,85,1555117200,12,23,35,Clouds
89854,86,1555117200,1,37,38,Clouds
89855,87,1555117200,13,25,38,Clouds
89856,88,1555117200,0,30,30,Clouds
89857,89,1555117200,39,1,40,Clouds
89858,90,1555117200,37,3,40,Clouds
89859,91,1555117200,9,21,30,Clouds
89860,92,1555117200,2,38,40,Clouds
89861,93,1555117200,0,40,40,Clouds
89862,94,1555117200,11,29,40,Clouds
89863,95,1555117200,7,33,40,Clouds
89864,96,1555117200,15,15,30,Clouds
89865,97,1555117200,13,27,40,Clouds
89866,98,1555117200,40,0,40,Clouds
89867,99,1555117200,29,1,30,Clouds
89868,100,1555117200,0,25,25,Clouds
89869,101,1555117200,19,11,30,Clouds
89870,102,1555117200,15,25,40,Clouds
89871,103,1555117200,38,2,40,Clouds
89872,104,1555117200,26,14,40,Clouds
89873,105,1555117200,25,11,36,Clouds
89874,106,1555117200,15,25,40,Clouds
89875,107,1555117200,28,12,40,Clouds
89876,108,1555117200,35,5,40,Clouds
89877,109,1555117200,2,27,29,Clouds
89878,110,1555117200,30,10,40,Clouds
89879,111,1555117200,25,15,40,Clouds
89880,112,1555117200,0,30,30,Clouds
89881,113,1555117200,39,1,40,Clouds
89882,114,1555117200,40,0,40,Clouds
89883,115,1555117200,0,30,30,Clouds
89884,2,1555120800,5,15,20,Clouds
89885,3,1555120800,14,6,20,Clouds
89886,4,1555120800,18,2,20,Clouds
89887,5,1555120800,38,2,40,Clouds
89888,6,1555120800,17,3,20,Clouds
89889,7,1555120800,16,13,29,Clouds
89890,8,1555120800,29,1,30,Clouds
89891,9,1555120800,24,0,24,Clouds
89892,10,1555120800,7,9,16,Clouds
89893,11,1555120800,30,0,30,Clouds
89894,12,1555120800,13,7,20,Clouds
89895,13,1555120800,30,0,30,Clouds
89896,14,1555120800,16,14,30,Clouds
89897,15,1555120800,13,3,16,Clouds
89898,16,1555120800,7,13,20,Clouds
89899,17,1555120800,12,8,20,Clouds
89900,18,1555120800,22,8,30,Clouds
89901,19,1555120800,27,3,30,Clouds
89902,21,1555120800,24,6,30,Clouds
89903,22,1555120800,12,8,20,Clouds
89904,23,1555120800,10,20,30,Clouds
89905,24,1555120800,0,20,20,Clouds
89906,25,1555120800,25,5,30,Clouds
89907,26,1555120800,20,0,20,Clouds
89908,27,1555120800,20,0,20,Clouds
89909,28,1555120800,22,8,30,Clouds
89910,29,1555120800,12,17,29,Clouds
89911,30,1555120800,18,2,20,Clouds
89912,31,1555120800,18,2,20,Clouds
89913,32,1555120800,18,12,30,Clouds
89914,33,1555120800,3,20,23,Clouds
89915,34,1555120800,16,14,30,Clouds
89916,35,1555120800,12,18,30,Clouds
89917,36,1555120800,40,0,40,Clouds
89918,37,1555120800,30,0,30,Clouds
89919,38,1555120800,37,3,40,Clouds
89920,39,1555120800,19,1,20,Clouds
89921,40,1555120800,20,1,21,Clouds
89922,41,1555120800,18,2,20,Clouds
89923,42,1555120800,0,30,30,Clouds
89924,43,1555120800,15,15,30,Clouds
89925,44,1555120800,0,30,30,Clouds
89926,45,1555120800,8,22,30,Clouds
89927,46,1555120800,18,2,20,Clouds
89928,47,1555120800,40,0,40,Clouds
89929,48,1555120800,39,1,40,Clouds
89930,49,1555120800,37,3,40,Clouds
89931,50,1555120800,0,40,40,Clouds
89932,51,1555120800,32,8,40,Clouds
89933,52,1555120800,32,0,32,Clouds
89934,53,1555120800,40,0,40,Clouds
89935,54,1555120800,31,2,33,Clouds
89936,55,1555120800,35,1,36,Clouds
89937,56,1555120800,37,3,40,Clouds
89938,57,1555120800,22,1,23,Clouds
89939,58,1555120800,35,5,40,Clouds
89940,59,1555120800,11,9,20,Clouds
89941,60,1555120800,0,30,30,Clouds
89942,61,1555120800,10,15,25,Clouds
89943,62,1555120800,40,0,40,Clouds
89944,63,1555120800,34,1,35,Clouds
89945,64,1555120800,39,1,40,Clouds
89946,65,1555120800,37,3,40,Clouds
89947,66,1555120800,29,11,40,Clouds
89948,67,1555120800,30,10,40,Clouds
89949,68,1555120800,39,1,40,Clouds
89950,69,1555120800,40,0,40,Clouds
89951,70,1555120800,19,9,28,Clouds
89952,71,1555120800,35,5,40,Clouds
89953,72,1555120800,14,17,31,Clouds
89954,73,1555120800,18,12,30,Clouds
89955,74,1555120800,6,24,30,Clouds
89956,75,1555120800,16,24,40,Clouds
89957,76,1555120800,12,26,38,Clouds
89958,77,1555120800,28,1,29,Clouds
89959,78,1555120800,23,17,40,Clouds
89960,79,1555120800,26,1,27,Clouds
89961,80,1555120800,20,20,40,Clouds
89962,81,1555120800,25,15,40,Clouds
89963,82,1555120800,10,12,22,Clouds
89964,83,1555120800,11,29,40,Clouds
89965,84,1555120800,8,22,30,Clouds
89966,85,1555120800,12,23,35,Clouds
89967,86,1555120800,1,37,38,Clouds
89968,87,1555120800,13,25,38,Clouds
89969,88,1555120800,0,30,30,Clouds
89970,89,1555120800,39,1,40,Clouds
89971,90,1555120800,37,3,40,Clouds
89972,91,1555120800,9,21,30,Clouds
89973,92,1555120800,2,38,40,Clouds
89974,93,1555120800,0,40,40,Clouds
89975,94,1555120800,11,29,40,Clouds
89976,95,1555120800,7,33,40,Clouds
89977,96,1555120800,15,15,30,Clouds
89978,97,1555120800,13,27,40,Clouds
89979,98,1555120800,40,0,40,Clouds
89980,99,1555120800,29,1,30,Clouds
89981,100,1555120800,0,25,25,Clouds
89982,101,1555120800,19,11,30,Clouds
89983,102,1555120800,15,25,40,Clouds
89984,103,1555120800,38,2,40,Clouds
89985,104,1555120800,26,14,40,Clouds
89986,105,1555120800,25,11,36,Clouds
89987,106,1555120800,15,25,40,Clouds
89988,107,1555120800,28,12,40,Clouds
89989,108,1555120800,35,5,40,Clouds
89990,109,1555120800,2,27,29,Clouds
89991,110,1555120800,30,10,40,Clouds
89992,111,1555120800,25,15,40,Clouds
89993,112,1555120800,0,30,30,Clouds
89994,113,1555120800,39,1,40,Clouds
89995,114,1555120800,40,0,40,Clouds
89996,115,1555120800,0,30,30,Clouds
89997,2,1555124400,5,15,20,Clouds
89998,3,1555124400,14,6,20,Clouds
89999,4,1555124400,18,2,20,Clouds
90000,5,1555124400,38,2,40,Clouds
90001,6,1555124400,17,3,20,Clouds
90002,7,1555124400,16,13,29,Clouds
90003,8,1555124400,29,1,30,Clouds
90004,9,1555124400,24,0,24,Clouds
90005,10,1555124400,7,9,16,Clouds
90006,11,1555124400,30,0,30,Clouds
90007,12,1555124400,13,7,20,Clouds
90008,13,1555124400,30,0,30,Clouds
90009,14,1555124400,16,14,30,Clouds
90010,15,1555124400,13,3,16,Clouds
90011,16,1555124400,7,13,20,Clouds
90012,17,1555124400,12,8,20,Clouds
90013,18,1555124400,22,8,30,Clouds
90014,19,1555124400,27,3,30,Clouds
90015,21,1555124400,24,6,30,Clouds
90016,22,1555124400,12,8,20,Clouds
90017,23,1555124400,10,20,30,Clouds
90018,24,1555124400,0,20,20,Clouds
90019,25,1555124400,25,5,30,Clouds
90020,26,1555124400,20,0,20,Clouds
90021,27,1555124400,20,0,20,Clouds
90022,28,1555124400,22,8,30,Clouds
90023,29,1555124400,11,18,29,Clouds
90024,30,1555124400,18,2,20,Clouds
90025,31,1555124400,18,2,20,Clouds
90026,32,1555124400,18,12,30,Clouds
90027,33,1555124400,3,20,23,Clouds
90028,34,1555124400,16,14,30,Clouds
90029,35,1555124400,12,18,30,Clouds
90030,36,1555124400,40,0,40,Clouds
90031,37,1555124400,30,0,30,Clouds
90032,38,1555124400,37,3,40,Clouds
90033,39,1555124400,19,1,20,Clouds
90034,40,1555124400,19,2,21,Clouds
90035,41,1555124400,18,2,20,Clouds
90036,42,1555124400,0,30,30,Clouds
90037,43,1555124400,15,15,30,Clouds
90038,44,1555124400,0,30,30,Clouds
90039,45,1555124400,7,23,30,Clouds
90040,46,1555124400,18,2,20,Clouds
90041,47,1555124400,40,0,40,Clouds
90042,48,1555124400,39,1,40,Clouds
90043,49,1555124400,37,3,40,Clouds
90044,50,1555124400,0,40,40,Clouds
90045,51,1555124400,32,8,40,Clouds
90046,52,1555124400,32,0,32,Clouds
90047,53,1555124400,40,0,40,Clouds
90048,54,1555124400,31,2,33,Clouds
90049,55,1555124400,35,1,36,Clouds
90050,56,1555124400,37,3,40,Clouds
90051,57,1555124400,22,1,23,Clouds
90052,58,1555124400,35,5,40,Clouds
90053,59,1555124400,11,9,20,Clouds
90054,60,1555124400,0,30,30,Clouds
90055,61,1555124400,10,15,25,Clouds
90056,62,1555124400,40,0,40,Clouds
90057,63,1555124400,34,1,35,Clouds
90058,64,1555124400,39,1,40,Clouds
90059,65,1555124400,37,3,40,Clouds
90060,66,1555124400,29,11,40,Clouds
90061,67,1555124400,30,10,40,Clouds
90062,68,1555124400,39,1,40,Clouds
90063,69,1555124400,40,0,40,Clouds
90064,70,1555124400,19,9,28,Clouds
90065,71,1555124400,35,5,40,Clouds
90066,72,1555124400,14,17,31,Clouds
90067,73,1555124400,18,12,30,Clouds
90068,74,1555124400,6,24,30,Clouds
90069,75,1555124400,16,24,40,Clouds
90070,76,1555124400,12,26,38,Clouds
90071,77,1555124400,28,1,29,Clouds
90072,78,1555124400,23,17,40,Clouds
90073,79,1555124400,26,1,27,Clouds
90074,80,1555124400,20,20,40,Clouds
90075,81,1555124400,25,15,40,Clouds
90076,82,1555124400,10,12,22,Clouds
90077,83,1555124400,11,29,40,Clouds
90078,84,1555124400,8,22,30,Clouds
90079,85,1555124400,12,23,35,Clouds
90080,86,1555124400,1,37,38,Clouds
90081,87,1555124400,13,25,38,Clouds
90082,88,1555124400,0,30,30,Clouds
90083,89,1555124400,39,1,40,Clouds
90084,90,1555124400,37,3,40,Clouds
90085,91,1555124400,9,21,30,Clouds
90086,92,1555124400,2,38,40,Clouds
90087,93,1555124400,0,40,40,Clouds
90088,94,1555124400,11,29,40,Clouds
90089,95,1555124400,7,33,40,Clouds
90090,96,1555124400,15,15,30,Clouds
90091,97,1555124400,13,27,40,Clouds
90092,98,1555124400,40,0,40,Clouds
90093,99,1555124400,29,1,30,Clouds
90094,100,1555124400,0,25,25,Clouds
90095,101,1555124400,19,11,30,Clouds
90096,102,1555124400,15,25,40,Clouds
90097,103,1555124400,38,2,40,Clouds
90098,104,1555124400,26,14,40,Clouds
90099,105,1555124400,25,11,36,Clouds
90100,106,1555124400,15,25,40,Clouds
90101,107,1555124400,28,12,40,Clouds
90102,108,1555124400,35,5,40,Clouds
90103,109,1555124400,2,27,29,Clouds
90104,110,1555124400,30,10,40,Clouds
90105,111,1555124400,25,15,40,Clouds
90106,112,1555124400,0,30,30,Clouds
90107,113,1555124400,39,1,40,Clouds
90108,114,1555124400,40,0,40,Clouds
90109,115,1555124400,0,30,30,Clouds
90110,2,1555128000,5,15,20,Clouds
90111,3,1555128000,14,6,20,Clouds
90112,4,1555128000,18,2,20,Clouds
90113,5,1555128000,38,2,40,Clouds
90114,6,1555128000,17,3,20,Clouds
90115,7,1555128000,16,13,29,Clouds
90116,8,1555128000,29,1,30,Clouds
90117,9,1555128000,24,0,24,Clouds
90118,10,1555128000,7,9,16,Clouds
90119,11,1555128000,30,0,30,Clouds
90120,12,1555128000,13,7,20,Clouds
90121,13,1555128000,30,0,30,Clouds
90122,14,1555128000,16,14,30,Clouds
90123,15,1555128000,13,3,16,Clouds
90124,16,1555128000,7,13,20,Clouds
90125,17,1555128000,12,8,20,Clouds
90126,18,1555128000,21,9,30,Clouds
90127,19,1555128000,27,3,30,Clouds
90128,21,1555128000,24,6,30,Clouds
90129,22,1555128000,12,8,20,Clouds
90130,23,1555128000,10,20,30,Clouds
90131,24,1555128000,0,20,20,Clouds
90132,25,1555128000,25,5,30,Clouds
90133,26,1555128000,20,0,20,Clouds
90134,27,1555128000,20,0,20,Clouds
90135,28,1555128000,22,8,30,Clouds
90136,29,1555128000,11,18,29,Clouds
90137,30,1555128000,18,2,20,Clouds
90138,31,1555128000,18,2,20,Clouds
90139,32,1555128000,18,12,30,Clouds
90140,33,1555128000,3,20,23,Clouds
90141,34,1555128000,16,14,30,Clouds
90142,35,1555128000,12,18,30,Clouds
90143,36,1555128000,40,0,40,Clouds
90144,37,1555128000,30,0,30,Clouds
90145,38,1555128000,37,3,40,Clouds
90146,39,1555128000,19,1,20,Clouds
90147,40,1555128000,19,2,21,Clouds
90148,41,1555128000,18,2,20,Clouds
90149,42,1555128000,0,30,30,Clouds
90150,43,1555128000,15,15,30,Clouds
90151,44,1555128000,0,30,30,Clouds
90152,45,1555128000,7,23,30,Clouds
90153,46,1555128000,18,2,20,Clouds
90154,47,1555128000,40,0,40,Clouds
90155,48,1555128000,39,1,40,Clouds
90156,49,1555128000,37,3,40,Clouds
90157,50,1555128000,0,40,40,Clouds
90158,51,1555128000,32,8,40,Clouds
90159,52,1555128000,32,0,32,Clouds
90160,53,1555128000,40,0,40,Clouds
90161,54,1555128000,31,2,33,Clouds
90162,55,1555128000,35,1,36,Clouds
90163,56,1555128000,37,3,40,Clouds
90164,57,1555128000,22,1,23,Clouds
90165,58,1555128000,35,5,40,Clouds
90166,59,1555128000,11,9,20,Clouds
90167,60,1555128000,0,30,30,Clouds
90168,61,1555128000,10,15,25,Clouds
90169,62,1555128000,40,0,40,Clouds
90170,63,1555128000,34,1,35,Clouds
90171,64,1555128000,39,1,40,Clouds
90172,65,1555128000,37,3,40,Clouds
90173,66,1555128000,29,11,40,Clouds
90174,67,1555128000,30,10,40,Clouds
90175,68,1555128000,39,1,40,Clouds
90176,69,1555128000,40,0,40,Clouds
90177,70,1555128000,19,9,28,Clouds
90178,71,1555128000,35,5,40,Clouds
90179,72,1555128000,14,17,31,Clouds
90180,73,1555128000,18,12,30,Clouds
90181,74,1555128000,6,24,30,Clouds
90182,75,1555128000,16,24,40,Clouds
90183,76,1555128000,12,26,38,Clouds
90184,77,1555128000,28,1,29,Clouds
90185,78,1555128000,23,17,40,Clouds
90186,79,1555128000,26,1,27,Clouds
90187,80,1555128000,20,20,40,Clouds
90188,81,1555128000,25,15,40,Clouds
90189,82,1555128000,10,12,22,Clouds
90190,83,1555128000,11,29,40,Clouds
90191,84,1555128000,8,22,30,Clouds
90192,85,1555128000,12,23,35,Clouds
90193,86,1555128000,1,37,38,Clouds
90194,87,1555128000,13,25,38,Clouds
90195,88,1555128000,0,30,30,Clouds
90196,89,1555128000,38,1,39,Clouds
90197,90,1555128000,37,3,40,Clouds
90198,91,1555128000,9,21,30,Clouds
90199,92,1555128000,2,38,40,Clouds
90200,93,1555128000,0,40,40,Clouds
90201,94,1555128000,11,29,40,Clouds
90202,95,1555128000,7,33,40,Clouds
90203,96,1555128000,15,15,30,Clouds
90204,97,1555128000,13,27,40,Clouds
90205,98,1555128000,40,0,40,Clouds
90206,99,1555128000,29,1,30,Clouds
90207,100,1555128000,0,25,25,Clouds
90208,101,1555128000,19,11,30,Clouds
90209,102,1555128000,15,25,40,Clouds
90210,103,1555128000,38,2,40,Clouds
90211,104,1555128000,26,14,40,Clouds
90212,105,1555128000,25,11,36,Clouds
90213,106,1555128000,15,25,40,Clouds
90214,107,1555128000,28,12,40,Clouds
90215,108,1555128000,35,5,40,Clouds
90216,109,1555128000,2,27,29,Clouds
90217,110,1555128000,30,10,40,Clouds
90218,111,1555128000,25,15,40,Clouds
90219,112,1555128000,0,30,30,Clouds
90220,113,1555128000,39,1,40,Clouds
90221,114,1555128000,40,0,40,Clouds
90222,115,1555128000,0,30,30,Clouds
90223,2,1555131600,5,15,20,Clouds
90224,3,1555131600,14,6,20,Clouds
90225,4,1555131600,18,2,20,Clouds
90226,5,1555131600,38,2,40,Clouds
90227,6,1555131600,17,3,20,Clouds
90228,7,1555131600,16,13,29,Clouds
90229,8,1555131600,29,1,30,Clouds
90230,9,1555131600,24,0,24,Clouds
90231,10,1555131600,7,9,16,Clouds
90232,11,1555131600,30,0,30,Clouds
90233,12,1555131600,13,7,20,Clouds
90234,13,1555131600,30,0,30,Clouds
90235,14,1555131600,16,14,30,Clouds
90236,15,1555131600,13,3,16,Clouds
90237,16,1555131600,7,13,20,Clouds
90238,17,1555131600,12,8,20,Clouds
90239,18,1555131600,21,9,30,Clouds
90240,19,1555131600,27,3,30,Clouds
90241,21,1555131600,24,6,30,Clouds
90242,22,1555131600,12,8,20,Clouds
90243,23,1555131600,10,20,30,Clouds
90244,24,1555131600,0,20,20,Clouds
90245,25,1555131600,25,5,30,Clouds
90246,26,1555131600,20,0,20,Clouds
90247,27,1555131600,20,0,20,Clouds
90248,28,1555131600,22,8,30,Clouds
90249,29,1555131600,12,17,29,Clouds
90250,30,1555131600,18,2,20,Clouds
90251,31,1555131600,18,2,20,Clouds
90252,32,1555131600,18,12,30,Clouds
90253,33,1555131600,3,20,23,Clouds
90254,34,1555131600,16,14,30,Clouds
90255,35,1555131600,12,18,30,Clouds
90256,36,1555131600,40,0,40,Clouds
90257,37,1555131600,30,0,30,Clouds
90258,38,1555131600,37,3,40,Clouds
90259,39,1555131600,19,1,20,Clouds
90260,40,1555131600,19,2,21,Clouds
90261,41,1555131600,18,2,20,Clouds
90262,42,1555131600,0,30,30,Clouds
90263,43,1555131600,15,15,30,Clouds
90264,44,1555131600,0,30,30,Clouds
90265,45,1555131600,7,23,30,Clouds
90266,46,1555131600,18,2,20,Clouds
90267,47,1555131600,40,0,40,Clouds
90268,48,1555131600,39,1,40,Clouds
90269,49,1555131600,37,3,40,Clouds
90270,50,1555131600,0,40,40,Clouds
90271,51,1555131600,32,8,40,Clouds
90272,52,1555131600,32,0,32,Clouds
90273,53,1555131600,40,0,40,Clouds
90274,54,1555131600,31,2,33,Clouds
90275,55,1555131600,35,1,36,Clouds
90276,56,1555131600,37,3,40,Clouds
90277,57,1555131600,22,1,23,Clouds
90278,58,1555131600,35,5,40,Clouds
90279,59,1555131600,11,9,20,Clouds
90280,60,1555131600,0,30,30,Clouds
90281,61,1555131600,10,15,25,Clouds
90282,62,1555131600,40,0,40,Clouds
90283,63,1555131600,34,1,35,Clouds
90284,64,1555131600,39,1,40,Clouds
90285,65,1555131600,37,3,40,Clouds
90286,66,1555131600,29,11,40,Clouds
90287,67,1555131600,30,10,40,Clouds
90288,68,1555131600,39,1,40,Clouds
90289,69,1555131600,40,0,40,Clouds
90290,70,1555131600,19,9,28,Clouds
90291,71,1555131600,35,5,40,Clouds
90292,72,1555131600,14,17,31,Clouds
90293,73,1555131600,18,12,30,Clouds
90294,74,1555131600,6,24,30,Clouds
90295,75,1555131600,16,24,40,Clouds
90296,76,1555131600,12,26,38,Clouds
90297,77,1555131600,28,1,29,Clouds
90298,78,1555131600,23,17,40,Clouds
90299,79,1555131600,26,1,27,Clouds
90300,80,1555131600,20,20,40,Clouds
90301,81,1555131600,25,15,40,Clouds
90302,82,1555131600,10,12,22,Clouds
90303,83,1555131600,11,29,40,Clouds
90304,84,1555131600,8,22,30,Clouds
90305,85,1555131600,12,23,35,Clouds
90306,86,1555131600,1,37,38,Clouds
90307,87,1555131600,13,25,38,Clouds
90308,88,1555131600,0,30,30,Clouds
90309,89,1555131600,38,1,39,Clouds
90310,90,1555131600,37,3,40,Clouds
90311,91,1555131600,9,21,30,Clouds
90312,92,1555131600,2,38,40,Clouds
90313,93,1555131600,0,40,40,Clouds
90314,94,1555131600,11,29,40,Clouds
90315,95,1555131600,7,33,40,Clouds
90316,96,1555131600,15,15,30,Clouds
90317,97,1555131600,13,27,40,Clouds
90318,98,1555131600,40,0,40,Clouds
90319,99,1555131600,29,1,30,Clouds
90320,100,1555131600,0,25,25,Clouds
90321,101,1555131600,19,11,30,Clouds
90322,102,1555131600,15,25,40,Clouds
90323,103,1555131600,38,2,40,Clouds
90324,104,1555131600,26,14,40,Clouds
90325,105,1555131600,25,11,36,Clouds
90326,106,1555131600,15,25,40,Clouds
90327,107,1555131600,28,12,40,Clouds
90328,108,1555131600,35,5,40,Clouds
90329,109,1555131600,2,27,29,Clouds
90330,110,1555131600,30,10,40,Clouds
90331,111,1555131600,25,15,40,Clouds
90332,112,1555131600,0,30,30,Clouds
90333,113,1555131600,39,1,40,Clouds
90334,114,1555131600,40,0,40,Clouds
90335,115,1555131600,0,30,30,Clouds
90336,2,1555135200,5,15,20,Clouds
90337,3,1555135200,14,6,20,Clouds
90338,4,1555135200,18,2,20,Clouds
90339,5,1555135200,37,3,40,Clouds
90340,6,1555135200,18,2,20,Clouds
90341,7,1555135200,16,13,29,Clouds
90342,8,1555135200,29,1,30,Clouds
90343,9,1555135200,21,3,24,Clouds
90344,10,1555135200,7,9,16,Clouds
90345,11,1555135200,30,0,30,Clouds
90346,12,1555135200,16,4,20,Clouds
90347,13,1555135200,30,0,30,Clouds
90348,14,1555135200,10,19,29,Clouds
90349,15,1555135200,14,2,16,Clouds
90350,16,1555135200,7,13,20,Clouds
90351,17,1555135200,12,8,20,Clouds
90352,18,1555135200,21,9,30,Clouds
90353,19,1555135200,29,1,30,Clouds
90354,21,1555135200,27,3,30,Clouds
90355,22,1555135200,12,8,20,Clouds
90356,23,1555135200,10,20,30,Clouds
90357,24,1555135200,0,20,20,Clouds
90358,25,1555135200,24,6,30,Clouds
90359,26,1555135200,20,0,20,Clouds
90360,27,1555135200,20,0,20,Clouds
90361,28,1555135200,21,9,30,Clouds
90362,29,1555135200,13,16,29,Clouds
90363,30,1555135200,18,2,20,Clouds
90364,31,1555135200,14,6,20,Clouds
90365,32,1555135200,19,11,30,Clouds
90366,33,1555135200,0,23,23,Clouds
90367,34,1555135200,18,12,30,Clouds
90368,35,1555135200,8,22,30,Clouds
90369,36,1555135200,40,0,40,Clouds
90370,37,1555135200,30,0,30,Clouds
90371,38,1555135200,34,6,40,Clouds
90372,39,1555135200,20,0,20,Clouds
90373,40,1555135200,19,2,21,Clouds
90374,41,1555135200,18,2,20,Clouds
90375,42,1555135200,2,28,30,Clouds
90376,43,1555135200,16,14,30,Clouds
90377,44,1555135200,1,29,30,Clouds
90378,45,1555135200,4,26,30,Clouds
90379,46,1555135200,18,2,20,Clouds
90380,47,1555135200,40,0,40,Clouds
90381,48,1555135200,39,1,40,Clouds
90382,49,1555135200,37,3,40,Clouds
90383,50,1555135200,2,38,40,Clouds
90384,51,1555135200,32,8,40,Clouds
90385,52,1555135200,30,2,32,Clouds
90386,53,1555135200,40,0,40,Clouds
90387,54,1555135200,31,2,33,Clouds
90388,55,1555135200,35,1,36,Clouds
90389,56,1555135200,37,3,40,Clouds
90390,57,1555135200,21,2,23,Clouds
90391,58,1555135200,35,5,40,Clouds
90392,59,1555135200,10,10,20,Clouds
90393,60,1555135200,2,28,30,Clouds
90394,61,1555135200,10,15,25,Clouds
90395,62,1555135200,40,0,40,Clouds
90396,63,1555135200,34,1,35,Clouds
90397,64,1555135200,39,1,40,Clouds
90398,65,1555135200,37,3,40,Clouds
90399,66,1555135200,29,11,40,Clouds
90400,67,1555135200,28,12,40,Clouds
90401,68,1555135200,39,1,40,Clouds
90402,69,1555135200,39,1,40,Clouds
90403,70,1555135200,18,10,28,Clouds
90404,71,1555135200,39,1,40,Clouds
90405,72,1555135200,13,18,31,Clouds
90406,73,1555135200,18,12,30,Clouds
90407,74,1555135200,6,24,30,Clouds
90408,75,1555135200,18,22,40,Clouds
90409,76,1555135200,12,26,38,Clouds
90410,77,1555135200,25,4,29,Clouds
90411,78,1555135200,23,17,40,Clouds
90412,79,1555135200,26,1,27,Clouds
90413,80,1555135200,22,18,40,Clouds
90414,81,1555135200,25,15,40,Clouds
90415,82,1555135200,11,11,22,Clouds
90416,83,1555135200,11,29,40,Clouds
90417,84,1555135200,11,19,30,Clouds
90418,85,1555135200,13,22,35,Clouds
90419,86,1555135200,2,36,38,Clouds
90420,87,1555135200,12,26,38,Clouds
90421,88,1555135200,1,29,30,Clouds
90422,89,1555135200,38,1,39,Clouds
90423,90,1555135200,37,3,40,Clouds
90424,91,1555135200,9,21,30,Clouds
90425,92,1555135200,3,37,40,Clouds
90426,93,1555135200,0,40,40,Clouds
90427,94,1555135200,11,29,40,Clouds
90428,95,1555135200,7,33,40,Clouds
90429,96,1555135200,15,15,30,Clouds
90430,97,1555135200,13,27,40,Clouds
90431,98,1555135200,40,0,40,Clouds
90432,99,1555135200,29,1,30,Clouds
90433,100,1555135200,0,25,25,Clouds
90434,101,1555135200,19,11,30,Clouds
90435,102,1555135200,15,25,40,Clouds
90436,103,1555135200,38,2,40,Clouds
90437,104,1555135200,26,14,40,Clouds
90438,105,1555135200,25,11,36,Clouds
90439,106,1555135200,15,25,40,Clouds
90440,107,1555135200,29,11,40,Clouds
90441,108,1555135200,37,3,40,Clouds
90442,109,1555135200,6,23,29,Clouds
90443,110,1555135200,31,9,40,Clouds
90444,111,1555135200,25,15,40,Clouds
90445,112,1555135200,3,27,30,Clouds
90446,113,1555135200,40,0,40,Clouds
90447,114,1555135200,40,0,40,Clouds
90448,115,1555135200,1,29,30,Clouds
90449,2,1555138800,11,9,20,Clouds
90450,3,1555138800,17,3,20,Clouds
90451,4,1555138800,19,1,20,Clouds
90452,5,1555138800,22,18,40,Clouds
90453,6,1555138800,17,3,20,Clouds
90454,7,1555138800,17,12,29,Clouds
90455,8,1555138800,28,2,30,Clouds
90456,9,1555138800,16,8,24,Clouds
90457,10,1555138800,5,11,16,Clouds
90458,11,1555138800,28,2,30,Clouds
90459,12,1555138800,20,0,20,Clouds
90460,13,1555138800,30,0,30,Clouds
90461,14,1555138800,4,26,30,Clouds
90462,15,1555138800,15,1,16,Clouds
90463,16,1555138800,7,13,20,Clouds
90464,17,1555138800,11,9,20,Clouds
90465,18,1555138800,24,6,30,Clouds
90466,19,1555138800,23,7,30,Clouds
90467,21,1555138800,28,2,30,Clouds
90468,22,1555138800,15,5,20,Clouds
90469,23,1555138800,27,3,30,Clouds
90470,24,1555138800,1,19,20,Clouds
90471,25,1555138800,25,5,30,Clouds
90472,26,1555138800,18,2,20,Clouds
90473,27,1555138800,17,3,20,Clouds
90474,28,1555138800,21,9,30,Clouds
90475,29,1555138800,11,18,29,Clouds
90476,30,1555138800,17,3,20,Clouds
90477,31,1555138800,8,12,20,Clouds
90478,32,1555138800,20,10,30,Clouds
90479,33,1555138800,1,22,23,Clouds
90480,34,1555138800,20,10,30,Clouds
90481,35,1555138800,11,19,30,Clouds
90482,36,1555138800,40,0,40,Clouds
90483,37,1555138800,30,0,30,Clouds
90484,38,1555138800,34,6,40,Clouds
90485,39,1555138800,17,3,20,Clouds
90486,40,1555138800,18,3,21,Clouds
90487,41,1555138800,20,0,20,Clouds
90488,42,1555138800,6,24,30,Clouds
90489,43,1555138800,17,13,30,Clouds
90490,44,1555138800,3,27,30,Clouds
90491,45,1555138800,2,28,30,Clouds
90492,46,1555138800,18,2,20,Clouds
90493,47,1555138800,40,0,40,Clouds
90494,48,1555138800,38,2,40,Clouds
90495,49,1555138800,38,2,40,Clouds
90496,50,1555138800,6,34,40,Clouds
90497,51,1555138800,30,10,40,Clouds
90498,52,1555138800,27,5,32,Clouds
90499,53,1555138800,40,0,40,Clouds
90500,54,1555138800,31,2,33,Clouds
90501,55,1555138800,35,1,36,Clouds
90502,56,1555138800,38,2,40,Clouds
90503,57,1555138800,21,2,23,Clouds
90504,58,1555138800,30,10,40,Clouds
90505,59,1555138800,11,9,20,Clouds
90506,60,1555138800,6,24,30,Clouds
90507,61,1555138800,11,14,25,Clouds
90508,62,1555138800,40,0,40,Clouds
90509,63,1555138800,33,2,35,Clouds
90510,64,1555138800,37,3,40,Clouds
90511,65,1555138800,37,3,40,Clouds
90512,66,1555138800,29,11,40,Clouds
90513,67,1555138800,23,17,40,Clouds
90514,68,1555138800,39,1,40,Clouds
90515,69,1555138800,39,1,40,Clouds
90516,70,1555138800,16,12,28,Clouds
90517,71,1555138800,38,2,40,Clouds
90518,72,1555138800,13,18,31,Clouds
90519,73,1555138800,18,12,30,Clouds
90520,74,1555138800,8,22,30,Clouds
90521,75,1555138800,17,23,40,Clouds
90522,76,1555138800,13,25,38,Clouds
90523,77,1555138800,27,2,29,Clouds
90524,78,1555138800,22,18,40,Clouds
90525,79,1555138800,26,1,27,Clouds
90526,80,1555138800,23,17,40,Clouds
90527,81,1555138800,25,15,40,Clouds
90528,82,1555138800,13,9,22,Clouds
90529,83,1555138800,14,26,40,Clouds
90530,84,1555138800,12,18,30,Clouds
90531,85,1555138800,14,21,35,Clouds
90532,86,1555138800,3,35,38,Clouds
90533,87,1555138800,12,26,38,Clouds
90534,88,1555138800,4,26,30,Clouds
90535,89,1555138800,38,1,39,Clouds
90536,90,1555138800,35,5,40,Clouds
90537,91,1555138800,10,20,30,Clouds
90538,92,1555138800,0,40,40,Clouds
90539,93,1555138800,0,40,40,Clouds
90540,94,1555138800,11,29,40,Clouds
90541,95,1555138800,7,33,40,Clouds
90542,96,1555138800,15,15,30,Clouds
90543,97,1555138800,13,27,40,Clouds
90544,98,1555138800,40,0,40,Clouds
90545,99,1555138800,28,2,30,Clouds
90546,100,1555138800,0,25,25,Clouds
90547,101,1555138800,22,8,30,Clouds
90548,102,1555138800,12,28,40,Clouds
90549,103,1555138800,39,1,40,Clouds
90550,104,1555138800,26,14,40,Clouds
90551,105,1555138800,25,11,36,Clouds
90552,106,1555138800,15,25,40,Clouds
90553,107,1555138800,30,10,40,Clouds
90554,108,1555138800,39,1,40,Clouds
90555,109,1555138800,9,20,29,Clouds
90556,110,1555138800,30,10,40,Clouds
90557,111,1555138800,26,14,40,Clouds
90558,112,1555138800,6,24,30,Clouds
90559,113,1555138800,40,0,40,Clouds
90560,114,1555138800,38,2,40,Clouds
90561,115,1555138800,2,28,30,Clouds
